Barcode,Sample,Barcoded_Reads,Trimmed_Reads,Unmapped_Reads,Mapped_Reads,Multimapped_Reads,Uniquely_Mapped_Reads,Exon_Reads,Ambiguous_Exon_Reads,Intron_Reads,Ambiguous_Intron_Reads,Gene_Reads,Intergenic_Reads,No_of_Genes,No_of_Transcripts,Mitochondrial_Reads,Ribosomal_Reads
TCTAGGTTCGTTGGTT,sample,69395,68280,2870,65410,15945,49465,27689,2747,13140,1589,40829,4300,2796,1396,5800,10125
GTCGTTCTCGTTGGTT,sample,122493,121363,3452,117911,20620,97291,54924,4834,27248,2985,82172,7300,3175,2315,13577,14963
AGAGTTCTCGTTGGTT,sample,212583,210723,5007,205716,43537,162179,140971,10013,7103,1571,148074,2521,1491,1944,41821,32014
GACGTATGCGTTGGTT,sample,154101,152877,6116,146761,23127,123634,77593,4748,28694,3628,106287,8971,5333,3171,15682,16171
CATAATGGCGTTGGTT,sample,194189,192561,13820,178741,35297,143444,75345,5450,32560,3802,107905,26287,9108,2405,25008,23553
TATACGGACGTTGGTT,sample,180973,179646,4058,175588,41570,134018,114098,9649,7106,778,121204,2387,1660,1945,37310,28452
GGAGAAGCCGTTGGTT,sample,147433,146206,6741,139465,22282,117183,67360,4691,29313,3451,96673,12368,4991,2287,14457,16042
GAGCCTCCCGTTGGTT,sample,179988,178572,5499,173073,40972,132101,102012,7393,14758,1985,116770,5953,4624,3411,22161,29696
CTAGCGACCGTTGGTT,sample,108915,107564,5377,102187,25405,76782,46151,4008,17009,2329,63160,7285,4233,1912,10895,15978
TCGAACGACGTTGGTT,sample,149915,148793,3650,145143,32790,112353,87594,6036,12080,1487,99674,5156,2876,2131,26184,22571
CGTCGCCACGTTGGTT,sample,22354,21974,1701,20273,2510,17763,6176,549,7239,856,13415,2943,2840,1128,880,1566
TCATCGAACGTTGGTT,sample,80246,79377,2914,76463,20483,55980,34149,2864,12562,1568,46711,4837,3214,1494,11898,12897
GCAACTAGCGTTGGTT,sample,14479,14001,388,13613,3045,10568,8072,667,1280,180,9352,369,1763,1691,1529,1930
ATACGTTCCGTTGGTT,sample,12529,12162,759,11403,1673,9730,3912,392,3696,422,7608,1308,1934,955,546,1014
CCGCAGTCCGTTGGTT,sample,10521,10091,461,9630,1864,7766,3517,336,2811,302,6328,800,1530,798,584,1231
CCGTACGCCGTTGGTT,sample,15525,15059,675,14384,3547,10837,7656,634,1585,234,9241,728,1602,1331,2061,2232
TCTCAGGACGTTGGTT,sample,2105,2005,141,1864,369,1495,757,85,400,58,1157,195,513,300,190,240
TGGATCAACGTTGGTT,sample,4257,3903,333,3570,422,3148,1132,77,1112,91,2244,736,972,400,168,221
TGCGCGTTCGTTGGTT,sample,2547,2428,120,2308,611,1697,1060,101,340,53,1400,143,519,339,261,372
CCATTCTTCGTTGGTT,sample,1710,1600,102,1498,286,1212,722,58,291,22,1013,119,402,228,163,183
CTAAGCATCGTTGGTT,sample,672,655,45,610,100,510,289,32,122,9,411,58,219,132,62,69
AGCAGAGCCGTTGGTT,sample,533,522,25,497,78,419,244,18,97,12,341,48,157,86,58,58
CGTCGAGGCGTTGGTT,sample,283,278,13,265,29,236,166,10,25,4,191,31,88,63,52,23
TTATGACGCGTTGGTT,sample,459,452,35,417,65,352,213,7,74,16,287,42,150,78,58,49
AAGTAGAGCGTTGGTT,sample,471,463,34,429,66,363,220,7,92,6,312,38,147,89,68,53
TAACGCCACGTTGGTT,sample,357,355,25,330,48,282,196,12,49,6,245,19,123,84,34,36
GCGCAATACGTTGGTT,sample,379,373,17,356,62,294,183,13,69,2,252,27,128,79,39,44
TTAACTGACGTTGGTT,sample,307,307,15,292,49,243,162,13,38,7,200,23,105,71,34,35
CATAATGGCTATCGTT,sample,103630,102728,3378,99350,16773,82577,57307,3876,15032,1673,72339,4689,2684,1921,15415,12089
TATACGGACTATCGTT,sample,115950,114818,5949,108869,15931,92938,50403,3133,24965,3489,75368,10948,5018,1799,9284,10455
CTAGCGACCTATCGTT,sample,30645,30060,3088,26972,3972,23000,8287,472,8497,1005,16784,4739,3179,874,2035,2456
TCGAACGACTATCGTT,sample,95962,95020,5227,89793,13975,75818,49777,3221,12820,1512,62597,8488,4383,1570,16589,9628
GGTAGAGACTATCGTT,sample,103781,102734,5871,96863,9449,87414,43083,3028,28180,3349,71263,9774,4736,2150,8761,6739
GCAACTAGCTATCGTT,sample,12196,12041,724,11317,1686,9631,5035,354,2955,307,7990,980,2065,1212,1220,1083
ATACGTTCCTATCGTT,sample,128061,126819,5632,121187,18971,102216,63769,4182,21443,2434,85212,10388,4261,2073,15158,13451
TCTCAGGACTATCGTT,sample,83300,82544,3694,78850,9917,68933,40266,2314,18654,2152,58920,5547,3518,1992,9607,6810
GGCAGGTTCTATCGTT,sample,58165,57664,2506,55158,11990,43168,31139,2194,5680,747,36819,3408,2851,1874,10132,8137
CTAAGCATCTATCGTT,sample,52901,52159,2724,49435,8289,41146,26252,2178,7927,670,34179,4119,3351,1824,4473,5130
AAGGTCTGCTATCGTT,sample,23288,22918,892,22026,5777,16249,10820,1013,3047,400,13867,969,1835,1240,3186,3699
CCTAGCGGCTATCGTT,sample,35283,34881,1210,33671,7737,25934,19996,1801,2679,353,22675,1105,1841,1600,4276,5303
CTAACCGGCTATCGTT,sample,14792,14603,397,14206,2328,11878,8755,841,1659,214,10414,409,1924,1777,1468,1672
AGCAGAGCCTATCGTT,sample,19057,18748,848,17900,3763,14137,10610,937,1637,220,12247,733,1675,1510,2030,2541
ATACCGCCCTATCGTT,sample,224,209,19,190,23,167,87,19,43,5,130,13,67,48,23,13
GTCGCGAACTATCGTT,sample,210,207,18,189,32,157,117,3,19,1,136,17,73,55,14,25
TTATGACGCTATCGTT,sample,256,250,17,233,30,203,129,7,40,3,169,24,90,52,28,22
TCTCCTAGCTATCGTT,sample,276,276,19,257,52,205,124,8,46,9,170,18,88,56,33,28
ATTCTACCCTATCGTT,sample,246,244,9,235,38,197,131,7,45,1,176,13,97,52,29,25
GACTAACCCTATCGTT,sample,213,208,20,188,27,161,119,1,16,4,135,21,61,40,42,19
CGTAGAACCTATCGTT,sample,212,203,14,189,34,155,95,5,38,2,133,15,71,45,16,27
GCGCAATACTATCGTT,sample,206,203,17,186,31,155,96,4,41,2,137,12,71,37,23,22
CTGGTCTTGTCTTCTT,Pos_Ctrl,34344,33434,3010,30424,1834,28590,23519,2248,1962,266,25481,595,4480,4329,2144,986
AGCTGAATGTCTTCTT,sample,113016,112301,4799,107502,21438,86064,56890,4049,15181,1800,72071,8144,4192,1871,17091,14097
GACGTATGGTCTTCTT,sample,59894,59466,1934,57532,12280,45252,33811,2714,5526,688,39337,2513,2330,1554,11439,8552
CATAATGGGTCTTCTT,sample,57198,56838,2142,54696,12877,41819,30141,2192,6260,744,36401,2482,2471,1673,8644,8807
TATACGGAGTCTTCTT,Pos_Ctrl,15716,15551,1134,14417,920,13497,11177,1077,859,140,12036,244,3070,2862,1143,475
GAGCCTCCGTCTTCTT,sample,90951,90298,3270,87028,17485,69543,54110,3860,6386,853,60496,4334,2918,2150,15225,12705
CTAGCGACGTCTTCTT,sample,55565,54953,3608,51345,7548,43797,20867,1561,11911,1154,32778,8304,4384,1503,2902,5614
TCGAACGAGTCTTCTT,sample,56220,55787,1583,54204,10899,43305,34641,2513,4206,493,38847,1452,1972,1769,9822,7751
GGTAGAGAGTCTTCTT,sample,38795,38311,2333,35978,3596,32382,15453,917,10777,1277,26230,3958,2662,1169,1304,2393
TCATCGAAGTCTTCTT,sample,43029,42475,3336,39139,6245,32894,18105,1268,7837,774,25942,4910,3591,1499,4899,4236
GACTCAAGGTCTTCTT,sample,78032,77292,2502,74790,15179,59611,47754,3256,5405,557,53159,2639,3058,2599,9593,11177
CCGTACGCGTCTTCTT,sample,72581,71985,1852,70133,9113,61020,47983,3465,7025,689,55008,1858,3220,3428,8055,6785
TCTCAGGAGTCTTCTT,sample,64484,63812,3040,60772,9767,51005,32870,1924,10503,1260,43373,4448,3181,1683,10303,6554
GATGCGTTGTCTTCTT,sample,51562,50968,4745,46223,8139,38084,21141,1587,8929,1039,30070,5388,4255,2257,4185,5160
ATGGCGTTGTCTTCTT,sample,72259,71728,3027,68701,17174,51527,41490,2886,4253,405,45743,2493,2863,2622,9515,11835
GCTCTTCTGTCTTCTT,sample,76851,75959,4542,71417,13330,58087,42726,2538,7050,573,49776,5200,2433,1469,13612,9206
GAGATTCTGTCTTCTT,sample,53933,53222,2955,50267,7445,42822,26899,1764,8500,817,35399,4842,3283,1763,4975,5224
CTAAGCATGTCTTCTT,sample,63761,63116,2292,60824,10416,50408,41217,2629,4490,580,45707,1492,1800,1421,12026,7510
CTAACCGGGTCTTCTT,sample,19176,18928,1238,17690,2730,14960,8635,665,3294,396,11929,1970,2120,1033,2442,1789
TAACGAAGGTCTTCTT,sample,8790,8646,1147,7499,784,6715,2378,201,2464,272,4842,1400,1627,630,460,432
GCGTTACCGTCTTCTT,sample,23349,22991,985,22006,3382,18624,10524,929,4804,568,15328,1799,2155,1269,2366,2309
GGCGTACCGTCTTCTT,sample,11893,11645,649,10996,2429,8567,5091,470,1872,243,6963,891,1494,889,1186,1487
CGCGGTCGGTCTTCTT,sample,230,223,19,204,22,182,105,15,40,7,145,15,87,61,30,17
TCAATCAGGTCTTCTT,sample,302,292,10,282,48,234,157,16,21,7,178,33,83,66,47,30
TAACGCCAGTCTTCTT,sample,263,257,11,246,39,207,139,10,35,4,174,19,86,60,39,35
CGTAGAACGTCTTCTT,sample,155,154,11,143,18,125,84,5,25,0,109,11,67,41,18,12
CCTAACTAGTCTTCTT,Pos_Ctrl,394,387,26,361,42,319,214,14,50,9,264,32,133,85,27,31
ATATGCAAGTCTTCTT,sample,194,189,13,176,31,145,105,10,14,9,119,7,59,43,32,23
AGAGTTCTTAGGCTCT,sample,221385,219759,6655,213104,56845,156259,133148,10700,8183,972,141331,3256,3031,3386,24683,37845
GACGTATGTAGGCTCT,sample,78705,77878,4629,73249,12393,60856,29990,2268,18242,1965,48232,8391,4579,1724,9855,8136
TATACGGATAGGCTCT,sample,229163,227766,10492,217274,32721,184553,108986,8426,39824,4228,148810,23089,7160,2677,34101,23013
GAGCCTCCTAGGCTCT,sample,173922,172393,8831,163562,22122,141440,80139,5497,34327,3721,114466,17756,5817,2501,12931,15204
CATACTCCTAGGCTCT,sample,146910,145804,6265,139539,27157,112382,72595,4458,20273,2401,92868,12655,5179,1992,22516,19093
TGATTCCGTAGGCTCT,sample,90385,89311,6795,82516,13762,68754,41118,3050,14427,1580,55545,8579,4735,2052,10512,9873
TCTCAGGATAGGCTCT,sample,228947,226095,14379,211716,21601,190115,99574,7506,46450,5544,146024,31041,8296,2109,22879,14068
CCATTCTTTAGGCTCT,sample,133735,131835,6650,125185,22821,102364,66475,4194,17187,2175,83662,12333,5544,1952,25907,15067
AGCGTCTTTAGGCTCT,sample,146199,144565,4408,140157,27961,112196,92923,8950,7075,532,99998,2716,2526,2873,19477,19656
CGGTTGGTTAGGCTCT,sample,100972,99570,5286,94284,13867,80417,48613,3576,18549,2089,67162,7590,4012,1983,11454,9368
TAGCGAGTTAGGCTCT,sample,139261,137516,9326,128190,17304,110886,45751,3544,35822,4148,81573,21621,7332,2147,6023,10933
AAGGTCTGTAGGCTCT,sample,154820,153210,4388,148822,16025,132797,83324,6689,30367,3483,113691,8934,3076,2307,14507,10676
GCCTATTCTAGGCTCT,sample,134891,133254,6830,126424,21810,104614,72426,5167,15139,1607,87565,10275,5191,1983,19393,15231
TGCGCTCCTAGGCTCT,sample,108938,107539,12374,95165,13957,81208,36167,2721,21945,2411,58112,17964,6587,1767,10755,8673
ATACCGCCTAGGCTCT,sample,33419,32787,3472,29315,3802,25513,8704,680,9336,1217,18040,5576,3534,1015,1831,2237
GGCGTACCTAGGCTCT,sample,105712,104035,7594,96441,12979,83462,45373,2698,19901,1746,65274,13744,5536,1386,8359,8938
CAGCTTCGTAGGCTCT,sample,80017,79110,3625,75485,10762,64723,34177,2664,17901,2310,52078,7671,3949,1770,6089,7171
TTATGACGTAGGCTCT,sample,80769,80065,4303,75762,13366,62396,31181,2132,17733,2167,48914,9183,5061,1622,6204,8829
GACTAACCTAGGCTCT,sample,6276,5929,377,5552,882,4670,2040,166,1619,185,3659,660,1053,571,313,575
CGTAGAACTAGGCTCT,sample,5473,5313,171,5142,694,4448,3634,256,342,61,3976,155,934,861,411,457
AGATACTATAGGCTCT,sample,1092,1062,95,967,182,785,515,28,118,25,633,99,287,190,125,117
TTAACTGATAGGCTCT,sample,426,422,33,389,55,334,181,11,77,5,258,60,139,83,51,39
TCTAGGTTTTGACTAT,sample,40049,39689,2412,37277,6138,31139,19108,1712,6367,811,25475,3141,3326,2114,3372,4007
CTGGTCTTTTGACTAT,sample,56808,55899,3092,52807,4938,47869,19458,1311,18526,2598,37984,5976,3035,1316,1595,2704
GTCGTTCTTTGACTAT,Neg_Ctrl,2234,1177,525,652,87,565,349,31,88,31,437,66,204,127,105,37
GACGTATGTTGACTAT,sample,31728,31258,3588,27670,4763,22907,11234,824,5489,703,16723,4657,3479,1409,3351,3030
CATAATGGTTGACTAT,sample,81276,80448,3181,77267,13222,64045,50438,3816,6110,595,56548,3086,2800,1943,14729,9581
GGAGAAGCTTGACTAT,Neg_Ctrl,2278,1337,635,702,112,590,391,9,101,19,492,70,227,141,90,38
GAGCCTCCTTGACTAT,sample,69450,68584,2064,66520,15040,51480,43394,3038,3677,562,47071,809,1289,1459,14580,11016
CATACTCCTTGACTAT,sample,76197,75435,2880,72555,10622,61933,44341,3353,9077,919,53418,4243,3474,2447,11298,7500
CTAGCGACTTGACTAT,sample,28453,28012,2425,25587,3247,22340,10869,962,6346,689,17215,3474,3438,1763,2078,2055
TCGAACGATTGACTAT,sample,88637,87806,2759,85047,15736,69311,55965,4522,5142,781,61107,2901,2844,2741,9861,11353
GGTAGAGATTGACTAT,sample,64733,63827,8111,55716,5966,49750,13079,688,18341,2070,31420,15572,6224,1420,2768,3054
CGTCGCCATTGACTAT,sample,78342,77398,4216,73182,13192,59990,42810,2975,8001,904,50811,5300,3690,1940,11725,9148
TCATACCATTGACTAT,sample,85834,84821,5610,79211,10928,68283,41705,3012,13914,1515,55619,8137,4195,1958,11567,7190
TGATTCCGTTGACTAT,Pos_Ctrl,19081,18659,2027,16632,995,15637,12902,1144,1099,132,14001,360,3483,3013,1112,508
TACGCGAGTTGACTAT,sample,77286,76353,4680,71673,13455,58218,37959,2327,10325,998,48284,6609,3013,1507,11608,9809
ATACGTTCTTGACTAT,sample,71366,70690,2683,68007,9716,58291,43084,2848,7853,903,50937,3603,3451,2840,10547,7338
CCGCAGTCTTGACTAT,sample,57460,56780,2554,54226,8019,46207,31361,2275,8403,904,39764,3264,3408,2546,5367,5734
CCGTACGCTTGACTAT,sample,51710,50959,3667,47292,6774,40518,24932,1726,8058,710,32990,5092,3897,1986,6277,4716
GGCAGGTTTTGACTAT,sample,45995,45268,4255,41013,6137,34876,18929,1195,8400,943,27329,5409,3620,1290,6882,4042
ATGGCGTTTTGACTAT,Pos_Ctrl,20067,19675,2052,17623,1097,16526,13697,1199,1081,146,14778,403,3402,2994,1220,586
AGCGTCTTTTGACTAT,sample,94063,92830,3521,89309,16553,72756,63057,4255,3785,578,66842,1081,1456,1689,17475,12055
CGGTTGGTTTGACTAT,sample,18625,18220,3397,14823,1345,13478,3101,147,5577,582,8678,4071,3045,707,679,727
GAGATTCTTTGACTAT,sample,85042,83884,4634,79250,13740,65510,43823,2836,10713,1189,54536,6949,3598,1793,11987,10003
AAGGTCTGTTGACTAT,sample,66242,65408,3981,61427,7041,54386,25705,1446,17807,1644,43512,7784,3841,1457,3341,4573
CCTAGCGGTTGACTAT,Pos_Ctrl,10897,10707,1072,9635,591,9044,7464,725,582,55,8046,218,2480,2011,553,321
GGCGACGATTGACTAT,sample,39151,38506,2997,35509,4295,31214,15463,969,9009,1228,24472,4545,3332,1351,3854,2843
TGCGCTCCTTGACTAT,sample,51887,51166,1517,49649,9156,40493,35273,2734,1880,249,37153,357,983,1217,10287,6904
GTCGCGAATTGACTAT,sample,37566,36888,4617,32271,3407,28864,9548,620,10120,1164,19668,7412,3780,975,1963,1956
CGTCGAGGTTGACTAT,Pos_Ctrl,9718,9504,987,8517,537,7980,6612,624,465,71,7077,208,2258,1847,527,325
CAGCTTCGTTGACTAT,sample,45572,44931,2167,42764,8044,34720,26138,1854,3861,508,29999,2359,2195,1233,8348,5319
CGCGGTCGTTGACTAT,sample,34661,34241,1884,32357,3628,28729,17378,1482,6312,743,23690,2814,2281,1309,3567,2464
TCTCCTAGTTGACTAT,sample,41273,40568,3289,37279,5461,31818,17641,925,7244,685,24885,5323,2859,958,4993,3805
AAGTAGAGTTGACTAT,sample,30513,30104,2320,27784,3364,24420,12728,957,6241,654,18969,3840,3536,1665,3071,2134
TAACGCCATTGACTAT,sample,48499,47955,1903,46052,5931,40121,27011,2188,7115,886,34126,2921,2111,1381,5859,3891
ATTCTACCTTGACTAT,sample,58392,57802,2048,55754,8712,47042,37279,3099,4276,447,41555,1941,1990,1662,8929,6369
GCGCAATATTGACTAT,Neg_Ctrl,491,476,37,439,46,393,276,14,59,2,335,42,150,92,86,35
AGCTGAATTGCAGTTG,sample,59951,59140,2509,56631,10555,46076,35356,2447,5401,455,40757,2417,2068,1544,12003,7634
CATAATGGTGCAGTTG,sample,54634,54011,2362,51649,7656,43993,27151,1755,9633,1041,36784,4413,2960,1598,7405,5635
GGAGAAGCTGCAGTTG,sample,53311,52694,2335,50359,8425,41934,33156,2630,3630,532,36786,1986,2323,1925,10096,5858
CGTCGCCATGCAGTTG,sample,37984,37393,1841,35552,3100,32452,14810,1088,10984,1503,25794,4067,2609,1180,1534,2070
TCATACCATGCAGTTG,sample,49071,48592,1545,47047,5406,41641,28967,1897,7520,899,36487,2358,2532,1946,4881,3976
ATTCAAGGTGCAGTTG,sample,69958,69288,3737,65551,7335,58216,35421,2220,11784,1510,47205,7281,4452,2167,5657,4791
GGCAGGTTTGCAGTTG,sample,13649,13442,895,12547,2038,10509,6444,524,2201,216,8645,1124,1834,1028,1680,1359
ATGGCGTTTGCAGTTG,sample,29617,29151,1468,27683,6400,21283,15257,1063,3217,344,18474,1402,1576,979,5829,4024
GAGATTCTTGCAGTTG,sample,72525,71829,2097,69732,17055,52677,38425,3223,7017,1171,45442,2841,2471,1768,9485,11710
CGCGGTCGTGCAGTTG,sample,28642,28218,1300,26918,2946,23972,14741,932,5563,771,20304,1965,2142,1107,4007,2083
AAGTAGAGTGCAGTTG,sample,28535,27927,1978,25949,2551,23398,9933,714,7698,969,17631,4084,2569,853,1533,1602
TCAATCAGTGCAGTTG,sample,32114,31650,2231,29419,3431,25988,11124,782,8402,915,19526,4765,3034,1053,2472,2271
TAACGCCATGCAGTTG,sample,50366,49947,1928,48019,7283,40736,32671,2603,3036,579,35707,1847,2128,1803,6842,5022
ATTCTACCTGCAGTTG,sample,33489,33047,2636,30411,4253,26158,15004,1183,5349,561,20353,4061,3123,1321,3443,2859
AGATACTATGCAGTTG,sample,30907,30464,1056,29408,4581,24827,17283,1186,4330,706,21613,1322,1621,1274,3128,2887
GCGCAATATGCAGTTG,sample,305,275,19,256,40,216,110,11,57,1,167,37,99,58,16,21
ATATGCAATGCAGTTG,sample,111,111,1,110,16,94,64,4,16,0,80,10,45,30,13,12
CTGGTCTTTCATGCTG,sample,23565,23046,2328,20718,3155,17563,10145,691,3693,478,13838,2556,1980,870,3595,2188
GTCGTTCTTCATGCTG,sample,20891,20469,985,19484,3503,15981,11484,761,2383,242,13867,1111,1453,1120,3393,2528
CATACTCCTCATGCTG,sample,26487,26100,1039,25061,3726,21335,16400,1230,2336,238,18736,1131,2087,1901,3339,2671
TCGAACGATCATGCTG,sample,17806,17512,1061,16451,1557,14894,7827,437,4743,490,12570,1397,2028,1057,1849,997
GGTAGAGATCATGCTG,sample,11731,11477,1685,9792,820,8972,2476,211,3586,395,6062,2304,1946,555,266,445
TCATACCATCATGCTG,sample,27404,27078,901,26177,4961,21216,18510,1546,771,97,19281,292,1194,1468,4723,3700
ATTCAAGGTCATGCTG,sample,9822,9624,524,9100,1830,7270,5097,340,1177,146,6274,510,1325,961,1398,1219
GCAACTAGTCATGCTG,Neg_Ctrl,732,281,201,80,14,66,45,0,14,2,59,5,39,23,9,1
TCTCAGGATCATGCTG,sample,18672,18324,1523,16801,1945,14856,8346,577,3372,402,11718,2159,1976,879,2381,1323
TGGATCAATCATGCTG,sample,16220,15906,1376,14530,1988,12542,6760,555,3105,401,9865,1721,1805,834,2190,1355
GGCAGGTTTCATGCTG,sample,16389,16020,2194,13826,1707,12119,3585,199,4410,454,7995,3471,2370,526,1195,1079
TGCGCGTTTCATGCTG,Neg_Ctrl,821,354,227,127,9,118,73,1,17,8,90,19,59,31,18,2
CCTAGCGGTCATGCTG,sample,19546,19241,1531,17710,2317,15393,5557,495,4887,518,10444,3936,2696,778,1435,1591
CTAACCGGTCATGCTG,Neg_Ctrl,702,306,190,116,10,106,67,0,31,0,98,8,47,25,15,1
ATACCGCCTCATGCTG,sample,15864,15597,1160,14437,1525,12912,7288,624,2798,324,10086,1878,1857,811,1576,1007
GTCGCGAATCATGCTG,sample,24383,24023,1103,22920,3330,19590,11589,924,4406,861,15995,1810,1695,920,3116,2231
CAGCTTCGTCATGCTG,Neg_Ctrl,871,399,227,172,29,143,83,6,34,5,117,15,65,40,20,6
TCAATCAGTCATGCTG,sample,18718,18396,996,17400,2242,15158,10503,758,2088,294,12591,1515,1453,906,2839,1567
CGCGAGACTCATGCTG,sample,22261,21920,1313,20607,3051,17556,12317,1003,2333,300,14650,1603,1517,935,3445,2133
AGATACTATCATGCTG,sample,29935,29634,1224,28410,3603,24807,19240,1359,2572,250,21812,1386,2026,1705,4051,2659
AACCGGTTTTAGGCGG,sample,82747,81857,2572,79285,16602,62683,55209,3560,2728,303,57937,883,1629,1900,20172,11734
TCTAGGTTTTAGGCGG,sample,79053,78234,4799,73435,13832,59603,43112,3450,7562,909,50674,4570,3536,2398,9690,9131
CTGGTCTTTTAGGCGG,Pos_Ctrl,22385,21757,1827,19930,1212,18718,15489,1425,1176,191,16665,437,3664,3272,1404,619
TATACGGATTAGGCGG,Pos_Ctrl,17749,17390,1497,15893,921,14972,12355,1104,1066,113,13421,334,3441,2980,1083,524
GGAGAAGCTTAGGCGG,sample,51466,50475,4661,45814,6674,39140,15835,856,12853,1482,28688,8114,4479,1200,2780,4223
GAGCCTCCTTAGGCGG,sample,25687,25377,1296,24081,4663,19418,14287,1024,2464,306,16751,1337,2826,2169,4837,3221
TCATCGAATTAGGCGG,sample,83365,82729,2617,80112,10709,69403,47352,3644,12291,1732,59643,4384,4003,3048,7801,7724
TACGCGAGTTAGGCGG,sample,42542,41859,3111,38748,6420,32328,16022,1309,9246,996,25268,4755,3203,1181,2519,4186
CCGCAGTCTTAGGCGG,sample,101340,100121,5288,94833,17863,76970,53608,3629,11102,1332,64710,7299,4789,2826,10164,12777
TCTCAGGATTAGGCGG,sample,127508,126453,3539,122914,23610,99304,84295,6042,5807,907,90102,2253,2249,2257,21802,16822
GATGCGTTTTAGGCGG,sample,111218,109871,5229,104642,11137,93505,50820,3285,25744,2970,76564,10686,4409,1729,5067,7274
CATTCGGTTTAGGCGG,sample,21728,21319,1822,19497,1585,17912,6859,360,6765,773,13624,3155,2741,998,719,945
GGCGACGATTAGGCGG,sample,83449,82181,4286,77895,8638,69257,35752,3060,19713,2162,55465,8570,4051,1477,4285,5623
TAACGAAGTTAGGCGG,sample,42701,42081,4570,37511,4880,32631,14247,987,8930,1063,23177,7404,4566,1528,4179,2900
TGCGCTCCTTAGGCGG,sample,81563,80527,4390,76137,10490,65647,43817,3107,11869,1262,55686,5592,2873,1452,8847,7575
ATACCGCCTTAGGCGG,sample,80392,79369,2581,76788,11702,65086,49629,4740,6220,1048,55849,3449,2867,1896,9365,8291
CAGCTTCGTTAGGCGG,sample,35690,35032,3675,31357,2613,28744,10385,649,10708,1219,21093,5783,4184,1244,1746,1451
GCGCAATATTAGGCGG,sample,9384,8956,349,8607,1374,7233,6159,445,432,40,6591,157,950,1035,929,931
AACCGGTTTCAGATAC,sample,36185,35840,1543,34297,2714,31583,18215,1198,8555,1056,26770,2559,2731,1785,1147,1667
AGAGTTCTTCAGATAC,sample,42527,42001,1816,40185,7452,32733,24542,1753,4199,390,28741,1849,1888,1373,7855,5188
CATAATGGTCAGATAC,sample,13256,13044,572,12472,2611,9861,7928,569,807,77,8735,480,1581,1446,865,1633
CTAGCGACTCAGATAC,sample,27594,26987,2655,24332,2278,22054,7545,417,8216,987,15761,4889,2800,844,738,1303
GGTAGAGATCAGATAC,sample,25858,25461,1835,23626,4147,19479,11808,937,3822,461,15630,2451,2397,1329,2723,2771
TCATACCATCAGATAC,sample,68978,67754,5295,62459,5941,56518,25189,1543,17385,2276,42574,10125,4119,973,3167,3877
GATGCGTTTCAGATAC,sample,71891,70983,5024,65959,6653,59306,29866,2261,16162,1878,46028,9139,4222,1396,3996,4323
TGCGCGTTTCAGATAC,sample,90449,89475,2388,87087,13760,73327,62612,5756,3581,360,66193,1018,1163,1337,12352,9847
CCATTCTTTCAGATAC,sample,103648,102284,8874,93410,6130,87280,34957,2224,31380,3952,66337,14767,5505,1636,3504,3595
GAGATTCTTCAGATAC,sample,65551,64563,3864,60699,8569,52130,30964,2266,10973,1192,41937,6735,3772,1100,7712,6099
AAGGTCTGTCAGATAC,sample,66023,65059,6927,58132,3639,54493,18621,1527,20364,2497,38985,11484,4872,1155,677,1934
CTAACCGGTCAGATAC,sample,46292,45511,2728,42783,4504,38279,20719,1115,10856,812,31575,4777,2711,1010,2826,3146
GGCGACGATCAGATAC,sample,66913,65808,5262,60546,7018,53528,19695,1462,19806,1904,39501,10661,4500,1045,2833,4180
ATACCGCCTCAGATAC,sample,13521,13193,748,12445,1783,10662,6902,635,1905,250,8807,970,1246,814,1070,1196
GGCGTACCTCAGATAC,sample,14110,13766,1389,12377,1365,11012,5650,399,2763,325,8413,1875,1744,744,1671,850
GTCGCGAATCAGATAC,sample,11657,11414,514,10900,1532,9368,6511,568,1507,152,8018,630,1341,1034,622,1059
CGTCGAGGTCAGATAC,sample,8299,8172,544,7628,792,6836,4460,326,1170,174,5630,706,1383,964,987,510
AAGTAGAGTCAGATAC,sample,19218,18858,1544,17314,2110,15204,9907,605,2767,303,12674,1622,1629,802,3496,1334
CGTAGAACTCAGATAC,sample,23103,22511,2646,19865,2336,17529,6850,408,5455,692,12305,4124,2737,688,2058,1379
GTCGTTCTTCGCTAGG,Neg_Ctrl,2264,879,508,371,34,337,207,16,67,11,274,36,139,86,39,7
GGAGAAGCTCGCTAGG,Neg_Ctrl,2115,964,586,378,49,329,191,12,80,10,271,36,138,74,46,15
GCAACTAGTCGCTAGG,sample,11082,10775,1363,9412,1558,7854,4773,305,1536,137,6309,1103,1711,991,1259,917
CCGCAGTCTCGCTAGG,sample,14073,13762,1399,12363,1488,10875,4750,407,3426,463,8176,1829,2132,873,1061,999
CCGTACGCTCGCTAGG,sample,27993,27606,1342,26264,5221,21043,14474,1059,3210,322,17684,1978,2460,1582,3979,3408
TCTCAGGATCGCTAGG,sample,23792,23476,1531,21945,2366,19579,8810,601,6534,872,15344,2762,2505,1216,1597,1495
TGGATCAATCGCTAGG,sample,163152,160739,5834,154905,20529,134376,106468,12302,9584,873,116052,5149,3417,1851,24081,12806
GGCAGGTTTCGCTAGG,sample,131858,130114,3364,126750,18183,108567,94846,7887,4735,335,99581,764,1167,1458,16081,13657
GATGCGTTTCGCTAGG,sample,134985,133361,6153,127208,17489,109719,78754,5404,14207,1599,92961,9755,3464,1404,14673,12398
CGGTTGGTTCGCTAGG,sample,22977,22621,1677,20944,2141,18803,9997,547,5240,774,15237,2245,2547,1255,2285,1413
ACGCTTAATCGCTAGG,sample,7683,7465,985,6480,1012,5468,2022,117,1831,191,3853,1307,1253,407,605,624
CATTCGGTTCGCTAGG,sample,15746,15523,888,14635,2247,12388,8158,404,2667,224,10825,935,1564,986,2585,1575
TAGCGAGTTCGCTAGG,sample,27756,27344,1639,25705,3139,22566,13253,722,5678,562,18931,2351,2266,1264,3181,2240
CTAAGCATTCGCTAGG,sample,12180,11986,1144,10842,1522,9320,5263,353,2174,199,7437,1331,1522,823,1325,1023
CCTAGCGGTCGCTAGG,sample,5890,5776,396,5380,748,4632,3356,188,661,91,4017,336,1043,761,903,503
CTAACCGGTCGCTAGG,sample,134861,133414,8074,125340,9799,115541,59606,5047,30250,3174,89856,17464,6533,2153,6847,6042
TAACGAAGTCGCTAGG,sample,11560,11361,1163,10198,1549,8649,4448,334,2136,175,6584,1556,1675,764,1282,1000
GCTGCTTCTCGCTAGG,sample,6376,6226,579,5647,635,5012,2723,184,1339,165,4062,601,1136,557,767,408
TGCGCTCCTCGCTAGG,sample,15029,14704,817,13887,1765,12122,8172,476,2163,299,10335,1012,1438,996,1540,1168
CGCGGTCGTCGCTAGG,sample,14014,13772,440,13332,2335,10997,9384,713,612,103,9996,185,873,1011,2521,1744
TCAATCAGTCGCTAGG,sample,20611,20275,641,19634,2275,17359,14548,1036,1160,154,15708,461,1048,1054,3413,1671
TAACGCCATCGCTAGG,sample,26372,26094,869,25225,3291,21934,18258,1638,1278,108,19536,652,1338,1408,3430,2443
ATTCTACCTCGCTAGG,Pos_Ctrl,6335,6203,606,5597,286,5311,4425,388,329,55,4754,114,1775,1389,310,133
AGATACTATCGCTAGG,sample,23168,22844,917,21927,2670,19257,15828,1117,1410,159,17238,743,1167,1069,3469,2023
CCTAACTATCGCTAGG,sample,13692,13470,1399,12071,996,11075,4511,362,3696,362,8207,2144,2090,851,832,570
GCGCAATATCGCTAGG,sample,34628,34292,1156,33136,3632,29504,23528,1823,2503,402,26031,1248,1808,1856,3929,2528
TTAACTGATCGCTAGG,sample,504,482,28,454,52,402,275,22,62,17,337,26,174,134,48,39
AACCGGTTCCGTTGCG,sample,129996,128352,9720,118632,12265,106367,37508,2380,40909,4647,78417,20923,7341,2107,4429,7275
AGAGTTCTCCGTTGCG,sample,159815,158408,10618,147790,25379,122411,67148,4075,31231,3121,98379,16836,6396,2104,20244,17541
AGCTGAATCCGTTGCG,sample,175373,173696,5631,168065,36320,131745,105516,7159,12635,1435,118151,5000,3119,2047,31219,25071
CATAATGGCCGTTGCG,sample,155420,154082,4420,149662,31715,117947,101702,8607,5669,526,107371,1443,1732,2055,29652,23825
GAGCCTCCCCGTTGCG,sample,86026,84442,6918,77524,11568,65956,34596,2227,16487,1958,51083,10688,5084,1719,3474,7334
CATACTCCCCGTTGCG,sample,91509,90333,3873,86460,16513,69947,56810,3378,5616,697,62426,3446,2761,1934,18551,11268
CGTCGCCACCGTTGCG,sample,107553,106168,6572,99596,10588,89008,52221,3064,22210,2357,74431,9156,4655,2360,9714,7449
TGATTCCGCCGTTGCG,sample,47863,46989,7074,39915,3253,36662,8379,602,15577,1611,23956,10493,5272,1130,1316,1708
TACGCGAGCCGTTGCG,sample,85324,84318,5738,78580,12053,66527,41404,3300,12441,1827,53845,7555,3312,1626,13341,8615
TCTCAGGACCGTTGCG,sample,28632,28170,3698,24472,3309,21163,8175,701,7042,686,15217,4559,3553,1340,1485,1968
GATGCGTTCCGTTGCG,sample,65071,64327,4202,60125,13315,46810,28593,2197,9079,1073,37672,5868,3997,2118,6465,8261
CCATTCTTCCGTTGCG,sample,80834,79602,5355,74247,12879,61368,37080,2284,13553,1558,50633,6893,4141,1646,13594,8720
AGCGTCTTCCGTTGCG,sample,74490,73449,4501,68948,12032,56916,41794,2286,8238,944,50032,3654,2491,1722,13657,8770
ACGCTTAACCGTTGCG,sample,72629,71576,3336,68240,7651,60589,31743,2337,17472,2629,49215,6408,3402,1543,5460,4895
CATTCGGTCCGTTGCG,sample,66698,65667,3563,62104,7896,54208,29434,1676,15879,2005,45313,5214,3016,1378,3773,5399
TAGCGAGTCCGTTGCG,sample,129693,128258,7145,121113,13216,107897,66942,4111,22808,3074,89750,10962,5044,2420,13348,9117
CTAAGCATCCGTTGCG,sample,105803,104566,6632,97934,12292,85642,44742,3250,22953,3179,67695,11518,5341,2314,6214,7690
AAGGTCTGCCGTTGCG,sample,108584,107506,7484,100022,11472,88550,49836,3410,22543,2828,72379,9933,4828,2184,11752,7774
GCTGCTTCCCGTTGCG,sample,130485,128544,8697,119847,10135,109712,48887,4021,33510,3927,82397,19367,6719,1804,7622,5968
ATACCGCCCCGTTGCG,sample,79821,78806,2575,76231,12563,63668,54066,3911,4138,793,58204,760,1263,1441,16533,9441
GCGTTACCCCGTTGCG,sample,85638,84620,5337,79283,7716,71567,35093,2031,22068,2725,57161,9650,4428,1654,4557,5396
GGCGTACCCCGTTGCG,sample,46136,45226,3922,41304,5765,35539,17143,1310,9829,1083,26972,6174,3352,961,3455,3536
GTCGCGAACCGTTGCG,sample,69523,68737,3267,65470,7697,57773,37089,2688,12090,1422,49179,4484,3243,1745,8441,5240
CAGCTTCGCCGTTGCG,sample,82687,81867,2759,79108,12046,67062,52032,4513,7823,743,59855,1951,2298,1951,12147,8402
CGCGGTCGCCGTTGCG,sample,59805,59245,1739,57506,12451,45055,37567,2573,3298,447,40865,1170,2072,2075,9778,8479
TTATGACGCCGTTGCG,sample,71253,70732,2292,68440,11631,56809,44422,3021,6869,887,51291,1610,2984,2754,8884,8220
TCTCCTAGCCGTTGCG,sample,32781,32265,1807,30458,3140,27318,11722,781,9874,1420,21596,3521,2640,1231,1525,1868
AAGTAGAGCCGTTGCG,sample,78703,77965,2811,75154,11129,64025,53137,4039,4468,501,57605,1880,2871,2777,11035,8099
TAACGCCACCGTTGCG,sample,56129,54999,4609,50390,3887,46503,22013,1422,14857,1725,36870,6486,3615,1192,1289,2190
ATTCTACCCCGTTGCG,sample,94480,93519,4903,88616,12006,76610,51195,4535,12570,1340,63765,6970,4079,1626,13476,8074
GACTAACCCCGTTGCG,sample,56036,54822,5064,49758,7004,42754,20397,1748,11662,1437,32059,7510,3637,1101,3449,4711
CGCGAGACCCGTTGCG,sample,89897,88698,4585,84113,9730,74383,47929,2692,14888,2497,62817,6377,2885,1366,12469,7274
GTCGTTCTAGGCCAAG,sample,271553,267729,19031,248698,19847,228851,121052,7671,61458,6995,182510,31675,8013,2486,17045,12197
GACGTATGAGGCCAAG,sample,52527,51908,2460,49448,7740,41708,30709,1781,5946,708,36655,2564,2626,1645,9655,5947
TCGAACGAAGGCCAAG,sample,49762,49307,3646,45661,8206,37455,23002,1595,7054,817,30056,4987,3266,1965,5188,5663
GGTAGAGAAGGCCAAG,sample,73420,72565,3590,68975,10025,58950,41961,2861,8848,1087,50809,4193,2996,1740,12858,7474
TCATCGAAAGGCCAAG,sample,54954,54086,4830,49256,7770,41486,18161,1097,12098,1265,30259,8865,4487,1325,4431,4841
GCAACTAGAGGCCAAG,sample,27535,26995,1540,25455,3910,21545,14314,1026,4154,589,18468,1462,2241,1632,3939,2645
ATACGTTCAGGCCAAG,sample,60965,60031,3320,56711,5426,51285,24376,1848,18083,1713,42459,5265,3075,1375,2820,3656
CCGCAGTCAGGCCAAG,sample,78764,77857,3357,74500,8939,65561,38430,2703,17513,2127,55943,4788,3456,2205,4771,6241
TGGATCAAAGGCCAAG,sample,47240,46235,2947,43288,9854,33434,23561,1796,5186,485,28747,2406,2276,1421,8263,6843
GGCAGGTTAGGCCAAG,sample,43754,42959,3818,39141,3955,35186,15623,1276,11109,1243,26732,5935,4201,1798,1439,2153
ACGCTTAAAGGCCAAG,sample,78852,77997,4507,73490,12834,60656,43841,2860,8652,1004,52493,4299,3432,2057,9172,9504
CATTCGGTAGGCCAAG,sample,85742,84629,6170,78459,9615,68844,33275,2247,20551,2156,53826,10615,5077,1735,8871,6423
TAGCGAGTAGGCCAAG,sample,119529,118146,6481,111665,14520,97145,63441,3233,17305,2150,80746,11016,5160,1956,16192,9335
AAGGTCTGAGGCCAAG,sample,32837,32466,1489,30977,3664,27313,17504,1335,5760,692,23264,2022,2051,1401,4659,2772
CCTAGCGGAGGCCAAG,sample,20943,20685,1646,19039,2582,16457,9120,608,3942,476,13062,2311,2383,1069,2824,1581
TAACGAAGAGGCCAAG,sample,116246,114999,7642,107357,10570,96787,45428,2724,30422,3485,75850,14728,5854,2050,5868,7123
GCTGCTTCAGGCCAAG,sample,113993,112569,4623,107946,14970,92976,62335,5071,16124,2415,78459,7031,3189,1684,17224,10961
GCCTATTCAGGCCAAG,sample,75090,74006,5309,68697,7419,61278,28157,1746,17581,2102,45738,11692,5532,1730,4716,4877
GCGTTACCAGGCCAAG,sample,85061,83767,10535,73232,7054,66178,16890,1203,24758,2551,41648,20776,7801,1449,3874,3719
GGCGTACCAGGCCAAG,sample,88723,87820,4472,83348,13128,70220,50944,4232,9131,722,60075,5191,2875,1593,14819,9114
CGCGGTCGAGGCCAAG,sample,78624,77860,1896,75964,14026,61938,52932,4489,3681,321,56613,515,1401,1725,11721,9885
TTATGACGAGGCCAAG,sample,83377,82550,4153,78397,7149,71248,38490,2459,19440,2480,57930,8379,4148,1852,5688,4873
TCTCCTAGAGGCCAAG,sample,47790,47251,3059,44192,5695,38497,19300,1781,11239,1106,30539,5071,3564,1475,3255,3749
GACTAACCAGGCCAAG,Neg_Ctrl,2220,1025,558,467,54,413,242,7,84,4,326,76,154,91,55,14
CGCGAGACAGGCCAAG,sample,81419,80515,2998,77517,10702,66815,42748,3222,14637,1364,57385,4844,2822,1364,9296,7503
CGTAGAACAGGCCAAG,sample,113202,112145,8071,104074,14546,89528,43651,3848,22655,2176,66306,17198,6911,1967,9872,9167
AGATACTAAGGCCAAG,sample,94600,93887,3610,90277,14161,76116,55465,3933,10457,1537,65922,4724,3353,2114,14219,10138
ATATGCAAAGGCCAAG,sample,8411,8146,402,7744,957,6787,3457,310,2095,249,5552,676,1319,847,351,595
AACCGGTTAGAACCGC,sample,113777,112512,5095,107417,20581,86836,56608,4400,17575,2126,74183,6127,3139,2110,14139,13728
AGCTGAATAGAACCGC,sample,95143,93894,4747,89147,11288,77859,47717,3158,19067,2467,66784,5450,3691,2339,7498,8058
GACGTATGAGAACCGC,sample,121630,120461,3537,116924,24984,91940,79488,6002,4387,511,83875,1552,2219,2622,18427,17827
CATAATGGAGAACCGC,sample,74356,73354,4543,68811,13558,55253,41960,2907,6709,738,48669,2939,1809,1591,12577,9243
TCGAACGAAGAACCGC,sample,132554,131602,6742,124860,22961,101899,60105,3848,22168,1942,82273,13836,4801,1567,25578,15672
ATTCAAGGAGAACCGC,sample,80964,80246,2618,77628,7597,70031,38242,2962,21276,2603,59518,4948,3393,2165,3308,5378
TGATTCCGAGAACCGC,sample,84314,83668,3232,80436,13402,67034,46389,3149,11998,1422,58387,4076,3755,2853,8352,9384
CCGTACGCAGAACCGC,sample,196305,193986,8065,185921,25845,160076,118913,12415,16386,1710,135299,10652,4316,2037,22274,16647
TCTCAGGAAGAACCGC,sample,154186,152617,5226,147391,16616,130775,101821,7776,14972,1280,116793,4926,2602,2316,16924,12162
TGGATCAAAGAACCGC,sample,106865,105975,3064,102911,12018,90893,61964,5015,16322,1696,78286,5896,3711,2507,6328,7789
GGCAGGTTAGAACCGC,sample,177346,174242,12788,161454,15613,145841,87303,5741,31211,3430,118514,18156,6692,2144,15431,10048
TGCGCGTTAGAACCGC,sample,128751,127667,5788,121879,19672,102207,70950,4850,16585,1734,87535,8088,4173,2175,17397,13593
AGCGTCTTAGAACCGC,sample,62486,61747,4712,57035,8074,48961,30782,2117,9694,877,40476,5491,3901,1861,7825,5366
CGGTTGGTAGAACCGC,sample,68982,67943,2711,65232,12798,52434,37736,2144,7853,1197,45589,3504,2820,1561,7839,8992
GCTCTTCTAGAACCGC,sample,200723,198945,12758,186187,28081,158106,98552,8088,31012,3290,129564,17164,6438,2614,23713,18688
AAGGTCTGAGAACCGC,sample,88526,87422,5996,81426,12801,68625,41797,3078,13371,1302,55168,9077,4552,1516,16745,8790
AGCAGAGCAGAACCGC,sample,61906,61052,3252,57800,6433,51367,28858,1767,13533,1711,42391,5498,2789,1361,3629,4309
GCGTTACCAGAACCGC,sample,88221,87074,7327,79747,9717,70030,36553,2005,17543,1913,54096,12016,5515,1588,10947,6113
CGTCGAGGAGAACCGC,sample,39533,38716,4981,33735,4124,29611,9967,767,10518,1158,20485,7201,4137,980,2439,2398
TTATGACGAGAACCGC,sample,56654,54230,6137,48093,4560,43533,16956,1227,14516,1705,31472,9129,4315,1301,977,3926
TCTCCTAGAGAACCGC,sample,80712,79856,3207,76649,6646,70003,44611,3280,14515,1944,59126,5653,3536,2115,6200,4347
ATGAATAGAGAACCGC,sample,67173,66505,3115,63390,6237,57153,31909,2442,16535,1670,48444,4597,3369,1886,5351,4223
TCAATCAGAGAACCGC,sample,59755,58979,2696,56283,6404,49879,30871,2265,10894,1392,41765,4457,2605,1328,5213,4813
ATTCTACCAGAACCGC,sample,51393,50656,1065,49591,7483,42108,35399,3071,2580,405,37979,653,1820,2031,5762,5402
GCGCAATAAGAACCGC,sample,70698,69747,3246,66501,9067,57434,34594,2467,11958,1334,46552,7081,4243,1652,4871,5978
GGAGAAGCCATCAAGC,sample,43892,43286,3159,40127,3626,36501,15163,1140,13708,1306,28871,5184,3216,1228,1852,2208
GAGCCTCCCATCAAGC,sample,48992,48356,2189,46167,9488,36679,25516,2060,6058,770,31574,2275,2538,1765,4341,6415
TCGAACGACATCAAGC,sample,77925,77262,3070,74192,15232,58960,44628,2985,6822,677,51450,3848,3828,2707,11273,10406
TCATCGAACATCAAGC,sample,89666,88815,3411,85404,19432,65972,47396,3528,10472,874,57868,3702,2875,1763,13256,13550
ATTCAAGGCATCAAGC,sample,74207,73719,2009,71710,11351,60359,45137,3510,8087,1010,53224,2615,3333,3235,7841,8269
TACGCGAGCATCAAGC,sample,90504,89681,4857,84824,15088,69736,52428,3807,7566,969,59994,4966,3740,2612,12441,10885
ATACGTTCCATCAAGC,sample,91785,90897,4008,86889,15530,71359,50496,3489,11698,1000,62194,4676,2261,1672,15662,11167
CCGCAGTCCATCAAGC,sample,73903,72976,3209,69767,10577,59190,34847,2259,15645,2322,50492,4117,2968,1742,6119,7286
TCTCAGGACATCAAGC,sample,97415,96604,2611,93993,20069,73924,63099,5285,3943,452,67042,1145,1711,2117,16465,14267
TGGATCAACATCAAGC,sample,99029,98032,5075,92957,11491,81466,43361,2389,24604,3245,67965,7867,4053,1789,8208,8114
TGCGCGTTCATCAAGC,sample,96358,95437,3775,91662,14716,76946,59761,4006,8122,1102,67883,3955,3277,2477,13738,10395
ACGCTTAACATCAAGC,sample,66212,65310,3206,62104,5751,56353,28883,2040,17277,2281,46160,5872,3048,1404,3517,3685
GCTCTTCTCATCAAGC,sample,138715,137229,6396,130833,20276,110557,82087,6244,13138,1173,95225,7915,4561,2342,13561,13908
GGCGACGACATCAAGC,sample,68871,67713,3806,63907,7027,56880,29327,1550,17592,1820,46919,6591,3316,1350,2156,4567
GCCTATTCCATCAAGC,sample,56595,55843,3227,52616,7204,45412,28641,1873,9072,889,37713,4937,3053,1626,8076,4890
AGCAGAGCCATCAAGC,sample,34254,33657,3439,30218,5320,24898,11098,775,7754,889,18852,4382,3062,1007,2320,3505
GCGTTACCCATCAAGC,sample,96227,95055,11550,83505,11114,72391,39273,2753,16109,1776,55382,12480,6800,2199,8351,6804
GGCGTACCCATCAAGC,sample,49557,48814,3102,45712,3733,41979,17577,1109,15748,1800,33325,5745,3027,1048,900,2220
CGTCGAGGCATCAAGC,Pos_Ctrl,16165,15835,1522,14313,883,13430,11163,991,876,99,12039,301,3174,2738,968,443
CAGCTTCGCATCAAGC,sample,65310,64487,3516,60971,9052,51919,37273,2585,7008,918,44281,4135,3256,1905,7715,6297
CGCGGTCGCATCAAGC,sample,24717,24338,3223,21115,1868,19247,6941,600,6406,697,13347,4603,3597,1138,1527,1037
ATGAATAGCATCAAGC,sample,69604,68859,2908,65951,10303,55648,43032,3112,5741,493,48773,3270,1994,1388,13475,7479
TAACGCCACATCAAGC,sample,45256,44582,4278,40304,4839,35465,17910,1212,8901,1117,26811,6325,3320,1047,3675,3120
CGCGAGACCATCAAGC,sample,32985,32359,5164,27195,2513,24682,7040,442,9153,1168,16193,6879,4435,1024,1657,1234
CCTAACTACATCAAGC,sample,51763,50967,4879,46088,4840,41248,17158,958,13799,1417,30957,7916,4104,1074,2093,2903
GCGCAATACATCAAGC,sample,51171,50520,1517,49003,7184,41819,35673,3119,2039,296,37712,692,1023,1264,9058,5373
TTAACTGACATCAAGC,sample,57793,57114,1619,55495,7978,47517,39083,3352,3496,571,42579,1015,1390,1404,8922,5949
AGAGTTCTAGAGAGCC,sample,73804,72982,3598,69384,13546,55838,43551,3156,5803,636,49354,2692,2047,1471,14729,10028
TATACGGAAGAGAGCC,sample,54870,54338,1824,52514,4857,47657,21510,1579,18010,2705,39520,3853,2438,1257,2013,3207
TCATACCAAGAGAGCC,sample,52763,52075,4193,47882,6676,41206,18642,1517,11755,1308,30397,7984,4055,1193,5323,4413
ATTCAAGGAGAGAGCC,sample,91583,90548,10782,79766,6414,73352,28641,2165,25794,2599,54435,14153,7785,2983,4503,3528
TGATTCCGAGAGAGCC,sample,56746,56191,1993,54198,9061,45137,36233,2661,4058,447,40291,1738,2195,1979,9979,6404
GCAACTAGAGAGAGCC,sample,13233,12921,972,11949,1992,9957,5334,454,2645,253,7979,1271,1857,991,993,1225
ATACGTTCAGAGAGCC,sample,55082,54361,3975,50386,8495,41891,22943,1440,9947,1366,32890,6195,3833,1434,5480,5613
CCGCAGTCAGAGAGCC,sample,51305,50651,2956,47695,6092,41603,22785,1849,11033,1423,33818,4513,3343,1474,6209,4164
CCGTACGCAGAGAGCC,sample,36446,35772,2916,32856,5517,27339,14631,847,7276,758,21907,3827,2936,1114,2676,3466
CTAACCGGAGAGAGCC,sample,65666,64894,2844,62050,9714,52336,36162,2925,8456,821,44618,3972,3142,1788,9143,6856
TAACGAAGAGAGAGCC,sample,42960,42388,2561,39827,5487,34340,18177,1066,9475,1252,27652,4370,2852,1172,3204,3852
GCCTATTCAGAGAGCC,sample,10556,10354,946,9408,1133,8275,3413,200,2955,356,6368,1351,1609,658,555,714
AGCAGAGCAGAGAGCC,sample,18301,18064,1290,16774,1981,14793,7647,542,4255,399,11902,1950,2027,974,2084,1449
ATACCGCCAGAGAGCC,sample,28298,27848,2305,25543,2325,23218,10100,874,7602,851,17702,3791,2855,1055,1462,1516
GTCGCGAAAGAGAGCC,sample,41993,41404,2079,39325,4017,35308,23821,1473,6039,684,29860,3291,2769,1581,2147,2697
CGTCGAGGAGAGAGCC,sample,29990,29420,3200,26220,2446,23774,9963,690,7315,714,17278,5092,2953,754,1059,1440
CAGCTTCGAGAGAGCC,sample,31522,31062,1571,29491,3040,26451,15375,979,6661,892,22036,2544,2308,1257,3027,2018
ATGAATAGAGAGAGCC,sample,68118,67290,6179,61111,7003,54108,29915,2497,12399,1204,42314,8093,4258,1534,7477,4967
AAGTAGAGAGAGAGCC,sample,42507,41869,1727,40142,6175,33967,27619,2352,2422,249,30041,1325,1273,1129,8453,4772
TCAATCAGAGAGAGCC,sample,54452,53787,1856,51931,7252,44679,36384,2078,4128,459,40512,1630,1514,1258,9315,5397
GACTAACCAGAGAGCC,sample,52192,51508,1762,49746,6412,43334,35286,2721,3447,567,38733,1313,1848,1709,7093,4571
CGTAGAACAGAGAGCC,sample,54610,53788,2709,51079,6861,44218,31879,2129,5950,714,37829,3546,1921,1291,8600,4682
CCTAACTAAGAGAGCC,sample,35691,35064,2595,32469,3394,29075,14832,1014,7920,918,22752,4391,2432,893,1404,2073
CATAATGGAGCATTGA,sample,74202,73421,2004,71417,15207,56210,47558,3604,3739,424,51297,885,1310,1532,14585,11017
TATACGGAAGCATTGA,sample,67334,66575,2839,63736,11668,52068,36435,2438,8331,869,44766,3995,2950,1775,9070,8106
GAGCCTCCAGCATTGA,sample,77388,76355,3977,72378,12823,59555,41146,2719,9666,1257,50812,4767,3259,1678,13494,8980
CGTCGCCAAGCATTGA,sample,25701,25237,2315,22922,3801,19121,11038,734,4081,410,15119,2858,2624,1352,3321,2430
TGATTCCGAGCATTGA,sample,92360,91491,2726,88765,7993,80772,43749,2585,25939,3350,69688,5149,2728,1855,4873,5298
TACGCGAGAGCATTGA,sample,137786,136523,5226,131297,22500,108797,86688,6970,9148,1028,95836,4963,2639,1797,28239,16732
ATACGTTCAGCATTGA,sample,98398,97343,4693,92650,13051,79599,55336,3490,13433,1165,68769,6175,3690,1865,16956,9599
CCGCAGTCAGCATTGA,sample,86967,85816,4902,80914,10780,70134,40027,2766,17695,2044,57722,7602,4198,1882,9057,7272
GGCAGGTTAGCATTGA,sample,93840,92654,3905,88749,10694,78055,48199,3634,17968,2351,66167,5903,3923,2225,7010,7782
GATGCGTTAGCATTGA,sample,95488,94458,3610,90848,14874,75974,58710,4258,8282,891,66992,3833,3144,2185,15573,10484
ATGGCGTTAGCATTGA,sample,50096,49507,3283,46224,6674,39550,24023,1684,7828,840,31851,5175,3543,1442,9731,4306
AGCGTCTTAGCATTGA,sample,97829,96912,4933,91979,17370,74609,47766,3749,12823,1540,60589,8731,4697,2551,10252,11922
CATTCGGTAGCATTGA,sample,96607,95525,4031,91494,14818,76676,56071,3975,10388,1292,66459,4950,3587,2156,13222,10987
TAGCGAGTAGCATTGA,sample,140258,138883,4299,134584,16826,117758,90434,6580,13419,1592,103853,5733,3694,2694,14022,11634
CCTAGCGGAGCATTGA,sample,88442,87613,1997,85616,16023,69593,57188,4365,5434,506,62622,2100,2474,2306,8521,11496
GGCGACGAAGCATTGA,sample,131556,130320,3926,126394,14056,112338,66760,4902,29515,3061,96275,8100,3843,2072,10083,9380
GCTGCTTCAGCATTGA,sample,213907,211069,14418,196651,24010,172641,114988,7623,31501,3022,146489,15507,5278,2168,20938,15313
GGCGTACCAGCATTGA,sample,108275,107156,3894,103262,13175,90087,64007,5006,13561,1678,77568,5835,3644,1991,9637,8945
GTCGCGAAAGCATTGA,sample,55590,54680,1802,52878,10132,42746,31238,1924,5807,871,37045,2906,2038,1150,5129,6762
CAGCTTCGAGCATTGA,Neg_Ctrl,2261,1107,445,662,99,563,356,22,121,14,477,50,217,123,102,29
CGCGGTCGAGCATTGA,sample,56135,55512,2040,53472,10047,43425,32200,2405,5356,622,37556,2842,2590,1323,9524,6748
TTATGACGAGCATTGA,sample,59551,58665,3766,54899,6195,48704,24553,2173,12393,1037,36946,8548,3895,1084,3035,4368
TCAATCAGAGCATTGA,sample,57914,56694,3587,53107,6487,46620,29680,2368,9179,851,38859,4542,2764,1151,3767,4601
ATTCTACCAGCATTGA,sample,104969,104121,2619,101502,13072,88430,75440,6393,3752,650,79192,2195,3013,3278,12249,9417
GACTAACCAGCATTGA,sample,110527,109517,4146,105371,15625,89746,65911,5179,11876,1718,77787,5062,3257,2240,13801,10975
TTAACTGAAGCATTGA,sample,41086,39972,4298,35674,4083,31591,22454,1569,5100,636,27554,1832,2258,1462,5065,2502
ATATGCAAAGCATTGA,sample,34424,33932,973,32959,5367,27592,20691,1595,3250,389,23941,1667,2146,1740,3143,3523
AGAGTTCTAATTACCA,sample,65356,64408,5500,58908,8339,50569,32826,2184,8770,982,41596,5807,3944,1990,7915,5835
CATAATGGAATTACCA,sample,55122,54385,5230,49155,6905,42250,21532,1384,10683,1219,32215,7432,3772,1186,7730,4748
GAGCCTCCAATTACCA,sample,36801,36332,1314,35018,5426,29592,24588,1869,1819,276,26407,1040,2242,2323,5519,3900
GGTAGAGAAATTACCA,sample,75418,74639,4512,70127,10869,59258,32476,1698,15880,1500,48356,7704,3936,1555,8982,7187
TCATACCAAATTACCA,sample,89498,88747,3568,85179,15142,70037,46471,3313,11182,1218,57653,7853,3829,1602,14737,10379
ATTCAAGGAATTACCA,sample,39398,39078,1582,37496,8897,28599,19774,1359,4725,698,24499,2043,2961,2210,3595,5819
GACTCAAGAATTACCA,sample,78631,77995,5258,72737,10740,61997,38810,2757,11653,1358,50463,7419,3878,1769,13251,7359
CCGTACGCAATTACCA,sample,76984,76256,3296,72960,10634,62326,41444,3220,11112,1485,52556,5065,3283,1955,10730,7510
TCTCAGGAAATTACCA,sample,62682,61923,5111,56812,4258,52554,20370,1397,19633,2175,40003,8979,4302,1236,2383,2280
ATGGCGTTAATTACCA,sample,48358,47720,5202,42518,8397,34121,14096,1121,10159,1289,24255,7456,4198,1259,4932,5138
AGCGTCTTAATTACCA,sample,87729,86790,5896,80894,7447,73447,37234,2436,22565,2766,59799,8446,4348,1909,7958,5119
ACGCTTAAAATTACCA,sample,63169,62317,7129,55188,6957,48231,19312,1114,14156,1588,33468,12061,5293,1229,5698,4471
CATTCGGTAATTACCA,sample,43716,43290,1582,41708,7095,34613,27069,2073,3360,474,30429,1637,2166,1792,6624,4901
CTAAGCATAATTACCA,sample,105775,104803,4958,99845,15794,84051,57855,4794,13618,1635,71473,6149,3843,2381,12254,11220
CCTAGCGGAATTACCA,sample,67227,66521,2808,63713,9858,53855,38930,2350,7290,770,46220,4515,2723,1611,9908,6990
GCGTTACCAATTACCA,sample,55249,54483,4883,49600,5218,44382,24643,1635,11008,1707,35651,5389,3628,1592,5663,3892
CAGCTTCGAATTACCA,sample,46919,46255,2467,43788,5196,38592,24760,2343,6765,655,31525,4069,2905,1422,5732,3758
GACTAACCAATTACCA,sample,33977,33382,3464,29918,3010,26908,11082,695,8143,879,19225,6109,3765,1059,2683,1824
CCTAACTAAATTACCA,sample,72661,71787,6091,65696,5425,60271,33661,2236,13686,1586,47347,9102,4491,1394,8878,3592
GCGCAATAAATTACCA,sample,36470,35932,4028,31904,2864,29040,12303,552,9625,955,21928,5605,3248,886,1836,1576
TTAACTGAAATTACCA,sample,47730,47203,2134,45069,4178,40891,28688,1772,6131,848,34819,3452,2693,1471,6307,2723
CTGGTCTTTAGATGAC,Pos_Ctrl,55811,54790,4864,49926,2786,47140,39424,3321,3038,426,42462,931,5630,5971,3809,1466
GACGTATGTAGATGAC,sample,116801,115633,4412,111221,32047,79174,55917,5099,11528,1503,67445,5127,3238,1796,12317,20252
CATACTCCTAGATGAC,Pos_Ctrl,30651,30074,2349,27725,1569,26156,21942,1942,1547,209,23489,516,4419,4345,2017,813
TCATCGAATAGATGAC,sample,80495,79612,3230,76382,14472,61910,39937,2692,13055,1014,52992,5212,2944,1375,10450,9627
TCATACCATAGATGAC,sample,74137,73335,4752,68583,11433,57150,31073,2640,13878,1334,44951,8225,4674,1760,6676,7469
TGATTCCGTAGATGAC,Pos_Ctrl,19999,19761,1772,17989,1027,16962,14140,1313,1028,146,15168,335,3536,3248,1194,620
ATACGTTCTAGATGAC,sample,104347,103358,4899,98459,13103,85356,56342,4141,15603,1595,71945,7675,4506,2434,8397,8552
CCGTACGCTAGATGAC,sample,51974,50144,2166,47978,5518,42460,28282,2701,7241,974,35523,3262,2553,1439,1919,3273
TGGATCAATAGATGAC,sample,214651,212613,6812,205801,25323,180478,118265,11385,33698,3537,151963,13593,4267,1672,26038,17380
TGCGCGTTTAGATGAC,sample,79378,78479,3045,75434,9114,66320,40860,2549,16199,1698,57059,5014,2984,1825,6232,6187
CGGTTGGTTAGATGAC,sample,47232,46765,1842,44923,6029,38894,24285,1772,9066,1089,33351,2682,3063,2247,5370,4484
TAGCGAGTTAGATGAC,sample,32145,31635,2022,29613,3270,26343,15656,1196,6020,780,21676,2691,3011,1882,1223,2236
GCTCTTCTTAGATGAC,sample,43206,42559,3571,38988,6095,32893,16937,1181,8962,963,25899,4850,3338,1365,3544,4022
GAGATTCTTAGATGAC,sample,48181,47605,2055,45550,5750,39800,23137,1751,10851,1238,33988,2823,2708,1676,3250,3900
CTAAGCATTAGATGAC,sample,43544,43002,2251,40751,6521,34230,22434,1464,6806,892,29240,2634,2568,1673,6455,4367
CCTAGCGGTAGATGAC,sample,18000,17757,992,16765,2865,13900,8598,581,3077,301,11675,1343,2045,1325,1875,1936
GGCGACGATAGATGAC,sample,19633,19328,1844,17484,2994,14490,9195,591,2776,281,11971,1647,2359,1427,2382,2003
GCCTATTCTAGATGAC,sample,4934,4826,570,4256,532,3724,1653,111,1184,90,2837,686,982,375,564,336
AGCAGAGCTAGATGAC,sample,2258,2186,247,1939,234,1705,746,62,576,56,1322,265,561,260,132,154
TCTCCTAGTAGATGAC,sample,58733,58038,2313,55725,5753,49972,30640,2279,11905,1434,42545,3714,2309,1213,5173,3782
ATGAATAGTAGATGAC,sample,44780,44350,2217,42133,6605,35528,26062,2368,4357,570,30419,2171,2319,1577,4673,4707
AAGTAGAGTAGATGAC,sample,26050,25520,1779,23741,3492,20249,12420,1013,4076,413,16496,2327,2099,1080,1604,1899
TCAATCAGTAGATGAC,sample,71652,70849,3702,67147,8233,58914,39558,2970,9746,838,49304,5802,3357,1430,8834,5420
TAACGCCATAGATGAC,sample,16389,16146,1518,14628,1709,12919,7511,467,2745,271,10256,1925,1899,939,1622,1096
CGCGAGACTAGATGAC,sample,61598,60841,4126,56715,5134,51581,29965,1805,12137,1260,42102,6414,3600,1659,4512,3100
AGATACTATAGATGAC,sample,30548,29987,2590,27397,2466,24931,10569,847,8442,1099,19011,3974,2365,821,871,1530
CCTAACTATAGATGAC,sample,63460,62754,1961,60793,4985,55808,39455,3800,9041,1410,48496,2102,2326,1844,5778,2795
AGAGTTCTGTTCAGAA,sample,119596,118757,3548,115209,21731,93478,71072,6035,10442,1252,81514,4677,3268,2366,16730,14479
CATAATGGGTTCAGAA,sample,17020,16823,783,16040,3860,12180,7090,602,3041,401,10131,1046,1753,1039,1558,2551
GGTAGAGAGTTCAGAA,sample,75519,74774,3996,70778,13165,57613,37448,2500,10699,1165,48147,5801,4002,1887,9207,8515
TCATCGAAGTTCAGAA,sample,47214,46798,1615,45183,15763,29420,24743,1717,2054,332,26797,574,1181,1296,8452,9632
TCATACCAGTTCAGAA,sample,80275,79613,2737,76876,9116,67760,42779,3397,14992,1983,57771,4609,3280,2323,5842,5881
GCAACTAGGTTCAGAA,sample,13374,13053,658,12395,2372,10023,5507,449,2455,280,7962,1332,1776,1053,910,1409
CCGCAGTCGTTCAGAA,sample,27042,26680,1020,25660,4336,21324,15280,940,3343,449,18623,1312,2222,1526,3184,2829
CCGTACGCGTTCAGAA,sample,46997,46567,3058,43509,9402,34107,21334,1575,6193,755,27527,4250,3253,1955,6076,6313
GGCAGGTTGTTCAGAA,sample,132384,130763,9067,121696,12976,108720,49640,2965,30045,3159,79685,22911,7203,1815,9006,8088
AGCGTCTTGTTCAGAA,sample,38720,38238,2585,35653,6128,29525,18393,1238,5916,710,24309,3268,2787,1457,6150,3988
CATTCGGTGTTCAGAA,sample,52280,51770,2744,49026,8520,40506,25329,1836,8158,868,33487,4315,3259,1818,7333,5662
CCTAGCGGGTTCAGAA,sample,12198,12014,490,11524,1394,10130,6071,427,2604,357,8675,671,1732,1134,1190,944
CTAACCGGGTTCAGAA,sample,90194,89019,3652,85367,8627,76740,50602,4157,12485,1404,63087,8092,3653,1517,10465,5632
AGCAGAGCGTTCAGAA,sample,45135,44586,1942,42644,6578,36066,30822,2272,1798,264,32620,910,1457,1651,7336,4493
TGCGCTCCGTTCAGAA,sample,54663,54106,2086,52020,7828,44192,34127,2957,4163,403,38290,2542,2386,1914,7440,5603
ATACCGCCGTTCAGAA,sample,41314,40781,1690,39091,4548,34543,25042,1723,4408,756,29450,2614,2588,2013,2771,3101
GTCGCGAAGTTCAGAA,sample,36792,36269,2036,34233,4179,30054,21057,1256,4619,511,25676,2611,2185,1184,5552,2960
CGCGGTCGGTTCAGAA,sample,24486,24151,1115,23036,2627,20409,14530,982,3046,282,17576,1569,2101,1460,2970,1828
ATGAATAGGTTCAGAA,sample,58662,58050,2152,55898,6591,49307,30344,2285,11524,1449,41868,3705,2575,1402,6390,4412
AAGTAGAGGTTCAGAA,sample,19022,18732,1677,17055,2016,15039,7269,547,4395,412,11664,2416,2315,1044,1424,1174
GACTAACCGTTCAGAA,sample,37201,36658,2365,34293,3585,30708,17685,1366,7041,1270,24726,3346,2098,1070,3954,2321
AGATACTAGTTCAGAA,sample,40751,40277,2040,38237,4807,33430,24896,1949,4106,488,29002,1991,2145,1443,4849,3339
CCTAACTAGTTCAGAA,Pos_Ctrl,12332,11920,892,11028,669,10359,8628,738,697,76,9325,220,2581,2220,712,337
CTGGTCTTTTCTGGTT,sample,67910,66912,4343,62569,12117,50452,31006,2185,9483,1175,40489,6603,3995,1553,11391,8127
GTCGTTCTTTCTGGTT,Neg_Ctrl,3099,1326,805,521,58,463,284,20,99,9,383,51,177,93,61,17
TATACGGATTCTGGTT,sample,117806,116828,6136,110692,19677,91015,65761,5461,12050,1102,77811,6641,4124,2401,14841,13989
GAGCCTCCTTCTGGTT,sample,84884,83888,3300,80588,7108,73480,38447,2427,22159,3321,60606,7126,3628,1959,4125,5187
CTAGCGACTTCTGGTT,Neg_Ctrl,1956,949,375,574,84,490,309,20,95,20,404,46,205,108,77,20
ATTCAAGGTTCTGGTT,sample,58869,58202,3429,54773,6516,48257,31598,1811,9264,875,40862,4709,3686,2026,6458,4492
GCAACTAGTTCTGGTT,Neg_Ctrl,1320,608,337,271,44,227,128,13,72,4,200,10,112,67,34,10
GACTCAAGTTCTGGTT,sample,28528,27940,1755,26185,4517,21668,12581,884,5201,506,17782,2496,2082,1006,3111,2936
TCTCAGGATTCTGGTT,sample,52157,51437,3440,47997,6571,41426,23239,1844,9459,976,32698,5908,3831,1653,5385,4254
TGCGCGTTTTCTGGTT,sample,38464,37805,4422,33383,4101,29282,11346,849,9938,1200,21284,5949,3638,1064,2239,2486
CCATTCTTTTCTGGTT,sample,64485,63711,4835,58876,9164,49712,29258,1976,11746,1394,41004,5338,3328,1660,9109,6005
GCTCTTCTTTCTGGTT,sample,92286,90837,4435,86402,13184,73218,50364,3680,11662,1284,62026,6228,3211,1475,16462,9657
CTAAGCATTTCTGGTT,sample,115139,114056,4570,109486,14370,95116,67945,4645,14829,1712,82774,5985,4213,2498,15891,10434
GCTGCTTCTTCTGGTT,sample,171435,169394,5534,163860,20664,143196,109176,9309,14674,1351,123850,8686,4070,1877,18642,13718
ATACCGCCTTCTGGTT,sample,56196,55493,2169,53324,8951,44373,36168,2169,3714,653,39882,1669,1696,1348,10515,6545
GCGTTACCTTCTGGTT,sample,49625,48956,2307,46649,6258,40391,27209,1915,6883,805,34092,3579,2769,1511,4654,4212
CAGCTTCGTTCTGGTT,sample,73453,72292,7669,64623,6015,58608,26643,1858,16252,1730,42895,12125,6061,1672,5444,4096
CGCGGTCGTTCTGGTT,sample,22356,22054,2716,19338,2013,17325,5767,367,6190,674,11957,4327,2816,881,1085,1126
ATGAATAGTTCTGGTT,sample,66497,65799,3928,61871,5452,56419,28927,2090,16200,2088,45127,7114,3942,1943,4433,3385
AAGTAGAGTTCTGGTT,sample,92345,91359,6145,85214,7914,77300,40276,3292,17519,1946,57795,14267,6636,2212,9545,5124
TTAACTGATTCTGGTT,sample,56781,56312,2760,53552,6865,46687,26948,2622,10615,1177,37563,5325,2808,1296,5709,4332
AACCGGTTGTTCGGTT,sample,201495,199977,4275,195702,45816,149886,123654,8570,11843,1818,135497,4001,3099,2946,32953,30951
TCTAGGTTGTTCGGTT,sample,203346,201935,4513,197422,29913,167509,111715,7072,35606,4799,147321,8317,3886,2972,16826,21709
TATACGGAGTTCGGTT,sample,65965,65383,3065,62318,6401,55917,25847,1818,19261,2440,45108,6551,3775,1886,3019,4501
GAGCCTCCGTTCGGTT,sample,111671,110317,3226,107091,16157,90934,67834,5257,11455,1245,79289,5143,3559,2637,6331,12012
GGTAGAGAGTTCGGTT,sample,44057,43414,2123,41291,4346,36945,22472,1385,9099,1018,31571,2971,2890,1752,3806,2992
CGTCGCCAGTTCGGTT,sample,34299,33542,2648,30894,4589,26305,13773,836,7355,996,21128,3345,2546,1072,1797,2869
TCATACCAGTTCGGTT,sample,42496,41881,1977,39904,2621,37283,18464,1016,12076,1636,30540,4091,2757,1477,856,1539
GACTCAAGGTTCGGTT,sample,57860,57176,2536,54640,9967,44673,30573,2311,8076,872,38649,2841,2955,1896,8205,6875
TCTCAGGAGTTCGGTT,sample,71954,71173,3385,67788,9585,58203,28845,3011,16873,2133,45718,7341,4053,1722,3632,6105
TGGATCAAGTTCGGTT,sample,82078,81266,5612,75654,9794,65860,35487,2926,15647,1892,51134,9908,5331,2098,10536,6618
GGCAGGTTGTTCGGTT,sample,90029,89169,4012,85157,14572,70585,43407,3018,16412,1885,59819,5863,3338,1824,7922,10693
ATGGCGTTGTTCGGTT,sample,81810,80938,4211,76727,14613,62114,38193,2575,12655,1573,50848,7118,3937,1687,11802,9559
CCATTCTTGTTCGGTT,sample,134890,133603,6641,126962,17282,109680,65349,4592,24550,2559,89899,12630,5582,2402,16594,11900
ACGCTTAAGTTCGGTT,sample,88846,87868,4966,82902,8588,74314,37005,2257,22898,2689,59903,9465,4386,1581,5173,5395
CATTCGGTGTTCGGTT,sample,87896,86868,5029,81839,12739,69100,41970,3465,14028,1644,55998,7993,4863,2026,7081,8112
CTAAGCATGTTCGGTT,sample,178734,176989,10298,166691,12466,154225,101892,7235,25878,2630,127770,16590,7467,3868,9345,8451
CTAACCGGGTTCGGTT,sample,21929,21611,1406,20205,2422,17783,8969,589,5508,664,14477,2053,2015,961,1333,1621
GCGTTACCGTTCGGTT,sample,69084,68209,2974,65235,9964,55271,39752,2775,7525,938,47277,4281,2843,1616,10569,7185
TTATGACGGTTCGGTT,sample,64727,64074,3141,60933,9123,51810,38084,2625,7109,805,45193,3187,3056,1852,9240,6149
TCAATCAGGTTCGGTT,sample,19259,18964,1441,17523,2060,15463,7137,430,4966,718,12103,2212,2267,1003,1894,1283
ATTCTACCGTTCGGTT,sample,65239,64411,3993,60418,6596,53822,29043,2095,13222,1991,42265,7471,3740,1809,4216,4181
CGCGAGACGTTCGGTT,sample,63781,62857,4156,58701,4844,53857,29764,2111,13817,1515,43581,6650,3792,1788,5193,3096
CCTAACTAGTTCGGTT,sample,77574,76719,2617,74102,6502,67600,38708,2217,19245,2567,57953,4863,2693,1432,5179,4028
GCGCAATAGTTCGGTT,Neg_Ctrl,1767,985,497,488,53,435,281,14,83,9,364,48,168,112,58,23
TTAACTGAGTTCGGTT,sample,70730,69979,2307,67672,10447,57225,43724,4079,6066,1016,49790,2340,2508,1953,9051,7427
ATATGCAAGTTCGGTT,sample,66137,65524,1774,63750,7983,55767,36818,3454,10925,1405,47743,3165,2711,2033,5244,5314
GTCGTTCTTGGCGGTT,sample,118508,117108,6904,110204,9628,100576,41328,2881,36039,5017,77367,15311,6455,2657,3901,6255
GACGTATGTGGCGGTT,sample,172318,170104,13985,156119,15197,140922,39268,3181,52555,6290,91823,39628,10071,2186,5309,9498
TATACGGATGGCGGTT,sample,167672,166212,4775,161437,33381,128056,110073,8778,7297,710,117370,1198,1535,1822,35765,24842
CTAGCGACTGGCGGTT,sample,93689,92520,4239,88281,12159,76122,46747,3182,17636,2263,64383,6294,4121,1998,9521,7665
GGTAGAGATGGCGGTT,sample,118489,117496,4124,113372,21985,91387,75833,5901,6067,565,81900,3021,2857,2458,14763,16568
TCATACCATGGCGGTT,sample,108990,107903,4234,103669,18035,85634,69280,4386,7416,1003,76696,3549,3249,2095,19079,13221
TGATTCCGTGGCGGTT,sample,71461,70698,3636,67062,7918,59144,34598,2105,15078,1838,49676,5525,3749,2034,8370,5275
TACGCGAGTGGCGGTT,sample,84422,83405,3530,79875,11749,68126,37759,2516,18896,2447,56655,6508,3123,1566,7756,8815
CCGCAGTCTGGCGGTT,sample,222453,220250,6660,213590,35698,177892,140229,12226,14470,1933,154699,9034,4674,2306,33936,26434
GGCAGGTTTGGCGGTT,sample,137069,135183,5231,129952,14376,115576,63587,4605,30520,4846,94107,12018,3968,1558,7197,9766
CGGTTGGTTGGCGGTT,sample,80720,79832,9267,70565,7637,62928,34439,2157,14338,1466,48777,10528,5575,2610,3249,4908
CATTCGGTTGGCGGTT,sample,73902,73345,2290,71055,8624,62431,34411,2828,17953,2638,52364,4601,2965,1912,3410,5206
CTAAGCATTGGCGGTT,sample,225406,223437,7097,216340,33265,183075,140047,8540,21701,3282,161748,9505,4219,2475,33756,23104
AAGGTCTGTGGCGGTT,sample,115062,113995,2955,111040,18333,92707,68999,4571,13546,1561,82545,4030,3503,2919,12469,12385
CCTAGCGGTGGCGGTT,sample,50198,49503,2598,46905,5699,41206,22810,1324,11505,1209,34315,4358,3489,1735,4618,3654
GGCGACGATGGCGGTT,sample,103602,102395,4668,97727,16030,81697,55060,4829,13367,1436,68427,7005,4717,2094,16705,10816
AGCAGAGCTGGCGGTT,sample,131376,130236,4453,125783,18675,107108,85507,7670,8422,896,93929,4613,4233,3370,14811,13399
GCGTTACCTGGCGGTT,sample,117377,116020,5421,110599,10251,100348,45500,2766,38537,4175,84037,9370,4210,2034,7413,7004
TTATGACGTGGCGGTT,sample,130933,129776,3589,126187,16744,109443,83549,6262,11595,2487,95144,5550,2478,1985,17142,12750
TCTCCTAGTGGCGGTT,sample,89275,88247,4564,83683,8129,75554,43836,3016,19196,2103,63032,7403,3753,1648,9274,5930
ATGAATAGTGGCGGTT,sample,102877,101689,5776,95913,9502,86411,48137,3363,20803,2523,68940,11585,5455,2472,5012,5919
CCTAACTATGGCGGTT,sample,134486,133141,5546,127595,19191,108404,79219,7338,12360,1107,91579,8380,4092,1887,20353,13680
AACCGGTTTCCTTATT,sample,54938,54264,1684,52580,11920,40660,34846,2878,2134,208,36980,594,1129,1444,11338,8229
TCTAGGTTTCCTTATT,sample,60823,60282,1631,58651,10592,48059,42186,2830,1723,321,43909,999,1875,2231,12325,7665
AGCTGAATTCCTTATT,sample,34978,34750,900,33850,8948,24902,19197,1571,2829,364,22026,941,1817,1717,4598,5911
GACGTATGTCCTTATT,sample,18440,18306,434,17872,4336,13536,11128,1028,874,109,12002,397,1373,1431,2707,2858
CATAATGGTCCTTATT,sample,22032,21844,851,20993,3565,17428,10883,777,3897,439,14780,1432,1714,1150,3402,2424
TATACGGATCCTTATT,sample,46265,45856,2184,43672,6753,36919,19987,1389,9798,1000,29785,4745,2929,1281,3935,4330
GGAGAAGCTCCTTATT,sample,25178,24989,582,24407,5778,18629,15854,1067,1172,167,17026,369,1944,2027,3416,4051
GAGCCTCCTCCTTATT,sample,12170,12065,984,11081,1443,9638,4836,362,2550,289,7386,1601,1904,896,1621,885
CATACTCCTCCTTATT,sample,69464,68781,3341,65440,9473,55967,34364,2355,12306,1501,46670,5441,3353,1725,8456,6531
TCATCGAATCCTTATT,sample,16004,15776,2092,13684,1678,12006,3166,206,4599,483,7765,3552,2600,611,912,964
TCATACCATCCTTATT,sample,63261,62668,3090,59578,6849,52729,33674,2401,10288,1455,43962,4911,3938,2392,5333,4835
GACTCAAGTCCTTATT,sample,36220,35785,1059,34726,7089,27637,24040,1705,1438,175,25478,279,1139,1383,7132,5173
ATACGTTCTCCTTATT,sample,32718,32292,2069,30223,2483,27740,12620,891,9518,1187,22138,3524,2773,1280,864,1489
TGCGCGTTTCCTTATT,sample,15724,15389,1914,13475,2010,11465,3749,319,4365,535,8114,2497,1996,582,884,1215
AGCGTCTTTCCTTATT,sample,70055,69406,2861,66545,13367,53178,42645,3318,4024,346,46669,2845,2781,2486,7632,9274
ACGCTTAATCCTTATT,sample,28230,27810,2656,25154,1929,23225,9037,582,7788,942,16825,4876,3114,1062,638,1100
GCTGCTTCTCCTTATT,sample,23387,23008,1346,21662,3449,18213,11343,830,3325,385,14668,2330,2325,1373,1448,2345
CGTCGAGGTCCTTATT,Pos_Ctrl,11717,11487,1011,10476,499,9977,8230,787,639,79,8869,242,2539,2227,523,238
CAGCTTCGTCCTTATT,sample,34209,33716,3951,29765,3587,26178,10609,846,7679,787,18288,6257,3948,1082,3233,2154
CGCGGTCGTCCTTATT,sample,12498,12247,725,11522,1352,10170,5700,362,2469,333,8169,1306,1367,723,880,852
TAACGCCATCCTTATT,sample,28548,27991,3885,24106,1953,22153,5566,375,8670,970,14236,6572,3736,752,1382,1061
AGAGTTCTAATAAGGT,sample,51072,50267,4066,46201,6214,39987,22343,1347,9569,1167,31912,5561,3765,1691,6218,4090
GAGCCTCCAATAAGGT,sample,120705,119488,5851,113637,18919,94718,49893,3374,24071,2470,73964,14910,6032,1940,15056,12767
GCAACTAGAATAAGGT,sample,21818,21380,896,20484,4148,16336,12072,1023,2229,280,14301,732,1744,1470,3630,2790
TGGATCAAAATAAGGT,sample,72855,71847,5975,65872,10037,55835,25236,1600,14698,1564,39934,12737,5379,1378,6896,6393
GATGCGTTAATAAGGT,sample,61254,60534,7487,53047,7724,45323,18096,1265,14158,1423,32254,10381,6181,2168,4700,4627
ATGGCGTTAATAAGGT,Pos_Ctrl,17431,17142,1513,15629,871,14758,12229,1039,1024,136,13253,330,3247,2746,1181,464
TGCGCGTTAATAAGGT,sample,81723,80856,4282,76574,8185,68389,34087,2081,21403,2662,55490,8156,3960,1759,6480,5402
CCATTCTTAATAAGGT,sample,80999,79927,6269,73658,10564,63094,36632,2480,12859,1259,49491,9864,5009,1637,12932,7217
GCTCTTCTAATAAGGT,sample,121859,120521,4648,115873,23037,92836,65938,4728,13430,1917,79368,6823,4349,2544,10689,16199
GAGATTCTAATAAGGT,sample,290799,288105,25127,262978,18522,244456,90423,7051,96193,9852,186616,40937,11282,3431,13846,11660
CCTAGCGGAATAAGGT,Pos_Ctrl,21164,20898,1610,19288,1055,18233,15187,1380,1139,152,16326,375,3639,3387,1223,521
TAACGAAGAATAAGGT,sample,89969,89064,2570,86494,9388,77106,47164,3526,19411,2023,66575,4982,2963,1896,5021,6692
GCTGCTTCAATAAGGT,sample,119224,118048,4637,113411,12692,100719,62524,4538,22933,3270,85457,7454,3942,2078,13039,8661
GTCGCGAAAATAAGGT,sample,110305,109136,3053,106083,15925,90158,75948,5439,5872,690,81820,2209,1856,1605,24272,12027
CAGCTTCGAATAAGGT,sample,55338,54638,3452,51186,4870,46316,20945,1680,15325,1517,36270,6849,4000,1573,2627,2968
TTATGACGAATAAGGT,sample,83001,81882,5003,76879,7797,69082,36590,2661,18763,1781,55353,9287,4603,1466,3875,4573
TCTCCTAGAATAAGGT,sample,148989,147674,4541,143133,16582,126551,100733,7392,11379,1293,112112,5754,4033,2765,17467,11642
AAGTAGAGAATAAGGT,sample,68904,68079,5520,62559,9431,53128,28476,2276,12072,1253,40548,9051,5045,2048,6020,6045
TAACGCCAAATAAGGT,sample,131492,130420,3464,126956,14501,112455,94670,7016,6954,1025,101624,2790,3215,3305,13441,10188
ATTCTACCAATAAGGT,sample,25766,25279,1991,23288,3409,19879,7543,502,7411,914,14954,3509,2383,704,1314,1993
CGCGAGACAATAAGGT,sample,61092,60188,2634,57554,5200,52354,30240,2266,13181,1591,43421,5076,2633,1204,3940,3418
TTAACTGAAATAAGGT,sample,79452,78608,3052,75556,6868,68688,33963,2064,21815,2805,55778,8041,3215,1344,2646,4512
ATATGCAAAATAAGGT,sample,255,249,16,233,26,207,128,4,57,4,185,14,99,44,25,21
CTGGTCTTCAGGACCA,sample,115185,114066,5517,108549,13268,95281,55271,3714,25125,2367,80396,8804,4215,2079,13620,9280
GTCGTTCTCAGGACCA,sample,82635,81350,6783,74567,13156,61411,33893,2422,12997,1280,46890,10819,5183,1709,7290,8880
CATAATGGCAGGACCA,sample,57594,56900,3069,53831,9034,44797,31302,1893,7225,1067,38527,3310,2932,1917,5360,6061
CTAGCGACCAGGACCA,sample,103108,101928,4137,97791,18347,79444,65923,4790,5233,762,71156,2736,2827,2301,17435,13124
TCATCGAACAGGACCA,sample,64626,63847,3599,60248,10098,50150,37514,2754,6149,598,43663,3135,3548,2551,8756,7091
TACGCGAGCAGGACCA,sample,92120,91076,4349,86727,16346,70381,54663,3787,7148,863,61811,3920,2841,1886,14308,11472
GACTCAAGCAGGACCA,sample,47070,46239,2365,43874,8666,35208,23060,1420,6893,659,29953,3176,2844,1546,5918,5960
CCGCAGTCCAGGACCA,sample,64390,63516,3757,59759,7634,52125,26658,2027,15549,1826,42207,6065,4083,1923,3311,4967
CCGTACGCCAGGACCA,sample,37991,37321,2561,34760,7037,27723,16147,1402,6238,802,22385,3134,2941,1358,4028,4687
ATGGCGTTCAGGACCA,sample,79408,78600,4329,74271,6919,67352,35122,2307,20656,2356,55778,6911,3948,1949,5957,4047
AGCGTCTTCAGGACCA,sample,114809,113390,7262,106128,14303,91825,56259,4571,17380,2157,73639,11458,4606,1747,17710,9963
ACGCTTAACAGGACCA,sample,59664,58850,4400,54450,7675,46775,22898,1397,14493,1828,37391,6159,3868,1515,7225,5037
GAGATTCTCAGGACCA,sample,116948,116068,3676,112392,16019,96373,69241,5477,12344,1363,81585,7948,4383,2444,7576,10938
CCTAGCGGCAGGACCA,sample,98293,97484,2719,94765,18630,76135,65121,6623,2791,624,67912,976,1350,1703,18353,13529
GGCGACGACAGGACCA,sample,140780,139372,5541,133831,19101,114730,78199,6259,20096,1860,98295,8316,3926,2042,18005,12666
TGCGCTCCCAGGACCA,sample,85280,84397,4643,79754,9074,70680,43381,3426,15904,1895,59285,6074,3384,1655,7563,5668
ATACCGCCCAGGACCA,sample,75168,74119,7326,66793,8789,58004,27595,1927,16011,1725,43606,10746,5192,1438,7407,5202
CAGCTTCGCAGGACCA,Neg_Ctrl,1933,1099,586,513,79,434,243,20,106,23,349,42,197,115,36,22
CGCGGTCGCAGGACCA,sample,40174,39694,3079,36615,4728,31887,18260,1657,6390,917,24650,4663,3333,1177,5377,3124
TCTCCTAGCAGGACCA,sample,99417,98136,8947,89189,8833,80356,19923,1609,30890,3643,50813,24291,7641,1431,3393,5351
ATGAATAGCAGGACCA,sample,120370,119285,5960,113325,12034,101291,62836,4462,20723,2988,83559,10282,4843,1982,12975,7728
ATTCTACCCAGGACCA,sample,45186,44643,1616,43027,8113,34914,25665,2092,4883,486,30548,1788,2134,1616,5206,5436
CCTAACTACAGGACCA,sample,116886,115755,4978,110777,15259,95518,72848,5659,9596,1275,82444,6140,3441,1984,14690,11185
GCGCAATACAGGACCA,sample,89957,88896,4857,84039,11005,73034,43781,3349,14061,1554,57842,10289,4646,1346,15542,7639
TCTAGGTTCCTCGTTG,sample,111821,110810,4953,105857,16094,89763,64118,4857,13676,1064,77794,6048,3115,2303,14998,12423
AGCTGAATCCTCGTTG,sample,68913,68011,2752,65259,9479,55780,37303,2389,11489,1499,48792,3100,2386,1772,8050,6782
GACGTATGCCTCGTTG,sample,61331,60571,4779,55792,8708,47084,28957,2203,9019,969,37976,5936,3737,1570,10202,5814
CGTCGCCACCTCGTTG,sample,105423,104082,3143,100939,20799,80140,69217,4835,4540,891,73757,657,1398,1758,18456,14617
TCATACCACCTCGTTG,sample,65639,64772,2752,62020,10136,51884,38071,2130,7410,789,45481,3484,2748,1405,14346,7590
GCAACTAGCCTCGTTG,sample,28259,27648,924,26724,5223,21501,18728,1375,968,162,19696,268,1464,1791,4609,3713
CCGCAGTCCCTCGTTG,sample,67196,66218,6044,60174,8241,51933,24111,1708,14408,1881,38519,9825,5255,1856,6039,5115
TGGATCAACCTCGTTG,sample,80712,79548,3222,76326,13617,62709,44723,2407,9732,1998,54455,3849,2547,1312,13272,9193
ATGGCGTTCCTCGTTG,sample,128947,127441,4963,122478,18462,104016,72472,5402,17918,1705,90390,6519,2576,1614,19541,13875
TGCGCGTTCCTCGTTG,Neg_Ctrl,2836,1261,693,568,65,503,287,12,142,7,429,55,173,80,67,20
ACGCTTAACCTCGTTG,sample,103023,101764,8985,92779,12403,80376,31600,2830,24020,2370,55620,19556,6079,1730,3491,7651
CATTCGGTCCTCGTTG,sample,84790,83667,6425,77242,9668,67574,32089,2157,20804,2538,52893,9986,4499,1536,5926,6419
TAGCGAGTCCTCGTTG,sample,58712,57961,5255,52706,7804,44902,23035,1534,10887,1212,33922,8234,4142,1240,6926,5024
AAGGTCTGCCTCGTTG,sample,45850,45295,4110,41185,5336,35849,16824,1400,10593,1095,27417,5937,3845,1321,4368,3427
CTAACCGGCCTCGTTG,Neg_Ctrl,2651,1074,702,372,50,322,179,10,67,6,246,60,137,77,48,8
GGCGACGACCTCGTTG,sample,106064,104784,6634,98150,11885,86265,46162,3357,21582,2997,67744,12167,5270,1786,10867,8160
AGCAGAGCCCTCGTTG,sample,76865,76049,3734,72315,11631,60684,32811,2921,13526,1799,46337,9627,4840,1669,4816,7640
TGCGCTCCCCTCGTTG,sample,17796,17534,692,16842,3679,13163,11311,602,955,87,12266,208,920,933,4283,2635
TTATGACGCCTCGTTG,sample,94409,93559,3590,89969,12275,77694,56678,4127,10382,1339,67060,5168,3816,1979,14309,8600
TAACGCCACCTCGTTG,sample,65798,64939,3080,61859,5887,55972,36171,2717,10755,1465,46926,4864,2934,1471,5255,3962
ATTCTACCCCTCGTTG,Pos_Ctrl,16272,16040,1405,14635,721,13914,11524,1045,902,131,12426,312,3166,2858,773,390
CGCGAGACCCTCGTTG,sample,104995,103647,4735,98912,12419,86493,58125,4148,13172,1821,71297,9227,4703,1723,13459,8562
TCTAGGTTTTGCGGAC,sample,169983,168756,6624,162132,15922,146210,68844,4536,52161,6231,121005,14438,5109,2054,8352,9898
CTAGCGACTTGCGGAC,sample,92939,92182,3893,88289,18525,69764,47444,3003,11108,1286,58552,6923,3985,1653,19024,12341
ATTCAAGGTTGCGGAC,sample,72735,72200,3493,68707,10802,57905,36960,2621,12028,1278,48988,5018,3604,1699,10500,7151
TACGCGAGTTGCGGAC,sample,22294,22057,1862,20195,3082,17113,9914,727,3819,435,13733,2218,2273,1015,3352,1986
GACTCAAGTTGCGGAC,sample,52781,52367,2145,50222,7909,42313,32639,1857,4317,522,36956,2978,2681,1646,14593,5187
CCGCAGTCTTGCGGAC,sample,181746,179993,6661,173332,15470,157862,102971,6037,31936,3511,134907,13407,3962,1912,11194,9613
TCTCAGGATTGCGGAC,sample,180885,179348,9742,169606,19108,150498,87676,7185,30352,3466,118028,21819,7192,2159,20270,11919
TGGATCAATTGCGGAC,sample,198346,195980,13878,182102,16900,165202,61051,4895,52599,5339,113650,41318,9454,2063,7899,10341
TGCGCGTTTTGCGGAC,sample,123145,121976,8084,113892,16805,97087,53324,3220,22190,2359,75514,15994,5891,2040,13139,10970
CCATTCTTTTGCGGAC,sample,84359,83309,6161,77148,13341,63807,39878,3009,11741,1073,51619,8106,4470,2188,9092,8984
CATTCGGTTTGCGGAC,sample,81649,80857,4797,76060,10425,65635,38879,2304,16647,2071,55526,5734,4023,2124,9797,6583
TAGCGAGTTTGCGGAC,sample,82467,81707,4124,77583,12934,64649,44705,2857,9797,1058,54502,6232,3383,1828,14681,8604
GCTCTTCTTTGCGGAC,sample,47880,47344,1650,45694,6297,39397,27149,1954,7331,1044,34480,1919,2912,2342,3869,4459
GGCGACGATTGCGGAC,sample,24136,23707,2120,21587,3280,18307,7398,643,6067,497,13465,3702,3060,1137,1010,2107
TGCGCTCCTTGCGGAC,sample,7409,7290,708,6582,1063,5519,3377,202,1089,112,4466,739,1293,753,852,727
CAGCTTCGTTGCGGAC,sample,18385,18071,1022,17049,2529,14520,9647,641,2918,266,12565,1048,1818,1181,2371,1732
CGCGGTCGTTGCGGAC,sample,40914,40359,1907,38452,3042,35410,16822,1318,11577,1700,28399,3993,2583,1177,966,1972
AAGTAGAGTTGCGGAC,sample,71504,70769,2728,68041,6675,61366,41103,3038,11382,1549,52485,4294,2606,1484,7338,4449
TCAATCAGTTGCGGAC,sample,56974,56245,2359,53886,7067,46819,31776,2232,7051,915,38827,4845,2932,1227,4685,4653
CCTAACTATTGCGGAC,sample,126057,124497,11271,113226,9070,104156,42396,3521,30689,3539,73085,24011,7936,1855,8831,4843
GCGCAATATTGCGGAC,sample,115430,114309,3661,110648,12544,98104,72573,6152,11525,1359,84098,6495,3146,1765,13190,8809
AACCGGTTTCCATTGG,sample,86866,85891,5617,80274,8576,71698,36861,2507,19711,2342,56572,10277,4460,1824,10762,5707
AGAGTTCTTCCATTGG,sample,110298,108727,15068,93659,11777,81882,34816,1948,23115,2583,57931,19420,8001,1837,10511,7295
CTAGCGACTCCATTGG,sample,34507,34125,1125,33000,6137,26863,18171,1537,4684,600,22855,1871,1932,1220,6016,4128
TCATCGAATCCATTGG,sample,12185,12049,1343,10706,891,9815,2798,305,3905,409,6703,2398,2431,833,336,442
TCATACCATCCATTGG,sample,66299,65786,1970,63816,9302,54514,41553,3271,6895,624,48448,2171,2823,2528,8612,6797
TACGCGAGTCCATTGG,sample,37401,36945,2443,34502,5477,29025,16154,931,6314,724,22468,4902,3206,1118,6239,3668
GACTCAAGTCCATTGG,sample,6069,5969,574,5395,845,4550,2234,188,1185,145,3419,798,1061,476,733,523
CCGTACGCTCCATTGG,sample,46768,46203,1487,44716,8609,36107,31378,2285,1837,203,33215,404,1153,1366,10859,6427
AGCGTCTTTCCATTGG,sample,38592,38192,2092,36100,5427,30673,20997,1429,4588,457,25585,3202,2872,2080,4310,3705
ACGCTTAATCCATTGG,sample,24531,24219,742,23477,4526,18951,16432,1086,908,154,17340,371,1082,1241,4980,3287
TAGCGAGTTCCATTGG,sample,46379,45840,1065,44775,6528,38247,31318,2680,2704,434,34022,1111,2077,2165,5470,4386
GCTCTTCTTCCATTGG,sample,42969,42341,1049,41292,7362,33930,29123,2223,1868,120,30991,596,1655,1823,7877,4950
AAGGTCTGTCCATTGG,sample,16951,16723,802,15921,2464,13457,11019,842,987,126,12006,483,1455,1469,2549,1772
TAACGAAGTCCATTGG,sample,13922,13680,1397,12283,2065,10218,5067,385,2544,263,7611,1959,1630,669,1994,1376
AGCAGAGCTCCATTGG,sample,23694,23270,2245,21025,2705,18320,10288,623,3902,430,14190,3077,2458,981,3530,1712
TGCGCTCCTCCATTGG,sample,16924,16570,2422,14148,1505,12643,2377,171,4967,501,7344,4627,2624,430,370,815
CGTCGAGGTCCATTGG,sample,31660,31190,2598,28592,3077,25515,13253,938,6240,654,19493,4430,3131,1268,2130,1964
TCTCCTAGTCCATTGG,sample,47699,46962,4812,42150,4590,37560,19480,1484,8915,991,28395,6690,4042,1257,5697,2910
AAGTAGAGTCCATTGG,sample,29164,28755,2629,26126,2001,24125,9305,699,8010,904,17315,5207,3550,1157,1757,1307
TCAATCAGTCCATTGG,sample,16171,15885,1737,14148,1260,12888,4053,312,4551,519,8604,3453,2379,645,556,774
GACTAACCTCCATTGG,Neg_Ctrl,926,430,238,192,18,174,110,7,32,1,142,24,79,42,38,3
AGATACTATCCATTGG,sample,16766,16488,1020,15468,2010,13458,9983,693,1665,168,11648,949,1269,952,2408,1317
TTAACTGATCCATTGG,sample,30947,30587,2042,28545,3047,25498,13792,793,5559,709,19351,4645,2975,1181,3274,1960
ATATGCAATCCATTGG,sample,255,240,14,226,38,188,94,21,51,0,145,22,76,56,18,22
AACCGGTTCATAGGCG,sample,133427,132717,3654,129063,28163,100900,74201,6404,13066,2310,87267,4919,2929,2234,20122,18737
CTGGTCTTCATAGGCG,sample,176515,175293,4075,171218,26342,144876,117074,9591,12975,1572,130049,3664,3991,4296,18325,18529
GACGTATGCATAGGCG,sample,150011,148648,8813,139835,23219,116616,76529,4910,19505,1896,96034,13776,6021,2495,18348,15929
CATAATGGCATAGGCG,sample,153488,152201,6961,145240,24440,120800,79795,6109,22245,3264,102040,9387,4262,1883,23565,17165
GAGCCTCCCATAGGCG,sample,78669,77530,2452,75078,21808,53270,42857,2625,5907,657,48764,1224,2017,1783,13146,14185
CTAGCGACCATAGGCG,sample,127567,125881,6855,119026,14235,104791,48714,3005,33350,3801,82064,15921,5652,1819,6704,10059
GGTAGAGACATAGGCG,sample,67006,66046,5116,60930,8723,52207,25303,1839,16003,1834,41306,7228,4485,1587,5781,5455
CGTCGCCACATAGGCG,sample,143297,141789,4083,137706,18447,119259,95890,7954,9749,1201,105639,4465,3964,3338,12360,12414
TACGCGAGCATAGGCG,sample,60973,60354,3714,56640,8472,48168,25562,2026,13602,1502,39164,5476,3823,1794,7206,5760
GACTCAAGCATAGGCG,sample,110859,109853,7096,102757,16315,86442,56811,4154,14984,1607,71795,8886,5153,2399,13807,10805
TGGATCAACATAGGCG,sample,86513,85714,4047,81667,18968,62699,45352,3345,7758,911,53110,5333,3823,2305,12549,12796
GGCAGGTTCATAGGCG,sample,67938,67142,4991,62151,6560,55591,24719,1597,18947,2059,43666,8269,4169,1531,2762,3763
TGCGCGTTCATAGGCG,sample,78092,77142,6587,70555,9760,60795,27286,1633,18321,1860,45607,11695,5574,1737,8024,6310
AGCGTCTTCATAGGCG,sample,25112,24771,1521,23250,2266,20984,10378,717,7023,843,17401,2023,2953,1652,1270,1397
CGGTTGGTCATAGGCG,sample,102268,100965,14223,86742,3344,83398,26153,1409,39414,4205,65567,12217,7770,3277,1093,1367
ACGCTTAACATAGGCG,sample,97278,96136,4004,92132,12851,79281,50691,3433,17374,1473,68065,6310,3348,1668,10598,8760
TAGCGAGTCATAGGCG,sample,152559,150839,9512,141327,16045,125282,71026,5174,31550,3298,102576,14234,5239,1971,18475,10010
GCTCTTCTCATAGGCG,sample,90259,89110,4854,84256,9683,74573,35754,2364,23397,2802,59151,10256,4133,1841,3640,6353
CTAACCGGCATAGGCG,sample,87304,86117,9652,76465,8065,68400,24362,1938,22440,2442,46802,17218,6648,1566,6022,4767
GCTGCTTCCATAGGCG,sample,135722,133384,8410,124974,16294,108680,57487,4554,27432,2912,84919,16295,5188,1419,11203,10694
AGCAGAGCCATAGGCG,sample,73880,72916,4089,68827,7823,61004,39687,2712,11712,1903,51399,4990,3097,1633,9056,5258
CGTCGAGGCATAGGCG,sample,49633,48856,3926,44930,7343,37587,20361,1527,9138,795,29499,5766,3551,1164,6884,4641
CAGCTTCGCATAGGCG,sample,84368,83018,8999,74019,5863,68156,27565,1766,23477,2553,51042,12795,5981,1882,4750,3455
CGCGGTCGCATAGGCG,sample,43288,42722,1831,40891,6366,34525,24727,2027,4725,561,29452,2485,2424,1438,6301,4443
TCTCCTAGCATAGGCG,sample,84999,84047,2504,81543,15119,66424,55196,4427,4817,419,60013,1565,2018,1960,13976,10428
ATTCTACCCATAGGCG,sample,35456,34955,1917,33038,3465,29573,17592,1348,6814,763,24406,3056,2854,1523,4095,2359
CCTAACTACATAGGCG,sample,68334,67412,4714,62698,6704,55994,31658,2264,11464,1355,43122,9253,4049,1380,8512,4647
TCTAGGTTTTGGAGAG,sample,166301,164796,6036,158760,31227,127533,95744,7464,16227,1527,111971,6571,4337,2823,17351,22624
CTGGTCTTTTGGAGAG,Pos_Ctrl,32161,31669,2717,28952,1700,27252,22743,1892,1778,236,24521,603,4370,4080,2040,896
GACGTATGTTGGAGAG,sample,17346,17155,1076,16079,3732,12347,7770,609,2646,225,10416,1097,2386,1572,1679,2390
TATACGGATTGGAGAG,sample,56320,55523,3992,51531,7855,43676,23893,1507,10763,1336,34656,6177,3588,1437,6880,4944
GAGCCTCCTTGGAGAG,sample,176681,175146,5449,169697,32304,137393,108017,6509,13301,1615,121318,7951,3566,2081,33867,23123
TCATCGAATTGGAGAG,sample,81940,80904,6193,74711,11311,63400,26099,1957,20602,2196,46701,12546,4844,1509,5585,7208
TGATTCCGTTGGAGAG,Pos_Ctrl,23099,22749,2026,20723,1209,19514,16148,1466,1361,141,17509,398,3787,3441,1485,681
GCAACTAGTTGGAGAG,sample,20003,19271,979,18292,3637,14655,10367,701,2313,345,12680,929,1770,1274,2351,2253
TACGCGAGTTGGAGAG,sample,123632,122347,5908,116439,18414,98025,73871,5622,11066,1254,84937,6212,3643,2197,19158,13145
GGCAGGTTTTGGAGAG,sample,151313,149712,4116,145596,25016,120580,104843,6860,6076,644,110919,2157,1670,1951,30523,18665
AGCGTCTTTTGGAGAG,sample,99089,97630,4789,92841,14068,78773,54360,3851,12721,1153,67081,6688,3624,1809,7928,9767
CGGTTGGTTTGGAGAG,sample,103594,102135,6170,95965,10004,85961,40799,2426,27130,3037,67929,12569,4938,1641,4515,6232
CATTCGGTTTGGAGAG,sample,97563,96413,2967,93446,9986,83460,52425,3493,20828,2104,73253,4610,2895,1851,9191,7152
GAGATTCTTTGGAGAG,sample,88385,87271,3858,83413,7506,75907,41282,2277,22376,2868,63658,7104,3688,1919,3948,4508
CCTAGCGGTTGGAGAG,sample,15343,15062,896,14166,2348,11818,7200,670,2297,317,9497,1334,1554,867,1591,1647
AGCAGAGCTTGGAGAG,sample,35142,34415,3465,30950,4212,26738,9952,969,8544,947,18496,6326,3877,1056,2107,2724
GCGTTACCTTGGAGAG,sample,96936,95813,3746,92067,13442,78625,64431,5296,5322,672,69753,2904,2804,2517,10357,9372
GTCGCGAATTGGAGAG,sample,58921,57860,5183,52677,7264,45413,18281,1542,14345,1512,32626,9733,4497,1121,4053,5131
CGTCGAGGTTGGAGAG,sample,67550,66669,2658,64011,6948,57063,39154,3557,9359,1173,48513,3820,2691,1748,7980,4371
TTATGACGTTGGAGAG,sample,52856,52116,3112,49004,6040,42964,21705,1057,13406,1593,35111,5203,3240,1198,3240,3905
TAACGCCATTGGAGAG,sample,88254,87337,3369,83968,7539,76429,42156,3408,22144,2548,64300,6173,3279,1628,7948,5388
ATTCTACCTTGGAGAG,sample,64036,62930,4127,58803,8131,50672,28308,1893,11761,1167,40069,7543,3922,1256,6957,5259
GACTAACCTTGGAGAG,sample,88209,87331,2886,84445,10206,74239,58503,4271,6903,924,65406,3638,3183,2391,11908,7290
AGATACTATTGGAGAG,sample,101601,100292,4976,95316,11795,83521,55367,4199,15317,2172,70684,6466,3109,1437,13366,7825
GCGCAATATTGGAGAG,sample,41253,40438,2613,37825,4024,33801,19819,1606,8060,901,27879,3415,2487,1227,2879,2477
TCTAGGTTTTCAAGCC,sample,100494,99563,2512,97051,19858,77193,66743,4327,4880,314,71623,929,1306,1436,23860,13732
CTGGTCTTTTCAAGCC,sample,97834,96895,3083,93812,17874,75938,60199,4167,7887,763,68086,2922,2586,2140,16226,12765
GTCGTTCTTTCAAGCC,sample,94302,93240,5189,88051,11989,76062,37641,2816,23917,2863,61558,8825,4301,1851,8527,8153
GACGTATGTTCAAGCC,sample,73146,72503,3651,68852,14828,54024,38337,2845,7298,808,45635,4736,3935,2329,10319,10059
CATAATGGTTCAAGCC,sample,49265,48502,3264,45238,7473,37765,16863,1515,12691,1320,29554,5376,3122,1113,1705,4913
GGAGAAGCTTCAAGCC,sample,47799,47267,3894,43373,3875,39498,18610,1303,12293,1294,30903,5998,4338,2123,2029,2294
CTAGCGACTTCAAGCC,sample,61824,61182,2253,58929,7720,51209,41172,3107,4088,616,45260,2226,2910,2610,5583,5295
TCATCGAATTCAAGCC,sample,62873,62282,2381,59901,8355,51546,31414,2712,12445,1375,43859,3600,3047,1835,4685,5757
GCAACTAGTTCAAGCC,sample,18599,18250,1640,16610,2859,13751,7432,592,3283,393,10715,2051,2272,1050,2207,1650
GACTCAAGTTCAAGCC,sample,37242,36841,1411,35430,4685,30745,22922,1906,3544,665,26466,1708,2327,2022,5814,3351
CCGCAGTCTTCAAGCC,sample,92057,90502,3630,86872,11005,75867,50354,4186,13101,1900,63455,6326,3524,1529,6996,7093
ATGGCGTTTTCAAGCC,sample,55673,54831,2924,51907,12551,39356,23841,1973,7693,1199,31534,4650,3068,1345,4529,8056
CATTCGGTTTCAAGCC,sample,59130,58303,3658,54645,7094,47551,23732,1803,14075,1459,37807,6482,3821,1498,5374,4574
CTAAGCATTTCAAGCC,sample,80080,78916,6725,72191,9225,62966,31817,2913,14988,1668,46805,11580,5020,1691,3639,5981
TAACGAAGTTCAAGCC,sample,87195,86413,3205,83208,12013,71195,52403,3950,9587,835,61990,4420,2863,1796,12934,8080
GCCTATTCTTCAAGCC,sample,31182,30614,3855,26759,4057,22702,7761,373,7620,799,15381,6149,3738,953,1244,2388
TGCGCTCCTTCAAGCC,sample,18545,18277,2390,15887,1830,14057,6151,345,4340,422,10491,2799,2721,1103,1211,961
GCGTTACCTTCAAGCC,sample,24374,23801,3170,20631,1898,18733,4535,303,7755,836,12290,5304,3275,624,825,1050
CGTCGAGGTTCAAGCC,Pos_Ctrl,12212,12012,1047,10965,527,10438,8744,765,652,81,9396,196,2634,2335,638,273
CAGCTTCGTTCAAGCC,sample,64208,63548,1731,61817,8284,53533,47123,3705,1811,263,48934,631,1511,1969,7713,6450
CGCGGTCGTTCAAGCC,sample,41538,41050,3031,38019,3392,34627,18041,1183,9642,1081,27683,4680,3626,1496,4085,1946
TCTCCTAGTTCAAGCC,sample,78158,77545,5747,71798,8702,63096,43492,2898,9597,1536,53089,5573,2949,1735,9381,5779
AAGTAGAGTTCAAGCC,sample,64537,63789,3467,60322,7038,53284,36049,2670,8701,1029,44750,4835,3503,1532,8411,4891
ATATGCAATTCAAGCC,sample,39384,38846,3662,35184,4388,30796,12299,976,9910,982,22209,6629,3354,950,2552,2472
GTCGTTCTAACTTAAC,Neg_Ctrl,1917,853,441,412,105,307,172,26,73,8,245,28,148,86,31,20
CATAATGGAACTTAAC,sample,92188,91402,4404,86998,10740,76258,40938,2647,22423,2377,63361,7873,3958,1690,7608,7755
TATACGGAAACTTAAC,sample,47799,47337,3039,44298,6482,37816,20607,1739,8888,1030,29495,5552,4081,1840,2625,4167
GGAGAAGCAACTTAAC,sample,7921,7776,727,7049,1082,5967,2271,262,2101,249,4372,1084,1405,531,493,684
GAGCCTCCAACTTAAC,sample,67563,66744,3313,63431,5446,57985,25792,1462,21089,2446,46881,7196,3640,1411,1429,3508
CATACTCCAACTTAAC,sample,60262,59526,2671,56855,11094,45761,29319,2315,8968,1144,38287,4015,3188,1536,6339,7518
TGATTCCGAACTTAAC,sample,124006,123029,3662,119367,22357,97010,79880,6278,7624,957,87504,2271,2070,2352,18750,16045
GCAACTAGAACTTAAC,Neg_Ctrl,1177,525,311,214,22,192,122,4,39,2,161,25,85,48,26,5
TACGCGAGAACTTAAC,sample,41810,41256,2745,38511,7977,30534,17868,1172,7356,764,25224,3374,3214,1524,4886,5239
CCGCAGTCAACTTAAC,sample,71768,71048,3744,67304,9297,58007,31811,1958,15824,1993,47635,6421,4321,1869,7639,6084
CCGTACGCAACTTAAC,sample,44251,43695,2526,41169,5121,36048,21478,1361,8498,957,29976,3754,3383,1856,4241,3698
TGGATCAAAACTTAAC,sample,15820,15565,1227,14338,1565,12773,4961,365,4950,612,9911,1885,2118,898,664,961
GGCAGGTTAACTTAAC,sample,53666,53044,3604,49440,4993,44447,21397,1511,13813,1717,35210,6009,3766,1577,2191,3111
GATGCGTTAACTTAAC,sample,60771,60059,3011,57048,6852,50196,26281,1794,14965,1840,41246,5316,3231,1498,4052,4392
ATGGCGTTAACTTAAC,sample,103846,103002,4183,98819,13808,85011,60614,4773,12691,1224,73305,5709,3618,2609,12085,10311
CTAAGCATAACTTAAC,sample,29669,29116,3139,25977,4135,21842,9143,520,6729,726,15872,4724,2983,810,2320,2474
GGCGACGAAACTTAAC,sample,89648,88675,3076,85599,11766,73833,56273,4216,8032,802,64305,4510,2636,1804,12705,8697
GCGTTACCAACTTAAC,sample,3988,3800,224,3576,1673,1903,1176,90,374,48,1550,215,408,266,250,789
TTATGACGAACTTAAC,sample,45964,45398,2503,42895,4674,38221,22100,1084,10218,1034,32318,3785,2661,1152,2909,3466
TCTCCTAGAACTTAAC,sample,51423,50879,1851,49028,7170,41858,32508,2786,4161,299,36669,2104,1768,1413,8983,5190
ATGAATAGAACTTAAC,sample,64483,63825,4197,59628,7009,52619,32363,2463,9916,1238,42279,6639,4177,1721,7769,4541
AGATACTAAACTTAAC,sample,33752,33199,1993,31206,2779,28427,14851,1233,7576,998,22427,3769,2523,1224,998,1648
CTGGTCTTATACTTGA,sample,92833,92010,4095,87915,12206,75709,56085,3377,9613,1265,65698,5369,4188,3084,9726,8751
GACGTATGATACTTGA,sample,100907,99976,4449,95527,17315,78212,54817,4182,10541,1265,65358,7407,3335,1788,16395,12607
CATAATGGATACTTGA,sample,75706,75001,3235,71766,8861,62905,39266,2978,13560,1810,52826,5291,3664,2305,7376,6334
GGAGAAGCATACTTGA,sample,91042,90174,2584,87590,17540,70050,60212,3353,4349,508,64561,1628,1407,1324,21171,12672
GAGCCTCCATACTTGA,sample,102533,101578,3422,98156,17967,80189,62729,5451,7011,1129,69740,3869,2928,2308,13453,12637
TCGAACGAATACTTGA,sample,18893,18507,1027,17480,2144,15336,9058,782,3269,495,12327,1732,2263,1469,888,1269
ATTCAAGGATACTTGA,sample,82945,82235,4741,77494,12656,64838,42467,3245,10441,1227,52908,7458,4334,2082,11322,8539
GCAACTAGATACTTGA,sample,27916,27594,905,26689,4157,22532,17202,1503,2726,392,19928,709,2186,2218,3333,2985
ATACGTTCATACTTGA,sample,42982,42693,1381,41312,9104,32208,23559,2070,4047,456,27606,2076,2181,1502,7085,6048
GATGCGTTATACTTGA,sample,85516,84782,2965,81817,10128,71689,49443,2739,13806,2144,63249,3557,2435,1719,11751,7240
GCTCTTCTATACTTGA,sample,117908,116575,9257,107318,12715,94603,39425,2852,27898,3036,67323,21392,7640,1963,10322,7842
GAGATTCTATACTTGA,sample,130705,129283,6104,123179,15408,107771,81134,5419,12989,1221,94123,7008,3815,2050,19213,11218
CTAACCGGATACTTGA,sample,96691,95613,5158,90455,15031,75424,48254,3632,14204,1369,62458,7965,4175,1645,10025,9774
GGCGACGAATACTTGA,sample,74343,73377,2912,70465,8395,62070,37523,2815,14798,2060,52321,4874,2674,1536,7030,5586
TAACGAAGATACTTGA,sample,63307,62687,1626,61061,10872,50189,41870,3373,3248,504,45118,1194,2329,2293,7629,7613
GCCTATTCATACTTGA,sample,37472,36945,1627,35318,6104,29214,21759,1401,3675,378,25434,2001,1602,1054,7496,4490
CAGCTTCGATACTTGA,Neg_Ctrl,1756,897,424,473,69,404,277,21,59,4,336,43,168,104,64,21
CGCGGTCGATACTTGA,sample,68340,67698,1615,66083,8110,57973,49510,3806,2781,430,52291,1446,1890,2013,8300,6000
TTATGACGATACTTGA,sample,88505,87469,5216,82253,8805,73448,45315,3113,14168,1327,59483,9525,4597,1688,9075,5817
TCAATCAGATACTTGA,sample,66862,66143,3308,62835,7549,55286,37598,3279,8500,840,46098,5069,2858,1522,8896,5246
TAACGCCAATACTTGA,sample,61547,60828,3642,57186,5692,51494,32506,1643,10404,1008,42910,5933,3391,1481,5413,3867
CGCGAGACATACTTGA,sample,63210,62490,2449,60041,7575,52466,42527,3085,4924,486,47451,1444,1463,1288,9302,5849
CCTAACTAATACTTGA,sample,110870,109770,4326,105444,9824,95620,62054,5025,18264,2010,80318,8267,3461,1832,11011,7066
TTAACTGAATACTTGA,sample,84983,84175,4034,80141,8479,71662,45590,3804,15983,1092,61573,5193,2411,1506,9443,5725
ATATGCAAATACTTGA,sample,80806,80028,3299,76729,9028,67701,45227,3854,12275,1734,57502,4611,2927,1615,9273,6627
CATACTCCATCCGCGA,sample,69249,68526,3419,65107,10279,54828,29271,2068,14858,2368,44129,6263,3608,1401,7870,7341
CTAGCGACATCCGCGA,sample,145634,144225,3798,140427,26570,113857,98315,6939,6479,769,104794,1355,1410,1593,36869,19401
GGTAGAGAATCCGCGA,sample,96047,94751,10951,83800,10403,73397,23181,1339,26814,2939,49995,19124,7333,1532,6460,6436
TCATCGAAATCCGCGA,sample,86796,86130,2803,83327,15194,68133,54997,4017,5557,690,60554,2872,3492,3125,10199,10342
ATTCAAGGATCCGCGA,sample,105281,104013,7584,96429,15337,81092,45611,3074,17836,2362,63447,12209,5422,1612,11620,10395
ATACGTTCATCCGCGA,sample,121818,120398,9286,111112,15235,95877,48423,3520,25037,2905,73460,15992,5991,1692,11949,10009
TCTCAGGAATCCGCGA,sample,117628,116338,6523,109815,18941,90874,63263,5621,13649,1505,76912,6836,3103,1550,22160,12885
AGCGTCTTATCCGCGA,sample,42617,42115,2435,39680,6031,33649,23326,1642,5929,599,29255,2153,2542,1788,5019,4074
CTAAGCATATCCGCGA,sample,139061,137687,11271,126416,9609,116807,40853,2792,45383,5919,86236,21860,6740,1686,2256,5419
GTCGCGAAATCCGCGA,sample,101597,100403,4410,95993,11426,84567,50239,4004,19856,1850,70095,8618,3382,1358,8155,8042
CAGCTTCGATCCGCGA,sample,36711,36202,2719,33483,3724,29759,14998,1056,8722,892,23720,4091,3202,1467,2478,2291
TCTCCTAGATCCGCGA,sample,88635,87687,4601,83086,9262,73824,46394,3354,15151,1324,61545,7601,3534,1438,11265,5869
ATGAATAGATCCGCGA,sample,90574,89678,5233,84445,11264,73181,49054,4461,10818,1324,59872,7524,4245,1894,11533,7596
TCAATCAGATCCGCGA,sample,109686,108673,5685,102988,9559,93429,56403,3631,20935,2628,77338,9832,4381,1659,13327,6549
GACTAACCATCCGCGA,sample,109424,107878,9958,97920,9241,88679,35841,2557,29260,2855,65101,18166,6241,1487,5388,5285
CGTAGAACATCCGCGA,sample,80477,79267,6868,72399,6909,65490,28167,1919,21506,2556,49673,11342,4876,1170,2845,4237
AGATACTAATCCGCGA,sample,73980,73091,2936,70155,14522,55633,38906,3448,8784,994,47690,3501,2523,1392,5909,10019
GCGCAATAATCCGCGA,sample,85409,84466,4133,80333,8252,72081,40961,3408,17575,2324,58536,7813,3633,1827,4760,5348
ATATGCAAATCCGCGA,sample,139107,137827,6016,131811,20030,111781,67544,5069,23104,2289,90648,13775,4324,1494,19343,14453
AACCGGTTAGGACTCA,sample,125400,124538,7931,116607,16201,100406,60459,4166,20648,2213,81107,12920,5737,2385,14224,11325
CTGGTCTTAGGACTCA,sample,72102,71120,5745,65375,10950,54425,24057,1564,16769,1650,40826,10385,4694,1489,5050,7352
GTCGTTCTAGGACTCA,sample,51212,50419,1995,48424,7839,40585,26118,2120,8707,1137,34825,2503,2459,1455,3446,5312
AGAGTTCTAGGACTCA,sample,56877,56067,5504,50563,6895,43668,16247,1048,15013,1623,31260,9737,4543,1233,4628,4362
CATAATGGAGGACTCA,sample,70936,70118,4226,65892,7871,58021,30136,2270,16081,1700,46217,7834,4053,1660,6408,5308
TATACGGAAGGACTCA,sample,97333,96307,6565,89742,9933,79809,41140,2507,20830,2210,61970,13122,6414,2407,8092,6185
CATACTCCAGGACTCA,sample,75974,75112,5129,69983,9643,60340,37319,2063,11791,1362,49110,7805,4626,1772,12593,6782
TCATCGAAAGGACTCA,sample,73170,72395,3146,69249,9983,59266,33991,2453,13339,1756,47330,7727,4486,1963,3737,7023
GACTCAAGAGGACTCA,sample,22038,21646,2869,18777,1781,16996,4923,329,7159,730,12082,3855,3229,895,943,1009
CCGCAGTCAGGACTCA,sample,70449,69598,4254,65344,7509,57835,33081,2141,14084,1611,47165,6918,4272,2117,4951,4996
CCGTACGCAGGACTCA,sample,68350,67619,3144,64475,6307,58168,36601,2957,12271,1689,48872,4650,4423,2913,8904,4170
GGCAGGTTAGGACTCA,sample,46454,45598,5550,40048,3835,36213,8535,547,15137,1718,23672,10276,4733,862,1763,2208
CCATTCTTAGGACTCA,sample,93161,92098,4015,88083,13683,74400,50945,3712,13679,1322,64624,4742,3558,2239,11371,8808
CGGTTGGTAGGACTCA,sample,73847,72932,3366,69566,10135,59431,36843,2328,13077,1769,49920,5414,3170,1620,5563,6323
CATTCGGTAGGACTCA,sample,48854,48334,3205,45129,6125,39004,23232,1483,9213,979,32445,4097,3195,1481,6107,3955
CTAAGCATAGGACTCA,sample,61923,61160,4496,56664,6695,49969,29039,1806,11214,1355,40253,6555,4305,1996,5974,4407
GGCGACGAAGGACTCA,sample,14218,13982,1198,12784,1852,10932,6365,357,2354,257,8719,1599,1718,960,1718,1227
GCTGCTTCAGGACTCA,sample,49843,49176,2480,46696,4402,42294,25770,1676,10090,1086,35860,3672,2499,1418,6056,3485
AGCAGAGCAGGACTCA,sample,19209,18855,1971,16884,1599,15285,6726,637,4731,590,11457,2601,2445,1106,1333,872
GGCGTACCAGGACTCA,sample,49429,48656,3350,45306,5983,39323,21029,1198,10288,1079,31317,5729,3681,1230,5568,3806
TCTCCTAGAGGACTCA,sample,69568,68746,4067,64679,4241,60438,24881,1878,21335,3302,46216,9042,4347,1536,1895,2230
AAGTAGAGAGGACTCA,sample,21119,20717,988,19729,1487,18242,9033,766,5710,802,14743,1931,1963,1043,1026,720
GACTAACCAGGACTCA,sample,42898,42184,2461,39723,6392,33331,19698,1555,7386,739,27084,3953,2705,1196,2943,3753
CGCGAGACAGGACTCA,sample,37886,37288,1217,36071,3383,32688,27071,1775,2767,228,29838,847,1993,1837,3861,2232
AGATACTAAGGACTCA,sample,63828,62985,3774,59211,7490,51721,32852,2753,9295,974,42147,5847,3266,1309,7705,5156
CCTAACTAAGGACTCA,Pos_Ctrl,26629,26329,1249,25080,1110,23970,20045,2081,1221,174,21266,449,3874,4095,1582,364
AACCGGTTTATTGAAC,sample,82698,81969,3078,78891,14499,64392,45467,3616,9418,975,54885,4916,3274,1893,14522,9555
TCTAGGTTTATTGAAC,sample,158640,157480,5767,151713,18298,133415,78847,5640,31236,3777,110083,13915,5216,2374,20611,11833
AGAGTTCTTATTGAAC,sample,66035,64872,3941,60931,11144,49787,31711,1779,9627,1454,41338,5216,2973,1330,6021,7149
AGCTGAATTATTGAAC,sample,156101,154643,6189,148454,16621,131833,99735,5814,16294,1593,116029,8397,3981,2744,16211,11443
GAGCCTCCTATTGAAC,sample,129637,127827,5027,122800,14587,108213,78759,5714,13036,1905,91795,8799,4072,1669,19309,9825
GGTAGAGATATTGAAC,sample,150703,148933,7189,141744,13979,127765,85192,8599,19100,2368,104292,12506,5201,1929,16423,8994
TCATCGAATATTGAAC,sample,173576,171412,7589,163823,14716,149107,104441,7167,22532,2127,126973,12840,4560,1910,19110,10377
TGATTCCGTATTGAAC,sample,79838,79048,3536,75512,11039,64473,39386,2344,14943,2035,54329,5765,3686,1997,9282,7511
GACTCAAGTATTGAAC,sample,42311,41805,1905,39900,5700,34200,22418,1620,6447,865,28865,2850,2816,1756,5785,3915
CCGTACGCTATTGAAC,sample,69530,68806,2084,66722,9181,57541,42370,3021,8856,1131,51226,2163,2830,2387,9473,6536
TGGATCAATATTGAAC,sample,55547,54654,3715,50939,8081,42858,25684,1770,9209,884,34893,5311,3038,1251,6540,5524
GGCAGGTTTATTGAAC,sample,53948,53213,2955,50258,6506,43752,23543,1587,12542,1296,36085,4784,3000,1352,5348,4265
GATGCGTTTATTGAAC,sample,53118,52267,2655,49612,5511,44101,24455,1934,12496,1422,36951,3794,2861,1493,5831,3995
ACGCTTAATATTGAAC,sample,20303,19849,1453,18396,2307,16089,9228,607,3797,475,13025,1982,2195,1147,2858,1520
CATTCGGTTATTGAAC,sample,47489,46895,1940,44955,8299,36656,27617,1826,4749,609,32366,1855,2304,1741,7361,5608
CTAAGCATTATTGAAC,sample,14810,14473,1041,13432,2742,10690,6877,505,2071,251,8948,986,1358,797,1642,1902
TTATGACGTATTGAAC,sample,52833,52219,3339,48880,4542,44338,26112,1547,9859,1302,35971,5518,3344,1536,6702,2695
TCTCCTAGTATTGAAC,sample,52457,51725,3873,47852,6591,41261,24368,1657,8441,983,32809,5812,3476,1411,6320,4307
AGATACTATATTGAAC,sample,66015,65310,2229,63081,5180,57901,41521,3246,8895,1226,50416,3013,2424,1889,5556,3277
CCTAACTATATTGAAC,sample,69867,68934,5296,63638,5176,58462,27321,2384,15453,1632,42774,11672,4989,1321,7079,3367
TTAACTGATATTGAAC,sample,53563,52844,5569,47275,3295,43980,12660,750,16354,1744,29014,12472,5879,1141,2024,1842
AACCGGTTGTTCAACT,sample,34692,34096,2082,32014,3320,28694,12788,928,10069,1150,22857,3759,2731,1127,1349,2269
CTGGTCTTGTTCAACT,sample,46139,45559,2975,42584,8720,33864,21696,1766,5480,724,27176,4198,3205,1827,5093,5905
AGCTGAATGTTCAACT,sample,50426,49751,3183,46568,7247,39321,25327,1951,7202,772,32529,4069,3386,2126,5628,5021
CATAATGGGTTCAACT,sample,33167,32674,1705,30969,6082,24887,18658,1379,2840,378,21498,1632,2130,1654,4340,4372
TATACGGAGTTCAACT,sample,33554,33188,1437,31751,7108,24643,18519,1356,3196,422,21715,1150,1995,1629,5222,4751
GGAGAAGCGTTCAACT,sample,30766,30533,1017,29516,9482,20034,15850,1025,2107,264,17957,788,2048,1914,4217,5549
GAGCCTCCGTTCAACT,sample,30587,30061,1540,28521,2330,26191,16323,1511,5530,525,21853,2302,1970,1129,3444,1293
CATACTCCGTTCAACT,sample,24502,23949,1959,21990,1886,20104,7990,811,6737,930,14727,3636,2672,874,563,987
CGTCGCCAGTTCAACT,sample,37318,36637,4178,32459,2304,30155,8894,524,10887,1135,19781,8715,4102,919,701,1106
TCATCGAAGTTCAACT,sample,43816,43223,3396,39827,3788,36039,18540,1407,8616,770,27156,6706,3563,1117,3283,1953
TACGCGAGGTTCAACT,sample,29872,29403,1251,28152,4069,24083,14172,1031,6040,772,20212,2068,2091,1223,3408,2942
GACTCAAGGTTCAACT,sample,29046,28674,1860,26814,3322,23492,12538,907,5908,805,18446,3334,2682,1444,2490,2053
TCTCAGGAGTTCAACT,sample,39620,38800,2081,36719,4371,32348,22160,1529,5785,546,27945,2328,2671,1850,4882,2985
GGCAGGTTGTTCAACT,sample,22984,22589,1404,21185,2176,19009,10833,608,5175,651,16008,1742,1970,1153,1234,1484
ATGGCGTTGTTCAACT,sample,24732,24480,1962,22518,3596,18922,9992,622,4990,438,14982,2880,2637,1139,3460,2331
TGCGCGTTGTTCAACT,sample,31138,30738,1235,29503,4948,24555,21356,1386,1178,237,22534,398,1218,1385,6144,3616
CGGTTGGTGTTCAACT,sample,14613,14335,536,13799,2509,11290,8494,583,1502,209,9996,502,1171,956,2010,1727
CATTCGGTGTTCAACT,sample,26347,26025,1144,24881,2419,22462,12601,859,6457,709,19058,1836,2293,1506,1902,1615
GAGATTCTGTTCAACT,sample,24079,23485,1569,21916,4883,17033,14496,965,1134,185,15630,253,977,1090,4750,3714
AAGGTCTGGTTCAACT,sample,11722,11517,567,10950,2017,8933,7008,496,962,179,7970,288,1072,1006,2125,1467
CCTAGCGGGTTCAACT,sample,3029,2950,449,2501,308,2193,690,45,859,100,1549,499,725,220,172,147
GGCGACGAGTTCAACT,sample,7847,7669,701,6968,1049,5919,3052,161,1578,199,4630,929,1219,595,1016,693
TAACGAAGGTTCAACT,sample,12093,11878,672,11206,1166,10040,6095,449,2175,242,8270,1079,1594,1064,583,780
GCTGCTTCGTTCAACT,sample,14699,14440,1240,13200,953,12247,5183,404,4453,538,9636,1669,1611,734,433,522
GCGTTACCGTTCAACT,sample,19279,18963,886,18077,2714,15363,11964,920,1569,138,13533,772,1164,989,3115,2034
CGTCGAGGGTTCAACT,sample,21581,21247,2167,19080,2129,16951,7776,513,4422,525,12198,3715,2632,894,2596,1245
TCTCCTAGGTTCAACT,sample,8199,8022,941,7081,597,6484,2783,214,2017,186,4800,1284,1461,555,894,373
TAACGCCAGTTCAACT,sample,14756,14469,1461,13008,1448,11560,6932,502,2171,260,9103,1695,1443,712,1933,931
ATTCTACCGTTCAACT,sample,15217,14942,887,14055,1214,12841,6259,578,3795,563,10054,1646,1634,799,868,701
GACTAACCGTTCAACT,sample,15840,15629,840,14789,1799,12990,9808,787,1603,118,11411,674,1167,941,2591,1335
AGATACTAGTTCAACT,sample,19453,19236,856,18380,2104,16276,13859,1288,691,62,14550,376,1016,1197,2861,1456
CCTAACTAGTTCAACT,sample,22794,22537,1384,21153,2105,19048,9493,841,4618,508,14111,3588,2805,1194,1705,1272
GCGCAATAGTTCAACT,Neg_Ctrl,544,327,121,206,29,177,119,2,32,5,151,19,73,49,39,14
TTAACTGAGTTCAACT,sample,19998,19763,717,19046,1497,17549,12438,911,2393,304,14831,1503,2259,1798,882,782
CTGGTCTTCTGAGGTT,sample,234287,231477,14543,216934,20590,196344,91155,5886,58347,6228,149502,34728,9044,2997,9609,13429
GTCGTTCTCTGAGGTT,sample,184554,182546,5991,176555,28100,148455,116455,8547,14585,1897,131040,6971,3881,2717,27316,18675
GGAGAAGCCTGAGGTT,sample,159782,158370,6725,151645,21682,129963,91233,7384,18218,1962,109451,11166,5165,2565,19365,14451
GAGCCTCCCTGAGGTT,sample,39305,38870,2342,36528,6040,30488,17643,1215,7395,790,25038,3445,3284,1603,4745,4003
CTAGCGACCTGAGGTT,sample,186639,183778,9850,173928,14590,159338,78896,6601,40813,5321,119709,27707,6907,2032,11803,8413
CGTCGCCACTGAGGTT,sample,158401,156882,5885,150997,28600,122397,96596,8115,10606,1699,107202,5381,2819,1984,34849,19583
TCATACCACTGAGGTT,sample,32964,32541,2390,30151,3675,26476,10326,836,10130,1264,20456,3920,3143,1236,2730,2266
ATTCAAGGCTGAGGTT,sample,130061,129247,4910,124337,15115,109222,62134,4934,29585,4066,91719,8503,4848,2865,11766,10234
CCGTACGCCTGAGGTT,sample,134982,133333,9513,123820,8138,115682,39565,2809,48588,5254,88153,19466,6960,2252,2828,4430
TCTCAGGACTGAGGTT,sample,139567,138219,7194,131025,14739,116286,67771,4340,26691,3553,94462,13931,5870,2504,14384,9849
TGGATCAACTGAGGTT,sample,175606,174000,9122,164878,18493,146385,87154,5792,32944,3429,120098,17066,7006,2709,19057,13247
GATGCGTTCTGAGGTT,sample,126192,124789,4255,120534,27186,93348,79760,6144,5024,811,84784,1609,1384,1587,26641,19164
CCATTCTTCTGAGGTT,sample,70205,68448,4116,64332,8883,55449,30294,1819,15729,1138,46023,6469,3719,1345,3659,6021
GCTGCTTCCTGAGGTT,sample,94473,93400,4056,89344,5921,83423,44971,3360,23944,3184,68915,7964,3871,2160,4177,3553
GCCTATTCCTGAGGTT,sample,59676,58605,3217,55388,8281,47107,31698,1870,7613,929,39311,4997,3494,1559,8026,5502
AGCAGAGCCTGAGGTT,sample,128883,127144,7551,119593,13899,105694,63459,4807,21183,2069,84642,14176,6115,2024,19475,9089
GCGTTACCCTGAGGTT,sample,48605,47683,3753,43930,4167,39763,16286,1224,13857,1526,30143,6870,3919,1142,3156,2684
GGCGTACCCTGAGGTT,sample,82620,81642,3048,78594,8315,70279,48871,3457,12750,1515,61621,3686,3062,2127,8823,5467
GTCGCGAACTGAGGTT,sample,96007,94731,3830,90901,15883,75018,62843,4957,5302,528,68145,1388,1889,1766,16406,11612
TCAATCAGCTGAGGTT,sample,87924,86692,4541,82151,8252,73899,43551,2858,16805,1698,60356,8987,4449,1570,10054,5490
GTCGTTCTAGACCGTT,sample,180975,179610,7584,172026,28881,143145,91060,9011,26744,2789,117804,13541,5489,2275,27506,20183
GAGCCTCCAGACCGTT,sample,72797,72100,2212,69888,14492,55396,42643,3763,6362,694,49005,1934,2926,2592,8716,9616
CGTCGCCAAGACCGTT,sample,144409,143138,3858,139280,27171,112109,98651,7421,4023,479,102674,1535,2171,2518,24697,19327
TACGCGAGAGACCGTT,sample,54720,54140,4535,49605,3851,45754,13865,977,20437,2665,34302,7810,4460,1474,1212,2191
TCTCAGGAAGACCGTT,sample,110144,109057,5112,103945,10691,93254,45550,3001,30764,3066,76314,10873,4763,2082,4984,6919
TGGATCAAAGACCGTT,sample,127152,126201,4963,121238,18171,103067,67333,4703,20440,2040,87773,8551,4826,3351,10050,11924
GATGCGTTAGACCGTT,sample,105556,104144,4688,99456,17550,81906,54236,3499,15898,2253,70134,6020,3499,1801,11270,11843
TAGCGAGTAGACCGTT,sample,139308,138044,8656,129388,11162,118226,55929,3245,37949,5349,93878,15754,6324,2890,12133,6727
CTAACCGGAGACCGTT,sample,95240,93797,5955,87842,8746,79096,34536,1882,27103,3705,61639,11870,4356,1405,6755,5386
AAGTAGAGAGACCGTT,sample,83750,82816,3841,78975,9401,69574,50391,4437,8509,926,58900,5311,3638,2100,10020,6435
TAACGCCAAGACCGTT,sample,120443,119552,5448,114104,13030,101074,70312,5587,14290,1611,84602,9274,5690,2902,17509,8641
AACCGGTTCTTGAGTT,sample,190605,189209,13060,176149,32944,143205,68850,4593,36329,3840,105179,29593,9652,2539,21862,20721
ATTCAAGGCTTGAGTT,sample,262305,259020,16086,242934,28866,214068,116049,12123,46867,4580,162916,34449,8284,2560,25974,21235
GCAACTAGCTTGAGTT,sample,32619,32115,1385,30730,3556,27174,15817,1325,7045,938,22862,2049,2974,2318,1317,2309
TACGCGAGCTTGAGTT,sample,152361,150877,6716,144161,24772,119389,87809,6344,15954,1914,103763,7368,3390,2035,25340,17251
GACTCAAGCTTGAGTT,sample,75153,73942,3068,70874,13482,57392,40571,3128,9378,1015,49949,3300,2643,1596,10605,8855
CCGCAGTCCTTGAGTT,sample,122507,120818,6707,114111,19285,94826,63873,4631,15085,1467,78958,9770,5553,2606,14531,12365
CCGTACGCCTTGAGTT,sample,109119,107857,5502,102355,10297,92058,49745,3116,25849,3402,75594,9946,4543,2246,8410,6232
TGGATCAACTTGAGTT,sample,124204,122634,3854,118780,31603,87177,69554,4911,8007,843,77561,3862,2427,1985,24409,20416
TGCGCGTTCTTGAGTT,sample,117604,116321,4673,111648,14962,96686,56510,3454,25111,2645,81621,8966,4081,2272,9498,10364
CCATTCTTCTTGAGTT,sample,161773,159950,3887,156063,18371,137692,97051,7385,25311,2769,122362,5176,3230,2796,17964,13838
AGCGTCTTCTTGAGTT,sample,218105,216270,7159,209111,36297,172814,146836,13402,8097,1435,154933,3044,1890,2244,41765,25870
CGGTTGGTCTTGAGTT,sample,93606,92349,4172,88177,9070,79107,41383,2995,23915,3165,65298,7649,3974,1903,6050,5632
ACGCTTAACTTGAGTT,sample,158014,156529,7269,149260,11001,138259,60923,4073,49960,6193,110883,17110,5615,2064,4694,5696
CTAACCGGCTTGAGTT,sample,106796,105668,3750,101918,17192,84726,65354,4344,9339,760,74693,4929,2606,1672,18386,12437
CGCGGTCGCTTGAGTT,sample,49619,48891,2864,46027,5990,40037,26880,2343,6773,719,33653,3322,2802,1599,6659,4099
TCTCCTAGCTTGAGTT,sample,91965,90778,4087,86691,11775,74916,53649,4811,9169,1157,62818,6130,2516,1499,13867,8345
ATTCTACCCTTGAGTT,sample,47335,46185,3669,42516,4705,37811,18016,1257,11645,1095,29661,5798,3084,1056,3119,2854
CGCGAGACCTTGAGTT,sample,70728,69798,3081,66717,7821,58896,43804,2837,7120,972,50924,4163,3895,2947,4631,5394
GTCGTTCTTCGGAGTT,sample,54689,53287,5033,48254,6577,41677,35411,2561,2520,237,37931,948,2622,2800,5818,4413
AGCTGAATTCGGAGTT,sample,31847,31140,2337,28803,3963,24840,12909,970,7028,834,19937,3099,2567,1258,963,2710
GGAGAAGCTCGGAGTT,sample,34094,33526,2132,31394,3185,28209,14963,1066,7848,1040,22811,3292,3086,1602,2216,2042
GAGCCTCCTCGGAGTT,sample,31683,31303,1456,29847,4536,25311,18397,1445,3301,370,21698,1798,3217,2586,2404,3034
CGTCGCCATCGGAGTT,sample,74931,73836,6383,67453,7227,60226,24224,1681,18287,1996,42511,14038,6250,1507,6692,4330
TCATACCATCGGAGTT,sample,83830,82590,2082,80508,9936,70572,62239,4623,2841,275,65080,594,1143,1470,13705,7579
TGGATCAATCGGAGTT,sample,36232,35553,1678,33875,5742,28133,19889,1213,4374,525,24263,2132,2085,1439,5069,3767
GGCAGGTTTCGGAGTT,sample,35978,35402,2004,33398,4480,28918,18647,1365,5318,728,23965,2860,2574,1325,5306,3016
CCATTCTTTCGGAGTT,sample,40177,39037,2592,36445,2734,33711,16151,1140,9673,1139,25824,5608,3374,1024,3177,1554
TAGCGAGTTCGGAGTT,sample,72823,71986,2453,69533,10492,59041,47802,3555,4656,514,52458,2514,2802,2281,9228,7008
CTAACCGGTCGGAGTT,sample,29171,28644,1401,27243,3210,24033,17323,1412,3222,279,20545,1797,1911,1214,3923,2052
GCTGCTTCTCGGAGTT,sample,19134,18716,1849,16867,1887,14980,5805,384,4622,546,10427,3623,2682,815,1352,1095
GCCTATTCTCGGAGTT,sample,24838,24248,1187,23061,2267,20794,12892,1010,4822,657,17714,1413,1830,1266,2761,1403
CGTCGAGGTCGGAGTT,Pos_Ctrl,7894,7714,520,7194,300,6894,5810,506,370,79,6180,129,2021,1719,428,114
CAGCTTCGTCGGAGTT,sample,28439,27910,1973,25937,1354,24583,9116,607,9648,1181,18764,4031,2713,929,524,693
ATTCTACCTCGGAGTT,sample,11440,11204,716,10488,1070,9418,5807,499,1865,234,7672,1013,1737,1052,1313,737
TTAACTGATCGGAGTT,sample,21445,21123,1476,19647,1256,18391,9303,750,4524,390,13827,3424,3116,1608,534,682
CTGGTCTTTGAACCTT,Pos_Ctrl,16171,16015,762,15253,1003,14250,11919,1330,658,93,12577,250,2922,2778,1128,414
GTCGTTCTTGAACCTT,sample,111520,110571,4792,105779,18043,87736,61179,4711,11777,1201,72956,8868,4424,2341,14890,12572
AGAGTTCTTGAACCTT,sample,47037,46566,2919,43647,11140,32507,19635,1626,6230,654,25865,4362,3852,2206,3952,7135
TATACGGATGAACCTT,sample,99708,98774,3707,95067,10782,84285,51143,3437,20411,2417,71554,6877,3297,1886,14184,7020
TCGAACGATGAACCTT,sample,81303,80642,2772,77870,11519,66351,49856,3703,8426,1027,58282,3339,3192,2493,10377,7869
GGTAGAGATGAACCTT,Pos_Ctrl,28637,28271,1863,26408,1326,25082,20951,1988,1431,228,22382,484,4195,4161,1883,664
TCATCGAATGAACCTT,sample,95564,94675,3719,90956,10877,80079,51929,3786,16606,2206,68535,5552,3889,2619,7190,7399
TCATACCATGAACCTT,sample,42790,41957,2946,39011,4468,34543,19388,1405,8067,932,27455,4751,3196,1308,2343,3046
GCAACTAGTGAACCTT,sample,27190,26726,991,25735,5244,20491,15149,1270,2751,357,17900,964,2253,2018,2650,3602
TGGATCAATGAACCTT,sample,73292,72459,3718,68741,7745,60996,38343,2846,12801,1272,51144,5734,4512,2757,2645,4867
GGCAGGTTTGAACCTT,sample,90570,89602,5006,84596,10404,74192,40739,2958,20032,2184,60771,8279,4357,1865,8991,7471
ATGGCGTTTGAACCTT,Pos_Ctrl,27072,26678,1885,24793,1366,23427,19257,1959,1563,174,20820,474,4052,3917,1699,660
TGCGCGTTTGAACCTT,sample,61452,60313,4013,56300,4230,52070,24916,2106,16356,2104,41272,6588,3535,1393,1801,2343
AGCGTCTTTGAACCTT,sample,71590,70394,4237,66157,6916,59241,33367,2588,15523,1510,48890,6253,2977,1398,3855,4443
TAGCGAGTTGAACCTT,sample,109198,107995,6524,101471,10066,91405,46260,3162,24011,2642,70271,15330,6176,2040,13781,5255
CTAAGCATTGAACCTT,sample,40182,39307,3261,36046,4659,31387,13124,1112,9984,1379,23108,5788,3364,1012,2508,3195
CCTAGCGGTGAACCTT,Pos_Ctrl,14667,14443,978,13465,810,12655,10520,1004,748,114,11268,269,2960,2642,811,339
TGCGCTCCTGAACCTT,sample,106010,105025,3282,101743,12721,89022,72387,6373,5899,554,78286,3809,2938,2436,12874,9374
GGCGTACCTGAACCTT,sample,72888,72078,3115,68963,6131,62832,41636,2774,11549,1177,53185,5696,2952,1843,9009,4373
GTCGCGAATGAACCTT,sample,65058,64015,5889,58126,3321,54805,16249,1104,20471,2131,36720,14850,6061,1413,1522,1660
ATTCTACCTGAACCTT,Pos_Ctrl,17770,17493,1243,16250,836,15414,12791,1194,967,113,13758,349,3330,3109,883,334
CGTAGAACTGAACCTT,sample,102550,101336,10858,90478,9941,80537,45512,3668,17068,1553,62580,12736,5539,1698,10690,5967
ATATGCAATGAACCTT,sample,31253,30841,1313,29528,5621,23907,16117,1342,3610,360,19727,2478,2141,1344,2996,3564
AACCGGTTACCGAATT,sample,102496,101521,2963,98558,15895,82663,63877,5680,7977,864,71854,4265,3839,3160,7107,10713
AGAGTTCTACCGAATT,sample,113541,112052,6639,105413,20278,85135,50754,4709,17479,1971,68233,10222,4605,2072,11905,12880
CTAGCGACACCGAATT,sample,72845,71604,4726,66878,11765,55113,27408,1768,15874,1737,43282,8326,4408,1394,6872,7759
TCGAACGAACCGAATT,sample,130658,128782,5868,122914,18461,104453,79280,5309,14002,1531,93282,4331,2141,1773,26042,13495
ATTCAAGGACCGAATT,sample,66389,65590,4568,61022,18979,42043,17978,1377,12920,1305,30898,8463,4423,1308,4873,10985
TGATTCCGACCGAATT,sample,143168,141707,5499,136208,26997,109211,86769,6758,10533,2141,97302,3010,2063,1780,26488,19199
CCGTACGCACCGAATT,sample,136970,135505,4678,130827,24124,106703,86036,6361,8435,886,94471,4985,3454,2446,20848,17285
TGGATCAAACCGAATT,sample,156067,154435,6031,148404,13017,135387,70117,3852,43899,4830,114016,12689,4537,1891,9393,8366
GGCAGGTTACCGAATT,sample,113821,112480,4120,108360,5949,102411,55483,3921,31884,3852,87367,7271,4183,2875,3036,3389
TGCGCGTTACCGAATT,sample,51697,51275,3111,48164,6469,41695,25027,1910,9091,1022,34118,4645,3180,1518,8060,3969
AGCGTCTTACCGAATT,sample,211700,209830,9226,200604,27352,173252,123890,9977,22140,2805,146030,14440,6148,3064,25370,18572
GCTCTTCTACCGAATT,sample,71235,70153,6612,63541,4664,58877,22596,1737,21612,2529,44208,10403,5419,2226,1733,2149
GAGATTCTACCGAATT,sample,113169,111794,6280,105514,13325,92189,52814,4259,23531,2254,76345,9331,5245,2493,9185,8702
CTAAGCATACCGAATT,sample,148508,147140,24861,122279,12693,109586,45913,3004,34492,3756,80405,22421,5624,1954,12397,7835
AGCAGAGCACCGAATT,sample,150362,148862,12444,136418,14009,122409,66387,5239,28447,3579,94834,18757,7589,2766,16986,8935
GCGTTACCACCGAATT,sample,103184,102021,3984,98037,16355,81682,67336,5497,5625,671,72961,2553,2446,2048,18657,11925
CAGCTTCGACCGAATT,Neg_Ctrl,2538,1292,697,595,90,505,290,17,122,13,412,63,200,111,81,26
TTATGACGACCGAATT,sample,121283,119705,6139,113566,12956,100610,60987,5079,18865,2252,79852,13427,4765,1716,17791,8964
TCTCCTAGACCGAATT,sample,68566,67398,10761,56637,8620,48017,10210,727,18847,1790,29057,16443,5965,985,2368,6607
ATGAATAGACCGAATT,sample,87584,86419,3605,82814,6686,76128,44976,2675,19177,2747,64153,6553,3025,1436,6664,4141
CGCGAGACACCGAATT,sample,100598,99358,4107,95251,8595,86656,42629,2909,28841,3822,71470,8455,3666,1821,3689,5675
AGATACTAACCGAATT,sample,108693,107311,5572,101739,15068,86671,71658,5328,7220,717,78878,1748,1613,1450,17801,10946
GCGCAATAACCGAATT,sample,126758,125251,3799,121452,17797,103655,88805,7327,4942,596,93747,1985,1326,1599,23639,13216
ATATGCAAACCGAATT,sample,24848,24586,1352,23234,2217,21017,12728,901,5088,560,17816,1740,2055,1105,3877,1305
AACCGGTTGGTCTGGT,sample,29046,28646,1435,27211,4837,22374,10857,836,7174,982,18031,2525,2206,1156,1289,3074
GTCGTTCTGGTCTGGT,Neg_Ctrl,2439,1245,631,614,65,549,270,11,174,17,444,77,181,105,59,25
GACGTATGGGTCTGGT,sample,138197,137335,4690,132645,23213,109432,83363,6637,12249,1342,95612,5841,4233,2978,13678,15977
GAGCCTCCGGTCTGGT,sample,88301,87262,3161,84101,8332,75769,41610,3138,21029,2339,62639,7653,3647,1811,5538,5599
TCGAACGAGGTCTGGT,sample,121045,119928,5351,114577,17740,96837,74482,5548,9444,1266,83926,6097,3980,2753,18706,12695
CGTCGCCAGGTCTGGT,Neg_Ctrl,2503,1257,731,526,72,454,286,11,94,8,380,55,191,120,74,25
TCATACCAGGTCTGGT,sample,115402,114319,3764,110555,19445,91110,78591,5754,3963,727,82554,2075,1427,1675,26712,14404
GCAACTAGGGTCTGGT,sample,8988,8763,612,8151,1037,7114,3023,298,2584,283,5607,926,1731,789,674,675
ATACGTTCGGTCTGGT,sample,72322,70951,6152,64799,6200,58599,22690,1974,18226,2124,40916,13585,5490,1377,3367,3638
TGGATCAAGGTCTGGT,sample,79190,77895,6169,71726,6613,65113,21804,1798,23104,2361,44908,16046,5938,1248,3036,3737
TGCGCGTTGGTCTGGT,Neg_Ctrl,1634,875,415,460,55,405,224,19,109,13,333,40,154,76,58,16
CCTAGCGGGGTCTGGT,sample,53447,52857,2207,50650,7983,42667,32687,2575,4445,552,37132,2408,2144,1543,8055,5580
CTAACCGGGGTCTGGT,Neg_Ctrl,1757,916,517,399,28,371,201,15,92,4,293,59,141,86,29,17
GGCGACGAGGTCTGGT,sample,72086,71369,2855,68514,5397,63117,34020,2056,19822,2029,53842,5190,3177,1914,2737,3585
GCTGCTTCGGTCTGGT,sample,93870,92756,6135,86621,8071,78550,38071,2704,23777,3122,61848,10876,5369,2242,4954,4995
AGCAGAGCGGTCTGGT,sample,62732,61895,4903,56992,3982,53010,20508,1353,19041,2384,39549,9724,4750,1374,1459,2316
CAGCTTCGGGTCTGGT,sample,82945,82116,3272,78844,6947,71897,49596,3930,12556,1170,62152,4645,3236,2056,7225,4939
CGCGGTCGGGTCTGGT,sample,43266,42899,1291,41608,3984,37624,28568,2192,4584,522,33152,1758,3028,2728,3629,2637
TCTCCTAGGGTCTGGT,sample,117058,115993,5837,110156,6773,103383,56099,3847,28151,3675,84250,11611,4510,2140,7381,4011
TCAATCAGGGTCTGGT,sample,53627,53020,3278,49742,5255,44487,25023,1898,10178,1086,35201,6302,3830,1405,7545,3434
TAACGCCAGGTCTGGT,sample,29476,29025,2396,26629,2144,24485,9166,878,9206,933,18372,4302,2873,1015,1168,1402
GACTAACCGGTCTGGT,Neg_Ctrl,1482,712,417,295,33,262,174,15,39,3,213,31,110,71,45,10
TTAACTGAGGTCTGGT,sample,52953,52207,2498,49709,4847,44862,28525,2165,8336,1297,36861,4539,3188,1602,3507,2790
TCTAGGTTCGACGTTA,sample,163006,161630,5814,155816,26575,129241,99013,7393,12806,1724,111819,8305,4546,2884,23243,17809
AGAGTTCTCGACGTTA,sample,98447,96969,10183,86786,9440,77346,27228,1494,25725,2586,52953,20313,7222,1526,8982,5537
GACGTATGCGACGTTA,sample,97365,95745,7880,87865,12188,75677,32652,2635,24494,2575,57146,13321,4937,1270,8470,8127
GAGCCTCCCGACGTTA,sample,119072,117788,6171,111617,22628,88989,62488,4555,14049,1722,76537,6175,4307,2186,20008,15270
CATACTCCCGACGTTA,sample,96157,94466,6470,87996,9159,78837,41826,2658,20824,2305,62650,11224,4477,1764,4584,5778
CTAGCGACCGACGTTA,sample,101096,99808,10376,89432,9876,79556,28639,2219,25891,3058,54530,19749,7338,1809,9381,5807
TCGAACGACGACGTTA,sample,79716,78780,4294,74486,10958,63528,35422,2306,16766,2203,52188,6831,3624,1838,8219,7896
GGTAGAGACGACGTTA,sample,226254,223647,10301,213346,22344,191002,139965,12348,23354,3214,163319,12121,3976,1851,33544,14344
CGTCGCCACGACGTTA,sample,283130,280194,8102,272092,36045,236047,199126,14069,15111,2044,214237,5697,2774,1868,46768,25139
GCAACTAGCGACGTTA,sample,59640,58902,3595,55307,4881,50426,19355,1287,21513,2308,40868,5963,3696,2034,2027,3101
TACGCGAGCGACGTTA,sample,134994,133635,7201,126434,17109,109325,60062,4337,30016,3022,90078,11888,4681,1821,15644,11063
TGGATCAACGACGTTA,sample,167715,166119,9844,156275,25298,130977,79844,5093,25396,3160,105240,17484,6243,2215,23147,17904
GATGCGTTCGACGTTA,sample,100272,99033,6473,92560,16471,76089,41136,2259,20085,2035,61221,10574,4820,1595,11465,11131
TGCGCGTTCGACGTTA,sample,138159,137071,5455,131616,14220,117396,70269,4481,31305,3544,101574,7797,3595,2089,22396,9943
CCATTCTTCGACGTTA,sample,136187,134670,7600,127070,16640,110430,59980,4477,28979,3743,88959,13251,4593,1949,18661,11473
CGGTTGGTCGACGTTA,sample,78956,78209,2862,75347,8486,66861,46936,3389,11244,1270,58180,4022,3496,2763,3607,5221
ACGCTTAACGACGTTA,sample,63864,63336,3808,59528,7648,51880,27595,1884,14229,1658,41824,6514,4173,2176,7450,4762
CTAAGCATCGACGTTA,sample,73518,72922,2741,70181,8094,62087,34877,2472,18346,2586,53223,3806,2988,1959,4295,5519
AGCAGAGCCGACGTTA,sample,66704,66206,2846,63360,6690,56670,34450,2923,12432,1981,46882,4884,3203,1915,7906,4034
CGCGGTCGCGACGTTA,sample,62500,61964,1938,60026,6946,53080,35048,2661,10391,1028,45439,3952,3259,2447,5189,4352
TCAATCAGCGACGTTA,sample,80124,79679,1565,78114,8441,69673,56058,5902,5159,598,61217,1956,2316,2549,8533,5817
ATTCTACCCGACGTTA,sample,50550,50125,2172,47953,7240,40713,27847,2341,5874,667,33721,3984,3019,1349,6884,4319
AGATACTACGACGTTA,sample,5047,4937,368,4569,827,3742,2196,227,881,127,3077,311,731,510,512,557
ATATGCAACGACGTTA,sample,669,639,46,593,73,520,272,27,134,15,406,72,195,115,60,40
CTGGTCTTTACTAAGT,sample,78846,77400,5366,72034,9229,62805,31199,1787,18328,2186,49527,9305,4305,1438,7176,5897
TATACGGATACTAAGT,sample,72843,72133,4247,67886,9631,58255,32657,2767,12734,1299,45391,8798,4636,1826,6134,6425
CATACTCCTACTAAGT,sample,101174,99818,7538,92280,7260,85020,33657,2595,28507,2870,62164,17391,5151,1471,2627,3596
CTAGCGACTACTAAGT,sample,50844,49726,4378,45348,5846,39502,18037,1342,10892,1456,28929,7775,3707,928,3757,3140
TCGAACGATACTAAGT,sample,86143,85022,9283,75739,5933,69806,19586,1616,24976,2465,44562,21163,7115,1462,1404,2973
CGTCGCCATACTAAGT,sample,87512,86571,3319,83252,8441,74811,55244,3748,9788,1074,65032,4957,3412,1823,9600,5857
GCAACTAGTACTAAGT,sample,18846,18556,920,17636,2222,15414,9428,664,3638,437,13066,1247,1931,1293,2467,1558
CCGTACGCTACTAAGT,sample,34766,34254,1329,32925,3567,29358,17352,968,7882,1124,25234,2032,2041,1340,1985,2548
ATGGCGTTTACTAAGT,sample,41135,40753,1614,39139,5107,34032,23759,1762,5814,890,29573,1807,2751,2075,4231,3597
TGCGCGTTTACTAAGT,sample,18304,17946,2221,15725,1745,13980,5187,305,4341,494,9528,3653,2386,692,1414,1051
GAGATTCTTACTAAGT,sample,5584,5431,429,5002,523,4479,2104,139,1549,125,3653,562,1106,510,362,320
AAGGTCTGTACTAAGT,sample,10760,10582,601,9981,2044,7937,6791,405,495,75,7286,171,908,952,2026,1418
CTAACCGGTACTAAGT,sample,6665,6513,573,5940,595,5345,2651,166,1619,206,4270,703,1247,597,604,409
ATACCGCCTACTAAGT,sample,24421,24070,1760,22310,2381,19929,11490,899,4703,487,16193,2350,2302,1128,2931,1576
CAGCTTCGTACTAAGT,sample,29047,28705,885,27820,3519,24301,20267,1811,1451,230,21718,542,1163,1189,5825,2729
TTATGACGTACTAAGT,sample,31452,30991,3174,27817,2958,24859,12338,758,6064,696,18402,5003,3014,923,3672,1807
TCTCCTAGTACTAAGT,sample,20206,19846,1669,18177,2188,15989,8696,532,3798,558,12494,2405,2040,861,2613,1392
TCAATCAGTACTAAGT,sample,27979,27548,3529,24019,1678,22341,5476,352,9291,856,14767,6366,4012,723,559,755
GACTAACCTACTAAGT,sample,10548,10343,1012,9331,755,8576,3592,276,2698,406,6290,1604,1452,607,548,420
CGCGAGACTACTAAGT,sample,21356,20934,2868,18066,1464,16602,3791,299,6378,654,10169,5480,3264,561,747,775
TTAACTGATACTAAGT,sample,30917,30547,2236,28311,1949,26362,14392,853,6189,695,20581,4233,3484,1599,2306,1181
TCTAGGTTTTGCCGCT,sample,314294,311865,9451,302414,32908,269506,208677,13432,29061,4172,237738,14164,5675,3431,27656,23312
CTGGTCTTTTGCCGCT,sample,213539,211212,5882,205330,25242,180088,123319,9091,34108,4113,157427,9457,4131,2834,17526,16676
CTAGCGACTTGCCGCT,sample,176476,173509,8508,165001,15418,149583,67286,7300,45018,4572,112304,25407,6608,1657,7411,8645
ATTCAAGGTTGCCGCT,sample,68614,68117,7863,60254,6478,53776,26512,1800,17416,2040,43928,6008,4115,2038,3977,6711
GCAACTAGTTGCCGCT,sample,33745,32946,1820,31126,5503,25623,14962,934,6270,757,21232,2700,2499,1211,3473,3366
TACGCGAGTTGCCGCT,sample,196172,194856,6207,188649,29585,159064,115370,8744,23377,3223,138747,8350,3378,2287,34428,21346
GGCAGGTTTTGCCGCT,sample,119110,117631,5804,111827,7977,103850,50927,4110,32866,4014,83793,11933,5289,2454,3562,4507
GATGCGTTTTGCCGCT,sample,200636,199140,5464,193676,36281,157395,135152,11199,6965,959,142117,3120,3001,3172,26092,26568
TGCGCGTTTTGCCGCT,sample,149118,147750,5144,142606,17758,124848,94027,7568,14159,1742,108186,7352,4539,3055,20852,13034
AGCGTCTTTTGCCGCT,sample,177558,176125,5037,171088,24832,146256,128880,9363,5222,444,134102,2347,2467,3257,24887,17433
TAGCGAGTTTGCCGCT,sample,92644,91637,4352,87285,9267,78018,45596,2543,20389,2229,65985,7261,4272,2237,10950,6647
GCTCTTCTTTGCCGCT,sample,136366,135141,11998,123143,18105,105038,63712,4562,23963,2691,87675,10110,4514,2455,16009,12026
GAGATTCTTTGCCGCT,sample,66582,65637,2893,62744,12486,50258,41573,3608,3546,245,45119,1286,1305,1352,15708,8991
CTAAGCATTTGCCGCT,sample,127886,126557,4008,122549,11867,110682,69352,4902,25967,3599,95319,6862,2932,2099,10452,7692
AGCAGAGCTTGCCGCT,sample,98201,97067,4354,92713,7121,85592,45635,3232,27259,2803,72894,6663,3638,1753,4778,3834
GGCGTACCTTGCCGCT,sample,70410,69396,3155,66241,12335,53906,40882,3075,6584,800,47466,2565,2755,1777,9153,7983
CGTCGAGGTTGCCGCT,sample,89588,88731,2340,86391,11983,74408,58176,4124,8191,1058,66367,2859,2922,2232,13597,8839
CGCGGTCGTTGCCGCT,sample,74203,73476,2824,70652,8681,61971,44908,3937,8886,1009,53794,3231,2095,1305,14932,6352
TTATGACGTTGCCGCT,sample,62734,62085,2923,59162,5593,53569,25890,2046,17675,2012,43565,5946,3596,1584,3379,3498
ATGAATAGTTGCCGCT,sample,107112,106144,4954,101190,8713,92477,51282,3551,24720,2530,76002,10394,4629,1804,11100,5391
AAGTAGAGTTGCCGCT,sample,64638,63796,5869,57927,5082,52845,18166,1986,18747,2441,36913,11505,5481,1320,4386,3086
TCAATCAGTTGCCGCT,sample,97312,96602,3246,93356,11401,81955,63606,4849,7791,623,71397,5086,3407,1971,18668,7597
GACTAACCTTGCCGCT,sample,74275,73180,5698,67482,7908,59574,26083,1963,19129,2145,45212,10254,4865,1171,6132,5355
CGCGAGACTTGCCGCT,sample,102236,101187,4125,97062,8152,88910,58817,3976,16980,1587,75797,7550,3963,1871,12412,5530
AGCTGAATTTCGACCT,sample,144137,142139,7207,134932,23450,111482,80684,7689,12773,1794,93457,8542,3214,1813,23389,15384
TATACGGATTCGACCT,sample,107592,106341,5697,100644,13387,87257,48265,3409,22140,2283,70405,11160,4770,2030,8804,8874
GAGCCTCCTTCGACCT,sample,92224,91037,2597,88440,11977,76463,52682,3971,14480,1405,67162,3925,2766,2184,9770,8128
GCAACTAGTTCGACCT,sample,36720,35930,2231,33699,4950,28749,16387,1356,7240,776,23627,2990,2754,1300,4711,3340
CCGCAGTCTTCGACCT,sample,127898,126653,5051,121602,15859,105743,74343,5338,17772,2652,92115,5638,2841,1941,17478,11377
TCTCAGGATTCGACCT,sample,114355,113247,4043,109204,18105,91099,76751,5520,5520,718,82271,2590,2216,1963,21037,14065
GATGCGTTTTCGACCT,sample,42799,42124,2435,39689,7104,32585,22048,1510,5754,497,27802,2776,2242,1191,6148,4786
TGCGCGTTTTCGACCT,sample,94926,93845,6005,87840,11104,76736,47734,3668,15317,1864,63051,8153,4388,1768,16497,7566
ACGCTTAATTCGACCT,sample,104675,103804,3401,100403,15914,84489,69025,4898,6763,600,75788,3203,3290,3068,13496,10890
CATTCGGTTTCGACCT,sample,116020,114886,6081,108805,10754,98051,54812,3948,26246,3310,81058,9735,4315,1925,10865,6951
GCTCTTCTTTCGACCT,sample,120135,118928,3988,114940,16764,98176,74583,5462,11828,1636,86411,4667,3565,2618,15830,11300
CTAACCGGTTCGACCT,sample,94785,93687,4654,89033,6826,82207,37878,2664,29375,3491,67253,8799,3665,1447,2934,4439
GCTGCTTCTTCGACCT,sample,83803,83046,2539,80507,12075,68432,55173,4848,5477,655,60650,2279,2446,2229,13842,8855
AGCAGAGCTTCGACCT,sample,93435,92216,4189,88027,11980,76047,50217,3234,15328,1521,65545,5747,3197,1468,12332,7627
TGCGCTCCTTCGACCT,sample,56568,55662,3897,51765,4282,47483,21081,1451,15446,1808,36527,7697,3853,1201,2446,2488
ATACCGCCTTCGACCT,sample,89268,88265,3246,85019,5622,79397,41801,2630,25600,3651,67401,5715,3150,1840,2651,2508
CAGCTTCGTTCGACCT,sample,78060,77254,5330,71924,5727,66197,28311,2233,22607,2638,50918,10408,4586,1550,2422,2740
CGCGGTCGTTCGACCT,sample,73299,72681,5632,67049,6742,60307,32075,2327,14047,1587,46122,10271,5302,1904,8740,3938
TTATGACGTTCGACCT,sample,114122,113292,6948,106344,8001,98343,42707,3044,31727,2992,74434,17873,6645,1960,4313,4130
TAACGCCATTCGACCT,sample,101627,100919,3891,97028,12284,84744,65965,5331,8510,954,74475,3984,2354,1453,21166,8457
CCTAACTATTCGACCT,sample,105255,104340,4269,100071,10908,89163,58900,5112,14978,2030,73878,8143,3722,1618,15632,6464
AACCGGTTTCCAGACT,sample,7332,7232,296,6936,1228,5708,3193,320,1491,174,4684,530,1133,725,933,795
TCTAGGTTTCCAGACT,sample,39538,39067,1849,37218,5292,31926,18361,1250,7651,905,26012,3759,2702,1294,3326,3518
AGAGTTCTTCCAGACT,sample,83441,82059,6068,75991,4099,71892,29070,2134,24764,3218,53834,12706,4434,1231,966,1631
CATAATGGTCCAGACT,sample,39122,38536,1908,36628,2648,33980,15367,964,12208,1556,27575,3885,2791,1255,1203,1335
TCGAACGATCCAGACT,sample,39915,39541,1744,37797,6394,31403,23341,1938,3595,425,26936,2104,1990,1246,8357,4537
GGTAGAGATCCAGACT,sample,49169,48752,1601,47151,9446,37705,32133,2409,2166,191,34299,806,1525,1643,9957,6639
TCATACCATCCAGACT,sample,156239,154562,6551,148011,17962,130049,98005,10035,13206,1499,111211,7304,3496,1731,18167,12601
CCGTACGCTCCAGACT,sample,48171,47587,2018,45569,6401,39168,30497,2489,3466,352,33963,2364,1971,1451,8882,4649
TCTCAGGATCCAGACT,sample,12764,12542,1490,11052,1057,9995,3830,292,3435,340,7265,2098,2013,747,800,584
AGCGTCTTTCCAGACT,sample,19185,18806,1748,17058,1738,15320,6555,545,4635,481,11190,3104,2318,914,1083,1076
CGGTTGGTTCCAGACT,sample,11502,11294,1089,10205,1009,9196,4279,305,2586,351,6865,1675,1662,690,1224,594
GCTCTTCTTCCAGACT,sample,23309,22830,2910,19920,1534,18386,5778,313,7093,623,12871,4579,2926,792,787,777
TAACGAAGTCCAGACT,sample,23588,23325,1288,22037,2329,19708,12155,735,4455,536,16610,1827,1777,1012,3218,1539
GCTGCTTCTCCAGACT,sample,28164,27711,2266,25445,2761,22684,13775,1073,4520,417,18295,2899,2405,1299,2996,1807
TGCGCTCCTCCAGACT,Pos_Ctrl,9055,8933,655,8278,345,7933,6579,688,455,70,7034,141,2100,1814,487,130
CGTCGAGGTCCAGACT,Pos_Ctrl,6778,6684,472,6212,289,5923,4957,455,383,39,5340,89,1746,1464,444,139
TTATGACGTCCAGACT,sample,10691,10425,638,9787,966,8821,4794,300,2608,312,7402,807,1116,685,436,678
ATTCTACCTCCAGACT,sample,17825,17492,1092,16400,1667,14733,9877,691,2250,342,12127,1573,1496,791,3354,1146
GACTAACCTCCAGACT,sample,14044,13727,1032,12695,1379,11316,7124,520,2034,186,9158,1452,1432,729,2263,932
CGCGAGACTCCAGACT,sample,27732,27371,1014,26357,2787,23570,18047,1465,2402,252,20449,1404,1980,1518,4042,1925
CGTAGAACTCCAGACT,sample,14401,14044,1630,12414,980,11434,4340,314,3883,452,8223,2445,1978,632,568,472
AACCGGTTACCATTAT,sample,134209,132649,6031,126618,19190,107428,70979,5053,20764,2167,91743,8465,3534,1632,14422,13611
CTGGTCTTACCATTAT,sample,220995,218796,8561,210235,25879,184356,109681,8588,44035,5922,153716,16130,5021,2082,30253,17956
AGAGTTCTACCATTAT,sample,109218,108104,6684,101420,7515,93905,39297,2701,33287,4593,72584,14027,5733,2163,3398,4573
CATAATGGACCATTAT,sample,214859,213398,6314,207084,36647,170437,123794,9963,23902,3317,147696,9461,3945,3197,26061,26571
GGAGAAGCACCATTAT,sample,174633,172757,5713,167044,28339,138705,107081,7919,16226,1714,123307,5765,2590,1839,36015,19807
GAGCCTCCACCATTAT,sample,126831,125505,5698,119807,15762,104045,67250,4774,21553,2433,88803,8035,4712,2286,19133,10529
CGTCGCCAACCATTAT,sample,279253,276494,9117,267377,39854,227523,181656,18873,14398,1694,196054,10902,4425,2354,36670,26847
TCATACCAACCATTAT,sample,256968,254277,13235,241042,32930,208112,160482,12430,20882,2858,181364,11460,3437,1701,38610,21435
ATTCAAGGACCATTAT,sample,203915,201438,6569,194869,19815,175054,121914,9837,27189,2954,149103,13160,4579,2016,14332,13181
GCAACTAGACCATTAT,sample,104436,102692,5778,96914,9918,86996,43252,4119,22206,2094,65458,15325,6254,1937,7068,5559
CCGTACGCACCATTAT,sample,136616,135388,7810,127578,15701,111877,71046,5760,21158,2231,92204,11682,5793,2527,16716,10684
CCATTCTTACCATTAT,sample,107864,106400,4809,101591,5619,95972,45230,3424,32810,3446,78040,11062,4740,2051,2434,2514
TAGCGAGTACCATTAT,sample,218560,216252,9004,207248,22617,184631,137124,9562,24132,2618,161256,11195,5109,2056,34147,14696
CTAAGCATACCATTAT,sample,100482,99006,7012,91994,11689,80305,42497,2279,20308,2416,62805,12805,5067,1378,15035,7404
AAGGTCTGACCATTAT,sample,54038,53256,2945,50311,5587,44724,25698,1800,11683,1126,37381,4417,3381,1652,6078,3890
CAGCTTCGACCATTAT,sample,119079,117688,6579,111109,12404,98705,60613,4494,19569,2277,80182,11752,4353,1584,19749,9061
TTATGACGACCATTAT,sample,41589,41133,3100,38033,3750,34283,17527,1237,8961,993,26488,5565,4042,1880,2830,2032
TCTCCTAGACCATTAT,sample,71169,70480,3766,66714,9652,57062,40202,2829,8288,1006,48490,4737,3678,1922,13880,6448
TCAATCAGACCATTAT,sample,43271,42643,4301,38342,4192,34150,12713,849,11148,1005,23861,8435,4441,982,3767,2434
ATTCTACCACCATTAT,sample,142833,141050,6368,134682,11582,123100,85152,5617,21114,2157,106266,9060,4071,2134,18832,7755
CGCGAGACACCATTAT,sample,88010,86966,2597,84369,9713,74656,59242,4742,7710,761,66952,2201,2584,1902,12468,6502
GCGCAATAACCATTAT,sample,77106,75916,4006,71910,5429,66481,34259,1993,19505,2198,53764,8526,3677,1164,4221,3144
ATATGCAAACCATTAT,sample,91736,90719,5666,85053,7727,77326,41216,3523,18785,2413,60001,11389,5484,2146,4001,4593
TCTAGGTTCAATGGAT,sample,218929,217673,4363,213310,40496,172814,153814,11411,4669,680,158483,2240,2187,3039,35441,29291
AGCTGAATCAATGGAT,sample,217178,215499,9437,206062,27408,178654,115484,9156,38731,3962,154215,11321,4936,2981,26474,20741
TCGAACGACAATGGAT,sample,169254,168061,5314,162747,21026,141721,113858,9819,11249,1316,125107,5479,3821,2952,20567,15518
CGTCGCCACAATGGAT,sample,52513,52086,1112,50974,16255,34719,28042,2182,3282,351,31324,862,2875,2839,5316,9783
TCATACCACAATGGAT,sample,152692,151517,9642,141875,19765,122110,69283,4280,27141,2576,96424,18830,6764,2273,20044,12577
ATTCAAGGCAATGGAT,sample,101681,100756,5662,95094,12941,82153,44252,3721,21301,2494,65553,10385,5156,1763,15967,8330
TGATTCCGCAATGGAT,sample,53315,52670,3640,49030,7566,41464,23947,1855,8896,947,32843,5819,3797,1291,8063,4751
GACTCAAGCAATGGAT,sample,304195,301965,14728,287237,28157,259080,155869,14491,46813,4614,202682,37293,9973,2974,39687,18498
TGCGCGTTCAATGGAT,sample,97457,96199,3776,92423,7661,84762,46154,3406,24200,3233,70354,7769,3086,1604,4674,5145
CCATTCTTCAATGGAT,sample,34162,33514,2301,31213,2752,28461,11007,824,11264,1487,22271,3879,2908,1232,2036,1605
AGCGTCTTCAATGGAT,sample,123646,122051,5786,116265,17965,98300,68794,4487,15946,1999,84740,7074,3003,1606,22867,12277
CGGTTGGTCAATGGAT,sample,193219,191419,7539,183880,17030,166850,118237,8775,23021,2701,141258,14116,6698,3596,14465,10995
GCTCTTCTCAATGGAT,sample,103731,101941,6355,95586,10168,85418,43235,3251,23067,2954,66302,12911,5167,1439,7943,6124
CTAAGCATCAATGGAT,sample,116008,114731,7677,107054,9552,97502,53643,3263,24351,2876,77994,13369,6115,2670,7005,5889
CCTAGCGGCAATGGAT,sample,83147,82234,2978,79256,11234,68022,48986,4342,9820,1112,58806,3762,2328,1643,14722,8427
CTAACCGGCAATGGAT,sample,104989,104053,3539,100514,8715,91799,59522,4631,20230,2534,79752,4882,2685,2084,11898,5673
GCTGCTTCCAATGGAT,sample,107995,106898,6371,100527,10683,89844,51270,3908,19735,2237,71005,12694,5546,2079,14034,6810
ATACCGCCCAATGGAT,Neg_Ctrl,2227,1173,707,466,58,408,234,23,94,10,328,47,166,89,39,28
CGTCGAGGCAATGGAT,sample,82509,81393,4887,76506,10238,66268,33432,2522,17658,1994,51090,10662,4380,1305,9136,6706
CAGCTTCGCAATGGAT,Neg_Ctrl,2913,1666,969,697,69,628,392,19,139,13,531,65,245,132,102,26
ATGAATAGCAATGGAT,sample,145728,144402,8983,135419,16670,118749,87761,5401,14051,1491,101812,10045,3954,1749,28127,12029
AGATACTACAATGGAT,sample,132287,131044,6846,124198,14006,110192,76508,5944,15440,1753,91948,10547,4316,1780,16737,9366
CCTAACTACAATGGAT,Pos_Ctrl,19098,18749,1080,17669,841,16828,13961,1383,1009,102,14970,373,3421,3200,1192,366
GCGCAATACAATGGAT,sample,143690,142433,4690,137743,11314,126429,101521,6620,11033,1214,112554,6041,3644,2439,15456,7168
AGCTGAATAGATTCAT,sample,76203,75303,4579,70724,8933,61791,35310,2605,15059,1538,50369,7279,3928,1878,8882,5666
CATAATGGAGATTCAT,sample,37915,37333,3151,34182,4978,29204,11956,843,10060,1089,22016,5256,3310,976,3787,3206
TATACGGAAGATTCAT,sample,101325,100270,5180,95090,15283,79807,57477,3276,11112,1284,68589,6658,3494,1491,21642,10311
TCGAACGAAGATTCAT,sample,57059,56675,1668,55007,6050,48957,28755,2350,12717,1794,41472,3341,2741,1888,6399,4014
CGTCGCCAAGATTCAT,sample,105767,104886,2872,102014,23968,78046,67070,5596,3783,433,70853,1164,1410,1724,22501,16514
TCATCGAAAGATTCAT,sample,161920,160950,4707,156243,25735,130508,104923,8187,10732,1391,115655,5275,2912,2399,25670,18675
ATTCAAGGAGATTCAT,sample,85742,84935,2672,82263,16670,65593,51099,4616,6901,652,58000,2325,2724,2383,10684,10527
TGATTCCGAGATTCAT,sample,63482,62799,2388,60411,10053,50358,33953,3277,8549,807,42502,3772,2843,1830,3716,6878
GCAACTAGAGATTCAT,sample,24615,24131,732,23399,4770,18629,15352,1486,1175,126,16527,490,1448,1553,3505,2904
ATACGTTCAGATTCAT,sample,139337,138449,7217,131232,18324,112908,73813,5728,22031,2431,95844,8905,4169,2191,22483,13774
CCGCAGTCAGATTCAT,sample,117357,116363,5066,111297,14535,96762,62103,4848,18547,1791,80650,9473,4217,2192,15767,9356
TCTCAGGAAGATTCAT,sample,106718,105892,4219,101673,16378,85295,65033,4375,9647,1143,74680,5097,4173,2977,14219,12674
TGGATCAAAGATTCAT,sample,121251,120178,6186,113992,15231,98761,65646,4077,18095,2453,83741,8490,3871,1942,19537,10784
TGCGCGTTAGATTCAT,sample,74271,73282,3103,70179,5157,65022,35351,2300,18176,2547,53527,6648,2968,1356,3270,3465
CGGTTGGTAGATTCAT,sample,93495,92356,5996,86360,6898,79462,31939,2167,27628,3350,59567,14378,5167,1482,3240,3774
CATTCGGTAGATTCAT,sample,101642,100717,4612,96105,10544,85561,59616,3803,14897,2287,74513,4958,3332,1806,15692,7640
TAGCGAGTAGATTCAT,sample,70044,69310,3311,65999,9168,56831,37696,2227,11247,1301,48943,4360,3219,1624,9427,6166
CTAAGCATAGATTCAT,sample,87247,86089,5519,80570,10940,69630,40465,2849,13986,1379,54451,10951,4966,1510,11975,7144
TAACGAAGAGATTCAT,sample,51897,51320,3026,48294,4156,44138,21669,1487,14020,1607,35689,5355,3321,1508,2089,2432
GCCTATTCAGATTCAT,sample,26750,26463,1326,25137,2669,22468,16092,1239,3057,399,19149,1681,2880,2163,4096,1635
AGCAGAGCAGATTCAT,sample,59300,58477,2815,55662,4976,50686,27475,1861,15220,1518,42695,4612,2719,1461,5486,3365
GCGTTACCAGATTCAT,sample,62496,61716,4320,57396,6364,51032,29009,2002,11862,1203,40871,6956,3952,1430,8316,4174
GTCGCGAAAGATTCAT,sample,70064,69193,3062,66131,5569,60562,35659,2695,15061,1979,50720,5168,2948,1587,6819,3627
CGTCGAGGAGATTCAT,sample,58321,57641,2757,54884,6658,48226,32197,2566,8069,902,40266,4492,2772,1535,6302,4653
TTATGACGAGATTCAT,sample,109556,108709,5206,103503,13144,90359,67284,6204,9408,989,76692,6474,3632,2002,14951,9162
CGTAGAACAGATTCAT,sample,17617,17147,1958,15189,1281,13908,4173,489,5447,780,9620,3019,2206,647,440,636
AGATACTAAGATTCAT,sample,64276,63493,4088,59405,5084,54321,30356,1792,13473,1523,43829,7177,3424,1270,9970,3416
CCTAACTAAGATTCAT,sample,58516,58026,1516,56510,7602,48908,41836,2934,2473,494,44309,1171,2089,2189,9115,5438
AACCGGTTCAATCTTG,sample,7104,6950,322,6628,1410,5218,3122,240,1283,180,4405,393,1031,653,856,866
TCTAGGTTCAATCTTG,sample,87282,86461,4900,81561,9511,72050,35560,2746,20440,2046,56000,11258,5460,1898,4340,6441
CTGGTCTTCAATCTTG,sample,42096,41593,2227,39366,4360,35006,17273,1250,11566,1238,28839,3679,3055,1540,2804,2618
GTCGTTCTCAATCTTG,sample,141467,140211,6113,134098,24002,110096,78958,5481,16002,1638,94960,8017,4149,1857,18693,16085
GACGTATGCAATCTTG,sample,160972,159823,11324,148499,20245,128254,65764,4818,31701,3347,97465,22624,7610,2501,18867,13287
GGAGAAGCCAATCTTG,sample,93128,92188,4908,87280,8930,78350,39458,2974,23780,2803,63238,9335,4526,1870,5051,5688
GGTAGAGACAATCTTG,sample,178500,176868,7937,168931,21572,147359,102535,7415,23685,2552,126220,11172,5040,2402,26377,15060
CCGCAGTCCAATCTTG,sample,151444,149152,13384,135768,13183,122585,51130,3280,37552,4466,88682,26157,8393,1729,8481,7968
TGGATCAACAATCTTG,sample,216046,214371,5979,208392,21956,186436,148675,11312,16974,1580,165649,7895,4295,3136,22349,14803
ATGGCGTTCAATCTTG,sample,127486,126185,9825,116360,14294,102066,54745,3903,25192,2346,79937,15880,5345,1901,14380,9073
AGCGTCTTCAATCTTG,sample,156618,155232,6002,149230,16817,132413,93673,6244,21275,2969,114948,8252,3508,2312,21009,11864
CGGTTGGTCAATCTTG,sample,76379,75755,3574,72181,7071,65110,35228,2759,17106,2403,52334,7614,4662,2430,5113,4303
TAGCGAGTCAATCTTG,sample,59937,59223,4579,54644,5648,48996,30654,1887,9278,1029,39932,6148,3992,1785,6422,3532
GAGATTCTCAATCTTG,sample,68564,67626,5464,62162,5170,56992,22905,1317,20295,2263,43200,10212,5012,1541,4404,3106
CTAAGCATCAATCTTG,sample,20155,19789,2034,17755,2034,15721,8369,480,3766,420,12135,2686,2262,977,2315,1279
TAACGAAGCAATCTTG,sample,77168,76042,6570,69472,7100,62372,30367,1901,17082,1793,47449,11229,4745,1442,5693,4615
AGCAGAGCCAATCTTG,sample,96678,95634,4049,91585,8626,82959,54204,3974,17479,2030,71683,5272,3032,1720,11362,5989
GGCGTACCCAATCTTG,sample,61112,60296,3048,57248,7935,49313,35341,3037,6428,654,41769,3853,3035,1740,7512,5424
CGCGGTCGCAATCTTG,sample,32822,32276,2630,29646,2548,27098,12396,941,8607,955,21003,4199,2803,1007,2084,1596
ATTCTACCCAATCTTG,sample,87279,86064,4884,81180,4798,76382,31571,2599,27389,3492,58960,11331,4553,1192,1797,2581
GACTAACCCAATCTTG,sample,29621,29104,3618,25486,2160,23326,9031,781,7028,709,16059,5777,3489,1055,1325,1038
AGATACTACAATCTTG,sample,45598,44727,6877,37850,2409,35441,7221,544,14541,1423,21762,11712,5131,1048,915,960
GCGCAATACAATCTTG,Neg_Ctrl,1858,1108,623,485,60,425,262,21,70,13,332,59,157,97,74,17
TTAACTGACAATCTTG,sample,86224,85353,3484,81869,7847,74022,49689,3256,13721,2018,63410,5338,3112,1598,11464,5063
AACCGGTTCGTTCCGA,sample,261325,259553,10462,249091,33907,215184,145371,11901,40518,5068,185889,12326,5357,3548,23010,23928
CTGGTCTTCGTTCCGA,sample,140643,138890,7985,130905,18387,112518,69112,4489,22861,2709,91973,13347,5645,2100,10240,12129
AGCTGAATCGTTCCGA,sample,169090,167399,8096,159303,23938,135365,93801,7142,22492,2746,116293,9184,4973,2644,18528,15824
CATAATGGCGTTCCGA,sample,157673,155991,9846,146145,15854,130291,56513,4215,44102,5001,100615,20460,6146,1833,9518,10019
CATACTCCCGTTCCGA,sample,187402,185601,13847,171754,20050,151704,91922,5803,29237,2861,121159,21881,8221,3394,14360,13183
CTAGCGACCGTTCCGA,sample,214701,211663,13830,197833,20479,177354,107983,7876,35639,4207,143622,21649,6859,2016,29096,12095
CGTCGCCACGTTCCGA,sample,142882,140034,10409,129625,14551,115074,46634,5381,34099,3738,80733,25222,6754,1468,8901,8124
TACGCGAGCGTTCCGA,sample,260538,258499,20339,238160,29146,209014,103947,7441,54321,6221,158268,37084,10340,3354,27672,17849
GACTCAAGCGTTCCGA,sample,127610,126484,11014,115470,18730,96740,48994,3537,24128,2554,73122,17527,7823,2601,12724,12701
CCATTCTTCGTTCCGA,sample,71285,70541,5894,64647,12432,52215,30930,2339,10458,1239,41388,7249,5167,2754,8961,8124
AGCGTCTTCGTTCCGA,sample,168292,166513,10241,156272,24305,131967,79412,5814,30133,2811,109545,13797,5592,2217,24555,16891
TAGCGAGTCGTTCCGA,sample,131602,130005,7249,122756,12275,110481,58584,3792,30858,3727,89442,13520,4550,1780,5618,7346
AAGGTCTGCGTTCCGA,sample,74135,73361,4977,68384,12415,55969,33336,2881,11121,1526,44457,7105,3803,1493,7904,8927
TAACGAAGCGTTCCGA,sample,19070,18733,2049,16684,1954,14730,6585,394,4803,596,11388,2352,2555,1098,1451,1193
GCCTATTCCGTTCCGA,sample,108388,107395,4003,103392,16853,86539,62211,5230,12516,1395,74727,5187,3829,2105,13986,11674
CAGCTTCGCGTTCCGA,sample,180975,179350,10994,168356,24602,143754,94791,5851,24394,2631,119185,16087,5277,2027,24314,16574
TCAATCAGCGTTCCGA,sample,88701,87605,3024,84581,7589,76992,46779,3344,18661,1571,65440,6637,2674,1330,6783,4611
GCGCAATACGTTCCGA,sample,1835,1747,158,1589,246,1343,690,56,320,46,1010,231,386,223,185,157
CTGGTCTTCAATTCGG,Pos_Ctrl,70084,68897,4630,64267,3424,60843,50830,4563,3759,511,54589,1180,6117,7047,4897,1648
AGAGTTCTCAATTCGG,sample,91497,90394,4391,86003,14351,71652,55831,4368,7179,668,63010,3606,3382,2501,14690,10002
GACGTATGCAATTCGG,sample,114242,112797,6108,106689,16092,90597,54995,3856,20301,2062,75296,9383,4774,2086,14427,11415
GAGCCTCCCAATTCGG,sample,170742,168180,4085,164095,22559,141536,122199,13472,4067,546,126266,1252,1596,1949,21411,14691
CATACTCCCAATTCGG,Pos_Ctrl,84539,82958,4914,78044,3525,74519,62161,5948,4336,571,66497,1503,6352,8262,3735,1311
TCATACCACAATTCGG,sample,173357,171108,7984,163124,13442,149682,87050,7044,35138,3649,122188,16801,5342,2043,10950,8322
GACTCAAGCAATTCGG,Pos_Ctrl,16825,16490,1271,15219,907,14312,11901,1029,949,132,12850,301,3314,2796,1299,466
CCGCAGTCCAATTCGG,sample,87872,86694,6672,80022,10099,69923,37290,2530,17111,1989,54401,11003,5737,2149,12141,6551
CCGTACGCCAATTCGG,sample,82673,81691,2563,79128,15174,63954,55084,4651,2773,548,57857,898,1624,2046,14812,11441
ATGGCGTTCAATTCGG,Pos_Ctrl,30652,30214,2109,28105,1574,26531,21901,2069,1753,208,23654,600,4335,4139,2247,713
AGCGTCTTCAATTCGG,sample,106193,104783,5033,99750,18007,81743,58466,4592,10742,1637,69208,6306,2880,1426,19761,11975
CGGTTGGTCAATTCGG,sample,103240,102181,3478,98703,16340,82363,62118,4903,10408,1058,72526,3876,2961,2121,14682,11053
TAGCGAGTCAATTCGG,sample,47796,47255,2626,44629,6226,38403,23989,1678,8566,864,32555,3306,3044,1747,6479,4312
GAGATTCTCAATTCGG,Pos_Ctrl,15275,15047,1090,13957,768,13189,11029,950,850,102,11879,258,3042,2595,1338,424
CTAAGCATCAATTCGG,sample,45617,44876,2597,42279,4179,38100,19415,1221,12185,1518,31600,3761,2823,1350,2248,2731
GCTGCTTCCAATTCGG,sample,124225,123097,4311,118786,14182,104604,72743,7028,16633,1644,89376,6556,3647,2105,17706,10355
GCCTATTCCAATTCGG,sample,91110,90317,5222,85095,7007,78088,38625,2252,24754,3039,63379,9418,4710,2218,6335,4544
AGCAGAGCCAATTCGG,Pos_Ctrl,17824,17622,1077,16545,876,15669,13128,1251,874,95,14002,321,3431,3209,1243,379
TGCGCTCCCAATTCGG,sample,51014,50334,1952,48382,8537,39845,34008,2364,2157,294,36165,1022,1130,1197,10794,6223
ATACCGCCCAATTCGG,sample,63909,62880,5384,57496,5420,52076,17046,1188,20624,2451,37670,10767,5187,1212,2271,2937
GCGTTACCCAATTCGG,sample,132571,131083,4294,126789,12470,114319,83987,7863,14238,2230,98225,6001,3752,3347,9948,8368
CGTCGAGGCAATTCGG,Pos_Ctrl,25245,24963,1396,23567,1142,22425,18718,1849,1265,146,19983,447,3987,4112,1670,370
CGCGGTCGCAATTCGG,sample,96945,95941,4188,91753,11273,80480,57231,3791,12261,1054,69492,6143,3687,1826,13871,8273
TTATGACGCAATTCGG,sample,98020,97233,2486,94747,11576,83171,60809,4423,13493,1638,74302,2808,2577,1948,16772,7676
AAGTAGAGCAATTCGG,sample,70166,69410,3896,65514,7542,57972,34927,2467,11862,1265,46789,7451,4451,1582,10969,5043
TCAATCAGCAATTCGG,sample,28549,28037,1300,26737,3900,22837,14713,1268,4120,379,18833,2357,2038,1157,1994,2432
GACTAACCCAATTCGG,sample,548,520,46,474,40,434,306,22,77,8,383,21,203,129,68,39
CGTAGAACCAATTCGG,sample,22254,21935,955,20980,1838,19142,9508,1074,5920,861,15428,1779,1663,1020,566,937
TCTAGGTTAACTCCGG,sample,106174,105070,2837,102233,16560,85673,70216,5542,7588,693,77804,1634,2212,2242,22015,11540
GTCGTTCTAACTCCGG,sample,75500,75022,1356,73666,17343,56323,48980,4688,1828,238,50808,589,1936,2705,10140,11574
AGCTGAATAACTCCGG,sample,78921,77784,5084,72700,11139,61561,31882,2630,17933,2222,49815,6894,3703,1607,6786,7381
CATAATGGAACTCCGG,sample,123362,121682,6183,115499,9920,105579,57543,3924,25657,3332,83200,15123,4836,1468,7572,5659
GGAGAAGCAACTCCGG,sample,72519,71603,4077,67526,12332,55194,33751,2371,11649,1163,45400,6260,3857,1841,7192,7732
GAGCCTCCAACTCCGG,sample,119006,117403,9224,108179,12547,95632,42792,3347,28519,3308,71311,17666,7053,1787,13998,8109
CTAGCGACAACTCCGG,sample,126695,124415,13273,111142,7173,103969,23950,1794,42852,4923,66802,30450,8626,1711,2032,2859
CGTCGCCAAACTCCGG,sample,63074,61944,3509,58435,8394,50041,27507,1853,13192,2221,40699,5268,2896,1414,3758,5289
TGATTCCGAACTCCGG,sample,89819,88670,5134,83536,6258,77278,34880,2128,25742,3361,60622,11167,4370,1633,2886,3338
CCGTACGCAACTCCGG,sample,99493,98403,4458,93945,12330,81615,51762,3758,16127,1769,67889,8199,4570,2216,10714,8626
TGGATCAAAACTCCGG,sample,45842,44947,3884,41063,4377,36686,13729,1291,12652,1518,26381,7496,4030,1072,3143,2634
GGCAGGTTAACTCCGG,sample,67283,66514,2643,63871,8781,55090,39902,3496,7353,910,47255,3429,3727,2861,5376,6208
GATGCGTTAACTCCGG,sample,107915,106789,3932,102857,13729,89128,57278,4483,19785,2103,77063,5479,2828,1795,12860,9456
TGCGCGTTAACTCCGG,sample,94133,92995,2817,90178,14312,75866,64681,5538,3822,530,68503,1295,1347,1522,20713,9923
ACGCTTAAAACTCCGG,sample,141564,140131,4702,135429,13608,121821,76965,5834,25698,3045,102663,10279,3938,2108,12857,9185
TAGCGAGTAACTCCGG,sample,44745,44125,3007,41118,7472,33646,20995,1604,5995,788,26990,4264,3713,2210,5798,4713
AAGGTCTGAACTCCGG,sample,94630,93551,4400,89151,13805,75346,49184,4125,12899,1484,62083,7654,4261,1844,13689,9659
CCTAGCGGAACTCCGG,sample,44568,43966,1836,42130,5592,36538,24113,1465,6850,851,30963,3259,2271,1374,5845,3781
TAACGAAGAACTCCGG,sample,111767,110515,7474,103041,10489,92552,47802,3554,22952,2923,70754,15321,6223,1947,4781,5895
GCTGCTTCAACTCCGG,sample,106568,105048,3832,101216,10125,91091,52656,4190,22399,2909,75055,8937,3599,1377,9114,5784
GCCTATTCAACTCCGG,sample,69652,68762,2731,66031,8301,57730,37814,3131,10549,1293,48363,4943,3088,1955,5444,5622
AGCAGAGCAACTCCGG,sample,67306,66342,6725,59617,4829,54788,19085,1594,18737,1985,37822,13387,5332,1414,3306,2761
CGCGGTCGAACTCCGG,sample,62661,61835,4000,57835,7371,50464,27964,2282,11335,1683,39299,7200,4069,1446,6434,4915
ATGAATAGAACTCCGG,sample,37788,37168,2932,34236,3270,30966,17076,1143,7669,809,24745,4269,3520,1660,3561,2012
CGCGAGACAACTCCGG,sample,53029,52122,2054,50068,4489,45579,30133,1957,8842,1470,38975,3177,2392,1466,5264,2762
CGTAGAACAACTCCGG,sample,41983,41356,3275,38081,3524,34557,13073,1256,11832,1129,24905,7267,3906,1015,2588,2360
AGATACTAAACTCCGG,sample,66926,66072,5759,60313,4948,55365,28783,2217,12978,1385,41761,10002,4342,1434,4198,2790
TTAACTGAAACTCCGG,sample,79657,79007,2169,76838,8694,68144,54625,4757,4912,574,59537,3276,2119,1817,11827,6221
GTCGTTCTCCTGAAGG,Neg_Ctrl,3735,1794,1244,550,98,452,269,13,115,11,384,44,203,115,61,18
GGAGAAGCCCTGAAGG,sample,88005,86843,9712,77131,10374,66757,23935,1719,22041,2117,45976,16945,7260,2350,4590,6435
CTAGCGACCCTGAAGG,Neg_Ctrl,3385,1775,1109,666,85,581,313,25,139,16,452,88,228,124,68,23
TGATTCCGCCTGAAGG,sample,104120,103040,4478,98562,14285,84277,65462,4706,8410,912,73872,4787,4124,3202,10227,9076
TACGCGAGCCTGAAGG,sample,84035,83079,3081,79998,11135,68863,49462,3520,10829,1047,60291,4005,3293,2321,8383,8346
GACTCAAGCCTGAAGG,sample,77051,76044,7178,68866,8935,59931,29218,2530,15135,1839,44353,11209,5828,1874,7335,5219
ATACGTTCCCTGAAGG,Neg_Ctrl,2878,1606,1019,587,63,524,333,17,91,8,424,75,202,120,98,24
ATGGCGTTCCTGAAGG,sample,44567,43893,1584,42309,6280,36029,27348,2038,4663,619,32011,1361,2716,2464,2458,4348
TGCGCGTTCCTGAAGG,Neg_Ctrl,2799,1589,975,614,87,527,286,15,115,15,401,96,172,98,72,18
AGCGTCTTCCTGAAGG,sample,117843,116162,4955,111207,22359,88848,76344,6290,4142,233,80486,1839,1544,1736,20223,16152
CGGTTGGTCCTGAAGG,sample,103357,102004,4040,97964,14771,83193,65037,4933,8341,1191,73378,3691,2028,1353,23543,10948
GAGATTCTCCTGAAGG,sample,108903,107335,7485,99850,13238,86612,37093,2360,26264,2710,63357,18185,6211,1577,9748,8704
CTAAGCATCCTGAAGG,Neg_Ctrl,3089,1643,923,720,82,638,391,26,124,5,515,92,245,143,83,32
CCTAGCGGCCTGAAGG,sample,68072,67237,3340,63897,9455,54442,36602,2555,9416,870,46018,4999,3640,1558,11009,6375
GGCGACGACCTGAAGG,sample,43876,43134,4092,39042,4682,34360,11727,811,12162,1254,23889,8406,4361,1076,3151,2944
TGCGCTCCCCTGAAGG,Neg_Ctrl,2155,1031,744,287,31,256,159,6,66,8,225,17,104,71,50,7
GGCGTACCCCTGAAGG,sample,89195,88294,2565,85729,7012,78717,50795,3814,16695,2499,67490,4914,3160,2307,6271,4266
GTCGCGAACCTGAAGG,sample,108988,107819,3082,104737,16106,88631,75226,7468,4236,775,79462,926,1115,1353,19960,11530
CAGCTTCGCCTGAAGG,Neg_Ctrl,1613,1003,544,459,60,399,237,14,88,9,325,51,157,94,58,20
TTATGACGCCTGAAGG,sample,15303,15042,1965,13077,1194,11883,3611,334,4730,494,8341,2714,2539,828,655,648
ATGAATAGCCTGAAGG,sample,94536,93432,3237,90195,10992,79203,69581,4678,3684,459,73265,801,1223,1488,19725,8347
AAGTAGAGCCTGAAGG,sample,96761,95610,4030,91580,10019,81561,51080,3727,17639,2606,68719,6509,3343,1904,9901,6614
GACTAACCCCTGAAGG,sample,100015,98710,4467,94243,10971,83272,60225,4901,9726,1558,69951,6862,3774,1660,10912,7727
CGCGAGACCCTGAAGG,sample,96498,95414,3896,91518,9675,81843,65207,4751,6614,707,71821,4564,3186,2142,14151,6776
CCTAACTACCTGAAGG,sample,129077,127142,5120,122022,12098,109924,86581,5590,9547,1043,96128,7163,3460,2270,12453,8694
ATATGCAACCTGAAGG,sample,80399,79439,2577,76862,12056,64806,55755,4454,3006,816,58761,775,896,1175,15176,8833
TCGAACGAAATATTCG,sample,65141,64417,2225,62192,11170,51022,37312,2959,7009,792,44321,2950,2106,1327,13624,8321
GCAACTAGAATATTCG,sample,46030,45553,2455,43098,5476,37622,22358,2043,8094,778,30452,4349,4323,2613,3511,3585
ATACGTTCAATATTCG,sample,96393,95494,6530,88964,10968,77996,41969,2690,19952,2016,61921,11369,5711,2013,13475,7557
CCGCAGTCAATATTCG,sample,33799,33434,2063,31371,3902,27469,12258,967,8950,1110,21208,4184,3558,1519,3132,2474
GGCAGGTTAATATTCG,sample,93968,92748,4714,88034,7307,80727,38011,2698,27526,3216,65537,9276,3830,1409,4651,4496
ATGGCGTTAATATTCG,sample,122527,121313,5453,115860,10824,105036,56079,4173,30411,3586,86490,10787,4540,2216,7147,7268
AGCGTCTTAATATTCG,sample,165055,163284,15855,147429,18747,128682,57393,3538,34857,3639,92250,29255,9200,2157,18100,12585
GAGATTCTAATATTCG,sample,113921,112792,3992,108800,16311,92489,74540,5960,7834,958,82374,3197,2562,2099,20260,11477
AAGGTCTGAATATTCG,sample,69629,68781,3406,65375,9188,56187,38166,2929,9174,921,47340,4997,3276,1630,6609,6068
CCTAGCGGAATATTCG,sample,36805,36194,1682,34512,4969,29543,17750,1273,6918,974,24668,2628,2080,1195,3681,3323
TGCGCTCCAATATTCG,sample,90409,89526,3035,86491,15053,71438,61396,4934,3719,427,65115,962,1114,1359,19987,10729
GTCGCGAAAATATTCG,sample,83948,82627,4392,78235,7881,70354,39270,2643,15895,2098,55165,10448,4424,1429,6715,5740
CGTCGAGGAATATTCG,sample,67569,66928,2488,64440,5056,59384,38364,2818,12519,1589,50883,4094,3659,2761,4643,3254
CAGCTTCGAATATTCG,sample,81966,81111,2670,78441,10622,67819,49657,4339,8707,745,58364,4371,2841,1846,9829,7527
TTATGACGAATATTCG,sample,60293,59541,3926,55615,6658,48957,26246,2180,11778,1150,38024,7603,4149,1443,4047,4004
TCTCCTAGAATATTCG,sample,127644,126234,7921,118313,12875,105438,57467,4292,23416,2826,80883,17437,6646,1779,17310,8403
AAGTAGAGAATATTCG,sample,130099,129031,5363,123668,10893,112775,73228,4865,22490,2739,95718,9453,4550,1968,14677,7860
TAACGCCAAATATTCG,sample,63910,63139,2055,61084,8751,52333,40689,2777,5891,631,46580,2345,2557,2023,7535,5819
ATTCTACCAATATTCG,Pos_Ctrl,25830,25555,1347,24208,1146,23062,19249,1818,1377,184,20626,434,4099,4116,1705,461
CGCGAGACAATATTCG,sample,90274,89039,4398,84641,10286,74355,47007,2821,13713,1488,60720,9326,3775,1310,15927,7078
CCTAACTAAATATTCG,sample,101227,99979,4991,94988,10250,84738,60566,4348,11499,1068,72065,7257,3023,1580,15245,6948
ATATGCAAAATATTCG,sample,57722,57183,2644,54539,4786,49753,31368,2146,10942,1748,42310,3549,2202,1521,4149,2985
CTGGTCTTAGTCTCCG,sample,123406,122191,3810,118381,10339,108042,60860,3650,31366,3876,92226,8290,3484,2207,6433,7303
GTCGTTCTAGTCTCCG,sample,104093,103342,4283,99059,21171,77888,59092,3813,8915,1072,68007,4996,4455,2934,13987,15188
AGAGTTCTAGTCTCCG,sample,64832,64148,2358,61790,12436,49354,42978,2841,2593,407,45571,535,1151,1336,14600,9352
AGCTGAATAGTCTCCG,sample,36108,35654,2333,33321,4305,29016,16173,1146,7487,1066,23660,3144,2780,1447,4573,3020
CATAATGGAGTCTCCG,sample,120434,119360,5317,114043,15832,98211,65440,4836,18541,2113,83981,7281,4492,2476,13166,11196
TATACGGAAGTCTCCG,sample,84296,83307,8249,75058,11274,63784,30068,2299,16339,1772,46407,13306,6610,1758,9124,7411
CATACTCCAGTCTCCG,sample,66741,65901,2115,63786,6465,57321,41692,3125,8318,983,50010,3203,3359,2689,3213,4190
TCATACCAAGTCTCCG,sample,67735,66500,5208,61292,6128,55164,19276,1937,19706,2682,38982,11563,5011,1180,2741,3469
TGGATCAAAGTCTCCG,sample,96593,95783,3653,92130,10479,81651,48513,3351,20869,2344,69382,6574,3124,1917,8302,7021
AGCGTCTTAGTCTCCG,sample,115772,114291,7799,106492,9079,97413,39941,2576,33746,3218,73687,17932,5522,1407,5749,4529
GCTCTTCTAGTCTCCG,sample,119910,118644,4212,114432,12820,101612,75458,7041,11857,936,87315,6320,3746,1773,13191,9012
GGCGACGAAGTCTCCG,sample,97837,97148,3721,93427,11395,82032,55862,3856,12023,1448,67885,8843,5155,1937,20513,6907
TGCGCTCCAGTCTCCG,sample,93283,92557,3462,89095,10709,78386,51484,4632,14232,1931,65716,6107,3359,1963,10673,6999
CGTCGAGGAGTCTCCG,sample,68175,67642,2423,65219,7774,57445,36319,3104,10694,1085,47013,6243,4487,2147,7372,5261
AAGTAGAGAGTCTCCG,sample,58256,57834,1838,55996,7851,48145,37053,3586,4979,414,42032,2113,2214,1415,11504,4949
TAACGCCAAGTCTCCG,sample,78494,77933,3494,74439,8372,66067,34683,2788,15670,1549,50353,11377,4866,1558,7763,4988
CGTAGAACAGTCTCCG,sample,53485,52767,4040,48727,4623,44104,22023,1406,11113,1343,33136,8219,4096,1279,2405,2703
CCTAACTAAGTCTCCG,sample,77701,76890,3834,73056,6770,66286,34368,3359,18468,2568,52836,7523,3872,1405,8997,4560
TTAACTGAAGTCTCCG,sample,80008,79413,1929,77484,11272,66212,56496,4817,3214,515,59710,1170,1033,1326,14424,7965
AGAGTTCTTGCCTACG,sample,39304,38964,1280,37684,4953,32731,24686,1845,4310,489,28996,1401,2727,2467,5405,3512
AGCTGAATTGCCTACG,sample,12116,11788,1412,10376,1602,8774,4171,263,2425,249,6596,1666,1700,736,959,986
GAGCCTCCTGCCTACG,sample,23711,23381,2592,20789,2247,18542,5467,398,6696,867,12163,5114,3753,1188,1020,1279
CTAGCGACTGCCTACG,sample,39353,38658,2017,36641,3903,32738,22252,1433,5324,760,27576,2969,2884,1760,1188,2884
TCATCGAATGCCTACG,sample,57418,56834,3789,53045,5706,47339,26943,1470,12579,1319,39522,5028,3443,1589,6038,3654
TCATACCATGCCTACG,sample,58593,57781,5118,52663,2897,49766,22597,1709,13896,1379,36493,10185,5006,1834,980,1388
TGATTCCGTGCCTACG,sample,50395,49638,2937,46701,7082,39619,26443,2267,6510,817,32953,3582,2378,1181,8088,5130
TCTCAGGATGCCTACG,sample,27974,27513,1892,25621,1986,23635,10504,665,8032,928,18536,3506,2498,966,1165,1054
TGGATCAATGCCTACG,sample,44337,43971,3399,40572,5205,35367,16483,1325,10369,1294,26852,5896,3486,1382,4436,3437
GATGCGTTTGCCTACG,sample,67636,66874,4208,62666,3134,59532,22373,1564,23793,2485,46166,9317,4434,1678,786,1559
GCTCTTCTTGCCTACG,sample,46335,45463,3595,41868,4462,37406,17332,1537,10243,1697,27575,6597,3501,1022,2515,2408
CTAAGCATTGCCTACG,sample,42083,41459,2850,38609,4443,34166,16996,1092,9807,958,26803,5313,3663,1172,5953,2938
GGCGACGATGCCTACG,sample,31161,30797,1575,29222,3872,25350,17014,1122,4527,613,21541,2074,2325,1646,3551,2519
GCCTATTCTGCCTACG,sample,26238,25826,1085,24741,3182,21559,12793,1024,5321,560,18114,1861,2145,1387,1961,1933
AGCAGAGCTGCCTACG,sample,50815,50210,3319,46891,6572,40319,24731,1462,7392,956,32123,5778,3764,1410,7430,4233
GCGTTACCTGCCTACG,sample,15171,14919,1300,13619,1185,12434,6198,450,3631,378,9829,1777,2046,909,1634,671
GACTAACCTGCCTACG,Neg_Ctrl,859,425,253,172,18,154,90,3,41,8,131,12,74,28,16,8
AGATACTATGCCTACG,sample,50222,49633,5727,43906,3247,40659,12213,811,14154,1434,26367,12047,5641,1111,3214,1711
CCTAACTATGCCTACG,sample,374,358,49,309,33,276,175,15,54,2,229,30,126,78,22,23
GCGCAATATGCCTACG,sample,26855,26436,1741,24695,2230,22465,12679,839,5493,526,18172,2928,2303,1097,941,1242
TTAACTGATGCCTACG,sample,24387,24023,1525,22498,1892,20606,9086,723,6629,681,15715,3487,2386,869,794,1063
CTGGTCTTCTTAGTTC,sample,139662,137958,5714,132244,17319,114925,71104,4648,26177,2761,97281,10235,4450,2036,13066,12136
GAGCCTCCCTTAGTTC,sample,40991,40002,1913,38089,6133,31956,19850,1835,7102,826,26952,2343,2397,1469,2430,3684
CATACTCCCTTAGTTC,sample,134212,132876,7993,124883,17833,107050,55907,4389,25706,2656,81613,18392,8044,2925,14867,12867
CTAGCGACCTTAGTTC,sample,82026,80861,3666,77195,6847,70348,35426,2081,23408,2601,58834,6832,3537,1578,3369,4333
CGTCGCCACTTAGTTC,sample,96616,95299,9275,86024,11338,74686,34196,2211,19953,2186,54149,16140,6681,2007,9091,7603
ATTCAAGGCTTAGTTC,sample,131318,129846,4280,125566,24078,101488,87256,7422,4500,469,91756,1841,1824,2164,24039,16796
GCAACTAGCTTAGTTC,sample,40154,39409,1201,38208,5808,32400,27317,2299,1883,319,29200,582,1924,2243,5812,4014
GACTCAAGCTTAGTTC,sample,140152,138740,4291,134449,13237,121212,77914,5364,26107,3675,104021,8152,3370,2063,18143,9127
CCGTACGCCTTAGTTC,sample,66725,65885,2215,63670,12809,50861,35901,3009,7680,1077,43581,3194,2759,2159,6114,8707
TCTCAGGACTTAGTTC,sample,90803,89760,3405,86355,14817,71538,55065,3889,7726,849,62791,4009,2614,1845,18357,10101
GGCAGGTTCTTAGTTC,sample,47049,46446,2830,43616,7733,35883,24709,1823,5088,643,29797,3620,2827,1696,7711,5199
ACGCTTAACTTAGTTC,sample,110839,109834,10944,98890,11438,87452,35203,2793,26145,2868,61348,20443,8045,2324,8490,6506
CCTAGCGGCTTAGTTC,sample,64110,63522,2781,60741,7024,53717,31954,3044,12407,1285,44361,5027,3236,1697,7720,4216
CTAACCGGCTTAGTTC,sample,68584,67695,5138,62557,4865,57692,19664,1353,22086,2387,41750,12202,5288,1418,2658,2815
TAACGAAGCTTAGTTC,sample,104370,103016,4603,98413,13278,85135,52882,2616,18553,2770,71435,8314,3837,1506,9382,8658
GCCTATTCCTTAGTTC,sample,121406,119878,7120,112758,7352,105406,46957,3955,33272,3833,80229,17389,6097,1870,5334,4237
AGCAGAGCCTTAGTTC,sample,137513,136122,8445,127677,8863,118814,59965,4231,29755,2991,89720,21872,7809,2821,3735,4609
ATACCGCCCTTAGTTC,sample,159196,157283,9851,147432,13591,133841,75300,5757,34063,4311,109363,14410,5546,2027,16939,10466
TCTCCTAGCTTAGTTC,sample,99901,98890,3549,95341,12145,83196,59622,5462,11987,1294,71609,4831,3686,2187,13316,8302
ATTCTACCCTTAGTTC,sample,191214,189847,5479,184368,23991,160377,136610,11418,6968,964,143578,4417,2944,2815,20011,16214
GACTAACCCTTAGTTC,sample,155787,154432,6862,147570,14555,133015,91369,7688,20486,2080,111855,11392,4293,2132,22146,9231
CCTAACTACTTAGTTC,sample,98284,97220,3584,93636,6998,86638,49471,3493,24031,2857,73502,6786,3567,1673,8071,4427
AACCGGTTCGAGCTTC,sample,105830,104656,5834,98822,14889,83933,47786,3202,19710,2409,67496,10826,4878,1469,9820,9753
AGAGTTCTCGAGCTTC,sample,189223,187754,9249,178505,19816,158689,101452,7463,31589,3926,133041,14259,7210,4621,18955,13631
AGCTGAATCGAGCTTC,sample,175430,173970,5374,168596,40995,127601,111613,7793,5437,776,117050,1982,1525,1913,35038,28952
CATAATGGCGAGCTTC,sample,92866,91866,6490,85376,13473,71903,34314,2387,19963,2312,54277,12927,5742,1732,10043,9009
GGAGAAGCCGAGCTTC,sample,131620,130297,6570,123727,13132,110595,49720,3554,38347,4496,88067,14478,5572,1837,9261,8936
TCGAACGACGAGCTTC,sample,96339,95429,3870,91559,14450,77109,54694,4554,10653,1489,65347,5719,3911,1940,15005,10031
TCATCGAACGAGCTTC,sample,63286,62296,3582,58714,10559,48155,30209,1685,10100,955,40309,5206,3374,1280,10975,7045
TACGCGAGCGAGCTTC,sample,148012,146841,6367,140474,24580,115894,88765,7433,12078,1645,100843,5973,3511,2003,27967,16642
CCGCAGTCCGAGCTTC,sample,119812,118084,6408,111676,8980,102696,46763,3800,31430,3913,78193,16790,5630,1687,5739,4867
CCGTACGCCGAGCTTC,sample,141019,139086,5568,133518,13628,119890,83884,5404,18248,1975,102132,10379,4486,1687,14961,8847
TCTCAGGACGAGCTTC,sample,121573,120258,2800,117458,12827,104631,85423,7611,7745,1017,93168,2835,2412,2191,14650,8129
TGGATCAACGAGCTTC,sample,200211,198466,7401,191065,24043,167022,107613,8912,28123,3201,135736,19173,4083,1901,28827,17186
CCATTCTTCGAGCTTC,sample,118957,117400,4015,113385,14765,98620,57560,4748,24226,3732,81786,8354,3658,1741,9689,9368
TAGCGAGTCGAGCTTC,sample,136331,135106,5464,129642,15228,114414,76766,5356,22205,2809,98971,7278,3977,2191,18221,9862
CTAAGCATCGAGCTTC,sample,93005,92163,4691,87472,9984,77488,51940,4643,13261,1527,65201,6117,3604,1684,27545,6307
GCGTTACCCGAGCTTC,sample,122597,121629,4513,117116,8572,108544,58120,4116,31058,4498,89178,10752,4121,1913,9316,5069
TTATGACGCGAGCTTC,sample,50957,50215,3232,46983,4833,42150,25208,1165,9394,1362,34602,5021,3077,1223,7343,3068
ATGAATAGCGAGCTTC,sample,60948,59831,5413,54418,3452,50966,19294,1245,17753,2066,37047,10608,4424,1001,1383,1773
AAGTAGAGCGAGCTTC,sample,124000,122662,9796,112866,11274,101592,30489,2130,33830,3610,64319,31533,9102,1681,7664,6451
CTGGTCTTGTAGAATG,Pos_Ctrl,35319,34753,2146,32607,1512,31095,26090,2424,1767,252,27857,562,4677,4647,2556,727
GACGTATGGTAGAATG,sample,90102,88816,5412,83404,11371,72033,36923,3553,20487,2786,57410,8284,4077,1680,6569,7599
GGAGAAGCGTAGAATG,sample,105175,104013,3940,100073,18371,81702,66853,4788,6052,903,72905,3106,1927,1633,22683,13587
GCAACTAGGTAGAATG,Pos_Ctrl,6317,6285,367,5918,435,5483,4457,500,378,38,4835,110,1974,1868,481,202
TACGCGAGGTAGAATG,sample,95537,94543,4456,90087,10903,79184,51091,3614,16488,2024,67579,5967,3716,2173,7715,7562
ATACGTTCGTAGAATG,sample,198263,196091,9277,186814,20880,165934,103808,9830,28875,3202,132683,20219,7819,2588,20268,12959
CCATTCTTGTAGAATG,sample,112297,110578,3978,106600,17900,88700,66963,4999,10690,1351,77653,4697,2931,1588,18772,12072
AGCGTCTTGTAGAATG,sample,82499,81514,3023,78491,10113,68378,55936,4401,4881,524,60817,2636,2233,2086,11297,7678
ACGCTTAAGTAGAATG,sample,62573,61635,3846,57789,9198,48591,27760,1911,10639,1309,38399,6972,3759,1191,10202,6151
GCTCTTCTGTAGAATG,Pos_Ctrl,45652,45079,2406,42673,2094,40579,33814,3267,2477,327,36291,694,5181,5854,2507,775
GGCGACGAGTAGAATG,sample,15007,14751,925,13826,2449,11377,8602,634,1403,205,10005,533,1270,1074,2817,1749
GCCTATTCGTAGAATG,sample,63097,62470,2433,60037,7425,52612,38601,3076,7349,853,45950,2733,3054,2370,7472,5103
GCGTTACCGTAGAATG,sample,97376,96180,5177,91003,5932,85071,41392,2418,27994,3143,69386,10124,4162,1685,3476,2773
CGCGGTCGGTAGAATG,Pos_Ctrl,19444,19223,1023,18200,800,17400,14656,1433,856,112,15512,343,3521,3496,1232,309
GACTAACCGTAGAATG,sample,38890,38449,2592,35857,2651,33206,14046,1144,11399,1210,25445,5407,3500,1501,1420,1288
CGCGAGACGTAGAATG,sample,34683,33957,1733,32224,4078,28146,19785,1595,3888,486,23673,2392,1981,985,3781,2552
CCTAACTAGTAGAATG,sample,119644,118356,3348,115008,13257,101751,81125,6928,9240,1248,90365,3210,2065,1784,14992,9381
GCGCAATAGTAGAATG,sample,102388,101643,2392,99251,12098,87153,70096,7070,6115,888,76211,2984,2939,2828,9804,8070
TTAACTGAGTAGAATG,sample,59524,58933,4258,54675,5738,48937,15041,1258,18065,1936,33106,12637,5457,1192,2720,3528
AGAGTTCTCAATAGTC,sample,96133,95168,4181,90987,13444,77543,48620,4103,16069,1982,64689,6769,3660,1833,7554,9119
AGCTGAATCAATAGTC,sample,55685,54988,2363,52625,7606,45019,29149,2252,8972,1060,38121,3586,3198,2169,4457,5069
CATAATGGCAATAGTC,sample,94102,93233,4664,88569,15410,73159,49258,4198,12125,1311,61383,6267,3850,1753,16647,11025
TATACGGACAATAGTC,sample,122512,121577,5137,116440,18102,98338,72463,5370,11678,1528,84141,7299,3831,2309,17421,12528
GAGCCTCCCAATAGTC,sample,158586,156679,7766,148913,13439,135474,80520,5797,26204,3584,106724,19369,6906,2061,17007,8060
GCAACTAGCAATAGTC,sample,21349,21178,1022,20156,2826,17330,11589,850,3164,344,14753,1383,2988,2346,2767,1748
GACTCAAGCAATAGTC,sample,42189,41710,3250,38460,6725,31735,15541,813,8653,957,24194,5771,3515,1134,4310,4376
CCGTACGCCAATAGTC,sample,74256,73680,2775,70905,12123,58782,47172,3912,4293,431,51465,2974,2916,2232,15512,8823
GGCAGGTTCAATAGTC,sample,33083,32727,2717,30010,2937,27073,9409,865,10270,1042,19679,5487,3430,1148,1692,1811
CATTCGGTCAATAGTC,sample,57428,56867,3430,53437,8372,45065,27361,2166,8425,942,35786,6171,3641,1924,7310,5727
TAGCGAGTCAATAGTC,sample,57121,56475,2794,53681,10154,43527,31571,2405,5835,610,37406,3106,2222,1571,9756,7142
TAACGAAGCAATAGTC,sample,22140,21812,1130,20682,3677,17005,11613,684,3079,332,14692,1297,1415,943,4452,2574
GCTGCTTCCAATAGTC,sample,58527,57878,1542,56336,8180,48156,38823,2860,4341,429,43164,1703,2104,1744,9509,5855
GCCTATTCCAATAGTC,sample,86523,85682,3397,82285,9264,73021,52101,3247,10403,1504,62504,5766,4336,2663,6900,6206
AGCAGAGCCAATAGTC,sample,53968,53337,3330,50007,6747,43260,25135,1994,9302,890,34437,5939,3929,1504,6419,4300
GTCGCGAACAATAGTC,sample,63462,62783,2114,60669,5942,54727,35399,2675,12066,1537,47465,3050,2405,1669,7011,3984
TCTCCTAGCAATAGTC,sample,77296,76582,2733,73849,10540,63309,51984,3912,4605,463,56589,2345,2261,2032,11455,7628
CGTAGAACCAATAGTC,sample,72534,71904,1722,70182,8526,61656,52614,4686,3180,378,55794,798,1259,1535,13171,6214
TTAACTGACAATAGTC,sample,40317,39794,2248,37546,3823,33723,19700,1546,7534,748,27234,4195,2642,1113,1802,2235
TCTAGGTTCGTTACTC,sample,330365,328058,10586,317472,67728,249744,207018,15918,16006,2516,223024,8286,3943,2883,64987,47825
GTCGTTCTCGTTACTC,Neg_Ctrl,4385,1698,988,710,118,592,372,22,105,4,477,89,234,131,80,23
GGTAGAGACGTTACTC,sample,85769,84926,2956,81970,16544,65426,39370,3383,16918,1804,56288,3951,2535,1585,7585,10317
TCATCGAACGTTACTC,sample,160182,158219,9731,148488,21919,126569,75681,4937,26109,3525,101790,16317,5857,2023,10150,14466
TGATTCCGCGTTACTC,sample,138668,137483,4835,132648,29800,102848,82507,6163,9688,1008,92195,3482,3610,3366,15316,20363
TACGCGAGCGTTACTC,Neg_Ctrl,3292,1615,928,687,94,593,315,24,154,15,469,85,207,115,68,48
GGCAGGTTCGTTACTC,sample,220874,218849,17464,201385,21314,180071,80985,6394,51068,5361,132053,36263,9689,3248,9764,12082
GAGATTCTCGTTACTC,Neg_Ctrl,2767,1479,924,555,92,463,264,24,92,14,356,69,184,103,78,36
AAGGTCTGCGTTACTC,sample,146058,144815,6881,137934,32547,105387,67806,5587,16741,2331,84547,12922,6087,2435,10273,21140
CTAACCGGCGTTACTC,sample,163132,161797,5604,156193,17579,138614,94121,6674,25113,3675,119234,9031,4071,2909,13559,12863
GTCGCGAACGTTACTC,sample,65016,63750,4945,58805,8213,50592,22071,1653,16573,2148,38644,8147,3682,1090,3773,5028
CGTCGAGGCGTTACTC,sample,125804,124522,6363,118159,16200,101959,63470,5204,21515,1666,84985,10104,4570,1973,13267,10848
CAGCTTCGCGTTACTC,sample,113789,112115,9070,103045,10563,92482,37571,2678,30691,3294,68262,18248,6408,1656,5797,6150
TTATGACGCGTTACTC,Neg_Ctrl,2309,1127,602,525,54,471,293,20,97,5,390,56,192,109,63,20
TCAATCAGCGTTACTC,sample,153006,151524,4475,147049,24943,122106,102569,9225,7713,1195,110282,1404,1484,1748,27403,17717
ATTCTACCCGTTACTC,sample,150277,148782,6780,142002,12195,129807,68013,5200,37478,4663,105491,14453,4867,1793,10798,7295
ATATGCAACGTTACTC,sample,127397,126468,3413,123055,14332,108723,70259,6091,22891,2870,93150,6612,3088,1808,11687,9458
AGAGTTCTTGGACTGC,sample,150295,149189,4893,144296,28881,115415,90180,6276,11618,1420,101798,5921,4076,2752,21933,19770
GACGTATGTGGACTGC,sample,95969,94050,4146,89904,11033,78871,49278,4836,14351,1414,63629,8992,4549,1353,6881,6822
TATACGGATGGACTGC,sample,145111,144082,4240,139842,19045,120797,93614,6381,13524,1231,107138,6047,4591,3477,13907,13855
GGAGAAGCTGGACTGC,sample,65104,64420,4929,59491,12949,46542,24123,1998,10951,1108,35074,8362,4301,1454,7301,8284
GAGCCTCCTGGACTGC,sample,112149,111028,5308,105720,9391,96329,51039,3247,26252,3053,77291,12738,6203,2839,5665,5856
CATACTCCTGGACTGC,sample,86327,85301,4094,81207,13471,67736,42314,3042,14643,1821,56957,5916,3560,1728,11055,9083
CTAGCGACTGGACTGC,sample,91776,90628,5083,85545,7687,77858,39621,2526,23094,2673,62715,9944,4906,2149,3235,5021
GGTAGAGATGGACTGC,sample,104333,103509,3774,99735,20700,79035,61841,4297,7902,842,69743,4153,3500,2839,13483,14400
CGTCGCCATGGACTGC,sample,44368,43815,2846,40969,7452,33517,21534,1248,6574,665,28108,3496,2777,1367,7932,4940
TGATTCCGTGGACTGC,sample,121548,120346,6755,113591,13685,99906,59741,5283,19641,2311,79382,12930,6198,2296,14285,8891
CCGTACGCTGGACTGC,sample,107211,106047,3872,102175,15567,86608,63388,4600,11907,1319,75295,5394,3642,1859,18890,10782
TGGATCAATGGACTGC,sample,54865,54296,2254,52042,10097,41945,28593,2277,6902,964,35495,3209,2987,1864,4978,6908
TGCGCGTTTGGACTGC,sample,70369,69537,4489,65048,8757,56291,25762,1892,15206,1576,40968,11855,5214,1747,3778,5730
CCATTCTTTGGACTGC,sample,69063,67845,3519,64326,10524,53802,37580,2801,8389,822,45969,4210,2728,1287,12006,7306
CATTCGGTTGGACTGC,sample,86922,86063,3506,82557,9807,72750,46466,3369,15369,2025,61835,5521,3504,2097,10425,6845
AAGGTCTGTGGACTGC,sample,80211,79253,6498,72755,7614,65141,25419,1910,21387,2297,46806,14128,5546,1468,5795,4677
CCTAGCGGTGGACTGC,sample,36005,35526,2739,32787,4629,28158,13162,1087,7831,920,20993,5158,3461,1048,3391,3094
GTCGCGAATGGACTGC,sample,39063,38579,1693,36886,5046,31840,24701,2018,3073,493,27774,1555,1962,1447,7259,3387
TAACGCCATGGACTGC,sample,71061,70467,2462,68005,5446,62559,39119,2857,14214,1842,53333,4527,3033,1949,8549,3371
GACTAACCTGGACTGC,sample,44048,43454,2661,40793,4868,35925,21032,1357,7608,812,28640,5116,3320,1369,5185,3229
CGCGAGACTGGACTGC,sample,54695,53851,4666,49185,4986,44199,19278,1379,12787,1486,32065,9269,4608,1166,4611,2771
CGTAGAACTGGACTGC,sample,74004,73352,2393,70959,11868,59091,47118,4315,4840,554,51958,2264,3015,2738,8527,8255
AGATACTATGGACTGC,sample,49955,49337,3805,45532,4975,40557,23463,1614,8926,974,32389,5580,3616,1292,6672,3289
AACCGGTTCCTTGAGC,sample,127326,126179,8123,118056,20214,97842,63171,5489,17419,2153,80590,9610,4781,2092,21970,13962
CTGGTCTTCCTTGAGC,sample,123405,122159,6132,116027,14677,101350,52144,4638,31367,3259,83511,9942,4909,2271,9821,9820
AGAGTTCTCCTTGAGC,sample,231816,228895,13928,214967,19081,195886,91760,6335,58645,7579,150405,31567,7790,2045,8035,11988
TATACGGACCTTGAGC,sample,233261,231458,8270,223188,44327,178861,154276,11492,8535,1449,162811,3109,1896,1975,49213,31640
GAGCCTCCCCTTGAGC,Pos_Ctrl,43646,43107,2956,40151,2116,38035,31727,2992,2273,305,34000,738,5353,5662,3232,1182
CATACTCCCCTTGAGC,sample,197338,195083,10274,184809,33085,151724,86494,5834,32541,4809,119035,22046,6318,1980,34811,20877
TCGAACGACCTTGAGC,sample,100839,99744,7215,92529,17292,75237,40661,2718,16270,1741,56931,13847,5613,1719,11340,11451
TCATCGAACCTTGAGC,sample,236189,233561,5669,227892,30264,197628,169332,15074,9204,1511,178536,2507,1610,1746,37895,21442
GCAACTAGCCTTGAGC,sample,87057,85891,2614,83277,16535,66742,56972,4476,3786,366,60758,1142,1919,2183,15120,10918
ATACGTTCCCTTGAGC,sample,214954,213209,15278,197931,25348,172583,90516,7124,40139,4067,130655,30737,9181,2953,23727,17551
TCTCAGGACCTTGAGC,sample,149608,147874,10332,137542,13010,124532,48832,3079,47331,5359,96163,19931,6563,1968,8230,7484
TGGATCAACCTTGAGC,sample,134669,133138,7297,125841,21749,104092,61133,5690,22804,2036,83937,12429,4639,1609,13808,14687
GGCAGGTTCCTTGAGC,Pos_Ctrl,39038,38444,2776,35668,1921,33747,28021,2847,1969,233,29990,677,4942,5093,2629,874
AGCGTCTTCCTTGAGC,sample,186633,184742,7335,177407,30286,147121,112073,8186,17511,1868,129584,7483,2777,1891,33798,21553
ACGCTTAACCTTGAGC,sample,212832,211546,5704,205842,37548,168294,141490,9827,10563,1258,152053,5156,3183,2821,30063,25849
TAGCGAGTCCTTGAGC,sample,80274,79333,5208,74125,7503,66622,27271,2785,23961,2915,51232,9690,4571,1767,3769,4430
GCTCTTCTCCTTGAGC,sample,99750,98496,4368,94128,9351,84777,43571,4149,25376,3526,68947,8155,4527,2444,3599,5756
CTAAGCATCCTTGAGC,sample,226809,224768,7359,217409,39412,177997,149621,12512,10444,1294,160065,4126,2862,2330,38227,27642
TAACGAAGCCTTGAGC,sample,162166,160973,3993,156980,25250,131730,108963,10256,8123,1092,117086,3296,3655,3501,20632,18310
GCTGCTTCCCTTGAGC,Pos_Ctrl,30400,30008,1974,28034,1661,26373,21944,2184,1525,192,23469,528,4513,4527,2050,709
GCCTATTCCCTTGAGC,sample,101502,100262,8636,91626,9626,82000,30422,2626,28975,3411,59397,16566,6748,1891,5486,5608
CGTCGAGGCCTTGAGC,sample,90385,89408,4619,84789,10297,74492,51542,3373,11618,1235,63160,6724,4342,2154,12885,6778
CGCGGTCGCCTTGAGC,sample,121928,120912,5214,115698,15869,99829,74730,5999,11107,1278,85837,6715,4016,2543,14565,11480
TCAATCAGCCTTGAGC,sample,145399,144075,4432,139643,21400,118243,96732,7440,10369,1239,107101,2463,2027,1600,30168,15726
CGCGAGACCCTTGAGC,sample,169477,167830,8370,159460,18229,141231,90411,6748,24344,3147,114755,16581,6596,2231,21725,12089
CGTAGAACCCTTGAGC,sample,207703,206291,5460,200831,27872,172959,149364,10498,9070,643,158434,3384,3085,3231,38435,19319
CCTAACTACCTTGAGC,Pos_Ctrl,30876,30440,1791,28649,1402,27247,22786,2239,1523,162,24309,537,4384,4602,1851,411
GCGCAATACCTTGAGC,sample,109963,108903,3838,105065,12014,93051,68403,5278,12703,2100,81106,4567,2644,1708,18903,8002
AACCGGTTCGATATCC,sample,218070,216402,9768,206634,39573,167061,107807,9289,27588,2741,135395,19636,6991,2363,33467,27247
TATACGGACGATATCC,sample,153565,152271,4899,147372,29028,118344,93429,7256,11001,1479,104430,5179,2858,1896,25359,20757
CGTCGCCACGATATCC,sample,179205,177271,5310,171961,24387,147574,115225,7855,13747,2560,128972,8187,3376,1711,35622,16764
TCATCGAACGATATCC,sample,250077,248297,4754,243543,34108,209435,183093,17466,6502,976,189595,1398,1771,2194,50089,22807
GACTCAAGCGATATCC,sample,155010,153410,9084,144326,16775,127551,70943,5862,27145,2863,98088,20738,7366,1843,15256,10739
ATACGTTCCGATATCC,sample,141436,140052,5929,134123,14211,119912,73813,5205,26192,2961,100005,11741,5280,2244,12832,9341
CCGTACGCCGATATCC,sample,98853,98019,4555,93464,15920,77544,56549,5195,9055,987,65604,5758,3630,1854,18083,10956
ATGGCGTTCGATATCC,sample,65026,64408,3123,61285,9472,51813,29622,2675,13101,1378,42723,5037,3462,1658,8992,6497
CATTCGGTCGATATCC,sample,126703,125211,11471,113740,8349,105391,21543,1769,43057,4543,64600,34479,9357,1691,3956,3762
CCTAGCGGCGATATCC,sample,53502,52975,2802,50173,5716,44457,19447,1815,15299,1374,34746,6522,3736,1391,1731,3596
GGCGACGACGATATCC,sample,103235,102332,5844,96488,14717,81771,49487,3760,16521,2037,66008,9966,4282,1590,16089,10327
TAACGAAGCGATATCC,sample,99274,98498,2464,96034,18421,77613,67335,4296,4094,722,71429,1166,1053,1313,25905,12775
GCTGCTTCCGATATCC,sample,78246,77745,3380,74365,16641,57724,37772,3266,9075,985,46847,6626,4373,2219,9423,10609
ATACCGCCCGATATCC,sample,93951,93189,4156,89033,12322,76711,44812,3542,17125,1855,61937,9377,5695,2826,7867,7832
CAGCTTCGCGATATCC,sample,67139,66339,5647,60692,5841,54851,17627,1274,21745,2256,39372,11949,5464,1284,3108,3609
TCTCCTAGCGATATCC,sample,145655,144344,4801,139543,19421,120122,89993,7116,13685,1524,103678,7804,3479,1995,24538,13561
AGATACTACGATATCC,sample,93018,91924,5902,86022,11606,74416,38228,2653,18754,1792,56982,12989,4973,1506,8408,7255
GCGCAATACGATATCC,sample,108323,107339,6112,101227,8148,93079,40151,2256,31638,3547,71789,15487,6010,1765,4406,4495
TTAACTGACGATATCC,sample,66221,65523,3119,62404,4996,57408,28756,1801,17576,1970,46332,7305,3504,1323,4063,3059
GACGTATGATCTGACC,sample,78528,77854,2944,74910,11610,63300,45069,3292,10208,1373,55277,3358,2864,1800,14554,8304
CATACTCCATCTGACC,Neg_Ctrl,1552,715,365,350,48,302,181,11,54,1,235,55,128,77,50,11
TCGAACGAATCTGACC,sample,55179,54654,1792,52862,8864,43998,33729,2063,5532,634,39261,2040,2519,1695,10049,6348
CGTCGCCAATCTGACC,sample,76527,75600,2334,73266,15539,57727,50220,3470,2940,419,53160,678,1084,1334,17294,11377
TCATACCAATCTGACC,sample,50696,49836,3412,46424,5771,40653,20284,1574,11789,1031,32073,5975,3069,1112,2840,3711
TGATTCCGATCTGACC,sample,30436,29944,1842,28102,2830,25272,11058,695,9259,1159,20317,3101,2671,1142,1481,1789
GATGCGTTATCTGACC,Neg_Ctrl,1441,720,387,333,43,290,180,18,39,5,219,48,102,70,40,19
ATGGCGTTATCTGACC,sample,748,728,51,677,74,603,419,41,100,7,519,36,211,142,87,50
ACGCTTAAATCTGACC,sample,68377,67386,3343,64043,9163,54880,32613,3133,10704,1290,43317,7140,4172,1377,5128,5828
TAGCGAGTATCTGACC,sample,92597,91773,2393,89380,13575,75805,63640,6738,3686,464,67326,1277,1425,1645,12946,9126
CCTAGCGGATCTGACC,sample,36787,36226,1838,34388,2982,31406,17017,956,8694,1008,25711,3731,2149,963,2109,1991
CTAACCGGATCTGACC,sample,38840,38359,2756,35603,4936,30667,12848,966,10032,1288,22880,5533,3811,1387,1705,3226
GCCTATTCATCTGACC,Neg_Ctrl,1525,638,389,249,30,219,135,14,46,1,181,23,93,59,36,8
ATACCGCCATCTGACC,sample,49456,48936,3259,45677,5549,40128,22532,1670,9489,1235,32021,5202,3376,1384,7000,3406
GCGTTACCATCTGACC,sample,67171,66645,1641,65004,10659,54345,47444,3841,2213,254,49657,593,1429,1855,10675,7564
TCTCCTAGATCTGACC,sample,57223,56546,2609,53937,6867,47070,32189,2760,7092,789,39281,4240,2781,1390,8130,4302
ATGAATAGATCTGACC,sample,14439,14294,574,13720,2269,11451,8816,704,1308,133,10124,490,1443,1255,1999,1653
AAGTAGAGATCTGACC,sample,76834,76156,2630,73526,10757,62769,45432,3599,9043,1014,54475,3681,3217,1911,13614,7469
TCAATCAGATCTGACC,sample,62764,62279,2399,59880,8703,51177,36633,2479,7019,856,43652,4190,2779,1455,9975,5854
GACTAACCATCTGACC,sample,76038,75363,2638,72725,10587,62138,45826,3574,7637,828,53463,4273,3364,1863,12500,6897
CCTAACTAATCTGACC,sample,90623,89896,2239,87657,10233,77424,67530,5642,2969,562,70499,721,1285,1757,12475,8137
GCGCAATAATCTGACC,Neg_Ctrl,1050,484,246,238,44,194,144,8,29,1,173,12,90,60,31,11
TTAACTGAATCTGACC,sample,31158,30716,1251,29465,2675,26790,14969,1057,7328,903,22297,2533,1993,951,1773,1583
ATATGCAAATCTGACC,sample,28537,28243,699,27544,2815,24729,20012,1326,1951,272,21963,1168,2029,1914,1330,1800
TCTAGGTTCTTCTTAC,sample,102545,101862,2110,99752,18732,81020,68742,5270,4626,836,73368,1546,2901,3223,12041,12963
CTGGTCTTCTTCTTAC,sample,153910,152769,6120,146649,22241,124408,80523,5593,24957,2868,105480,10467,4965,2190,22350,14879
GTCGTTCTCTTCTTAC,sample,100811,99994,2917,97077,18728,78349,59249,3648,9808,1304,69057,4340,3349,2230,15606,13005
AGCTGAATCTTCTTAC,sample,156461,154697,8613,146084,11152,134932,61396,4356,48192,4666,109588,16322,5378,1897,6257,6962
GGAGAAGCCTTCTTAC,sample,109254,108445,3051,105394,21992,83402,69220,5184,6521,799,75741,1678,2694,2786,15870,15454
CTAGCGACCTTCTTAC,sample,85781,84904,3199,81705,16167,65538,49036,3528,8143,870,57179,3961,3275,2041,14303,10807
GGTAGAGACTTCTTAC,sample,116810,115672,5178,110494,13314,97180,56990,3513,25490,2881,82480,8306,3737,1695,13857,8697
TCATACCACTTCTTAC,sample,57258,56309,4611,51698,6885,44813,18286,1544,13661,1207,31947,10115,4464,1134,3134,3710
ATTCAAGGCTTCTTAC,sample,112237,111351,3263,108088,10893,97195,59779,4224,24294,3355,84073,5543,2951,2191,10349,7863
GCAACTAGCTTCTTAC,sample,26294,25958,1198,24760,4937,19823,13937,1122,3114,490,17051,1160,2517,1985,2853,3268
CCGCAGTCCTTCTTAC,sample,91001,90189,2219,87970,13699,74271,61683,5366,5291,636,66974,1295,2802,3009,13153,9922
ATGGCGTTCTTCTTAC,sample,95077,93889,8072,85817,7790,78027,25339,1696,28512,2864,53851,19616,6925,1540,4306,5243
AGCGTCTTCTTCTTAC,sample,40751,40234,4073,36161,4462,31699,11765,981,11105,1217,22870,6631,4033,1279,2522,2672
CATTCGGTCTTCTTAC,sample,51785,50965,3664,47301,5138,42163,19188,1730,13618,1304,32806,6323,3196,1103,2290,3259
GAGATTCTCTTCTTAC,sample,108656,107621,4019,103602,12209,91393,64101,4054,15716,2150,79817,5372,2946,1851,16142,9212
AAGGTCTGCTTCTTAC,sample,123391,122494,3977,118517,18621,99896,81424,6086,7976,935,89400,3475,2868,2507,26529,13595
CCTAGCGGCTTCTTAC,sample,33749,33180,3518,29662,2769,26893,7884,542,10011,1025,17895,7431,4214,943,1016,1653
GCTGCTTCCTTCTTAC,sample,106535,105416,4750,100666,11650,89016,61388,3897,15699,1558,77087,6474,3826,1913,15932,8082
GTCGCGAACTTCTTAC,sample,54704,53984,4284,49700,5213,44487,24120,1788,10751,1104,34871,6724,3782,1437,6465,3474
CGTCGAGGCTTCTTAC,sample,65099,64440,2225,62215,6544,55671,37042,3064,10398,1373,47440,3794,3025,1869,6158,4915
ATTCTACCCTTCTTAC,sample,59935,59364,2882,56482,6896,49586,31442,2752,9833,1259,41275,4300,3380,1733,7446,4740
CGCGAGACCTTCTTAC,sample,44628,43889,2653,41236,6254,34982,22095,1280,7135,815,29230,3657,2772,1218,4893,4428
GCGCAATACTTCTTAC,sample,87056,86195,2645,83550,11384,72166,59868,3907,5041,861,64909,2489,2233,1778,13213,8241
ATATGCAACTTCTTAC,sample,84656,84075,2140,81935,6117,75818,47391,4442,17616,2237,65007,4132,2848,2278,7097,4071
AACCGGTTACTTCTAC,sample,54148,53654,3209,50445,7364,43081,20725,1738,13022,1401,33747,6195,3663,1431,6236,5010
TCTAGGTTACTTCTAC,sample,41035,40462,1965,38497,3366,35131,17142,1081,11542,1678,28684,3688,2453,1122,2113,1998
CTGGTCTTACTTCTAC,sample,69605,68873,3827,65046,5606,59440,27911,1855,19500,2432,47411,7742,4023,1595,2796,3584
GTCGTTCTACTTCTAC,sample,61949,61200,3202,57998,4913,53085,25850,1352,17646,1987,43496,6250,3632,1481,2717,3020
GACGTATGACTTCTAC,sample,72500,71743,2953,68790,11821,56969,38777,2914,9558,1216,48335,4504,3343,1524,13606,8214
GAGCCTCCACTTCTAC,sample,45351,44880,2791,42089,5293,36796,20424,1714,8985,995,29409,4678,4004,2140,4696,3451
CTAGCGACACTTCTAC,sample,84222,83432,2533,80899,11102,69797,47149,3477,13978,1723,61127,3470,2669,2176,10088,7712
TCGAACGAACTTCTAC,sample,44886,44345,2807,41538,4240,37298,15202,1277,13485,1485,28687,5849,3385,1235,2383,2692
TCATCGAAACTTCTAC,sample,84096,83377,2817,80560,11081,69479,52362,3700,8438,959,60800,4020,3353,2242,7754,7746
TCATACCAACTTCTAC,sample,73170,72413,2878,69535,10252,59283,42020,3478,8414,971,50434,4400,3450,2057,7919,6704
GCAACTAGACTTCTAC,sample,16139,15801,948,14853,1492,13361,5501,583,5066,711,10567,1500,1996,954,613,879
ATACGTTCACTTCTAC,sample,164104,162560,9265,153295,12742,140553,72980,6737,34436,3610,107416,22790,7237,1998,18812,7800
ATGGCGTTACTTCTAC,sample,84278,83330,6034,77296,12526,64770,39672,3427,11523,1084,51195,9064,4260,1507,11718,8322
CGGTTGGTACTTCTAC,sample,63791,63173,5880,57293,7741,49552,25724,1831,12109,1478,37833,8410,4356,1460,7826,4925
GAGATTCTACTTCTAC,sample,58981,58313,3240,55073,7152,47921,24895,1558,13345,1900,38240,6223,3526,1363,5263,4547
AAGGTCTGACTTCTAC,sample,20302,20037,1553,18484,2307,16177,8295,689,4386,465,12681,2342,2692,1349,1804,1454
CCTAGCGGACTTCTAC,sample,16057,15874,1239,14635,1645,12990,5606,552,4350,477,9956,2005,2306,949,1541,1019
CTAACCGGACTTCTAC,sample,59657,59096,1586,57510,5167,52343,36518,2459,9601,1255,46119,2510,2622,2111,4327,3711
TAACGAAGACTTCTAC,sample,54162,53684,3018,50666,7824,42842,27995,2496,6858,662,34853,4831,3839,2063,6167,5051
GGCGTACCACTTCTAC,sample,48904,48270,3079,45191,3866,41325,17418,1338,13711,1619,31129,7239,4045,1339,1984,2223
TAACGCCAACTTCTAC,sample,32855,32445,1532,30913,3539,27374,15277,1073,7363,944,22640,2717,2091,982,2416,2392
CGCGAGACACTTCTAC,sample,51172,50621,2934,47687,4305,43382,20923,1134,12932,1357,33855,7036,4006,1567,2568,2455
CGTAGAACACTTCTAC,sample,39889,39322,1558,37764,2986,34778,19269,1182,9895,1178,29164,3254,2064,1196,1353,1770
CCTAACTAACTTCTAC,sample,84259,83637,2163,81474,7717,73757,63648,4923,3043,418,66691,1725,2724,2979,9207,5576
TTAACTGAACTTCTAC,sample,43728,43351,1494,41857,3366,38491,20947,1569,11675,1690,32622,2610,2172,1396,2568,2097
AACCGGTTAGAAGTAA,sample,122157,121152,6047,115105,15070,100035,56276,4493,29316,3349,85592,6601,3490,2030,10656,9653
TCTAGGTTAGAAGTAA,sample,122104,121279,5680,115599,22832,92767,59508,4846,15875,1620,75383,10918,4879,1998,19099,15519
AGCTGAATAGAAGTAA,sample,71509,70834,4460,66374,12204,54170,30755,2132,12758,1423,43513,7102,4046,1526,7536,8190
GACGTATGAGAAGTAA,sample,121697,120759,2694,118065,20707,97358,69001,4989,16918,2137,85919,4313,2651,2363,16041,14662
GAGCCTCCAGAAGTAA,sample,185422,184103,5253,178850,38263,140587,110073,7650,12454,1689,122527,8721,3149,1972,36169,25966
TCATCGAAAGAAGTAA,sample,162881,161751,4710,157041,30721,126320,109320,9413,5315,525,114635,1747,1342,1691,37439,22194
TCATACCAAGAAGTAA,sample,164437,163294,6265,157029,23999,133030,95177,7447,19228,2143,114405,9035,4928,2793,23252,17506
TGATTCCGAGAAGTAA,sample,39133,38923,2485,36438,6949,29489,19225,1380,5071,566,24296,3247,3798,2477,6462,4632
TACGCGAGAGAAGTAA,sample,33584,33117,2348,30769,5324,25445,14514,1367,5348,771,19862,3445,2445,1045,2199,3493
CCGCAGTCAGAAGTAA,sample,159801,158523,7458,151065,13039,138026,77444,5768,35682,3916,113126,15216,5871,2360,13027,8212
TGGATCAAAGAAGTAA,sample,175577,173733,5674,168059,20547,147512,105078,8165,22724,2973,127802,8572,3578,1739,18368,13895
CATTCGGTAGAAGTAA,sample,48672,48093,2551,45542,7220,38322,23429,1361,8234,1109,31663,4189,3035,1448,5134,4817
GAGATTCTAGAAGTAA,sample,211254,210121,4495,205626,29755,175871,144815,13870,10428,1539,155243,5219,4036,3635,21518,20225
AGCAGAGCAGAAGTAA,sample,116381,115258,5545,109713,16369,93344,61522,4542,15071,2209,76593,10000,4373,1899,11842,11014
GCGTTACCAGAAGTAA,sample,38722,38117,1311,36806,5120,31686,17428,1682,9708,841,27136,2027,1698,1126,2537,3380
AAGTAGAGAGAAGTAA,sample,56208,55884,1446,54438,9696,44742,34229,3150,5316,584,39545,1463,2014,1999,7815,6644
CGCGAGACAGAAGTAA,sample,499,488,24,464,67,397,235,24,72,11,307,55,159,112,57,45
AGATACTAAGAAGTAA,sample,5347,5283,215,5068,727,4341,3226,311,549,91,3775,164,880,772,748,459
CCTAACTAAGAAGTAA,sample,552,532,31,501,83,418,279,26,75,11,354,27,174,122,49,53
Short,Non_sample,0,NA,NA,NA,NA,NA,NA,NA,NA,NA,NA,NA,NA,NA,NA,NA
Unselected,Non_sample,1840290,NA,NA,NA,NA,NA,NA,NA,NA,NA,NA,NA,NA,NA,NA,NA
Undetermined,Non_sample,143749807,NA,NA,NA,NA,NA,NA,NA,NA,NA,NA,NA,NA,NA,NA,NA
