Barcode,Sample,Barcoded_Reads,Trimmed_Reads,Unmapped_Reads,Mapped_Reads,Multimapped_Reads,Uniquely_Mapped_Reads,Exon_Reads,Ambiguous_Exon_Reads,Intron_Reads,Ambiguous_Intron_Reads,Gene_Reads,Intergenic_Reads,No_of_Genes,No_of_Transcripts,Mitochondrial_Reads,Ribosomal_Reads
AAGTTCGTCGTTGGTT,sample,76811,74891,8188,66703,7593,59110,4207,240,27592,2899,31799,24172,7776,1402,399,4119
CCTCTAGACGTTGGTT,sample,2301,1399,542,857,151,706,115,3,308,24,423,256,343,58,16,54
ATGCCTGGCGTTGGTT,sample,213,183,55,128,46,82,12,1,36,3,48,30,39,6,4,21
TTAGAAGTCGTTGGTT,sample,192,187,35,152,22,130,25,1,57,3,82,44,70,10,3,16
TCGCATCTCGTTGGTT,sample,211,204,34,170,27,143,31,0,63,11,94,38,76,20,2,21
GCCTTGCTCGTTGGTT,sample,313,308,88,220,28,192,54,4,75,7,129,52,108,33,9,20
ACTATACTCGTTGGTT,sample,276,271,82,189,16,173,22,3,79,7,101,62,93,15,9,12
ACCTCGAGCGTTGGTT,sample,326,205,60,145,35,110,16,0,40,5,56,49,49,11,2,8
GGCCAGAGCGTTGGTT,sample,29959,29351,2476,26875,2607,24268,1739,94,11140,1162,12879,10133,6004,705,98,1405
ACGACTTCCGTTGGTT,sample,84082,82866,8091,74775,9881,64894,4434,202,28714,2747,33148,28797,8360,1256,345,6307
TTGGTACCCGTTGGTT,sample,205715,203577,18709,184868,17000,167868,12928,541,75995,7543,88923,70861,10654,2783,726,10575
GTTAGGACCGTTGGTT,sample,116818,115381,10920,104461,5921,98540,5450,245,43939,4313,49389,44593,9951,1621,315,1635
AACTCGTACGTTGGTT,sample,60501,59368,6282,53086,5365,47721,4523,370,21053,2179,25576,19596,7621,1177,446,2848
CCAATTCCCGTTGGTT,sample,5965,5339,580,4759,965,3794,435,14,1630,183,2065,1532,1176,133,33,609
GTACCGTACGTTGGTT,sample,4704,4226,548,3678,819,2859,393,23,1164,121,1557,1158,1038,129,46,483
GGCATATACGTTGGTT,sample,9915,9403,1064,8339,797,7542,691,57,3363,333,4054,3098,2365,276,90,397
TCGCCTGACGTTGGTT,sample,54767,53951,4382,49569,7099,42470,4775,373,18578,1991,23353,16753,8106,1383,277,4990
TTATTCGACGTTGGTT,sample,8120,7678,835,6843,421,6422,409,21,2833,293,3242,2866,2168,188,49,176
ATTCTCTTCTATCGTT,sample,78461,76877,6715,70162,9716,60446,5505,286,26497,2585,32002,25573,5650,1179,503,6528
TCCTCCGTCTATCGTT,sample,99751,98178,9373,88805,11964,76841,8812,457,32914,3535,41726,31123,8313,1613,1011,8652
AGTACCATCTATCGTT,sample,59757,58309,7270,51039,16631,34408,5883,301,14470,1643,20353,12111,4289,969,788,11247
CAACCGCGCTATCGTT,sample,199,195,58,137,15,122,20,2,45,5,65,50,57,9,7,12
TCGCATCTCTATCGTT,sample,139,132,31,101,20,81,16,0,33,2,49,30,44,10,4,14
CCAGAGCGCTATCGTT,sample,293,274,72,202,34,168,23,2,74,7,97,62,88,15,4,19
GGCCAGAGCTATCGTT,sample,23511,23003,2225,20778,3141,17637,1696,84,7908,876,9604,7073,4223,544,116,2278
CATTGCAGCTATCGTT,sample,7771,7529,942,6587,2657,3930,1274,162,1272,133,2546,1089,1087,239,135,1509
GTCCTGCCCTATCGTT,sample,28072,27566,2759,24807,3415,21392,1798,115,9476,882,11274,9121,4995,502,289,2258
AACTCGTACTATCGTT,sample,25592,24960,3391,21569,10556,11013,2997,189,4234,407,7231,3186,2115,485,558,5158
TGCTTCGCCTATCGTT,sample,111350,110074,13955,96119,8993,87126,6216,263,39989,3775,46205,36883,10058,1336,386,5628
CTTCATGACTATCGTT,sample,5959,5771,635,5136,437,4699,398,23,2199,263,2597,1816,1766,136,17,238
AGGTCGGACTATCGTT,sample,149594,148165,16721,131444,12734,118710,9163,367,52284,4894,61447,52002,8751,1739,340,9235
TATCAGTTGTCTTCTT,sample,26379,25707,3255,22452,6402,16050,3061,135,6682,584,9743,5588,2548,487,398,4230
ATTCTCTTGTCTTCTT,Pos_Ctrl,1224760,1213050,58210,1154840,82281,1072559,644905,65309,269265,31325,914170,61755,6177,6892,14008,49659
GGTTGCGTGTCTTCTT,sample,117752,115999,15035,100964,5719,95245,6647,267,42897,4274,49544,41160,9882,1472,539,2581
TGAGCGCGGTCTTCTT,sample,23685,23160,2922,20238,6763,13475,2905,185,4910,443,7815,5032,2893,526,519,4352
CAACCGCGGTCTTCTT,sample,5382,5177,709,4468,975,3493,434,17,1493,151,1927,1398,1268,175,33,678
CCGCAACGGTCTTCTT,sample,166186,164409,19822,144587,16604,127983,16590,1528,55134,5354,71724,49377,13087,2617,1421,12171
GGCCAGAGGTCTTCTT,sample,17236,16763,1931,14832,3385,11447,1727,158,4572,444,6299,4546,3013,423,384,2305
CATGATTCGTCTTCTT,sample,40447,39889,5548,34341,11791,22550,4021,487,9478,932,13499,7632,3300,684,528,7734
CTAGGACCGTCTTCTT,sample,21747,21299,2533,18766,6608,12158,2424,123,5078,604,7502,3929,2557,440,384,4215
CGGATTACGTCTTCTT,sample,47277,46567,5630,40937,3734,37203,2824,132,16713,1616,19537,15918,6510,674,341,2414
GCCTGAACGTCTTCTT,sample,22409,21941,2879,19062,7395,11667,2002,138,4647,545,6649,4335,2576,380,450,4432
AATATATCGTCTTCTT,sample,65845,65139,6675,58464,7562,50902,5194,380,22359,2330,27553,20639,8499,1232,522,5853
ACCAATGCGTCTTCTT,sample,32231,31802,3932,27870,4422,23448,3064,255,9291,1165,12355,9673,4884,604,879,3355
TGCTTCGCGTCTTCTT,sample,83319,82458,11836,70622,9005,61617,4643,253,27868,2660,32511,26193,8280,1056,337,6839
TCAATATAGTCTTCTT,sample,21440,21134,1909,19225,4144,15081,2223,91,6670,661,8893,5436,3268,543,177,2860
AGGTCGGAGTCTTCTT,Pos_Ctrl,816094,809489,39421,770068,62114,707954,435809,40953,169616,22056,605425,39520,5698,6213,8369,44034
AAGTTCGTTAGGCTCT,sample,528509,521096,70109,450987,35899,415088,27240,1302,186063,18814,213303,181669,16689,4522,1077,25195
CAACCGCGTAGGCTCT,sample,288287,285015,46956,238059,65517,172542,24726,1224,71820,7319,96546,67453,12822,3288,3008,51693
ACGACTTCTAGGCTCT,sample,55905,54363,9652,44711,25135,19576,5799,255,6800,580,12599,6142,2733,555,1280,10890
AGTCCGCATAGGCTCT,sample,64295,62662,12414,50248,31364,18884,11795,472,3265,300,15060,3052,1951,490,1222,11269
TTGGTACCTAGGCTCT,sample,350768,347156,42575,304581,37626,266955,23905,1139,117786,11360,141691,112765,15047,3589,1359,29765
GTTAGGACTAGGCTCT,sample,51605,50338,6537,43801,21994,21807,7015,725,6962,905,13977,6200,2479,696,1137,10620
CGTATGAATAGGCTCT,sample,173300,171133,20088,151045,22135,128910,15092,749,56203,5711,71295,51155,11294,2275,2230,18485
GAAGGCGCTAGGCTCT,sample,104446,102816,12627,90189,24434,65755,10582,960,25903,2520,36485,25790,8203,1610,1478,16563
TCAATATATAGGCTCT,sample,31381,30571,3384,27187,3624,23563,2380,146,10030,1015,12410,9992,5242,692,447,2382
CTTCATGATAGGCTCT,sample,3988,3587,466,3121,934,2187,319,17,995,120,1314,736,948,116,26,562
ATGACCGATAGGCTCT,sample,39248,38398,3833,34565,5247,29318,2325,133,12573,1433,14898,12854,5876,785,249,3386
TCCAACTTTTGACTAT,Neg_Ctrl,2229,1208,575,633,70,563,150,12,173,11,323,217,258,73,9,63
AGTACCATTTGACTAT,Neg_Ctrl,2354,1622,927,695,111,584,216,14,178,23,394,153,306,119,8,46
TTCGTAATTTGACTAT,sample,219751,217128,31501,185627,10015,175612,11765,456,78148,7832,89913,77411,12948,2236,519,4021
TTCTAATGTTGACTAT,sample,45399,44115,13824,30291,19587,10704,3442,235,3384,347,6826,3296,2510,443,436,7157
TTCCGTCTTTGACTAT,Pos_Ctrl,974583,964489,65124,899365,100117,799248,503151,40921,187044,25401,690195,42731,6148,6863,12881,76967
ACTATACTTTGACTAT,sample,236054,233373,37225,196148,32578,163570,16423,867,70204,6284,86627,69792,10223,2394,1069,29655
CCAGAGCGTTGACTAT,sample,129036,127206,17774,109432,11956,97476,8634,433,41258,4071,49892,43080,9828,1579,647,8265
CCGCAACGTTGACTAT,Pos_Ctrl,1023587,1004736,92467,912269,87319,824950,500373,38254,209002,28833,709375,48488,6223,6728,11195,72430
GGCCAGAGTTGACTAT,sample,85697,84569,9748,74821,4162,70659,4568,273,32316,3537,36884,29965,9544,1221,418,2020
CCATGAAGTTGACTAT,sample,173418,171919,19804,152115,11535,140580,10281,473,61777,6179,72058,61870,12912,2510,572,5735
AATCCGTCTTGACTAT,Pos_Ctrl,918544,908712,60124,848588,79355,769233,478234,35320,192145,22646,670379,40888,6039,6527,9729,58230
CGTACGTCTTGACTAT,sample,174654,172659,22265,150394,10323,140071,8674,373,61756,5946,70430,63322,11489,1949,410,4748
TTGGCCTCTTGACTAT,Pos_Ctrl,849779,842240,45350,796890,70058,726832,446909,39336,178735,21883,625644,39969,5780,6435,10272,53858
CCAATTCCTTGACTAT,sample,47631,46810,5298,41512,8213,33299,3927,207,14490,1358,18417,13317,4089,771,732,5853
CTTCATGATTGACTAT,sample,84853,83789,9408,74381,10894,63487,5064,289,28440,3080,33504,26614,8158,1179,462,7421
TTATTCGATTGACTAT,Neg_Ctrl,988,567,216,351,29,322,159,13,84,16,243,50,202,77,8,9
ATGACCGATTGACTAT,sample,42771,42168,3997,38171,5913,32258,3171,188,14202,1361,17373,13336,4859,833,433,4077
GACCGGAATTGACTAT,sample,178549,177185,16408,160777,10448,150329,11283,610,69097,6923,80380,62416,14448,3183,618,4915
ATTCTCTTTGCAGTTG,sample,11742,11389,2290,9099,5838,3261,1121,95,1017,96,2138,932,1046,317,251,2043
AAGTTCGTTGCAGTTG,sample,253630,251163,27822,223341,22722,200619,17904,1678,90805,9281,108709,80951,15595,3419,820,17835
TCCTCCGTTGCAGTTG,sample,107343,105396,15968,89428,11570,77858,8505,356,34589,3439,43094,30969,8967,1325,635,9568
TTCGTAATTGCAGTTG,sample,170568,168253,22258,145995,17988,128007,10974,620,56615,5714,67589,54084,11398,1944,1025,13991
ATGCCTGGTGCAGTTG,sample,52369,51334,10616,40718,15409,25309,5589,662,8549,779,14138,9730,4490,795,484,9581
AATGGTAATGCAGTTG,sample,266414,262597,42607,219990,31968,188022,18700,1118,86180,8655,104880,73369,16202,3358,1498,24800
TTCCGTCTTGCAGTTG,sample,80700,79244,15226,64018,14653,49365,6100,431,21193,2423,27293,19218,6901,1071,628,11911
GGACCTCTTGCAGTTG,sample,42553,41646,7304,34342,13271,21071,3211,190,8108,752,11319,8810,2531,497,434,8240
CAAGGCCTTGCAGTTG,sample,35480,34522,10642,23880,12209,11671,3615,119,3837,410,7452,3690,1663,333,346,6082
CATAACCTTGCAGTTG,sample,28683,28279,3731,24548,2511,22037,2053,84,9617,894,11670,9389,4835,447,215,1699
GACGGAGATGCAGTTG,sample,40271,39382,7136,32246,11262,20984,3764,186,8290,847,12054,7897,3731,514,557,7575
CCAGAGCGTGCAGTTG,sample,27883,27188,3874,23314,7936,15378,3667,238,5345,571,9012,5557,2341,497,495,5217
GGAGGACGTGCAGTTG,sample,51621,50780,6182,44598,3953,40645,3338,218,17822,1690,21160,17577,6638,702,313,2381
TGGACGAGTGCAGTTG,sample,89637,88337,11603,76734,5139,71595,5733,381,32348,3006,38081,30127,9420,1227,765,2806
GTCCTGCCTGCAGTTG,sample,36150,35539,4067,31472,7015,24457,2801,307,10131,1150,12932,10068,4291,591,351,5187
CTAGGACCTGCAGTTG,sample,197975,195438,26016,169422,7950,161472,11078,467,73893,7571,84971,68463,14576,2413,431,2777
AATATATCTGCAGTTG,sample,122673,121151,16327,104824,8395,96429,6897,440,44642,4602,51539,39848,10909,1469,327,4792
TTGGTTAATGCAGTTG,sample,27394,26814,5298,21516,10121,11395,4418,356,3247,274,7665,3100,1691,378,354,5526
GGCATATATGCAGTTG,sample,31603,31038,4010,27028,2583,24445,2239,143,10920,1134,13159,10009,4975,533,299,1483
ATTCTCTTTCATGCTG,sample,87667,86561,13040,73521,6877,66644,5208,230,30733,3117,35941,27356,9099,1252,294,3951
AAGTTCGTTCATGCTG,sample,75863,74920,9754,65166,8913,56253,6246,383,24070,2616,30316,22938,7589,1036,310,7296
AATGGTAATCATGCTG,sample,33895,33023,6443,26580,6400,20180,3421,320,7741,857,11162,7841,3687,559,369,4984
GGACCTCTTCATGCTG,Neg_Ctrl,865,455,290,165,25,140,37,4,59,6,96,34,81,22,5,5
GCCTTGCTTCATGCTG,sample,54294,53523,9926,43597,13939,29658,4408,291,12206,1193,16614,11560,5689,711,667,9496
GGACGTAGTCATGCTG,Neg_Ctrl,808,352,226,126,16,110,32,1,42,2,74,33,61,6,2,6
CTTGATAGTCATGCTG,sample,29721,29198,6253,22945,6135,16810,2727,169,6883,666,9610,6365,3787,436,348,4774
CATTGCAGTCATGCTG,sample,37314,36789,4783,32006,1955,30051,2279,78,13834,1361,16113,12499,6374,523,80,907
AATCCGTCTCATGCTG,sample,32765,32307,5281,27026,4303,22723,2218,141,9583,994,11801,9787,4284,511,169,2854
CGTACGTCTCATGCTG,Neg_Ctrl,627,247,177,70,7,63,10,1,31,3,41,18,36,5,2,1
CGTATGAATCATGCTG,sample,83661,82618,12891,69727,9324,60403,5734,242,26086,2605,31820,25736,8142,973,283,6686
AATATATCTCATGCTG,Neg_Ctrl,675,351,206,145,13,132,30,0,54,8,84,40,71,6,5,3
ACCAATGCTCATGCTG,sample,11307,11027,1688,9339,3975,5364,1088,86,2052,243,3140,1895,1281,234,108,2263
TTGGTTAATCATGCTG,sample,39166,38589,6622,31967,3394,28573,2283,135,12634,1152,14917,12369,4512,419,270,2314
GTACCGTATCATGCTG,sample,32902,32492,3696,28796,2931,25865,2007,92,12025,1251,14032,10490,5646,565,129,1844
GGCATATATCATGCTG,sample,10642,10399,1476,8923,2358,6565,1344,50,2550,237,3894,2384,1670,196,96,1723
CTTCATGATCATGCTG,sample,21796,21453,2885,18568,2452,16116,1475,97,7298,869,8773,6377,3380,341,150,1600
TTATTCGATCATGCTG,sample,6595,6368,700,5668,2879,2789,674,45,1130,95,1804,845,980,168,179,1350
GACCGGAATCATGCTG,sample,42660,42197,4771,37426,4749,32677,2825,136,14849,1511,17674,13356,6753,653,273,3293
TCCTCCGTTTAGGCGG,sample,377303,372765,50136,322629,37868,284761,30697,1341,121826,12004,152523,118893,15923,4194,1158,31466
CCTCTAGATTAGGCGG,Pos_Ctrl,1516941,1500288,99910,1400378,120510,1279868,779094,65801,319479,42843,1098573,72651,6796,7518,22853,89974
ACGTTATGTTAGGCGG,sample,249023,245426,32198,213228,16942,196286,14910,636,90243,8844,105153,81653,13972,2856,710,12189
TGAGCGCGTTAGGCGG,sample,115863,113920,24942,88978,37284,51694,12138,749,19508,1913,31646,17386,7060,1573,2353,23810
CATAACCTTTAGGCGG,sample,164453,162283,19778,142505,13916,128589,11782,497,56108,6058,67890,54144,11381,2069,1389,8988
ACTATACTTTAGGCGG,sample,478476,471678,62371,409307,25607,383700,32451,1322,173146,16891,205597,159890,18857,5064,1715,20144
ACCTCGAGTTAGGCGG,sample,32537,31618,4242,27376,13055,14321,4201,309,4938,483,9139,4390,2993,553,821,6520
CATGATTCTTAGGCGG,sample,87296,85823,12988,72835,23220,49615,7262,612,20610,2510,27872,18621,4855,1190,743,15678
GTCCTGCCTTAGGCGG,sample,92790,91412,10050,81362,6469,74893,5887,521,33814,3380,39701,31291,9228,1304,492,3422
CTAGGACCTTAGGCGG,sample,76793,75395,10338,65057,22476,42581,10170,1428,16458,1627,26628,12898,5553,1193,1273,14673
GTTAGGACTTAGGCGG,sample,68013,66879,12112,54767,37536,17231,7803,834,4209,379,12012,4006,2728,805,2552,11861
GCCTGAACTTAGGCGG,sample,149946,148043,19757,128286,28439,99847,13353,674,40614,3763,53967,41443,7626,1795,1675,20907
CGTATGAATTAGGCGG,sample,47550,46353,9568,36785,21955,14830,5817,844,3802,332,9619,4035,2234,564,856,8992
GTACCGTATTAGGCGG,sample,78664,77406,9397,68009,19612,48397,6324,406,20652,2064,26976,18951,6127,1233,843,13497
TCAATATATTAGGCGG,sample,156780,154993,15625,139368,7617,131751,9148,394,58880,5664,68028,57665,11298,2130,705,3583
TCGCCTGATTAGGCGG,sample,302565,299599,35344,264255,33562,230693,21122,1295,102553,10395,123675,95328,16306,3943,2042,24868
CTTCATGATTAGGCGG,sample,292016,289488,29481,260007,19523,240484,15963,687,109398,11910,125361,102526,16028,3647,620,10461
TTATTCGATTAGGCGG,sample,48241,47384,4547,42837,5989,36848,3257,179,16340,1613,19597,15459,6463,934,294,4064
GACCGGAATTAGGCGG,sample,28742,27762,4397,23365,16580,6785,2755,372,1835,157,4590,1666,1556,427,875,4599
GGAGAGTTTCAGATAC,sample,36731,36180,3563,32617,2176,30441,1884,76,13649,1437,15533,13395,6119,671,82,876
TATCAGTTTCAGATAC,sample,88862,87817,11806,76011,15307,60704,7392,251,25968,2497,33360,24596,4932,1139,530,10653
ACGTAAGTTCAGATAC,sample,163702,161593,24978,136615,20345,116270,11031,1028,51829,5128,62860,47254,9603,1956,604,16382
ACGTTATGTCAGATAC,sample,109882,108145,17659,90486,8524,81962,6061,307,36466,3483,42527,35645,9887,1312,501,6130
TAGTACGGTCAGATAC,sample,129069,126965,25040,101925,20486,81439,9174,410,35175,3737,44349,32943,9836,1318,677,16116
TGAGCGCGTCAGATAC,sample,50254,49429,12231,37198,18655,18543,4067,248,6806,709,10873,6713,4483,638,641,9173
CAACCGCGTCAGATAC,sample,250906,247646,39598,208048,24493,183555,14914,682,80519,8083,95433,79357,13907,2788,563,18961
AATGGTAATCAGATAC,sample,74050,72838,15896,56942,22159,34783,5605,527,14260,1379,19865,13012,3730,785,1812,14556
TCGCATCTTCAGATAC,sample,89775,88122,14020,74102,13979,60123,11291,480,25361,2768,36652,20223,5488,1436,1055,12042
GCCTTGCTTCAGATAC,sample,70800,69385,10323,59062,6045,53017,6326,245,21493,2080,27819,22873,6673,991,822,3610
CAAGGCCTTCAGATAC,sample,217670,214547,30639,183908,14676,169232,12399,573,75868,7726,88267,72666,12700,2418,1095,9832
ACTATACTTCAGATAC,sample,383964,378506,53079,325427,20992,304435,19455,737,135944,13339,155399,134960,16942,3692,548,9985
CCAGAGCGTCAGATAC,sample,23257,22617,5997,16620,11377,5243,1567,206,1512,129,3079,1829,1135,257,380,3586
TGGACGAGTCAGATAC,sample,53186,52463,12455,40008,14099,25909,5406,270,9411,985,14817,9837,4678,755,863,7422
CATGATTCTCAGATAC,sample,142053,140432,19062,121370,10094,111276,8783,685,47791,5017,56574,49000,10601,1494,549,5741
CTAGGACCTCAGATAC,sample,38253,37555,6039,31516,7601,23915,2946,135,10038,1051,12984,9745,4542,534,440,5368
TTGGCCTCTCAGATAC,sample,93168,92192,10333,81859,6243,75616,5580,235,35051,3411,40631,31339,8474,1346,262,4075
ACCAATGCTCAGATAC,sample,147545,146048,18484,127564,6845,120719,8024,352,54292,5548,62316,52503,11867,1815,550,2812
TCCAACTTTCGCTAGG,Neg_Ctrl,968,491,304,187,27,160,36,1,73,13,109,37,90,11,6,9
ACGTAAGTTCGCTAGG,sample,74366,73028,13152,59876,6214,53662,5067,214,23828,2409,28895,22144,7943,901,458,5382
AGTACCATTCGCTAGG,Neg_Ctrl,1713,1129,755,374,51,323,96,6,129,6,225,86,192,53,14,18
ACGTTATGTCGCTAGG,sample,144577,141972,28362,113610,18889,94721,9077,645,40901,4145,49978,39953,9341,1554,442,15013
CATAACCTTCGCTAGG,sample,23927,23417,3572,19845,1356,18489,1202,69,7977,706,9179,8535,3636,321,131,578
ACTATACTTCGCTAGG,sample,59265,58394,10815,47579,9041,38538,4739,313,17432,1673,22171,14381,5479,755,237,7241
CTTGATAGTCGCTAGG,sample,68351,67156,10213,56943,5739,51204,4897,181,22903,2368,27800,20855,7713,999,325,4864
ACCTCGAGTCGCTAGG,sample,16391,16045,2286,13759,4495,9264,1982,78,3437,326,5419,3441,2286,335,218,2893
GACGATAATCGCTAGG,sample,115033,113473,17215,96258,10342,85916,6088,252,38474,3849,44562,37253,9952,1380,398,7328
ACGACTTCTCGCTAGG,sample,35234,34546,6107,28439,6987,21452,2912,127,8431,902,11343,9080,3495,489,402,4775
TTGGTACCTCGCTAGG,sample,170628,168138,25992,142146,8639,133507,8626,398,61544,6141,70170,56798,13079,1813,365,4031
TGCTTCGCTCGCTAGG,sample,61847,61175,7495,53680,3536,50144,3496,166,23001,2317,26497,21164,8264,939,191,1629
CCAATTCCTCGCTAGG,sample,25721,25224,3189,22035,2606,19429,1898,117,8598,936,10496,7880,4508,482,248,1579
GTACCGTATCGCTAGG,Pos_Ctrl,231718,230173,9398,220775,27561,193214,121773,11853,45108,5009,166881,9471,4124,4523,3175,19669
TCGCCTGATCGCTAGG,sample,87771,86908,11115,75793,8048,67745,6446,330,30035,3268,36481,27666,8945,1487,283,4796
AGGTCGGATCGCTAGG,sample,44127,43538,5995,37543,2246,35297,2529,156,15918,1620,18447,15074,6515,671,272,1157
ATGACCGATCGCTAGG,sample,19333,19070,2348,16722,1795,14927,1141,51,6728,696,7869,6311,4059,412,66,1006
ATTCTCTTCCGTTGCG,sample,942077,930440,134819,795621,36896,758725,44651,2114,342280,34040,386931,335640,22034,7622,948,9256
TCCTCCGTCCGTTGCG,sample,70710,68780,18553,50227,29913,20314,4998,673,7307,738,12305,6598,2974,753,1273,12484
ACGTTATGCCGTTGCG,sample,71413,69481,18452,51029,29515,21514,9249,332,6041,692,15290,5200,3148,762,1076,12736
CAACCGCGCCGTTGCG,sample,268749,264841,41603,223238,17451,205787,15756,718,91515,9199,107271,88599,14085,3199,908,10906
TTAGAAGTCCGTTGCG,sample,289897,285496,42842,242654,27528,215126,21003,947,96920,10448,117923,85808,13143,3317,869,22867
TCGCATCTCCGTTGCG,sample,428339,421538,82682,338856,51679,287177,27093,1532,129839,13098,156932,115615,19698,4494,1181,45747
GCCTTGCTCCGTTGCG,sample,257148,253494,40878,212616,23927,188689,19057,899,83673,9120,102730,75940,15325,3111,1294,19170
CATAACCTCCGTTGCG,sample,581519,574873,82107,492766,46666,446100,38424,1759,201943,20967,240367,183007,21446,6685,980,32699
GTTAGCCGCCGTTGCG,sample,226323,222361,41697,180664,31315,149349,12934,689,67867,6601,80801,61258,12387,2241,691,25583
CCGCAACGCCGTTGCG,sample,158008,154996,34843,120153,23102,97051,10188,544,41465,4179,51653,40675,7955,1710,828,17993
CGAGGCAGCCGTTGCG,sample,53292,52394,10233,42161,11211,30950,3388,222,13376,1306,16764,12658,4745,621,500,8532
GTCCTGCCCCGTTGCG,sample,115591,114024,13887,100137,11742,88395,7478,576,40971,4143,48449,35227,10151,1484,695,8583
AACTCGTACCGTTGCG,sample,185569,183647,17100,166547,10705,155842,12961,601,72430,7854,85391,61996,12757,2683,859,7137
AATATATCCCGTTGCG,sample,247526,245253,30728,214525,26474,188051,18163,1062,83491,8465,101654,76870,14500,3283,2226,19519
GAAGGCGCCCGTTGCG,sample,262230,260019,23840,236179,16409,219770,18485,834,102408,10923,120893,87120,16569,4446,530,10131
CCAATTCCCCGTTGCG,sample,78323,77173,9760,67413,19930,47483,7135,458,18813,1894,25948,19183,7107,1282,1091,13342
TCGCCTGACCGTTGCG,sample,119388,118357,12517,105840,12086,93754,7014,326,42144,4289,49158,39981,11081,2000,335,7078
CTTCATGACCGTTGCG,sample,13160,12885,1635,11250,1866,9384,917,45,4167,458,5084,3797,3130,343,64,1199
AGGTCGGACCGTTGCG,sample,46294,45384,8042,37342,20052,17290,4016,264,6341,622,10357,6047,3367,794,608,8869
TATCAGTTAGGCCAAG,sample,310153,306403,39685,266718,29665,237053,18504,1088,105667,10295,124171,101499,13196,3139,1397,21785
GGTTGCGTAGGCCAAG,sample,525550,518266,75621,442645,33197,409448,27018,1223,190801,19323,217819,171083,18036,5251,936,24198
ACGTAAGTAGGCCAAG,sample,465852,459178,69957,389221,33345,355876,24189,810,159365,16168,183554,155344,16310,3927,1071,23060
ACGTTATGAGGCCAAG,sample,1507536,1485737,197624,1288113,62729,1225384,89463,3404,565028,58510,654491,508979,29776,13748,894,30634
TAGTACGGAGGCCAAG,sample,143599,140783,33297,107486,22620,84866,9553,463,39843,3923,49396,31084,7574,1371,640,18831
TGAGCGCGAGGCCAAG,sample,153963,151247,25702,125545,13752,111793,9254,377,47463,4696,56717,50003,10692,1616,1101,10687
CAACCGCGAGGCCAAG,sample,48251,46856,8393,38463,1526,36937,2441,87,17146,1706,19587,15557,6850,620,76,273
TTAGAAGTAGGCCAAG,sample,177692,174554,30919,143635,17095,126540,10102,532,54461,5265,64563,56180,11337,1697,926,14830
CATAACCTAGGCCAAG,sample,138560,136484,23410,113074,16470,96604,9793,462,43040,4164,52833,39145,9528,1601,1057,11785
GGAGGACGAGGCCAAG,sample,266800,263430,40166,223264,14068,209196,15626,668,96172,10178,111798,86552,12832,2856,961,7635
GGACGTAGAGGCCAAG,sample,210187,207971,23792,184179,13042,171137,12581,642,78218,7498,90799,72198,13539,2475,619,6725
TGGACGAGAGGCCAAG,sample,121741,120255,13828,106427,8382,98045,7929,269,45049,4883,52978,39915,10323,1580,544,5843
TTGGCCTCAGGCCAAG,sample,189111,187528,18666,168862,21116,147746,11806,468,66288,6598,78094,62586,12793,2781,584,13799
TGCTTCGCAGGCCAAG,sample,25872,25412,2956,22456,4961,17495,1514,103,8237,883,9751,6758,4198,540,101,3519
GTCTTAGCAGGCCAAG,sample,5356,5005,665,4340,1399,2941,343,32,1250,139,1593,1177,1055,153,35,774
CCAATTCCAGGCCAAG,sample,73006,71992,8284,63708,13673,50035,5736,452,21680,2337,27416,19830,7313,1237,847,9576
GTACCGTAAGGCCAAG,sample,67777,66964,8092,58872,10179,48693,4708,678,21208,2045,25916,20054,7099,1159,569,6705
GGCATATAAGGCCAAG,Neg_Ctrl,1372,759,351,408,27,381,60,5,152,8,212,156,185,27,3,9
TCAATATAAGGCCAAG,sample,150418,149077,13432,135645,9679,125966,9491,466,56675,5868,66166,53466,12864,2364,553,5328
TCGCCTGAAGGCCAAG,sample,88982,87797,10804,76993,12323,64670,6802,259,28154,2541,34956,26914,8034,1371,581,8924
CTTCATGAAGGCCAAG,sample,54042,53232,7156,46076,12446,33630,4406,501,14538,1538,18944,12647,5267,862,434,9107
GGAGAGTTAGAACCGC,sample,253180,248902,44515,204387,21624,182763,14112,893,80944,7844,95056,78970,11843,2223,701,14218
ATTCTCTTAGAACCGC,sample,373969,368139,58756,309383,32862,276521,24413,1487,124611,13229,149024,112781,16523,4176,1411,25854
AAGTTCGTAGAACCGC,sample,247300,243255,44264,198991,32814,166177,13340,596,71289,6831,84629,74121,11381,2073,1319,24411
CCTCTAGAAGAACCGC,sample,152358,150038,18930,131108,14070,117038,10555,429,53000,5240,63555,47814,11002,2056,1007,10170
AGTACCATAGAACCGC,sample,451912,445888,65476,380412,31016,349396,26148,1454,152408,15123,178556,154263,15057,3840,1248,22221
TTCGTAATAGAACCGC,sample,329665,323999,58892,265107,45386,219721,21115,893,95676,9503,116791,92534,13985,2924,1279,34166
AATGGTAAAGAACCGC,sample,162734,161049,19546,141503,26881,114622,16365,961,48713,4799,65078,43784,10616,2263,1937,21193
TTCCGTCTAGAACCGC,sample,422276,417215,63116,354099,53092,301007,27271,1538,134011,12924,161282,125263,15713,4051,1203,43405
GGACCTCTAGAACCGC,sample,578957,572484,73310,499174,40445,458729,38363,1742,203957,20201,242320,194466,19403,6033,1153,28487
GCCTTGCTAGAACCGC,sample,144392,142403,24930,117473,40023,77450,14536,782,31080,3002,45616,28050,7885,1709,1439,28803
CCAGAGCGAGAACCGC,sample,167390,165266,20902,144364,25009,119355,12292,807,50716,5052,63008,50488,10419,2079,1865,17712
GGCCAGAGAGAACCGC,sample,133148,131491,13991,117500,22232,95268,9864,642,41063,4315,50927,39384,9151,1772,735,16891
CGAGGCAGAGAACCGC,sample,211364,208982,21348,187634,27897,159737,18037,1295,73288,8615,91325,58502,12124,3043,943,23944
CCATGAAGAGAACCGC,sample,136985,135440,15675,119765,26639,93126,11616,845,40078,3856,51694,36731,8796,1752,999,20441
ACGACTTCAGAACCGC,sample,267657,264726,38285,226441,30173,196268,14122,898,86292,8232,100414,86724,12769,2493,2133,21550
TTGGTACCAGAACCGC,sample,61479,60246,13331,46915,23630,23285,6790,466,8235,836,15025,6958,3193,625,819,12240
CTAGGACCAGAACCGC,sample,293846,290252,41870,248382,13768,234614,16439,777,105549,9911,121988,101938,14584,2903,952,5443
GTTAGGACAGAACCGC,sample,165828,163982,22569,141413,26747,114666,12362,621,51677,5100,64039,44906,8469,2049,1472,19711
GCCTGAACAGAACCGC,sample,245302,242644,30286,212358,26815,185543,21670,1946,81336,8365,103006,72226,14803,3422,1927,22098
TGCTTCGCAGAACCGC,sample,98637,97001,17157,79844,13165,66679,7249,524,28162,2642,35411,28102,8271,1262,744,9761
TCGCCTGAAGAACCGC,sample,148316,146496,21564,124932,8312,116620,9043,352,51781,5353,60824,50091,10862,1617,572,4816
GACCGGAAAGAACCGC,sample,244076,241940,32136,209804,36071,173733,17706,906,77070,7886,94776,70165,15394,3326,1376,25851
TATCAGTTCATCAAGC,sample,255545,252657,34417,218240,16305,201935,14891,886,90474,9139,105365,86545,12908,2658,809,10641
ATTCTCTTCATCAAGC,sample,83019,81619,19612,62007,38104,23903,7270,791,7825,966,15095,7051,3405,921,1355,14592
TCCAACTTCATCAAGC,sample,326969,321736,49576,272160,23240,248920,17212,692,112865,11903,130077,106248,15033,3027,504,15930
GGTTGCGTCATCAAGC,sample,141865,139319,28901,110418,21496,88922,9771,974,37375,3648,47146,37154,9377,1391,1069,17499
TCCTCCGTCATCAAGC,sample,233842,230799,36447,194352,22483,171869,13257,1368,74912,7447,88169,74885,12829,2317,1131,15640
ACGTAAGTCATCAAGC,sample,65837,64400,12344,52056,6870,45186,4878,336,18939,1888,23817,19145,6696,828,549,5327
CAACCGCGCATCAAGC,sample,43601,42740,9734,33006,11114,21892,3290,1248,8468,823,11758,8063,3858,484,343,7789
AATGGTAACATCAAGC,sample,152165,150460,22166,128294,12700,115594,10742,632,49016,4700,59758,50504,10250,1839,893,8854
GGACCTCTCATCAAGC,sample,141434,138717,26600,112117,18825,93292,7778,324,41255,4033,49033,39902,8625,1265,463,14833
ACTATACTCATCAAGC,sample,258230,253799,43748,210051,28290,181761,12829,538,79928,7845,92757,80621,13819,2186,704,24137
CCAGAGCGCATCAAGC,sample,381129,377192,49733,327459,20257,307202,18794,735,135334,13027,154128,139312,15847,3584,859,8048
GTTAGCCGCATCAAGC,sample,171911,169442,27158,142284,15022,127262,10507,356,57620,5424,68127,53355,10573,1874,426,11339
GGACGTAGCATCAAGC,sample,180052,178046,24156,153890,13753,140137,9802,416,62870,6492,72672,60557,12509,1949,407,9291
ACCTCGAGCATCAAGC,sample,31906,31181,4263,26918,14976,11942,5646,483,2784,287,8430,2742,1791,492,703,6632
CGAGGCAGCATCAAGC,sample,69960,68892,10310,58582,14343,44239,5574,287,18299,2059,23873,18020,5946,1034,552,10913
GCCTGAACCATCAAGC,sample,30042,29286,5094,24192,10293,13899,4804,129,4574,507,9378,3885,2090,361,443,6041
AACTCGTACATCAAGC,sample,152592,150828,21771,129057,5276,123781,7275,314,56656,5710,63931,53826,11725,1496,316,1225
TTGGCCTCCATCAAGC,Pos_Ctrl,843873,836012,51798,784214,79618,704596,432798,36425,170734,18455,603532,46184,5850,6310,10223,61440
GTCTTAGCCATCAAGC,sample,28529,28033,3502,24531,4138,20393,2414,148,8495,781,10909,8555,4439,637,539,2732
AGGTCGGACATCAAGC,sample,76440,75205,12537,62668,9797,52871,6755,236,22243,2759,28998,20878,6804,1077,754,7370
ATGACCGACATCAAGC,sample,77116,76214,8616,67598,8326,59272,5761,330,28077,3022,33838,22082,7530,1251,335,6377
GGAGAGTTAGAGAGCC,sample,192689,190953,18521,172432,13611,158821,11320,509,71975,7445,83295,67572,13311,2529,528,8766
GGTTGCGTAGAGAGCC,sample,146320,143486,26843,116643,20372,96271,10592,570,41206,3928,51798,39975,10706,1635,906,18599
ACGTAAGTAGAGAGCC,sample,37159,36515,10734,25781,16391,9390,3372,407,2507,253,5879,2851,1740,453,546,6183
CCTCTAGAAGAGAGCC,sample,40017,39321,9564,29757,16189,13568,4068,312,4738,533,8806,3917,2878,566,1021,7627
TGAGCGCGAGAGAGCC,sample,112479,110475,20167,90308,14818,75490,9008,678,30768,2931,39776,32105,8119,1204,787,12176
CAACCGCGAGAGAGCC,sample,40738,40043,12089,27954,17610,10344,2994,224,3519,301,6513,3306,2367,408,472,6724
AATGGTAAAGAGAGCC,sample,111188,109771,18921,90850,25079,65771,10993,483,26945,2577,37938,24773,8258,1367,1175,18507
CAAGGCCTAGAGAGCC,sample,113494,111412,20940,90472,16943,73529,7653,473,32007,3117,39660,30279,8112,1186,701,13374
TGGACGAGAGAGAGCC,sample,72447,71602,9178,62424,13935,48489,5992,357,20775,2081,26767,19284,7927,1233,909,9804
GACGATAAAGAGAGCC,sample,61098,60349,11732,48617,17236,31381,5719,685,11953,1214,17672,11810,5134,865,1000,11184
CCATGAAGAGAGAGCC,sample,13846,13406,1626,11780,5635,6145,862,75,2747,239,3609,2222,1497,308,160,2774
CTAGGACCAGAGAGCC,sample,88941,87657,12744,74913,11323,63590,6359,323,28226,2990,34585,25692,8088,1226,438,9087
ACGTATTAAGAGAGCC,sample,26017,25470,5458,20012,9821,10191,3133,129,3436,354,6569,3139,1921,329,427,5034
AATATATCAGAGAGCC,sample,273952,271399,32215,239184,23460,215724,17147,1012,95270,9365,112417,92930,15583,3339,1125,16912
TGCTTCGCAGAGAGCC,sample,82465,81352,10593,70759,4892,65867,5165,226,29393,3226,34558,27857,9142,1226,569,3543
AAGAGCGCAGAGAGCC,sample,66073,65104,10786,54318,10025,44293,4176,337,18794,1855,22970,19131,6521,760,659,7831
GTACCGTAAGAGAGCC,sample,81331,80383,9977,70406,14189,56217,5150,283,25940,2448,31090,22396,8106,994,690,10495
TCGCCTGAAGAGAGCC,sample,74314,73356,10365,62991,8727,54264,5110,240,23732,2350,28842,22832,7168,949,513,6365
TTATTCGAAGAGAGCC,sample,15573,15189,1817,13372,5816,7556,2395,208,2489,252,4884,2212,1833,353,347,3152
ATTCTCTTAGCATTGA,sample,77363,75938,16139,59799,38231,21568,7778,892,7865,668,15643,4365,2749,777,1028,14252
ACGTAAGTAGCATTGA,sample,159936,157626,21769,135857,9931,125926,8396,417,57830,5808,66226,53475,11104,1830,862,6271
ACGTTATGAGCATTGA,sample,254500,251332,37340,213992,41243,172749,20262,1072,79726,7862,99988,63827,10817,2722,788,32373
TTCTAATGAGCATTGA,sample,57866,56299,10143,46156,6761,39395,4267,522,16980,1776,21247,15850,5304,858,1310,6251
TAGTACGGAGCATTGA,sample,158264,155318,21519,133799,7197,126602,9290,433,56575,5420,65865,54884,11403,1886,662,4013
TTCCGTCTAGCATTGA,sample,138715,136610,21523,115087,17041,98046,9055,470,44664,4432,53719,39425,9386,1700,957,14118
GCCTTGCTAGCATTGA,sample,50665,49465,11643,37822,23774,14048,3942,230,4679,443,8621,4754,2424,568,767,8677
ACTATACTAGCATTGA,sample,126571,124792,29194,95598,31464,64134,10939,798,26253,2689,37192,23455,7382,1329,1544,23139
CCAGAGCGAGCATTGA,sample,146068,144272,15982,128290,14548,113742,10488,571,50600,5115,61088,46968,10908,1975,678,10976
GGAGGACGAGCATTGA,sample,273933,271331,30303,241028,29166,211862,19235,862,93171,9029,112406,89565,15679,3504,1095,21546
CCGCAACGAGCATTGA,sample,232473,229394,34310,195084,28238,166846,15265,611,71163,7084,86428,72723,12945,2576,760,22791
CTTGATAGAGCATTGA,sample,164371,162055,23596,138459,19517,118942,14136,787,54361,5477,68497,44181,12909,2598,1257,16413
CATGATTCAGCATTGA,sample,101294,99750,15363,84387,22872,61515,8994,357,23906,2443,32900,25815,5666,1145,707,17371
GTCCTGCCAGCATTGA,sample,25670,24815,4168,20647,12735,7912,3115,148,2095,497,5210,2057,1401,286,520,4675
CGGATTACAGCATTGA,sample,105128,103456,16791,86665,19873,66792,7636,367,29027,2974,36663,26788,8293,1280,699,14968
GCCTGAACAGCATTGA,sample,35529,34541,6634,27907,15891,12016,4664,1294,3151,306,7815,2601,1906,447,823,6899
AATATATCAGCATTGA,Neg_Ctrl,1529,839,477,362,47,315,53,1,133,12,186,116,155,23,7,14
CCAATTCCAGCATTGA,sample,132469,130706,15437,115269,7296,107973,7168,279,49568,5009,56736,45949,10823,1604,530,4286
TTGGTTAAAGCATTGA,sample,199889,197759,27972,169787,23726,146061,13304,660,65511,6631,78815,59955,11870,2533,933,19192
GGCATATAAGCATTGA,sample,468878,463894,57867,406027,23948,382079,31023,1442,175980,18027,207003,155607,22158,5969,418,13410
TATCAGTTAATTACCA,sample,207437,205372,26125,179247,18168,161079,12121,471,69865,6918,81986,71704,12319,2239,688,12000
TCCAACTTAATTACCA,sample,144494,142093,25711,116382,16778,99604,9127,630,44872,4496,53999,40479,9388,1584,705,13964
AAGTTCGTAATTACCA,sample,141633,139757,23912,115845,19144,96701,8540,370,41685,4237,50225,41869,8202,1436,772,15172
TCCTCCGTAATTACCA,sample,305641,301311,46010,255301,25424,229877,18281,700,104767,10027,123048,96102,15267,3022,728,21838
AGTACCATAATTACCA,sample,206061,203343,30163,173180,22292,150888,14460,850,66374,6563,80834,62641,11545,2176,1340,17035
ACGTTATGAATTACCA,sample,216691,214543,30420,184123,18745,165378,16361,976,72251,7007,88612,68783,14226,2908,1118,13660
ATGCCTGGAATTACCA,sample,110516,109215,14528,94687,15416,79271,7886,440,31241,3259,39127,36445,5683,1304,900,11977
TTAGAAGTAATTACCA,sample,75452,73948,16300,57648,11921,45727,4209,242,20096,1914,24305,19266,6356,711,433,9506
TCGCATCTAATTACCA,sample,86233,84357,18248,66109,10019,56090,4919,469,24841,2429,29760,23432,7980,820,430,8340
GGACGTAGAATTACCA,sample,118007,116731,15595,101136,6671,94465,6296,268,42118,4061,48414,41722,10983,1432,484,3268
ACCTCGAGAATTACCA,sample,112250,111168,13818,97350,8053,89297,6137,271,40929,4078,47066,37882,11110,1468,286,5411
TGGACGAGAATTACCA,sample,40914,40097,6999,33098,2828,30270,2437,105,13160,1376,15597,13192,5399,562,244,1779
GACGATAAAATTACCA,sample,103751,102206,17409,84797,15678,69119,9597,606,30460,3098,40057,25358,7382,1444,932,13339
CATTGCAGAATTACCA,sample,101929,100687,13474,87213,8434,78779,6347,448,35288,3590,41635,33106,9419,1280,327,5475
CGTACGTCAATTACCA,sample,114596,112689,19057,93632,8072,85560,6052,327,37890,3549,43942,37742,9744,1240,408,4842
GTCCTGCCAATTACCA,sample,12831,12405,2291,10114,6527,3587,1354,148,1070,114,2424,901,905,218,301,2245
TTGGTACCAATTACCA,sample,39746,39058,7739,31319,10349,20970,3485,159,8636,926,12121,7764,3276,513,505,7721
GCCTGAACAATTACCA,sample,101226,99691,14847,84844,7027,77817,6292,290,35360,3560,41652,32315,8214,1343,263,4062
CGTATGAAAATTACCA,sample,48731,47819,8125,39694,4963,34731,3678,233,14770,1424,18448,14626,5561,745,766,3952
CCAATTCCAATTACCA,sample,41657,41001,6456,34545,4486,30059,3342,195,13451,1420,16793,11651,5796,579,251,3204
TTGGTTAAAATTACCA,sample,81827,80532,12945,67587,11300,56287,6342,337,25546,2548,31888,21514,7718,1196,494,9647
GGCATATAAATTACCA,sample,95264,94156,12433,81723,7868,73855,5608,457,31878,3011,37486,32901,8291,1103,276,4711
AGGTCGGAAATTACCA,sample,103240,101748,16811,84937,13935,71002,7373,422,31471,3198,38844,28538,9300,1410,614,10863
ATGACCGAAATTACCA,sample,51913,51295,6441,44854,5083,39771,4125,222,18086,1951,22211,15387,7584,1067,293,3865
TATCAGTTTAGATGAC,sample,77420,76533,7318,69215,8529,60686,4689,209,27106,2645,31795,26037,8832,1417,322,5018
ATTCTCTTTAGATGAC,Pos_Ctrl,833191,826176,50041,776135,93272,682863,426210,38306,164795,16886,591005,36666,6004,6662,10248,72861
GGTTGCGTTAGATGAC,sample,41578,40574,8886,31688,10832,20856,3882,226,8368,841,12250,7539,3304,570,710,7944
ACGTTATGTAGATGAC,Pos_Ctrl,826520,815695,76101,739594,95872,643722,391564,33306,158271,22716,549835,37865,6234,6437,9372,78727
TTCTAATGTAGATGAC,sample,300823,297480,46666,250814,35476,215338,17931,880,96056,9473,113987,90998,15842,3510,777,29006
TTAGAAGTTAGATGAC,sample,386499,382530,52603,329927,27053,302874,22749,1157,130591,12580,153340,135797,16681,4165,2044,17839
TTCCGTCTTAGATGAC,Pos_Ctrl,960270,941213,103510,837703,106386,731317,445243,37122,185468,22604,630711,40880,6190,6626,10726,89878
TCGCATCTTAGATGAC,sample,196821,193932,27566,166366,12494,153872,12393,536,69445,7317,81838,64181,12470,2448,657,8062
ACTATACTTAGATGAC,sample,88726,87107,15584,71523,15995,55528,7463,920,23873,2452,31336,20820,7851,1260,906,13276
GACGGAGATAGATGAC,sample,119593,118252,15892,102360,21330,81030,8881,467,34471,3544,43352,33667,10036,1734,1152,15679
CCGCAACGTAGATGAC,sample,184403,181869,27363,154506,21456,133050,13728,672,58044,5847,71772,54759,11370,2515,1291,18826
GGACGTAGTAGATGAC,sample,95997,94860,10747,84113,9159,74954,6661,318,32964,3141,39625,31870,9045,1472,579,7278
CATTGCAGTAGATGAC,sample,98096,96921,11466,85455,17727,67728,7490,479,28695,2791,36185,28273,8945,1507,743,12807
CGAGGCAGTAGATGAC,sample,190411,188148,24339,163809,16544,147265,10510,615,65672,6717,76182,63751,12964,2226,487,11015
CCATGAAGTAGATGAC,sample,53772,52797,7998,44799,15967,28832,5073,412,11914,1385,16987,10048,5018,870,920,10226
CATGATTCTAGATGAC,sample,66248,64995,10567,54428,8866,45562,5577,436,18770,1820,24347,18959,6901,1022,807,6720
CGTACGTCTAGATGAC,sample,154817,152737,20963,131774,10077,121697,8203,329,51792,5062,59995,56311,10177,1734,440,5293
CTAGGACCTAGATGAC,sample,215122,212878,26947,185931,13362,172569,11096,504,77821,7795,88917,75353,13907,2617,657,5850
AAGAGCGCTAGATGAC,sample,98853,97410,14854,82556,8895,73661,5771,497,32405,3211,38176,31777,8630,1235,346,6717
CCAATTCCTAGATGAC,sample,110162,108819,12156,96663,11219,85444,7415,406,38252,3857,45667,35514,10969,1737,802,7963
TCGCCTGATAGATGAC,sample,143976,142257,18223,124034,16447,107587,11036,677,46619,4562,57655,44693,11210,1986,657,12157
CTTCATGATAGATGAC,sample,32157,31478,5249,26229,11231,14998,3148,246,5631,540,8779,5433,2540,521,602,6543
AGGTCGGATAGATGAC,sample,333391,329572,43112,286460,15351,271109,19360,885,125405,12178,144765,113281,17568,4121,627,7455
TATCAGTTGTTCAGAA,sample,59578,58520,7712,50808,10310,40498,5725,303,17819,1822,23544,14829,6725,1033,536,8172
CCTCTAGAGTTCAGAA,sample,102257,100687,13364,87323,9660,77663,6313,295,34004,3460,40317,33591,9611,1312,652,6865
ATGCCTGGGTTCAGAA,sample,196927,194598,23335,171263,15356,155907,13711,801,69426,6946,83137,65023,12031,2568,340,11537
CAACCGCGGTTCAGAA,sample,22007,21341,3091,18250,1821,16429,1672,123,7137,765,8809,6732,4072,458,252,1639
TCGCATCTGTTCAGAA,sample,57143,56083,10599,45484,16189,29295,5600,205,12069,1058,17669,10363,3801,817,528,10871
GACGGAGAGTTCAGAA,sample,29808,29173,4285,24888,2733,22155,1791,126,9809,958,11600,9471,4816,487,228,2022
GACGATAAGTTCAGAA,sample,63564,62750,9626,53124,10137,42987,3907,273,18944,1794,22851,18069,7299,859,377,8580
GGCCAGAGGTTCAGAA,sample,34750,34272,3248,31024,2581,28443,2368,138,12968,1294,15336,11675,6143,729,254,1214
CGAGGCAGGTTCAGAA,sample,21303,20875,3763,17112,4654,12458,1606,117,5462,491,7068,4782,3205,369,211,3356
CATGATTCGTTCAGAA,sample,40032,39224,5555,33669,3500,30169,2747,166,13506,1332,16253,12418,5727,633,290,2277
CGTACGTCGTTCAGAA,sample,9821,9448,998,8450,567,7883,554,30,3634,365,4188,3300,2489,191,61,219
TTGGCCTCGTTCAGAA,sample,85136,84073,10841,73232,9593,63639,5110,235,27750,2814,32860,27730,8568,1134,556,7216
ACCAATGCGTTCAGAA,sample,18040,17565,3687,13878,8491,5387,1456,164,1907,170,3363,1690,1347,278,464,3199
TGCTTCGCGTTCAGAA,sample,141632,139919,17800,122119,8613,113506,7664,441,50917,4920,58581,49564,11930,1720,217,5346
TCAATATAGTTCAGAA,sample,12479,12170,2106,10064,7053,3011,1515,155,649,81,2164,611,684,238,250,2089
TCGCCTGAGTTCAGAA,sample,13169,12854,2421,10433,6398,4035,1179,86,1609,113,2788,1048,904,197,201,2462
CTTCATGAGTTCAGAA,sample,26112,25659,2771,22888,9346,13542,3653,104,4865,558,8518,4362,2744,487,338,5441
AGGTCGGAGTTCAGAA,Pos_Ctrl,744740,738743,34340,704403,54614,649789,403617,37499,152727,20381,556344,35565,5307,5875,9055,38012
TTATTCGAGTTCAGAA,sample,23606,23345,2485,20860,2496,18364,1995,112,7995,897,9990,7365,4863,611,240,1544
GACCGGAAGTTCAGAA,sample,33549,33121,3826,29295,3995,25300,3071,160,10568,1011,13639,10490,4817,550,226,3134
TATCAGTTTTCTGGTT,sample,413375,409105,52611,356494,32619,323875,29212,1395,146911,15817,176123,130540,19159,5565,1470,23513
TCCAACTTTTCTGGTT,Neg_Ctrl,3114,1155,835,320,50,270,50,0,113,10,163,97,135,15,10,6
AGTACCATTTCTGGTT,sample,42521,41176,8191,32985,15997,16988,4012,532,7293,621,11305,4530,2809,561,620,8183
TTCGTAATTTCTGGTT,sample,204367,201459,28583,172876,12534,160342,10749,899,71605,7013,82354,70076,12169,2195,907,6798
TTCTAATGTTCTGGTT,Neg_Ctrl,1642,817,545,272,35,237,35,2,87,16,122,97,108,19,4,7
TGAGCGCGTTCTGGTT,sample,202144,199555,25300,174255,16512,157743,13001,552,71913,7374,84914,64903,13553,2776,803,12682
CAACCGCGTTCTGGTT,sample,22348,21290,5052,16238,8976,7262,1761,78,2861,261,4622,2301,1552,321,259,4005
GGACCTCTTTCTGGTT,Neg_Ctrl,1415,856,445,411,52,359,78,3,165,12,243,101,200,42,5,18
GCCTTGCTTTCTGGTT,sample,66557,65123,11457,53666,12468,41198,4339,207,17864,1945,22203,16843,5332,791,446,9817
CAAGGCCTTTCTGGTT,sample,85983,84233,14058,70175,10675,59500,7435,496,25408,2278,32843,23883,7637,969,665,8936
ACTATACTTTCTGGTT,sample,23148,22555,7025,15530,10492,5038,2068,113,1430,146,3498,1281,1052,230,349,3458
GTTAGCCGTTCTGGTT,sample,47748,46765,9348,37417,7936,29481,4370,234,12166,1271,16536,11440,5507,732,573,6046
GGAGGACGTTCTGGTT,sample,76161,74870,10620,64250,6966,57284,4727,206,25255,2479,29982,24617,6414,902,328,5751
CTTGATAGTTCTGGTT,sample,59286,58174,11145,47029,15415,31614,4210,279,13369,1164,17579,12592,4621,668,431,11264
GACGATAATTCTGGTT,sample,64945,63713,10272,53441,7647,45794,4262,213,20824,2036,25086,18459,5600,870,236,7464
GGCCAGAGTTCTGGTT,sample,58559,57779,8292,49487,6747,42740,3870,143,17725,1769,21595,19233,6398,818,327,4479
CATTGCAGTTCTGGTT,sample,21119,20741,3768,16973,822,16151,1034,59,7414,721,8448,6923,4080,274,67,421
CGTACGTCTTCTGGTT,sample,53527,52642,7676,44966,5847,39119,3876,182,17492,1880,21368,15689,6989,789,515,4025
AGTCCGCATTCTGGTT,sample,34530,33851,4734,29117,9411,19706,2772,194,8201,777,10973,7762,3706,533,619,6514
TTGGCCTCTTCTGGTT,sample,47820,47229,5494,41735,9970,31765,4345,223,13236,1408,17581,12553,6431,1073,495,7137
TGCTTCGCTTCTGGTT,sample,201316,199210,25089,174121,10556,163565,9214,380,73183,7294,82397,73494,12821,2283,270,5217
GAAGGCGCTTCTGGTT,sample,132297,130585,17775,112810,12557,100253,7922,407,46056,4619,53978,41249,9260,1778,417,9594
GTCTTAGCTTCTGGTT,sample,62519,61790,6863,54927,10548,44379,4257,359,19021,2037,23278,18705,7501,1042,538,6732
TTGGTTAATTCTGGTT,sample,155626,153603,20804,132799,9330,123469,8373,379,55427,5626,63800,53664,12423,1942,545,4531
TTATTCGATTCTGGTT,sample,120975,119953,12071,107882,6719,101163,6386,266,45701,4510,52087,44300,11828,1791,174,2822
TCCTCCGTGTTCGGTT,sample,116403,114480,16233,98247,8141,90106,7386,447,39654,3949,47040,38670,9580,1496,1010,4406
AATGGTAAGTTCGGTT,sample,141109,139172,26840,112332,27339,84993,11218,1223,36397,3678,47615,32477,10662,1729,1357,21044
GGACCTCTGTTCGGTT,sample,93821,91919,15106,76813,13122,63691,7385,465,27104,2629,34489,26108,8285,1188,1273,11407
CATAACCTGTTCGGTT,sample,31473,30907,5435,25472,10710,14762,3358,196,5485,504,8843,5219,2874,464,432,6043
GGACGTAGGTTCGGTT,sample,163834,161945,18987,142958,12012,130946,8990,342,58155,5532,67145,57927,11317,1840,521,7319
CTTGATAGGTTCGGTT,sample,127667,125404,19136,106268,14023,92245,8146,296,40943,4189,49089,38671,9584,1409,352,11973
CATGATTCGTTCGGTT,sample,202125,199858,28987,170871,13874,156997,12870,729,70671,6980,83541,65747,14620,2676,657,9278
GTTAGGACGTTCGGTT,sample,42759,41907,5808,36099,15433,20666,7880,431,6267,556,14147,5532,2533,528,707,8772
TTGGCCTCGTTCGGTT,sample,46083,45140,5801,39339,11408,27931,3864,405,11627,1201,15491,10834,4478,843,569,8018
TCGCCTGAGTTCGGTT,sample,82049,81025,8434,72591,9663,62928,5302,227,29144,2916,34446,25339,8590,1356,371,6582
CTTCATGAGTTCGGTT,sample,231244,229410,18831,210579,19818,190761,18872,1396,86120,8727,104992,75646,16841,4210,524,12380
TTATTCGAGTTCGGTT,Neg_Ctrl,843,419,215,204,35,169,71,5,51,6,122,36,95,38,17,7
ATGACCGAGTTCGGTT,sample,253,246,40,206,39,167,51,0,47,8,98,61,84,33,5,28
TATCAGTTTGGCGGTT,sample,114035,111999,22246,89753,32203,57550,8547,608,24483,2724,33030,21188,5280,1278,1943,22001
TCCAACTTTGGCGGTT,sample,244718,240163,35177,204986,25058,179928,17705,917,83195,9790,100900,68321,11891,2621,972,22455
AAGTTCGTTGGCGGTT,sample,299951,295652,43022,252630,45515,207115,25136,1171,87611,8149,112747,85048,12965,2920,1430,33407
GGTTGCGTTGGCGGTT,sample,56371,53739,10882,42857,17684,25173,5356,527,9245,877,14601,9168,3536,593,522,9948
TCCTCCGTTGGCGGTT,sample,196162,192773,33030,159743,34493,125250,15676,991,52702,5695,68378,50186,10471,2373,2288,24649
ACGTTATGTGGCGGTT,sample,400476,394906,55728,339178,49487,289691,26431,1718,129075,12164,155506,120303,16032,4738,2440,42555
CAACCGCGTGGCGGTT,sample,41882,40210,9636,30574,15329,15245,2810,156,5951,577,8761,5751,2966,521,409,7741
ACTATACTTGGCGGTT,sample,49727,48543,6343,42200,6034,36166,3710,286,16200,1706,19910,14264,6332,1003,741,4162
GGACGTAGTGGCGGTT,sample,207294,205437,16828,188609,15023,173586,10409,530,79187,7964,89596,75496,14063,3020,394,8366
CTTGATAGTGGCGGTT,sample,57305,55575,11845,43730,24585,19145,9573,861,5054,541,14627,3116,2431,606,884,11100
TGGACGAGTGGCGGTT,sample,143745,141637,16529,125108,26717,98391,10406,609,40855,3628,51261,42893,6410,1661,999,21163
GGCCAGAGTGGCGGTT,sample,49147,47591,6326,41265,18252,23013,5285,961,8116,771,13401,7880,3432,737,986,9538
ACGACTTCTGGCGGTT,sample,156288,153619,18749,134870,14455,120415,12526,702,52720,5208,65246,49259,11130,2463,1459,10644
CATGATTCTGGCGGTT,sample,195780,193235,23921,169314,18967,150347,14573,975,65001,6125,79574,63673,12785,2486,1672,14643
AGTCCGCATGGCGGTT,sample,140947,138969,16001,122968,23582,99386,12148,1093,42669,4183,54817,39293,8652,2149,832,17551
CGTATGAATGGCGGTT,sample,226504,223693,23520,200173,22339,177834,15115,611,81086,8270,96201,72752,11306,2788,697,17232
GAAGGCGCTGGCGGTT,sample,226928,224419,23436,200983,12572,188411,13795,488,84792,8908,98587,80428,14204,2794,727,7762
AAGAGCGCTGGCGGTT,sample,244692,241542,29386,212156,30283,181873,18788,963,79531,8111,98319,74480,12552,2931,1529,25753
TTGGTTAATGGCGGTT,sample,229035,225979,27955,198024,21195,176829,21076,950,77177,7805,98253,69821,13909,2999,1551,17276
TCGCCTGATGGCGGTT,sample,270693,268008,26397,241611,18383,223228,15982,904,102260,10200,118242,93882,15852,3692,1001,11697
AGGTCGGATGGCGGTT,sample,149008,147199,18063,129136,19720,109416,12351,507,47772,4981,60123,43805,8999,2197,1061,15219
TTATTCGATGGCGGTT,sample,19869,19068,2074,16994,5726,11268,2174,190,4333,465,6507,4106,2656,484,446,3533
GGAGAGTTTCCTTATT,sample,117913,116420,16002,100418,14606,85812,8258,506,37550,3774,45808,35724,9266,1434,906,10477
GGTTGCGTTCCTTATT,sample,154779,152254,29273,122981,18022,104959,8757,455,46695,4939,55452,44113,10250,1716,448,15166
TCCTCCGTTCCTTATT,sample,89239,87762,15332,72430,9977,62453,5459,237,27634,2967,33093,26156,7870,1023,376,7869
CCTCTAGATCCTTATT,sample,29182,28457,5727,22730,1711,21019,1623,78,9218,892,10841,9208,4546,374,84,1212
ACGTTATGTCCTTATT,sample,15374,15043,4374,10669,3902,6767,1325,138,2629,272,3954,2403,1995,266,164,2727
ATGCCTGGTCCTTATT,sample,19601,19104,4664,14440,8493,5947,2716,93,1784,124,4500,1230,1142,251,282,3562
TAGTACGGTCCTTATT,sample,83376,82101,15200,66901,10309,56592,6353,305,25002,2562,31355,22370,7251,1049,672,9631
TGAGCGCGTCCTTATT,sample,51708,50770,9750,41020,13382,27638,4077,227,10698,1196,14775,11440,3638,661,695,9493
TCGCATCTTCCTTATT,sample,42468,41645,8207,33438,9737,23701,3258,141,9816,1057,13074,9429,4229,527,246,7366
CAAGGCCTTCCTTATT,sample,95502,93616,13818,79798,4333,75465,5212,198,32687,3020,37899,34348,8472,1092,276,2346
CCAGAGCGTCCTTATT,sample,60761,59794,9853,49941,4124,45817,3583,184,20267,1911,23850,19872,6734,810,256,2304
GGACGTAGTCCTTATT,sample,13515,12974,2192,10782,5975,4807,2347,181,1103,138,3450,1038,925,218,245,2595
CTTGATAGTCCTTATT,sample,76342,75139,13167,61972,11773,50199,5159,193,22319,2112,27478,20416,6851,816,372,9422
ACCTCGAGTCCTTATT,sample,13417,12971,1783,11188,3383,7805,951,61,3353,338,4304,3102,1632,252,153,2274
CATTGCAGTCCTTATT,sample,33126,32555,3931,28624,5012,23612,2402,143,9847,1033,12249,10187,2770,421,239,4018
CTAGGACCTCCTTATT,sample,30422,29783,3871,25912,7568,18344,4439,165,6416,680,10855,6644,3441,674,482,5391
CGGATTACTCCTTATT,sample,181826,179852,23111,156741,13268,143473,9826,399,64368,6313,74194,62567,12356,2151,278,8149
CGTATGAATCCTTATT,sample,41754,41174,5513,35661,5078,30583,3040,148,13434,1438,16474,12523,6608,790,223,3905
TTGGCCTCTCCTTATT,Pos_Ctrl,240846,239275,11289,227986,24867,203119,129646,11263,46058,6715,175704,9437,4241,4586,2652,18260
CCAATTCCTCCTTATT,sample,34585,34090,3446,30644,6353,24291,2308,238,11044,1100,13352,9601,5354,682,237,4440
TTGGTTAATCCTTATT,sample,14797,14459,2735,11724,7195,4529,1508,96,1453,178,2961,1294,1199,270,270,2695
GTACCGTATCCTTATT,sample,5658,5470,650,4820,2022,2798,639,50,1055,104,1694,950,1039,240,89,1094
AGGTCGGATCCTTATT,sample,30251,29990,3501,26489,2271,24218,2184,149,10828,1140,13012,9917,5920,738,132,1331
GACCGGAATCCTTATT,sample,233,225,37,188,36,152,29,1,64,7,93,51,84,23,4,22
GGAGAGTTAATAAGGT,sample,90564,89461,7923,81538,10717,70821,5571,243,31767,3318,37338,29922,9702,1766,527,6699
TCCTCCGTAATAAGGT,sample,164001,161175,23782,137393,16667,120726,11120,568,54076,5256,65196,49706,10702,1964,1183,13134
ACGTAAGTAATAAGGT,sample,259331,255282,38882,216400,28457,187943,22462,1233,85466,9732,107928,69050,12299,3072,1254,26330
TTCTAATGAATAAGGT,sample,93912,91441,16981,74460,15378,59082,11909,603,23113,2402,35022,21055,7193,1399,1773,13594
TGAGCGCGAATAAGGT,sample,262707,258914,41519,217395,29471,187924,13910,977,80492,7560,94402,84985,12100,2348,1228,23415
TTCCGTCTAATAAGGT,sample,181968,179278,28937,150341,15032,135309,11740,605,59813,5990,71553,57161,13387,2265,822,12678
GGACCTCTAATAAGGT,sample,116594,114637,21455,93182,24091,69091,9169,954,28893,2675,38062,27400,8395,1578,1392,19145
GCCTTGCTAATAAGGT,sample,351537,347756,37883,309873,19202,290671,16755,578,132559,12765,149314,128014,15073,3612,598,9068
CCAGAGCGAATAAGGT,sample,219393,216743,27995,188748,14411,174337,14147,560,79643,8309,93790,71678,14817,2761,602,9954
GTTAGCCGAATAAGGT,sample,115049,113251,15792,97459,14578,82881,10109,500,38543,3870,48652,29859,9657,1900,624,12241
CCGCAACGAATAAGGT,Pos_Ctrl,1154617,1139776,81078,1058698,100900,957798,588347,45990,243190,27214,831537,53057,6117,6688,10769,75282
GACGATAAAATAAGGT,sample,512707,505823,66777,439046,37558,401488,30523,1454,180444,17932,210967,171135,18028,5145,959,26217
GGCCAGAGAATAAGGT,sample,386412,382765,42397,340368,27024,313344,26037,1295,143163,14491,169200,128358,19025,5159,1154,16889
CCATGAAGAATAAGGT,sample,119526,117482,16184,101298,9956,91342,8903,488,40057,4930,48960,36964,9642,1588,682,6183
CATGATTCAATAAGGT,sample,219469,216357,29938,186419,22809,163610,10591,420,73025,6825,83616,72749,12784,2246,745,16344
AATCCGTCAATAAGGT,Pos_Ctrl,1144082,1130495,80558,1049937,112804,937133,589599,47631,215500,28848,805099,55555,6210,6903,11906,91557
AACTCGTAAATAAGGT,sample,1573,1488,203,1285,249,1036,200,11,445,45,645,335,498,82,20,162
CGTATGAAAATAAGGT,sample,78677,77663,6764,70899,9652,61247,5888,404,27906,2692,33794,24357,8836,1619,352,6412
TTGGCCTCAATAAGGT,sample,71201,70033,9702,60331,6220,54111,4312,254,23392,2171,27704,23982,7861,1336,400,2207
GAAGGCGCAATAAGGT,sample,37545,36496,4667,31829,16076,15753,4180,238,5853,797,10033,4685,2447,628,897,7750
GTACCGTAAATAAGGT,sample,152821,151195,13872,137323,13049,124274,9838,527,56443,5586,66281,51880,12355,2435,738,8177
TCAATATAAATAAGGT,sample,84985,83787,8417,75370,17579,57791,7969,633,25590,2727,33559,20872,7406,1676,1378,13176
TTATTCGAAATAAGGT,sample,16493,15825,2297,13528,3364,10164,1576,84,4119,396,5695,3989,2575,408,278,2062
ATGACCGAAATAAGGT,sample,99245,98220,8981,89239,6437,82802,6003,338,36967,3755,42970,35739,10389,1667,236,2864
TATCAGTTCAGGACCA,sample,225296,221586,33159,188427,19308,169119,13372,665,74708,7423,88080,72951,12131,2106,1099,15220
TCCAACTTCAGGACCA,sample,134856,131318,28231,103087,20028,83059,9466,457,34246,3264,43712,35626,8843,1198,736,17542
AAGTTCGTCAGGACCA,sample,851861,840265,108738,731527,36363,695164,42617,1737,313684,31632,356301,305494,21564,7164,999,15849
TCCTCCGTCAGGACCA,sample,118939,115883,19436,96447,10837,85610,7147,303,36919,3698,44066,37543,8061,1256,494,8441
ACGTAAGTCAGGACCA,sample,557299,548667,76984,471683,46663,425020,31825,1509,189712,19056,221537,182918,17562,5163,1711,34979
AGTACCATCAGGACCA,sample,258423,253332,47924,205408,33921,171487,18688,1493,75703,7944,94391,67659,13000,2660,2119,27952
TTCGTAATCAGGACCA,sample,122895,119931,20021,99910,18493,81417,10225,677,34671,3441,44896,32403,9171,1422,1415,16478
TAGTACGGCAGGACCA,sample,304593,299002,50875,248127,24084,224043,17454,640,94793,8647,112247,102509,13097,2690,1193,15190
TTCCGTCTCAGGACCA,sample,182746,179556,40364,139192,42056,97136,11449,821,40080,3953,51529,40833,9214,1725,1922,30180
GGACCTCTCAGGACCA,sample,63346,61823,13542,48281,18797,29484,5280,270,12495,1260,17775,10179,4134,694,797,11820
TCGCATCTCAGGACCA,sample,78124,75923,17362,58561,10710,47851,4303,220,20317,1867,24620,21144,6093,712,259,8574
CAAGGCCTCAGGACCA,sample,437976,431520,59371,372149,36004,336145,30062,1736,149771,14802,179833,139774,17674,4802,2382,31127
GGACGTAGCAGGACCA,sample,35238,34023,4048,29975,12861,17114,2623,404,6710,639,9333,6738,3424,584,497,6869
CATTGCAGCAGGACCA,sample,140450,138201,15701,122500,12275,110225,8901,422,50188,4779,59089,45935,9963,1761,554,8233
ACGACTTCCAGGACCA,sample,172887,170817,18980,151837,20370,131467,12084,1114,59056,5965,71140,53248,10300,2200,1115,15434
TTGGTACCCAGGACCA,sample,115618,112915,20048,92867,11977,80890,8296,505,35333,3183,43629,33573,7956,1351,1215,9383
GCCTGAACCAGGACCA,sample,290045,286032,43265,242767,30907,211860,17840,762,93846,9067,111686,90345,15718,3169,1329,22160
CGTATGAACAGGACCA,sample,64005,62304,14425,47879,28989,18890,6993,928,4726,418,11719,5825,2251,649,1301,11632
TTGGCCTCCAGGACCA,sample,50681,49568,8925,40643,17440,23203,6914,544,8264,881,15178,6600,3179,833,690,10128
AATATATCCAGGACCA,Neg_Ctrl,2710,1637,1007,630,66,564,87,4,239,16,326,218,274,33,14,17
ACCAATGCCAGGACCA,sample,131902,129914,17091,112823,22485,90338,9698,644,37248,3923,46946,38825,6993,1559,1264,18447
TGCTTCGCCAGGACCA,sample,88601,86917,13905,73012,12529,60483,8016,501,26769,2680,34785,22517,7302,1275,883,10802
GAAGGCGCCAGGACCA,sample,172822,170436,25980,144456,15499,128957,10526,601,57365,5646,67891,54819,10986,1980,1421,10509
AAGAGCGCCAGGACCA,sample,219003,215759,29779,185980,22244,163736,14782,766,70776,7256,85558,70156,13325,2585,1860,18027
CCAATTCCCAGGACCA,sample,123900,121949,12674,109275,15970,93305,12136,663,44804,5043,56940,30659,7736,2228,775,14368
TCGCCTGACAGGACCA,sample,69935,68721,9913,58808,16135,42673,6656,374,18375,1840,25031,15428,5497,961,823,12020
AGGTCGGACAGGACCA,sample,119753,117712,20549,97163,21707,75456,8979,399,31960,3155,40939,30963,7308,1503,1041,17875
ATGACCGACAGGACCA,sample,173817,171701,19905,151796,11316,140480,11134,467,64621,6610,75755,57648,12155,2213,319,6026
GACCGGAACAGGACCA,sample,285565,282586,30471,252115,10585,241530,15124,536,110844,11436,125968,103590,16349,3313,299,2946
GGAGAGTTCCTCGTTG,sample,283982,280583,36091,244492,17127,227365,15300,941,99544,9629,114844,101951,13829,2910,974,8367
TATCAGTTCCTCGTTG,sample,195965,193371,28965,164406,40945,123461,19903,1154,52045,5400,71948,44959,11085,2600,2695,31643
GGTTGCGTCCTCGTTG,sample,140976,138181,21918,116263,11856,104407,9644,529,45404,4359,55048,44471,10806,1633,1291,10900
CCTCTAGACCTCGTTG,sample,395461,390772,49683,341089,29385,311704,24692,1037,140682,14427,165374,130866,18181,4657,896,19575
ACGTTATGCCTCGTTG,sample,65723,63412,14428,48984,27611,21373,9688,1138,5730,484,15418,4333,3004,776,1045,12308
TAGTACGGCCTCGTTG,sample,221168,218385,33210,185175,30008,155167,17857,1160,63703,6413,81560,66034,11632,2653,1088,22002
CAACCGCGCCTCGTTG,sample,171093,168641,32156,136485,25311,111174,11116,597,48909,5015,60025,45537,12545,2196,1484,20244
TTAGAAGTCCTCGTTG,sample,396665,392326,50353,341973,39865,302108,23263,1059,134357,13992,157620,129437,15523,4245,1115,28941
CCAGAGCGCCTCGTTG,sample,276834,273218,28903,244315,20908,223407,20039,829,105873,11547,125912,85119,14035,3812,852,15370
GGACGTAGCCTCGTTG,Neg_Ctrl,2218,1101,685,416,59,357,78,7,130,16,208,126,178,43,9,13
CATTGCAGCCTCGTTG,sample,131644,130150,17354,112796,18317,94479,9697,551,39643,4117,49340,40471,10505,1731,816,15645
CGTACGTCCCTCGTTG,Neg_Ctrl,1023,567,364,203,26,177,42,3,74,6,116,52,98,16,6,7
GTCCTGCCCCTCGTTG,sample,83626,82362,10396,71966,19605,52361,8961,284,21087,2237,30048,19792,6399,1197,997,14126
CGTATGAACCTCGTTG,sample,214565,211892,33932,177960,25806,152154,13565,853,66686,6481,80251,64569,11767,2060,738,19567
AATATATCCCTCGTTG,sample,189428,186891,27667,159224,15810,143414,11120,583,64657,6142,75777,60912,11990,2043,1260,12692
AAGAGCGCCCTCGTTG,sample,158085,155870,24415,131455,22634,108821,9655,506,48681,4776,58336,45203,10299,1751,1081,20393
GTACCGTACCTCGTTG,Pos_Ctrl,677895,672609,37378,635231,75567,559664,346939,30931,132553,17629,479492,31612,5531,6139,9388,55182
TCGCCTGACCTCGTTG,sample,165617,163719,25371,138348,18118,120230,11928,619,51191,5174,63119,51318,11130,1830,1120,13489
ATGACCGACCTCGTTG,sample,95306,94327,9146,85181,6378,78803,5343,254,35887,3715,41230,33604,10333,1783,216,2561
TCCAACTTTTGCGGAC,sample,144112,141470,23219,118251,29854,88397,10801,677,39172,3858,49973,33889,9417,2325,1691,25325
AGTACCATTTGCGGAC,sample,56936,55666,10659,45007,28524,16483,3562,2086,5231,546,8793,5058,2326,631,864,10235
TGAGCGCGTTGCGGAC,sample,170607,168644,22979,145665,25443,120222,10866,670,54432,5456,65298,48798,11396,2401,1150,22433
CAACCGCGTTGCGGAC,sample,149697,147794,18080,129714,16199,113515,10591,502,51879,5487,62470,45056,12724,2516,678,12838
TTAGAAGTTTGCGGAC,sample,61480,60249,11020,49229,25149,24080,6636,498,8670,820,15306,7456,3618,826,862,12591
CATAACCTTTGCGGAC,sample,286836,283698,32636,251062,19977,231085,17312,724,105738,10806,123050,96505,15128,3400,713,13495
GTTAGCCGTTGCGGAC,sample,225398,223131,34091,189040,33308,155732,16768,1352,69805,8789,86573,59018,11418,3711,1304,27377
CCGCAACGTTGCGGAC,sample,30203,29365,8324,21041,13785,7256,3449,202,1995,134,5444,1476,1167,386,403,4841
CTTGATAGTTGCGGAC,sample,194762,192210,31285,160925,27318,133607,11584,455,58064,5696,69648,57808,11709,1950,1183,23274
CGAGGCAGTTGCGGAC,sample,55893,55121,9839,45282,10000,35282,4898,374,14557,1469,19455,13984,6337,846,553,7670
CTAGGACCTTGCGGAC,sample,52846,51920,6983,44937,3830,41107,3676,158,17557,1754,21233,17962,6634,751,373,2363
AATATATCTTGCGGAC,sample,336683,333208,44747,288461,23864,264597,20764,1121,122380,12583,143144,107749,18403,4405,566,15240
GAAGGCGCTTGCGGAC,sample,43906,42964,7917,35047,7129,27918,2961,222,11923,1150,14884,11662,5060,664,511,5349
CCAATTCCTTGCGGAC,sample,199652,197701,20333,177368,11908,165460,11198,518,75241,7681,86439,70822,13777,2668,495,7147
AGGTCGGATTGCGGAC,sample,33664,32950,7148,25802,13613,12189,5057,261,3388,309,8445,3174,1643,468,757,6646
TTATTCGATTGCGGAC,sample,49168,48473,4467,44006,9860,34146,4348,204,14094,1433,18442,14067,4325,915,281,7331
GGAGAGTTTCCATTGG,sample,37166,36368,5154,31214,11371,19843,3452,159,8279,637,11731,7316,2699,562,519,7087
CCTCTAGATCCATTGG,sample,75981,75178,8044,67134,4829,62305,4845,243,27469,2770,32314,26978,8585,1140,252,2498
AGTACCATTCCATTGG,sample,124489,123184,15138,108046,15409,92637,8596,447,41343,4011,49939,38240,8530,1588,601,11700
ACTATACTTCCATTGG,sample,17702,17371,3141,14230,1609,12621,1518,85,5434,590,6952,4994,3366,274,190,1238
CCAGAGCGTCCATTGG,sample,21355,21063,3500,17563,3148,14415,1778,89,6306,607,8084,5635,4044,394,213,2535
CCGCAACGTCCATTGG,sample,40360,39800,5694,34106,2124,31982,2403,78,14328,1381,16731,13792,6567,636,90,1071
ACCTCGAGTCCATTGG,sample,18680,18437,2702,15735,1573,14162,1040,44,6504,638,7544,5936,3965,288,34,1047
TGGACGAGTCCATTGG,sample,11325,11052,2264,8788,1264,7524,790,39,3368,385,4158,2942,2440,202,83,1055
GACGATAATCCATTGG,sample,28157,27633,5302,22331,3338,18993,1953,102,8343,815,10296,7780,4385,387,188,2938
GTCCTGCCTCCATTGG,sample,12036,11834,2461,9373,2322,7051,791,36,3096,349,3887,2779,2275,199,90,1426
CTAGGACCTCCATTGG,sample,9418,9214,1766,7448,3664,3784,1142,97,1178,114,2320,1253,908,196,265,1897
GTTAGGACTCCATTGG,sample,35027,34444,6087,28357,4039,24318,1918,98,10543,1077,12461,10682,4747,420,147,3003
GCCTGAACTCCATTGG,sample,9571,9308,1997,7311,3119,4192,773,39,1569,137,2342,1674,972,170,110,1676
TTGGCCTCTCCATTGG,sample,5729,5583,1493,4090,2929,1161,463,49,304,32,767,313,415,161,114,817
TTGGTTAATCCATTGG,sample,29096,28532,5451,23081,2534,20547,1544,86,9100,874,10644,8943,4433,352,88,1880
GGCATATATCCATTGG,Neg_Ctrl,388,248,130,118,15,103,10,5,37,5,47,46,42,8,1,5
TCAATATATCCATTGG,sample,11631,11462,2002,9460,2424,7036,1097,51,2845,285,3942,2758,1990,221,178,1669
CTTCATGATCCATTGG,sample,21570,21179,3673,17506,3172,14334,1681,69,6295,704,7976,5585,3381,291,79,2343
ATGACCGATCCATTGG,sample,14575,14377,1846,12531,1560,10971,930,45,4869,549,5799,4578,3102,285,81,1137
ACGTAAGTCATAGGCG,sample,92379,90330,25592,64738,37395,27343,6589,714,10639,896,17228,8505,3652,796,823,16846
AGTACCATCATAGGCG,sample,338212,334125,44560,289565,35911,253654,22438,1100,114330,12154,136768,103632,15005,3835,1290,27876
TTCTAATGCATAGGCG,sample,106922,105111,21340,83771,26594,57177,8204,402,24068,2273,32272,22230,5254,1103,491,20046
TGAGCGCGCATAGGCG,sample,134354,132664,25647,107017,24071,82946,9944,582,36509,3854,46453,32057,10244,1848,909,19591
GGACCTCTCATAGGCG,sample,20309,19931,2709,17222,6678,10544,1502,169,4304,453,5806,4116,3085,493,215,3932
CCGCAACGCATAGGCG,sample,112993,111034,21794,89240,16013,73227,7642,419,31792,3068,39434,30306,8732,1421,798,14228
GGACGTAGCATAGGCG,sample,28791,28153,5993,22160,15676,6484,3148,171,1696,130,4844,1339,1205,288,530,4551
GGCCAGAGCATAGGCG,sample,54618,53947,7115,46832,7231,39601,4956,258,16650,1629,21606,16108,6724,937,578,5179
CCATGAAGCATAGGCG,sample,58668,57766,10309,47457,10057,37400,4951,224,16363,1686,21314,14176,6195,771,552,7386
CTAGGACCCATAGGCG,sample,43797,42929,7718,35211,8668,26543,4360,303,10266,933,14626,10681,4650,712,680,6694
CGGATTACCATAGGCG,sample,49344,48481,9686,38795,17005,21790,6304,354,7308,762,13612,7062,2945,679,563,10049
ACGTATTACATAGGCG,sample,107461,105863,18703,87160,15854,71306,7019,461,30531,3031,37550,30264,8039,1167,752,12542
CCAATTCCCATAGGCG,sample,105437,104031,13815,90216,4715,85501,5817,258,38432,3852,44249,37142,9580,1280,271,2086
GTACCGTACATAGGCG,sample,61631,60793,9823,50970,7012,43958,4917,433,18768,1823,23685,18017,6657,904,1025,5639
TCGCCTGACATAGGCG,sample,73231,72339,9155,63184,6754,56430,6254,391,25358,2560,31612,21867,8323,1201,980,5394
ATTCTCTTTTGGAGAG,Pos_Ctrl,1892517,1857947,170632,1687315,182664,1504651,936415,74200,355460,48578,1291875,89998,7082,7597,21019,142189
GGTTGCGTTTGGAGAG,sample,322410,317251,50534,266717,25454,241263,15315,657,108598,10731,123913,105962,14343,3014,665,18577
ACGTAAGTTTGGAGAG,sample,285286,280722,41676,239046,11970,227076,14828,724,103410,9759,118238,98355,14465,3034,948,6176
CAACCGCGTTGGAGAG,sample,118552,116680,19877,96803,12100,84703,7874,365,37584,3419,45458,35461,9974,1518,588,11307
TTCCGTCTTTGGAGAG,Pos_Ctrl,693593,680605,75563,605042,79019,526023,321051,25230,135561,17089,456612,27092,5832,6027,9228,67646
CAAGGCCTTTGGAGAG,sample,236452,233043,35525,197518,22236,175282,12814,604,77212,7866,90026,76786,13543,2535,642,19403
GTTAGCCGTTGGAGAG,sample,224445,221255,33940,187315,21893,165422,14474,491,73082,6925,87556,70450,13291,2418,679,19718
ACGACTTCTTGGAGAG,sample,282189,279220,36213,243007,17613,225394,14079,555,100764,9582,114843,100414,14867,3046,246,10277
CTAGGACCTTGGAGAG,sample,112510,111018,15600,95418,13981,81437,9799,628,36483,3666,46282,30861,10138,1559,528,11938
GTTAGGACTTGGAGAG,sample,183689,181587,22797,158790,9408,149382,9637,421,67016,6410,76653,65898,12446,1971,612,4212
GAAGGCGCTTGGAGAG,sample,60580,59796,9307,50489,13214,37275,5096,304,16130,1778,21226,13967,6491,986,667,10101
TTGGTTAATTGGAGAG,sample,121486,119750,19699,100051,19685,80366,8448,371,38298,4041,46746,29208,8104,1648,473,17985
GTACCGTATTGGAGAG,sample,85605,84606,8974,75632,12471,63161,7930,419,28362,3038,36292,23412,8838,1531,355,10093
CTTCATGATTGGAGAG,sample,43125,42497,4501,37996,6684,31312,4386,259,13055,1445,17441,12167,6177,898,673,5410
TTATTCGATTGGAGAG,sample,14296,13946,8496,5450,3613,1837,774,54,536,42,1310,431,555,200,143,604
GACCGGAATTGGAGAG,sample,201711,200218,17819,182399,8892,173507,12441,564,79661,8317,92102,72524,16492,3483,306,3383
ACGTAAGTTTCAAGCC,sample,45341,44027,13332,30695,21203,9492,3633,186,2838,226,6471,2609,1835,404,552,6656
CCTCTAGATTCAAGCC,sample,162703,160561,20859,139702,17992,121710,11605,641,54923,5361,66528,49180,10993,2007,739,14227
AGTACCATTTCAAGCC,sample,238779,235188,36911,198277,11797,186480,13950,585,85530,8395,99480,78020,13636,2554,1120,6452
TAGTACGGTTCAAGCC,sample,39792,39087,10053,29034,13259,15775,3101,239,5534,465,8635,6436,2725,442,469,7866
TTAGAAGTTTCAAGCC,sample,21352,20778,4152,16626,6832,9794,2778,232,3328,357,6106,3099,2083,333,188,4059
TTCCGTCTTTCAAGCC,sample,100875,98881,16171,82710,5248,77462,5614,201,34706,3616,40320,33325,9091,1104,294,2664
GGACCTCTTTCAAGCC,sample,111967,110268,19346,90922,11535,79387,6600,385,35297,3536,41897,33569,9893,1229,525,8597
CAAGGCCTTTCAAGCC,sample,183729,181063,30086,150977,12718,138259,10049,459,61376,6102,71425,60273,13751,2056,540,8627
CATAACCTTTCAAGCC,sample,13945,13522,3046,10476,6583,3893,1811,208,939,104,2750,831,763,217,256,2464
CCAGAGCGTTCAAGCC,sample,38845,38221,7337,30884,6664,24220,2545,205,10850,1264,13395,9356,3674,533,251,4693
TGGACGAGTTCAAGCC,sample,32446,31815,5741,26074,8691,17383,2436,133,7189,668,9625,6957,2901,406,243,6106
GACGATAATTCAAGCC,sample,78966,77826,13748,64078,8434,55644,5073,242,24321,2474,29394,23534,8194,1113,282,6771
ACGACTTCTTCAAGCC,sample,14936,14504,3519,10985,5915,5070,1857,167,1491,161,3348,1394,1040,241,262,2829
TTGGCCTCTTCAAGCC,Pos_Ctrl,442190,437128,34228,402900,45973,356927,225338,19209,85190,9535,310528,17655,4957,5318,5328,36870
GTCTTAGCTTCAAGCC,sample,35458,34982,4406,30576,4165,26411,2322,192,11603,1162,13925,11132,5488,605,222,2775
CCAATTCCTTCAAGCC,sample,11643,11264,2001,9263,3724,5539,903,50,2237,222,3140,2127,1563,173,146,2140
TCAATATATTCAAGCC,sample,46532,45986,6373,39613,6636,32977,3709,206,14042,1507,17751,13513,6282,839,536,4850
TTATTCGATTCAAGCC,sample,6878,6677,1017,5660,3488,2172,833,92,648,74,1481,525,568,146,110,1297
ATGACCGATTCAAGCC,sample,4493,4369,577,3792,732,3060,278,24,1258,107,1536,1393,1072,134,38,446
TCCAACTTAACTTAAC,Neg_Ctrl,1217,594,424,170,32,138,18,1,53,5,71,61,65,5,1,6
TCCTCCGTAACTTAAC,sample,58744,57531,12110,45421,7209,38212,4084,233,17171,1704,21255,15020,6812,749,344,6010
AGTACCATAACTTAAC,sample,43642,42917,8652,34265,8175,26090,4119,166,11290,1118,15409,9397,4365,585,424,6467
ACGTTATGAACTTAAC,sample,150226,147036,26203,120833,7774,113059,8342,492,51313,4929,59655,47983,11125,1570,240,5065
TAGTACGGAACTTAAC,sample,119851,117665,20620,97045,9939,87106,6949,288,39084,3879,46033,36906,10501,1328,330,8431
GGACCTCTAACTTAAC,Neg_Ctrl,785,535,264,271,28,243,63,5,85,6,148,84,125,33,6,13
TCGCATCTAACTTAAC,sample,63503,62370,11109,51261,6805,44456,4254,274,21335,2366,25589,16227,7771,871,195,6272
CAAGGCCTAACTTAAC,sample,151722,149242,22417,126825,10088,116737,8199,266,52822,5013,61021,50437,11697,1591,221,8031
GTTAGCCGAACTTAAC,sample,38117,37421,6723,30698,5072,25626,3137,188,11162,1155,14299,9984,5126,644,283,4361
GGAGGACGAACTTAAC,sample,86302,85337,11981,73356,5059,68297,4740,219,30766,3121,35506,29451,9228,1112,330,2738
CCGCAACGAACTTAAC,sample,72645,71374,12187,59187,7826,51361,4016,282,22977,2340,26993,21746,7801,926,343,6569
GGCCAGAGAACTTAAC,sample,60235,59601,7332,52269,2983,49286,3483,191,22125,2061,25608,21426,7816,871,261,1197
CCATGAAGAACTTAAC,sample,55574,54909,7128,47781,6969,40812,3486,203,18404,1740,21890,16979,7163,726,339,5358
ACGACTTCAACTTAAC,sample,45720,45142,6964,38178,10822,27356,3786,199,11903,1140,15689,10328,5037,723,316,7476
AGTCCGCAAACTTAAC,sample,70883,69911,11546,58365,3332,55033,4016,172,24995,2626,29011,23224,8071,834,237,1342
GCCTGAACAACTTAAC,sample,39135,38561,8233,30328,8678,21650,3047,219,9025,880,12072,8479,5116,584,386,6417
TCAATATAAACTTAAC,sample,11196,11002,1395,9607,1847,7760,807,56,3476,346,4283,3075,2304,238,154,1257
TCGCCTGAAACTTAAC,sample,42220,41859,4305,37554,4091,33463,3311,207,14858,1660,18169,13427,7187,820,123,2948
AGGTCGGAAACTTAAC,sample,21843,21526,2906,18620,3467,15153,1569,90,6510,694,8079,6290,3591,413,146,2679
TTATTCGAAACTTAAC,sample,4752,4638,521,4117,241,3876,315,8,1755,192,2070,1606,1506,119,16,89
AAGTTCGTATACTTGA,sample,157627,155459,23852,131607,11369,120238,8628,499,52690,4944,61318,53477,10807,1614,708,7767
ACGTTATGATACTTGA,sample,44516,43644,12177,31467,18182,13285,3754,197,4400,390,8154,4544,2369,481,692,8020
TAGTACGGATACTTGA,sample,57566,56431,8917,47514,2894,44620,3376,157,19601,2107,22977,19379,7040,729,430,1459
TTAGAAGTATACTTGA,sample,46425,45568,10284,35284,11160,24124,4145,279,9760,918,13905,9022,4679,664,723,8252
GTTAGCCGATACTTGA,sample,49272,48504,9947,38557,12136,26421,3498,183,11064,1162,14562,10514,4424,657,394,8504
GGAGGACGATACTTGA,sample,33961,33405,5611,27794,7426,20368,2712,139,8820,812,11532,7885,4416,478,508,5169
AATCCGTCATACTTGA,sample,118363,116871,16163,100708,18640,82068,8939,507,34923,3567,43862,34132,8798,1574,950,15108
TTGGTACCATACTTGA,sample,90490,89485,15854,73631,16110,57521,7908,1105,24544,2572,32452,21392,9308,1476,878,13736
AATATATCATACTTGA,Neg_Ctrl,1037,555,359,196,28,168,40,2,72,8,112,46,103,18,5,5
TGCTTCGCATACTTGA,sample,136449,135245,16809,118436,13763,104673,10301,522,46944,4859,57245,42047,13856,2394,509,9598
GAAGGCGCATACTTGA,sample,196,191,45,146,37,109,24,4,43,3,67,35,56,14,9,25
ATGCCTGGATCCGCGA,sample,198847,196571,22722,173849,12399,161450,13645,852,71889,6670,85534,68394,12808,2495,825,7152
AATGGTAAATCCGCGA,sample,117091,115406,17463,97943,27825,70118,11397,342,29454,2948,40851,25977,7745,1283,1329,20369
GCCTTGCTATCCGCGA,sample,260237,257732,40236,217496,71833,145663,24017,1414,60597,6311,84614,53324,12499,3180,2827,49030
CATAACCTATCCGCGA,sample,171782,169726,25475,144251,33625,110626,10698,571,47657,4457,58355,47243,6917,1667,740,25643
GACGGAGAATCCGCGA,sample,139982,138072,19637,118435,20774,97661,10211,618,44286,4726,54497,37820,9650,2001,942,18663
CCGCAACGATCCGCGA,sample,384156,380841,68097,312744,30453,282291,26973,1034,126395,13471,153368,114418,19884,5382,1237,23825
ACGACTTCATCCGCGA,sample,238026,235376,32823,202553,25318,177235,14256,669,77174,7510,91430,77626,13254,2593,1106,19283
TTGGTACCATCCGCGA,sample,220658,218251,40116,178135,42990,135145,14098,1560,60206,6064,74304,53217,12080,2388,1758,35732
CTAGGACCATCCGCGA,sample,477763,473270,76724,396546,56973,339573,33449,1783,144397,13459,177846,146485,15898,4314,1176,36639
GTTAGGACATCCGCGA,sample,210645,208360,36290,172070,47426,124644,14802,949,53524,5324,68326,50045,11278,2288,2466,34389
TTGGCCTCATCCGCGA,sample,118874,117592,25463,92129,42776,49353,9202,937,18903,1849,28105,18462,7088,1397,973,24128
AATATATCATCCGCGA,sample,228660,226141,30405,195736,14913,180823,13463,624,80316,7808,93779,78612,13102,2625,739,8372
ACCAATGCATCCGCGA,sample,154205,152368,24705,127663,37623,90040,14527,767,37833,4284,52360,32629,9425,2273,1622,26966
AAGAGCGCATCCGCGA,sample,271636,268216,42069,226147,31726,194421,16927,597,87276,8408,104203,81213,13373,2879,843,25605
CCAATTCCATCCGCGA,sample,143635,141730,19480,122250,23831,98419,10701,595,45328,5265,56029,36530,9508,1922,1054,20234
GTACCGTAATCCGCGA,sample,57879,56921,9980,46941,20726,26215,4822,259,10983,1026,15805,9125,3024,755,926,11822
GGCATATAATCCGCGA,sample,102574,101196,14315,86881,8280,78601,6378,497,33961,3387,40339,34378,8667,1172,492,5659
TCGCCTGAATCCGCGA,sample,136544,134718,20837,113881,17002,96879,8926,406,42356,4397,51282,40794,9930,1657,834,13243
ATGACCGAATCCGCGA,sample,106644,105401,13462,91939,7173,84766,8092,459,38086,4001,46178,34128,10582,1715,847,4365
GACCGGAAATCCGCGA,sample,247324,244776,31218,213558,13560,199998,15773,731,89362,8741,105135,85391,13943,3204,821,5819
GGAGAGTTAGGACTCA,sample,165446,163782,19201,144581,11886,132695,9555,436,60902,6320,70457,55482,13148,2055,538,8956
TATCAGTTAGGACTCA,sample,139980,138271,19679,118592,12707,105885,8802,427,46688,4652,55490,45316,10343,1482,573,8513
ATTCTCTTAGGACTCA,sample,42726,41841,9134,32707,13336,19371,3710,354,8146,707,11856,6454,3282,679,587,8124
TCCAACTTAGGACTCA,sample,216771,213454,32087,181367,14877,166490,10329,434,74054,7083,84383,74590,12516,1972,646,11121
AAGTTCGTAGGACTCA,sample,91865,90520,12961,77559,8122,69437,7689,389,29547,3080,37236,28732,9428,1254,979,6520
TCCTCCGTAGGACTCA,sample,64823,63716,12769,50947,11586,39361,3857,228,15830,1480,19687,17966,5825,704,567,8718
ACGTAAGTAGGACTCA,sample,58646,57632,16816,40816,21635,19181,5521,311,6210,685,11731,6454,2719,556,615,11063
ATGCCTGGAGGACTCA,sample,83450,82320,13668,68652,13228,55424,7810,341,23286,2293,31096,21694,7666,1138,622,11145
TTAGAAGTAGGACTCA,sample,81813,80534,14342,66192,8981,57211,4750,292,24717,2286,29467,25166,7473,887,687,7088
TTCCGTCTAGGACTCA,sample,73691,72594,15676,56918,14880,42038,5315,284,17724,1706,23039,17009,6825,838,538,11871
CATAACCTAGGACTCA,sample,66325,65470,10031,55439,12128,43311,4385,243,19022,1573,23407,18088,6383,867,320,9913
TGGACGAGAGGACTCA,sample,25148,24623,5926,18697,11465,7232,2162,133,3028,328,5190,1581,1338,313,343,4538
ACGACTTCAGGACTCA,sample,93697,92528,14278,78250,7144,71106,5746,366,30213,2669,35959,32112,8079,1116,381,4401
TTGGTACCAGGACTCA,sample,99663,98422,13320,85102,9425,75677,6125,276,34403,3414,40528,31459,9687,1256,364,7302
AATATATCAGGACTCA,sample,103361,102045,16253,85792,8589,77203,6378,353,34877,3388,41255,32207,9666,1195,357,5728
ACCAATGCAGGACTCA,sample,177417,174977,30541,144436,14543,129893,11371,504,59085,5825,70456,53108,12961,1852,251,9819
GAAGGCGCAGGACTCA,sample,17786,17384,3643,13741,8970,4771,1235,81,1646,168,2881,1641,1183,250,203,3052
CCAATTCCAGGACTCA,sample,11996,11665,2462,9203,6094,3109,846,32,1130,175,1976,926,808,168,176,2023
TCGCCTGAAGGACTCA,sample,76528,75640,13234,62406,14937,47469,3850,331,20901,2127,24751,20260,7477,795,404,11183
CTTCATGAAGGACTCA,sample,42957,42239,6082,36157,4847,31310,3746,280,14503,1415,18249,11366,4899,682,171,4436
AGGTCGGAAGGACTCA,Pos_Ctrl,719494,711486,54895,656591,68792,587799,359045,28579,148786,18893,507831,32496,5613,5994,8817,55605
AAGTTCGTTATTGAAC,sample,69453,68657,6745,61912,6655,55257,4012,223,24441,2363,28453,24218,6989,1082,325,4459
GGTTGCGTTATTGAAC,sample,77974,76988,10803,66185,12474,53711,4703,281,22482,2247,27185,23998,7056,1078,470,9324
TCCTCCGTTATTGAAC,sample,116858,114923,16101,98822,15524,83298,8865,592,36052,3705,44917,34084,9596,1920,1520,12944
ACGTAAGTTATTGAAC,sample,259502,256218,41690,214528,42728,171800,16412,815,75237,7237,91649,72099,12520,2940,2109,34497
AGTACCATTATTGAAC,sample,169900,167573,23474,144099,19824,124275,11732,577,55564,5528,67296,50874,10324,2044,948,15919
TTCTAATGTATTGAAC,sample,207887,205185,33679,171506,25366,146140,13791,771,65274,6185,79065,60119,13396,2746,1230,23133
CAACCGCGTATTGAAC,sample,103506,102107,14827,87280,13569,73711,6660,392,33855,3701,40515,29103,10052,1486,848,10887
AATGGTAATATTGAAC,sample,139008,137486,18477,119009,15045,103964,9285,484,45690,4749,54975,43756,10034,1689,696,10313
TCGCATCTTATTGAAC,sample,155252,152928,20135,132793,13345,119448,12030,962,52139,5236,64169,49081,11856,2379,1384,10368
GCCTTGCTTATTGAAC,sample,48761,47515,7063,40452,10530,29922,4004,241,12709,1168,16713,11800,5186,761,543,7591
GTTAGCCGTATTGAAC,sample,282869,279058,38480,240578,18680,221898,14607,629,95594,9309,110201,101759,14227,3015,802,10850
ACCTCGAGTATTGAAC,sample,249686,246991,29457,217534,27424,190110,14795,1241,82190,8079,96985,83805,12742,3031,936,19885
CGAGGCAGTATTGAAC,sample,92715,91210,12317,78893,23583,55310,8389,493,23061,2299,31450,21068,5660,1228,1007,16659
CCATGAAGTATTGAAC,sample,67676,66459,10563,55896,21071,34825,4915,468,14325,1572,19240,13545,5237,964,1092,13418
ACGACTTCTATTGAAC,sample,376913,373014,44480,328534,15157,313377,19880,743,141980,14708,161860,136066,17855,4262,335,5515
GTCCTGCCTATTGAAC,sample,157514,155862,17098,138764,10112,128652,8778,417,59645,5945,68423,53867,12577,2070,335,5969
CTAGGACCTATTGAAC,sample,506315,500914,60229,440685,21260,419425,26380,965,188472,18971,214852,184637,18936,5021,1000,7717
AACTCGTATATTGAAC,sample,97005,95792,10674,85118,12412,72706,7991,625,31985,3150,39976,28955,6103,1207,474,11000
AAGAGCGCTATTGAAC,sample,50522,49177,11225,37952,16194,21758,5477,486,7843,829,13320,7123,4437,729,1595,9838
GGCATATATATTGAAC,sample,184723,182397,21909,160488,16441,144047,10367,475,65243,6579,75610,61383,12092,2314,1008,11869
TCAATATATATTGAAC,sample,68421,67114,9954,57160,13495,43665,6206,475,18537,1982,24743,16465,6506,973,1285,9846
CTTCATGATATTGAAC,sample,113227,111954,10482,101472,13782,87690,6798,288,39310,4032,46108,37262,11177,2117,289,9032
AGGTCGGATATTGAAC,sample,66848,65667,7773,57894,8714,49180,4370,338,21497,2147,25867,20828,7701,1337,408,5960
ATGACCGATATTGAAC,sample,89639,88295,9367,78928,18119,60809,7727,533,26029,2514,33756,24006,7159,1625,679,13013
ATTCTCTTGTTCAACT,sample,22802,22392,5733,16659,9894,6765,2436,320,1987,170,4423,1852,1236,320,267,4194
TCCAACTTGTTCAACT,sample,38616,37879,6584,31295,4909,26386,2727,118,11480,1318,14207,10743,5033,540,372,4422
GGTTGCGTGTTCAACT,sample,41103,40156,8009,32147,3768,28379,2889,169,11836,1150,14725,12335,5306,491,384,2398
TAGTACGGGTTCAACT,sample,51498,50498,8721,41777,4707,37070,3292,174,16064,1539,19356,16001,6221,646,255,3562
TTCCGTCTGTTCAACT,sample,46372,45441,12082,33359,9987,23372,2344,224,9376,908,11720,10520,4033,427,296,7532
TCGCATCTGTTCAACT,sample,36846,36092,6942,29150,4036,25114,2781,252,10993,1123,13774,9965,5081,521,299,2965
GACGGAGAGTTCAACT,sample,15748,15380,2870,12510,4623,7887,1132,55,3388,285,4520,3027,1750,265,182,2933
GGAGGACGGTTCAACT,sample,44818,44313,7027,37286,4526,32760,2753,133,14538,1506,17291,13830,6363,591,137,3429
ACCTCGAGGTTCAACT,sample,14316,14044,1982,12062,933,11129,719,32,4997,417,5716,4964,2949,210,91,553
CGAGGCAGGTTCAACT,sample,33190,32712,6040,26672,9114,17558,2429,104,7688,745,10117,6592,4091,378,143,6152
CCATGAAGGTTCAACT,sample,23222,22926,5317,17609,10004,7605,1715,117,2847,322,4562,2604,1979,339,394,4522
AGTCCGCAGTTCAACT,sample,29961,29613,4170,25443,2007,23436,1312,74,10800,1018,12112,10232,4799,321,55,1122
ACGTATTAGTTCAACT,sample,35105,34600,5753,28847,3320,25527,1776,77,11493,1113,13269,11068,4987,403,165,2200
TGCTTCGCGTTCAACT,sample,49113,48348,7520,40828,2334,38494,2602,103,17302,1754,19904,16733,6599,585,122,850
TTATTCGAGTTCAACT,Neg_Ctrl,561,355,116,239,22,217,99,13,56,4,155,45,122,63,10,9
GGAGAGTTCTGAGGTT,sample,285291,281836,35088,246748,30081,216667,24545,1134,93179,8846,117724,88963,14758,3889,1980,23443
TTCGTAATCTGAGGTT,sample,543907,537879,66580,471299,43827,427472,34399,2451,191539,19553,225938,179530,17926,5492,1976,30692
ACGTTATGCTGAGGTT,sample,190862,187631,32880,154751,31596,123155,15336,750,53049,5224,68385,48796,11706,2332,1951,25320
TAGTACGGCTGAGGTT,sample,172408,169909,31433,138476,30748,107728,11238,516,47729,4860,58967,43385,11309,1773,1135,26317
GGACCTCTCTGAGGTT,sample,197809,195280,37694,157586,38910,118676,10872,744,51192,4987,62064,50881,10311,2152,1226,33146
CATAACCTCTGAGGTT,sample,171016,168636,25664,142972,29042,113930,12302,701,48269,5093,60571,47565,9282,2070,1617,20632
GACGGAGACTGAGGTT,sample,193625,191422,23242,168180,18112,150068,12718,749,68126,6917,80844,61558,13475,2782,1265,13130
CCAGAGCGCTGAGGTT,sample,45945,44785,6650,38135,5548,32587,2814,220,14442,1552,17256,13559,6074,768,593,4193
CCGCAACGCTGAGGTT,sample,81867,79752,12951,66801,11365,55436,5415,436,23503,2248,28918,23834,7255,1240,906,9729
GGACGTAGCTGAGGTT,sample,225302,222941,28918,194023,38768,155255,17795,1043,67612,6775,85407,62030,12510,3142,1435,28784
CTTGATAGCTGAGGTT,sample,226463,223460,33139,190321,35458,154863,16816,778,69090,7990,85906,60189,11506,2851,1102,29671
GGCCAGAGCTGAGGTT,sample,109693,108271,15176,93095,21329,71766,8609,659,31159,3237,39768,28102,9830,1888,1642,16649
CATTGCAGCTGAGGTT,sample,173028,170878,24660,146218,31802,114416,9401,498,51130,4867,60531,48520,9191,1882,833,25057
ACGACTTCCTGAGGTT,sample,150166,147990,20444,127546,17851,109695,12306,727,49880,5558,62186,41224,9706,2063,912,15839
AATATATCCTGAGGTT,sample,402668,399066,50950,348116,49702,298414,30895,1831,130920,13932,161815,120836,17961,5511,3288,38167
AAGTTCGTAGACCGTT,sample,314337,310226,44144,266082,27751,238331,16440,779,107575,10802,124015,102735,14743,3055,955,20901
TCCTCCGTAGACCGTT,sample,125878,123649,22541,101108,24184,76924,8218,614,34005,3154,42223,30933,8664,1377,1592,18215
ACGTTATGAGACCGTT,sample,164697,162344,22315,140029,14481,125548,12088,653,56714,5802,68802,50291,12247,2460,940,10357
ATGCCTGGAGACCGTT,sample,63687,62349,14422,47927,26969,20958,4019,242,7879,936,11898,7882,2889,665,609,11524
TAGTACGGAGACCGTT,sample,163395,161170,37554,123616,42053,81563,15927,913,37142,4698,53069,22883,8121,2621,1134,28971
CCAGAGCGAGACCGTT,sample,307490,304476,34122,270354,32072,238282,19039,841,109504,10899,128543,97999,14566,3950,1041,27497
CCGCAACGAGACCGTT,sample,63167,61404,10621,50783,14677,36106,5751,376,13937,1436,19688,14606,4399,1062,978,10932
CTTGATAGAGACCGTT,sample,351781,348178,44181,303997,44007,259990,19010,1177,115881,12846,134891,111076,15796,4177,1688,35098
TGGACGAGAGACCGTT,sample,94333,92939,14634,78305,30352,47953,8114,324,19399,2183,27513,17933,5124,1192,789,17953
CGTACGTCAGACCGTT,sample,94379,93108,10408,82700,13452,69248,6381,279,31384,3208,37765,27996,9838,1671,461,9812
CGTATGAAAGACCGTT,sample,101299,99420,14612,84808,11143,73665,8170,377,30659,2965,38829,31494,8393,1477,817,8449
AATATATCAGACCGTT,sample,141858,140056,22977,117079,49327,67752,15463,1626,26925,3294,42388,20444,5688,1808,2453,29912
GGAGAGTTCTTGAGTT,sample,29662,28500,4285,24215,18540,5675,2160,202,1554,240,3714,1519,1346,408,427,4096
TATCAGTTCTTGAGTT,sample,72765,71069,11685,59384,35905,23479,8455,391,7460,687,15915,6486,3064,777,1329,13930
TCCAACTTCTTGAGTT,sample,115721,113519,26758,86761,55298,31463,14386,568,7578,997,21964,7934,3271,867,1427,20973
AAGTTCGTCTTGAGTT,sample,348542,344681,45731,298950,51622,247328,28718,1240,105478,10552,134196,101340,12445,4152,1384,41600
CCTCTAGACTTGAGTT,sample,57140,55631,8339,47292,27542,19750,7069,555,6118,582,13187,5426,2717,720,1543,11328
ACGTTATGCTTGAGTT,sample,279200,275778,51010,224768,75984,148784,20385,1473,63452,6076,83837,57398,11412,2894,2804,54573
AATGGTAACTTGAGTT,sample,470415,465039,62193,402846,36885,365961,28373,1506,164595,16522,192968,154965,16348,4661,1756,25873
GGACCTCTCTTGAGTT,sample,838103,830220,95130,735090,53202,681888,47479,2115,306088,30630,353567,295576,21965,8307,1978,35389
CAAGGCCTCTTGAGTT,sample,790346,780866,100690,680176,42194,637982,40791,1570,287380,27484,328171,280757,21554,7273,1842,22074
ACTATACTCTTGAGTT,sample,421069,416147,51046,365101,24179,340922,25273,1072,152600,15393,177873,146584,17783,4924,1341,17489
CTTGATAGCTTGAGTT,sample,90547,88493,23730,64763,40869,23894,4888,299,9348,921,14236,8438,3424,738,840,15115
GACGATAACTTGAGTT,sample,168900,166185,31630,134555,41137,93418,17708,964,36998,3486,54706,34262,8711,2010,1448,31678
ACGACTTCCTTGAGTT,sample,457344,452755,56154,396601,34933,361668,25898,1749,161892,16012,187790,156117,17729,5344,2179,27305
ACGTATTACTTGAGTT,sample,536612,530827,78198,452629,78235,374394,29696,1281,163230,15650,192926,164537,15756,4494,1723,60651
CGTATGAACTTGAGTT,sample,279230,275287,43034,232253,27873,204380,20168,798,89359,9377,109527,84678,12644,3097,1654,23953
TGCTTCGCCTTGAGTT,sample,254606,251700,38762,212938,43924,169014,21570,1068,72376,7927,93946,66073,11596,2683,1258,37892
TCGCCTGACTTGAGTT,sample,228026,225446,33466,191980,47255,144725,18021,975,62192,6395,80213,57142,11770,2673,1731,35356
TTCGTAATTCGGAGTT,sample,173890,172141,21195,150946,7502,143444,8981,360,65308,6519,74289,62276,12908,2012,417,2280
TTCTAATGTCGGAGTT,sample,53772,52906,10230,42676,10459,32217,2948,225,13848,1333,16796,13863,5761,703,454,7960
ATGCCTGGTCGGAGTT,sample,55380,54478,8270,46208,6409,39799,3742,206,18421,1893,22163,15537,6468,785,336,5337
TGAGCGCGTCGGAGTT,sample,60461,59366,9257,50109,5175,44934,5180,234,19021,1863,24201,18636,6334,919,359,4057
TCGCATCTTCGGAGTT,sample,57405,56288,11137,45151,9555,35596,3619,142,15279,1549,18898,15007,6223,731,292,7752
CCAGAGCGTCGGAGTT,sample,70700,69723,10228,59495,9773,49722,3975,216,21086,2118,25061,22327,7185,929,477,7582
CCGCAACGTCGGAGTT,sample,97832,96622,16631,79991,10543,69448,4794,253,29717,2888,34511,31796,9046,1161,382,7687
GGACGTAGTCGGAGTT,sample,49517,48763,6452,42311,3664,38647,3858,233,16682,1724,20540,16150,6720,809,402,2388
CTTGATAGTCGGAGTT,sample,13878,13626,3501,10125,4566,5559,1480,137,1956,212,3436,1774,1564,217,201,2607
CATTGCAGTCGGAGTT,sample,23403,22879,4573,18306,9961,8345,3340,384,2263,244,5603,2114,1699,321,1202,4645
CCATGAAGTCGGAGTT,sample,35201,34566,6133,28433,6337,22096,2125,132,9268,865,11393,9706,4628,493,421,4633
ACGACTTCTCGGAGTT,sample,94358,93101,13886,79215,8652,70563,5596,334,31162,3095,36758,30376,9056,1200,510,5849
CGGATTACTCGGAGTT,sample,23693,23190,5470,17720,9659,8061,1691,132,3128,273,4819,2837,1763,284,294,4500
GTTAGGACTCGGAGTT,sample,59491,58656,7587,51069,5596,45473,3789,298,20727,2086,24516,18573,7560,874,563,4206
ACGTATTATCGGAGTT,sample,82727,81433,12347,69086,5397,63689,5049,227,29455,3185,34504,25773,8060,1063,323,3305
TTGGCCTCTCGGAGTT,Pos_Ctrl,998841,990794,44625,946169,85261,860908,535365,47705,199879,25004,735244,52955,5812,6498,10807,58455
GGAGAGTTTGAACCTT,sample,124983,123692,14329,109363,23822,85541,10817,490,35865,3567,46682,34802,8677,2051,778,16090
TATCAGTTTGAACCTT,sample,161780,160046,19047,140999,17789,123210,11164,675,52125,5396,63289,53850,11553,2263,1940,12419
ATTCTCTTTGAACCTT,Pos_Ctrl,1024272,1016763,55972,960791,128137,832654,537761,53040,179547,22770,717308,39536,6522,7363,10869,98586
TTCGTAATTGAACCTT,sample,129909,128024,21778,106246,10684,95562,8806,595,42267,4341,51073,39553,10724,1884,1446,7281
ATGCCTGGTGAACCTT,sample,62313,60959,15618,45341,27959,17382,4930,382,5801,490,10731,5779,2764,704,1152,11072
TAGTACGGTGAACCTT,Pos_Ctrl,1462613,1442437,128873,1313564,151901,1161663,720526,59377,273438,34101,993964,74221,6769,7338,17370,128828
GGACCTCTTGAACCTT,sample,380058,375663,55908,319755,48124,271631,23859,968,121664,11867,145523,113273,15752,3993,1104,41532
TCGCATCTTGAACCTT,sample,321140,317276,49263,268013,35758,232255,19439,817,104315,10809,123754,96875,14768,3771,950,28451
CAAGGCCTTGAACCTT,sample,334895,329986,54300,275686,47803,227883,21064,1651,102763,10250,123827,92155,15018,3727,835,42910
GGAGGACGTGAACCTT,sample,163224,161212,25101,136111,30900,105211,11855,725,43037,4054,54892,45540,10290,1882,1978,23840
CCGCAACGTGAACCTT,Pos_Ctrl,1032756,1020163,83318,936845,110232,826613,514701,41700,198595,22527,713296,49090,6269,6764,9685,96135
GGACGTAGTGAACCTT,sample,184060,181936,24743,157193,25075,132118,11001,778,57010,5676,68011,57653,10890,2292,1186,17717
CATTGCAGTGAACCTT,sample,106448,105078,14563,90515,21442,69073,6105,323,30812,3171,36917,28662,9630,1550,497,15230
CGAGGCAGTGAACCTT,sample,71133,69801,14098,55703,34581,21122,6581,380,6631,1558,13212,5972,3445,910,1300,13120
CATGATTCTGAACCTT,sample,185328,183295,33421,149874,36475,113399,14628,1183,47886,4884,62514,44818,12944,2602,1025,29869
AATCCGTCTGAACCTT,Pos_Ctrl,1110106,1100433,60631,1039802,112176,927626,578739,50975,208898,29654,787637,59360,6214,6916,12838,85248
CGTACGTCTGAACCTT,sample,161483,159528,21209,138319,26380,111939,12915,595,45970,4667,58885,47792,7154,1853,863,21313
AGTCCGCATGAACCTT,sample,306311,303698,28791,274907,23030,251877,20442,1267,114157,11711,134599,104300,16063,4374,1338,15943
TTGGTACCTGAACCTT,sample,68806,67535,17049,50486,36820,13666,5538,551,3714,365,9252,3498,2402,708,844,9977
GTTAGGACTGAACCTT,sample,152183,150563,20312,130251,35508,94743,11635,872,40519,4113,52154,37604,10200,2251,1980,25429
TGCTTCGCTGAACCTT,sample,110816,109395,17659,91736,26524,65212,10642,2835,25017,2890,35659,23828,6307,1528,941,18305
AAGAGCGCTGAACCTT,sample,78321,76806,10675,66131,8146,57985,7025,602,24876,2407,31901,23075,7636,1321,1533,6975
GTACCGTATGAACCTT,Pos_Ctrl,1125723,1116485,56795,1059690,99336,960354,594424,50178,227220,37858,821644,50674,6173,6919,11689,75003
TCAATATATGAACCTT,sample,781174,774323,94213,680110,49465,630645,52066,2553,288100,29579,340166,258347,25681,9552,1159,30460
TCGCCTGATGAACCTT,sample,113475,111873,21221,90652,40563,50089,9873,689,19336,2130,29209,18061,6203,1173,1309,22630
GACCGGAATGAACCTT,sample,136899,135057,15481,119576,14286,105290,7900,433,46769,4423,54669,45765,10142,1799,814,9233
ATTCTCTTACCGAATT,sample,377060,373051,46613,326438,43694,282744,20196,1161,124739,11614,144935,125034,13015,3982,832,33137
AAGTTCGTACCGAATT,sample,743049,735520,84156,651364,51316,600048,41710,1751,270729,27166,312439,258692,19171,7044,1554,44523
ACGTTATGACCGAATT,sample,293494,290167,52447,237720,65385,172335,19846,1133,76095,7571,95941,67690,13219,3359,2632,50183
TGAGCGCGACCGAATT,sample,513747,509143,59106,450037,55726,394311,34933,2218,179532,19087,214465,158541,20244,6991,2253,48145
TCGCATCTACCGAATT,sample,304528,300076,45100,254976,29924,225052,18499,835,101761,10043,120260,93914,15142,3388,1811,26848
ACTATACTACCGAATT,sample,143878,141181,36007,105174,56260,48914,9172,441,20111,1831,29283,17359,5448,1142,1458,27993
CCAGAGCGACCGAATT,sample,1008148,999203,110356,888847,63856,824991,50114,2229,371480,37099,421594,364069,23913,9419,1095,42074
GTTAGCCGACCGAATT,sample,249752,246626,39417,207209,35289,171920,23141,1761,75692,7656,98833,63670,12969,2957,1488,32011
ACCTCGAGACCGAATT,sample,107135,105435,11709,93726,26230,67496,7960,376,26278,2650,34238,30232,4084,1060,849,18696
CGAGGCAGACCGAATT,sample,148902,146624,25800,120824,36873,83951,12406,843,36519,3660,48925,30523,7564,1964,2108,25915
ACGACTTCACCGAATT,sample,31844,30322,7876,22446,7386,15060,4301,318,4924,506,9225,5011,3130,570,1187,5383
CATGATTCACCGAATT,sample,584426,578751,68408,510343,50561,459782,35570,1379,203262,20650,238832,198921,15492,6095,1531,43495
AGTCCGCAACCGAATT,sample,203501,200857,26472,174385,20464,153921,12460,534,69046,6854,81506,65027,11990,2477,931,15145
CTAGGACCACCGAATT,sample,316046,312302,38999,273303,24396,248907,18367,1081,111906,11172,130273,106381,15470,3843,2266,15880
TTGGCCTCACCGAATT,sample,318421,314898,36524,278374,12474,265900,18233,755,121125,12181,139358,113606,15237,3592,731,3456
AATATATCACCGAATT,Neg_Ctrl,2202,1260,617,643,79,564,77,13,241,23,318,210,267,28,15,24
TGCTTCGCACCGAATT,sample,260629,257485,31406,226079,15950,210129,16968,995,92745,9591,109713,89830,14411,3520,1786,9897
TTGGTTAAACCGAATT,sample,472245,467667,64358,403309,65325,337984,27009,1712,149412,14886,176421,144965,15649,4875,1259,50224
TCAATATAACCGAATT,sample,252617,249960,39132,210828,61199,149629,17517,1237,63809,8979,81326,58087,11032,2824,1823,39591
GGAGAGTTGGTCTGGT,sample,86861,85941,9796,76145,16458,59687,7353,377,26050,2545,33403,23362,9475,1837,657,11340
TCCAACTTGGTCTGGT,Neg_Ctrl,1665,827,543,284,42,242,36,1,113,7,149,85,129,17,8,8
GGTTGCGTGGTCTGGT,sample,347188,342812,43506,299306,30894,268412,17903,900,121111,12608,139014,115890,15049,3522,1286,28236
TCCTCCGTGGTCTGGT,sample,229792,226825,45772,181053,49005,132048,14199,889,56724,5862,70923,54374,9914,2068,2474,39376
CCTCTAGAGGTCTGGT,sample,74069,73107,10656,62451,17669,44782,7194,294,17416,1870,24610,18008,6295,975,751,12570
AGTACCATGGTCTGGT,sample,114565,112971,17827,95144,19076,76068,6749,411,33363,3048,40112,32497,8043,1232,875,15449
TTCGTAATGGTCTGGT,sample,165030,163166,26770,136396,30260,106136,8911,441,45892,4784,54803,46108,8557,1592,768,22872
ACGTTATGGGTCTGGT,sample,96683,95049,15985,79064,12853,66211,6789,510,28711,2861,35500,27340,8590,1238,1264,11480
TGAGCGCGGGTCTGGT,Neg_Ctrl,1387,765,510,255,39,216,36,2,87,18,123,73,110,15,6,11
GTTAGCCGGGTCTGGT,sample,131309,129286,18415,110871,12927,97944,8356,481,43533,4591,51889,40983,7320,1479,519,12194
GGACGTAGGGTCTGGT,Neg_Ctrl,1334,735,373,362,44,318,36,1,135,20,171,126,156,16,2,10
CTTGATAGGGTCTGGT,sample,343026,338521,47673,290848,34221,256627,19988,1247,113449,11392,133437,110551,15759,3740,1083,26047
CATTGCAGGGTCTGGT,sample,140496,139120,15480,123640,11904,111736,9968,422,50274,5159,60242,45913,11107,1858,768,9050
CGAGGCAGGGTCTGGT,sample,16863,16203,2756,13447,1352,12095,1168,104,5186,489,6354,5148,3067,319,324,984
CGTACGTCGGTCTGGT,Neg_Ctrl,1212,557,386,171,20,151,17,1,66,7,83,60,72,4,6,4
TTGGTACCGGTCTGGT,sample,111101,109684,18189,91495,19611,71884,8077,389,30389,2860,38466,30169,7957,1284,947,17280
AACTCGTAGGTCTGGT,sample,243735,241386,26666,214720,13356,201364,13635,503,90288,9251,103923,87687,14110,2755,394,5799
AATATATCGGTCTGGT,sample,273762,270920,29869,241051,14194,226857,16787,819,103258,10643,120045,95350,15812,3381,645,8938
AAGAGCGCGGTCTGGT,sample,49655,48837,12775,36062,25014,11048,4383,327,3283,459,7666,2596,1941,511,777,7841
TTGGTTAAGGTCTGGT,sample,206075,203387,26672,176715,16437,160278,15079,883,70639,7035,85718,66642,12399,2388,449,12597
GGCATATAGGTCTGGT,Neg_Ctrl,1191,614,359,255,28,227,38,3,90,13,128,83,106,18,6,8
TCAATATAGGTCTGGT,sample,181561,179533,23716,155817,17810,138007,11775,722,63578,6482,75353,55450,12250,2222,1020,13110
TTATTCGAGGTCTGGT,sample,105076,104182,9100,95082,18291,76791,8130,665,33278,3558,41408,31160,10458,1780,981,13453
TCCAACTTCGACGTTA,sample,348128,342643,49928,292715,35841,256874,30971,1245,110716,11235,141687,102707,14601,3997,1734,33881
AGTACCATCGACGTTA,sample,611423,605969,110308,495661,105412,390249,43899,2312,171956,18569,215855,153513,15439,6042,2876,82810
TAGTACGGCGACGTTA,sample,354856,351023,72507,278516,67809,210707,19215,1834,92601,9405,111816,87652,14493,3476,1740,56701
TGAGCGCGCGACGTTA,sample,86328,85163,22459,62704,35413,27291,8968,516,9401,732,18369,7674,3433,790,1138,16560
GACGGAGACGACGTTA,sample,146144,144413,26767,117646,23350,94296,12073,494,37630,4349,49703,39750,8583,1591,1097,17793
CCAGAGCGCGACGTTA,sample,74069,72787,18653,54134,40586,13548,5267,593,3965,288,9232,3435,1976,472,1073,10230
GGACGTAGCGACGTTA,sample,196628,194661,26610,168051,31466,136585,16697,770,55509,5431,72206,58178,10843,2216,727,24394
GTCCTGCCCGACGTTA,sample,173585,171974,16714,155260,17051,138209,12721,830,60889,6025,73610,57744,12651,2697,1441,12217
CTAGGACCCGACGTTA,sample,74877,73852,10676,63176,21083,42093,6141,372,17755,1844,23896,15981,6323,1156,574,14332
ACGTATTACGACGTTA,sample,142081,140402,17904,122498,12357,110141,10430,542,47619,4377,58049,47173,10684,2031,944,9648
AAGAGCGCCGACGTTA,sample,191736,189648,20053,169595,20253,149342,13998,711,65589,6851,79587,62193,10616,2556,858,16278
GGCATATACGACGTTA,sample,299081,296951,28346,268605,33863,234742,24318,1492,105641,11232,129959,92059,19410,5962,429,23638
TCGCCTGACGACGTTA,sample,49403,48007,6273,41734,2878,38856,2519,107,17811,1775,20330,16644,6674,878,188,1080
TTATTCGACGACGTTA,sample,20638,19927,2077,17850,2798,15052,1391,103,6384,747,7775,6427,3937,511,132,1791
TCCAACTTTACTAAGT,sample,85417,84101,16534,67567,17849,49718,5208,254,21441,2201,26649,20614,6472,843,320,13433
GGTTGCGTTACTAAGT,sample,82945,81650,21679,59971,28595,31376,6302,594,11469,1040,17771,11971,4641,833,919,15979
ACGTAAGTTACTAAGT,sample,141246,138791,21457,117334,8673,108661,7441,353,48178,4570,55619,48119,9658,1464,479,5867
TTCGTAATTACTAAGT,sample,162905,160243,26718,133525,9245,124280,9385,357,56103,5333,65488,53102,12237,1783,280,5033
ATGCCTGGTACTAAGT,sample,38097,37345,7166,30179,5629,24550,3229,149,10818,1225,14047,9129,4891,558,234,5408
TGAGCGCGTACTAAGT,sample,102977,101137,16280,84857,6547,78310,5439,289,35243,3403,40682,33936,9674,1130,259,4126
TTCCGTCTTACTAAGT,sample,92579,91214,18117,73097,15083,58014,5971,314,25695,2615,31666,23419,8454,1067,496,13482
GCCTTGCTTACTAAGT,sample,50862,50181,8093,42088,10506,31582,3678,232,13886,1319,17564,12467,5015,731,538,7870
CATAACCTTACTAAGT,sample,46074,45357,8838,36519,12965,23554,3977,354,9176,1370,13153,8677,4036,685,530,8375
AGTCCGCATACTAAGT,sample,9305,9132,1991,7141,3510,3631,651,58,1569,115,2220,1238,1038,150,145,1836
GCCTGAACTACTAAGT,sample,28195,27772,4360,23412,7034,16378,1837,69,7265,851,9102,6356,2979,405,215,5144
GTCTTAGCTACTAAGT,sample,21757,21473,2940,18533,2700,15833,1685,85,7133,730,8818,6200,4021,392,137,1785
CCAATTCCTACTAAGT,sample,20771,20422,3055,17367,6816,10551,2341,250,3882,370,6223,3708,2136,326,1195,4217
TTGGTTAATACTAAGT,sample,76490,75413,12742,62671,7487,55184,4082,192,24076,2258,28158,24576,7980,806,378,5667
GGCATATATACTAAGT,sample,46187,45619,6201,39418,8503,30915,3432,387,13927,1217,17359,11952,5260,643,226,6566
TCGCCTGATACTAAGT,sample,67842,67034,9270,57764,6828,50936,4148,197,22775,2252,26923,21564,6796,798,181,5455
CTTCATGATACTAAGT,sample,60821,60074,8007,52067,3803,48264,4058,189,22427,2469,26485,19121,7143,915,126,2292
GACCGGAATACTAAGT,sample,18115,17613,2986,14627,9072,5555,2732,307,1314,103,4046,1099,1102,305,1046,3384
TCCTCCGTTTGCCGCT,sample,603054,595292,75374,519918,40323,479595,31863,1318,215004,20878,246867,210532,19455,5640,1230,29543
CCTCTAGATTGCCGCT,sample,102797,101075,15209,85866,14474,71392,9045,536,29071,2851,38116,29889,7914,1438,1125,11287
AGTACCATTTGCCGCT,sample,87706,86088,20081,66007,41948,24059,6315,568,8553,765,14868,7858,3157,781,1706,15450
TTCGTAATTTGCCGCT,sample,333272,329422,42578,286844,44649,242195,20543,786,105531,10755,126074,104580,13671,3560,1035,32308
TTAGAAGTTTGCCGCT,sample,231015,228653,39262,189391,48091,141300,13484,755,60997,6392,74481,59672,12515,2305,1058,39790
GCCTTGCTTTGCCGCT,sample,44055,43200,7596,35604,24070,11534,4679,212,3547,340,8226,2756,1901,491,578,7737
CCAGAGCGTTGCCGCT,sample,199976,197359,26473,170886,14913,155973,12441,719,70327,7325,82768,65161,13570,2479,846,11510
GGAGGACGTTGCCGCT,sample,105281,103868,17530,86338,38677,47661,12878,629,17077,1774,29955,15303,4367,1057,724,21947
CTTGATAGTTGCCGCT,sample,182698,180003,33232,146771,39167,107604,10591,1968,48509,5271,59100,41265,9711,1994,958,29494
GACGATAATTGCCGCT,sample,235562,232902,40281,192621,35313,157308,16176,1240,70868,7338,87044,61686,14282,3089,1102,31099
ACGACTTCTTGCCGCT,sample,329060,325897,41761,284136,28528,255608,20223,883,110618,10775,130841,113109,15607,3900,1353,19732
CATGATTCTTGCCGCT,sample,428175,424009,52459,371550,40120,331430,24547,1247,146833,14429,171380,144374,17221,4656,1527,31286
CGTACGTCTTGCCGCT,sample,262157,259046,46644,212402,63914,148488,17803,1084,62911,5900,80714,60790,11516,2359,1106,47011
TTGGTACCTTGCCGCT,sample,72757,71473,17422,54051,34388,19663,4516,281,7476,733,11992,6657,3122,688,736,12794
GTACCGTATTGCCGCT,sample,191195,189349,23749,165600,33610,131990,16053,990,57626,6035,73679,51286,12301,3040,1737,26068
AGGTCGGATTGCCGCT,sample,458487,454396,53392,401004,32030,368974,26135,1078,168030,17193,194165,156538,19431,5966,600,20773
ATGACCGATTGCCGCT,sample,127811,126413,11858,114555,20225,94330,8739,450,42122,4061,50861,38958,8451,2076,686,15055
GACCGGAATTGCCGCT,sample,270797,268537,26486,242051,22085,219966,12500,497,96573,9157,109073,101239,13440,3192,658,11834
GGAGAGTTTTCGACCT,sample,111258,109196,20410,88786,25047,63739,8599,441,26793,2730,35392,25176,8579,1359,1146,18745
ACGTTATGTTCGACCT,sample,90964,89600,26084,63516,45082,18434,4802,587,6045,662,10847,6338,3151,783,1899,13200
CAACCGCGTTCGACCT,sample,911110,903425,96591,806834,34608,772226,46141,1611,351103,35157,397244,338214,24750,9609,392,6795
TTCCGTCTTTCGACCT,sample,182852,180555,34635,145920,45884,100036,12175,580,40638,4316,52813,42327,8755,1916,1080,33992
CAAGGCCTTTCGACCT,sample,494861,490461,75243,415218,66306,348912,31372,1601,155547,15853,186919,144539,19999,5703,2548,55965
GTTAGCCGTTCGACCT,sample,169769,168026,39858,128168,68217,59951,10398,840,22216,1722,32614,24775,5988,1699,1613,34513
GGAGGACGTTCGACCT,sample,76859,75877,10824,65053,20023,45030,5510,442,20266,2082,25776,16730,4661,1114,527,13621
GGACGTAGTTCGACCT,sample,176274,174444,21482,152962,20489,132473,11729,604,59102,6248,70831,54790,13318,2570,1179,15075
GGCCAGAGTTCGACCT,sample,266422,264237,31208,233029,15982,217047,16261,819,99823,10747,116084,89397,16546,3905,713,8204
ACGACTTCTTCGACCT,sample,156943,155066,17786,137280,15480,121800,12992,491,54687,5620,67679,48010,10443,2224,851,14737
CTAGGACCTTCGACCT,sample,238973,236182,34280,201902,21816,180086,12283,813,77204,7168,89487,82618,12110,2416,1169,14172
CGGATTACTTCGACCT,sample,147950,145908,21024,124884,17976,106908,9863,641,46909,5010,56772,44485,11286,2379,896,14667
GTTAGGACTTCGACCT,sample,470766,466713,51496,415217,31241,383976,23622,1207,176420,17229,200042,165498,18907,5347,642,19659
TTGGCCTCTTCGACCT,sample,183261,181388,23441,157947,20163,137784,10218,530,62336,6684,72554,58016,13031,2514,570,14880
GAAGGCGCTTCGACCT,sample,79491,78501,9638,68863,9852,59011,5557,270,25871,2608,31428,24705,8378,1048,288,7736
GTACCGTATTCGACCT,sample,226222,224151,26536,197615,18254,179361,11119,724,80720,8012,91839,78786,13126,2396,531,10958
TCGCCTGATTCGACCT,sample,152070,150366,21369,128997,14495,114502,7362,361,49974,4758,57336,52047,10434,1650,839,9469
CTTCATGATTCGACCT,sample,86009,84864,14214,70650,38143,32507,9087,577,11933,1256,21020,9654,4750,1181,1201,17345
AGGTCGGATTCGACCT,sample,198624,195960,27172,168788,10450,158338,11106,686,72972,6786,84078,66788,12761,2403,717,5225
GACCGGAATTCGACCT,sample,111156,109662,16089,93573,27536,66037,7131,586,26316,2627,33447,29377,7175,1576,840,18318
TTCGTAATTCCAGACT,sample,500201,495945,55329,440616,21981,418635,28460,1165,190689,19143,219149,179178,21448,5814,1111,10256
ATGCCTGGTCCAGACT,sample,38476,37758,7240,30518,8213,22305,3357,155,9543,940,12900,8310,3794,494,470,6624
CAAGGCCTTCCAGACT,sample,210854,207612,34853,172759,15853,156906,10638,510,69477,6654,80115,69627,13289,2081,660,11595
GACGGAGATCCAGACT,sample,48084,47368,7925,39443,11372,28071,3231,232,11718,1279,14949,11611,5018,566,335,7562
GGACGTAGTCCAGACT,sample,65019,64174,7975,56199,4272,51927,4249,206,23377,2477,27626,21618,8073,984,335,3068
ACCTCGAGTCCAGACT,sample,29459,29024,4039,24985,4169,20816,2009,86,9020,860,11029,8841,4214,348,230,2991
GGCCAGAGTCCAGACT,sample,45124,44494,6673,37821,7329,30492,3566,148,13471,1581,17037,11726,5641,688,343,5330
ACGACTTCTCCAGACT,sample,18375,17945,4769,13176,9002,4174,963,138,1441,149,2404,1483,1087,230,158,2841
CATGATTCTCCAGACT,sample,63661,62848,9301,53547,4330,49217,3488,154,21381,2151,24869,22043,7426,799,257,2224
GTTAGGACTCCAGACT,Pos_Ctrl,582113,577208,30264,546944,59821,487123,304567,27993,109308,15062,413875,30193,4992,5435,5345,43353
CGTATGAATCCAGACT,sample,34571,33982,6073,27909,3861,24048,2103,119,10160,1002,12263,10664,4644,448,355,3061
TTGGCCTCTCCAGACT,Pos_Ctrl,420642,416777,23868,392909,41297,351612,217678,19009,86940,10898,304618,17087,4899,5213,4426,31469
GAAGGCGCTCCAGACT,sample,20056,19811,2695,17116,4886,12230,1851,130,4835,435,6686,4979,2530,334,557,3549
TTGGTTAATCCAGACT,sample,41411,40854,8254,32600,12574,20026,3175,198,8380,876,11555,7397,4326,596,458,8016
GTACCGTATCCAGACT,sample,12535,12235,2038,10197,5536,4661,1177,164,1836,195,3013,1289,1130,283,177,2512
ATGACCGATCCAGACT,sample,27386,26998,2956,24042,5151,18891,1959,98,8591,883,10550,7360,4874,643,143,3870
GACCGGAATCCAGACT,sample,44543,43923,5442,38481,7341,31140,3412,206,13559,1473,16971,12490,6226,882,373,5091
AAGTTCGTACCATTAT,sample,419562,414618,82443,332175,83514,248661,28628,1960,111447,11396,140075,95230,16082,3977,2970,69301
TCCTCCGTACCATTAT,sample,121751,119233,31879,87354,37825,49529,9553,985,17949,1759,27502,19283,5670,1129,1485,23347
CCTCTAGAACCATTAT,sample,216439,213682,37150,176532,41557,134975,15936,1008,58186,6546,74122,53299,12848,2936,1541,32394
TTCGTAATACCATTAT,sample,392035,387399,51880,335519,32188,303331,24168,1414,131220,12771,155388,133758,14087,3674,2118,21991
TGAGCGCGACCATTAT,sample,149518,147288,27738,119550,33727,85823,12479,606,34173,3280,46652,35285,7448,1707,1053,26733
GGACCTCTACCATTAT,sample,138330,136129,38724,97405,70992,26413,9941,467,7449,768,17390,7788,3367,868,1484,19606
GACGGAGAACCATTAT,sample,282477,279296,36454,242842,45556,197286,18464,855,88841,9628,107305,79498,11657,3119,1155,36182
GGACGTAGACCATTAT,sample,187830,185463,28064,157399,26542,130857,11232,803,59585,6147,70817,53090,11555,2254,999,19288
CTTGATAGACCATTAT,sample,86869,85667,20548,65119,31586,33533,6285,531,13812,1138,20097,11767,4381,827,1712,16950
GGCCAGAGACCATTAT,sample,348307,344889,40546,304343,41220,263123,21894,1334,119272,12708,141166,107915,15802,4199,1114,30864
CATTGCAGACCATTAT,sample,965064,957807,118146,839661,68386,771275,49314,2083,341609,33348,390923,344921,23270,8946,1534,43345
CCATGAAGACCATTAT,sample,155740,153837,29294,124543,46094,78449,10910,558,31800,2713,42710,32468,7292,1623,1453,29394
ACGTATTAACCATTAT,sample,267860,264225,36899,227326,22140,205186,15600,812,92283,10521,107883,85970,13577,2913,1900,16743
AACTCGTAACCATTAT,sample,451333,447206,53254,393952,51607,342345,26939,1551,152975,16606,179914,144274,17325,5045,1180,40054
CGTATGAAACCATTAT,sample,245107,241594,32149,209445,23519,185926,21220,959,79171,8250,100391,76326,12251,2867,1857,18964
TGCTTCGCACCATTAT,sample,479528,474459,58192,416267,33984,382283,26616,1137,172846,17111,199462,164573,18600,5096,1157,23663
CCAATTCCACCATTAT,sample,190159,187884,21160,166724,17319,149405,14772,761,69436,7963,84208,56473,13750,3257,813,12146
GGCATATAACCATTAT,sample,263017,260298,31352,228946,35330,193616,18852,924,86146,9059,104998,78635,12954,3114,997,29487
ACGTAAGTCAATGGAT,sample,277739,274081,46755,227326,36980,190346,13915,759,82302,8487,96217,84883,12420,2966,1396,30493
ATGCCTGGCAATGGAT,sample,104807,103100,28300,74800,49832,24968,7991,495,7995,746,15986,7741,3677,885,1613,16930
CATAACCTCAATGGAT,sample,364419,360777,44235,316542,46867,269675,23605,1231,118215,11632,141820,114992,15213,3878,1340,33871
CCAGAGCGCAATGGAT,sample,271639,269283,32970,236313,37605,198708,20287,1737,88535,9051,108822,79098,16579,4426,915,29210
CTTGATAGCAATGGAT,sample,290711,286920,49819,237101,41473,195628,20476,1382,88098,9399,108574,76273,15165,3684,2078,37247
ACCTCGAGCAATGGAT,sample,164418,162747,18203,144544,16385,128159,9887,430,55439,5091,65326,57312,11556,2194,861,12636
CCATGAAGCAATGGAT,sample,134394,132735,18725,114010,15483,98527,11160,569,44686,4803,55846,37309,11522,2353,729,12976
GTCCTGCCCAATGGAT,sample,92477,91075,12638,78437,13880,64557,7863,1564,25784,2511,33647,26835,7912,1278,663,10316
TTGGTACCCAATGGAT,sample,379726,375492,59442,316050,49601,266449,18193,1444,116622,11075,134815,119115,15169,3472,1415,39141
GTTAGGACCAATGGAT,sample,128042,126576,16993,109583,22999,86584,7989,458,37781,3855,45770,36501,7640,1743,501,16528
GCCTGAACCAATGGAT,Neg_Ctrl,1884,949,543,406,67,339,79,8,117,14,196,121,166,37,7,12
ACGTATTACAATGGAT,sample,239819,237537,35769,201768,44712,157056,13042,612,68335,6878,81377,68189,11981,2313,1322,33123
AACTCGTACAATGGAT,sample,182379,180403,24675,155728,14954,140774,8914,426,62074,5952,70988,63408,10988,1856,719,9023
CGTATGAACAATGGAT,sample,119223,117595,18947,98648,15570,83078,8968,499,34932,3662,43900,35017,9468,1677,943,12087
AATATATCCAATGGAT,Neg_Ctrl,1901,1159,551,608,84,524,135,11,186,21,321,171,276,86,6,25
TGCTTCGCCAATGGAT,sample,65887,64748,14123,50625,30698,19927,6287,640,6959,631,13246,5410,2967,748,881,12322
AAGAGCGCCAATGGAT,sample,139161,137180,26022,111158,37160,73998,8836,1704,30985,3437,39821,29036,7604,1622,1253,26765
TCAATATACAATGGAT,sample,555212,550952,58891,492061,40144,451917,27291,1472,199530,19397,226821,204227,19304,5663,1628,24358
AGGTCGGACAATGGAT,Pos_Ctrl,1981010,1961947,128902,1833045,182584,1650461,1040526,87515,398961,44375,1439487,79084,7076,8017,22488,142434
ATGACCGACAATGGAT,sample,55874,54928,7290,47638,21665,25973,5144,350,10878,1036,16022,8565,3593,863,1144,11802
AAGTTCGTAGATTCAT,sample,203915,201018,32435,168583,24030,144553,12135,537,62223,6126,74358,63532,10826,2011,711,20642
TCCTCCGTAGATTCAT,sample,109780,108227,29423,78804,46782,32022,6934,416,12388,1103,19322,11181,3729,852,838,19988
TTCGTAATAGATTCAT,sample,121748,120082,26726,93356,36275,57081,7643,283,25050,2803,32693,21302,4680,1011,596,24310
GGAGGACGAGATTCAT,sample,86066,84974,10550,74424,13529,60895,7334,463,24699,2557,32033,25842,7250,1290,1045,9712
CTTGATAGAGATTCAT,sample,203076,200834,27004,173830,15321,158509,8991,344,69968,6701,78959,72505,11382,2135,412,8353
GGCCAGAGAGATTCAT,sample,48881,48129,6098,42031,19788,22243,5440,339,8334,954,13774,7176,4516,748,540,10202
CCATGAAGAGATTCAT,sample,91343,90292,10492,79800,9751,70049,5915,402,29677,2708,35592,31347,8573,1447,629,6213
ACGACTTCAGATTCAT,sample,356796,354201,32716,321485,20776,300709,18329,877,135429,14119,153758,131955,17439,4662,631,10404
AATCCGTCAGATTCAT,sample,182761,181324,20623,160701,22941,137760,8980,508,60603,6003,69583,61666,11970,2296,517,14754
GCCTGAACAGATTCAT,sample,147883,146083,18404,127679,12219,115460,7738,349,51971,4871,59709,50531,10923,1673,566,7851
ACGTATTAAGATTCAT,sample,202998,200838,29504,171334,24344,146990,14119,704,65349,6748,79468,60070,12329,2625,1211,21813
AATATATCAGATTCAT,sample,185097,183466,23492,159974,11260,148714,10422,696,66986,6484,77408,64126,13197,2499,768,6156
ACCAATGCAGATTCAT,sample,109227,107947,14170,93777,23229,70548,7326,342,30273,3335,37599,29272,8161,1415,502,17651
TGCTTCGCAGATTCAT,sample,38127,37385,9220,28165,19801,8364,3810,127,2111,264,5921,2052,1419,331,434,5975
GGCATATAAGATTCAT,sample,198852,197100,23146,173954,13816,160138,9569,460,70398,6850,79967,72861,12783,2340,484,7702
TCAATATAAGATTCAT,sample,47292,46459,8723,37736,24861,12875,5154,1398,3124,318,8278,2881,1718,426,842,8501
GACCGGAAAGATTCAT,sample,55923,54989,6880,48109,6682,41427,3615,202,18931,1834,22546,16845,6463,939,283,4867
GGAGAGTTCAATCTTG,sample,85407,84201,11272,72929,24515,48414,5900,769,21524,2181,27424,18040,5196,1384,686,15100
ATTCTCTTCAATCTTG,sample,271021,267938,61195,206743,76127,130616,16284,1261,55481,5694,71765,51896,10759,2635,2927,54623
ACGTAAGTCAATCTTG,sample,228505,225466,51760,173706,50202,123504,15890,1201,52279,5332,68169,48802,11936,2530,1508,39743
TTCTAATGCAATCTTG,sample,430754,426077,73824,352253,67148,285105,28391,1629,123151,12386,151542,119548,14887,4185,2301,60755
ATGCCTGGCAATCTTG,sample,255399,252369,48410,203959,68201,135758,15865,953,58920,5717,74785,54303,11719,2478,1939,48574
CAACCGCGCAATCTTG,sample,357980,354309,47300,307009,30497,276512,21529,1108,122563,12514,144092,118798,18033,4552,1481,24111
TTCCGTCTCAATCTTG,sample,443995,439633,60094,379539,55683,323856,25311,1186,143646,14782,168957,138931,17410,4665,1565,48254
GCCTTGCTCAATCTTG,sample,172279,170100,31385,138715,58419,80296,9673,1526,32738,2967,42411,33392,5985,1539,1612,36518
CATAACCTCAATCTTG,sample,285182,282096,37705,244391,43524,200867,20623,1121,86985,8667,107608,83471,13212,3298,1499,34770
GACGGAGACAATCTTG,sample,279285,276420,31750,244670,24910,219760,17508,731,98090,9831,115598,93600,14980,3386,1201,17383
CCAGAGCGCAATCTTG,sample,300059,296828,39649,257179,27931,229248,14818,615,100595,9860,115413,103360,13617,3096,511,20746
GGCCAGAGCAATCTTG,sample,266769,264441,28052,236389,20872,215517,14847,973,95862,10023,110709,93812,14759,3189,875,13534
AATCCGTCCAATCTTG,sample,135200,133340,17631,115709,7995,107714,6595,282,47003,4453,53598,49381,9774,1536,427,3780
AGTCCGCACAATCTTG,sample,102568,101081,16518,84563,23659,60904,8532,715,23936,2510,32468,25211,6599,1076,651,17022
TGCTTCGCCAATCTTG,sample,130953,128979,23658,105321,20288,85033,7559,344,37716,3627,45275,35787,8461,1414,663,17006
AAGAGCGCCAATCTTG,sample,178629,176131,25275,150856,17821,133035,10929,951,56938,6674,67867,57543,9093,2021,1111,17281
TTATTCGACAATCTTG,Neg_Ctrl,1564,973,364,609,109,500,223,17,145,25,368,90,261,125,41,38
GACCGGAACAATCTTG,sample,295170,292592,31938,260654,21366,239288,16288,729,106948,10512,123236,104811,14531,3396,962,13160
TCCTCCGTCGTTCCGA,sample,464542,459096,106124,352972,74916,278056,32922,1586,124207,13160,157129,106181,19012,5187,2061,68234
CCTCTAGACGTTCCGA,sample,749296,740078,108549,631529,66810,564719,44975,2150,253862,27146,298837,236586,21640,7361,2552,57318
TAGTACGGCGTTCCGA,sample,473791,467501,79331,388170,46124,342046,31306,1459,153117,15276,184423,140888,17115,4957,1932,38514
AATGGTAACGTTCCGA,sample,781287,773961,91873,682088,59999,622089,43179,1850,276125,28342,319304,272593,21527,7432,1403,49269
GCCTTGCTCGTTCCGA,sample,588036,581816,74678,507138,51865,455273,35427,1786,208595,21583,244022,187882,18290,5968,1203,38288
GACGGAGACGTTCCGA,sample,951348,942696,110466,832230,50825,781405,47359,1644,356554,34608,403913,341240,22794,8505,975,26098
GGAGGACGCGTTCCGA,sample,213648,210948,31730,179218,27652,151566,14529,738,65580,5906,80109,64813,11325,2422,1000,21946
GACGATAACGTTCCGA,sample,338136,333388,51430,281958,34336,247622,20583,1013,109909,10686,130492,105431,14027,3310,2004,26941
CATTGCAGCGTTCCGA,sample,248256,245842,28622,217220,37661,179559,21239,1278,78639,8118,99878,70285,12714,3716,2016,26987
TTGGTACCCGTTCCGA,sample,120980,119150,29284,89866,62733,27133,11262,748,7997,812,19259,6314,3007,835,1129,19174
CTAGGACCCGTTCCGA,sample,262580,259510,38194,221316,38948,182368,21849,1160,76009,7485,97858,75865,12445,2963,2023,28577
GTTAGGACCGTTCCGA,sample,432533,428695,49076,379619,50249,329370,25341,1048,150157,15378,175498,137446,17532,4862,774,36066
GCCTGAACCGTTCCGA,sample,278012,274853,36133,238720,22878,215842,18500,981,95370,9431,113870,91560,14348,3565,1902,14806
ACGTATTACGTTCCGA,sample,115866,114199,25063,89136,67363,21773,6168,419,7237,729,13405,7220,3267,874,1434,16264
AACTCGTACGTTCCGA,sample,648817,644214,69428,574786,37548,537238,41601,1765,241102,25195,282703,227575,22004,8286,1741,18480
CGTATGAACGTTCCGA,sample,269413,266611,34930,231681,34526,197155,19818,1170,88460,9537,108278,78170,14376,3633,3283,27089
ACCAATGCCGTTCCGA,sample,515680,511397,54660,456737,50361,406376,29790,1208,180364,18394,210154,176620,19027,6330,1815,31656
GAAGGCGCCGTTCCGA,sample,154701,152638,20923,131715,78595,53120,14418,1134,18831,1969,33249,16768,5908,1694,2467,31542
GGCATATACGTTCCGA,sample,102385,101166,10666,90500,14509,75991,8235,466,34198,3685,42433,29407,12238,2509,433,8860
ATGACCGACGTTCCGA,sample,134002,132536,11437,121099,12379,108720,7630,415,49519,5298,57149,45858,12936,2674,218,7066
GACCGGAACGTTCCGA,sample,1239,1214,198,1016,110,906,75,5,382,43,457,401,390,29,11,84
GGAGAGTTCAATTCGG,sample,216084,213194,25899,187295,27619,159676,14543,593,70397,6334,84940,67809,11359,2671,1652,20550
ATTCTCTTCAATTCGG,Pos_Ctrl,2444731,2417147,198971,2218176,287173,1931003,1182614,95754,472100,59799,1654714,120736,7860,8819,24316,245237
AAGTTCGTCAATTCGG,sample,162250,158748,40595,118153,63227,54926,16418,1398,19936,2455,36354,14719,5419,1574,3262,31197
TTCGTAATCAATTCGG,sample,104201,102229,23793,78436,43957,34479,8750,579,12890,1297,21640,10963,4758,1291,1848,19811
ACGTTATGCAATTCGG,Pos_Ctrl,1868420,1837992,175440,1662552,205538,1457014,892233,76613,360570,47789,1252803,79809,7595,8108,21601,176444
TAGTACGGCAATTCGG,sample,83625,81994,19470,62524,35102,27422,9234,329,9592,902,18826,7365,4226,994,915,15951
GGACCTCTCAATTCGG,sample,236151,233103,55767,177336,80796,96540,15208,878,39380,3948,54588,37126,9872,2336,3012,48675
GCCTTGCTCAATTCGG,Pos_Ctrl,1464930,1452727,73937,1378790,154641,1224149,748474,64174,314228,28813,1062702,68460,6835,7725,14541,115559
CATAACCTCAATTCGG,sample,479649,474764,53700,421064,33119,387945,30998,1743,178014,18105,209012,159085,18212,5746,1316,21065
CCAGAGCGCAATTCGG,sample,126740,124836,24617,100219,39078,61141,8634,580,24357,2597,32991,24973,7703,1466,1175,24859
CCGCAACGCAATTCGG,Pos_Ctrl,1041803,1026272,99726,926546,116296,810250,501323,42392,195138,27985,696461,43412,6495,6965,8977,100389
GGACGTAGCAATTCGG,sample,151474,149332,19705,129627,12206,117421,10266,527,51220,5372,61486,50036,10768,1909,1034,9358
CCATGAAGCAATTCGG,Pos_Ctrl,1859440,1841699,106212,1735487,162844,1572643,993006,85204,366134,46138,1359140,82161,7072,7989,19781,115117
GTCCTGCCCAATTCGG,sample,238743,236427,28019,208408,23366,185042,16522,842,83187,8534,99709,75957,16149,3763,1539,15802
CTAGGACCCAATTCGG,sample,280207,277131,37541,239590,34544,205046,21235,1585,85798,8647,107033,87781,13488,3562,2770,27271
CGGATTACCAATTCGG,Pos_Ctrl,1239290,1228456,67406,1161050,121722,1039328,644896,56262,250020,34030,894916,54120,6231,6860,15750,88654
TTGGCCTCCAATTCGG,Pos_Ctrl,1012734,1004649,48392,956257,97617,858640,531496,51745,207049,25486,738545,42864,6194,6833,15349,70322
TGCTTCGCCAATTCGG,sample,143390,140975,20092,120883,16253,104630,9710,519,47755,4535,57465,42111,9877,2065,1002,13769
GGCATATACAATTCGG,sample,162220,160685,16366,144319,13212,131107,9729,380,57541,5514,67270,57943,12210,2664,752,6398
TCAATATACAATTCGG,sample,380458,376806,35494,341312,21792,319520,25612,986,144810,16685,170422,131427,16794,4880,881,12141
ATGACCGACAATTCGG,sample,79933,78191,11075,67116,30797,36319,8217,508,13748,1499,21965,12347,5624,1520,1880,16405
GACCGGAACAATTCGG,sample,84100,82111,11222,70889,27442,43447,8482,501,16888,1795,25370,15781,5582,1332,1357,16266
GGAGAGTTAACTCCGG,sample,870,823,127,696,245,451,85,10,182,15,267,159,202,46,13,142
TTCGTAATAACTCCGG,sample,335936,331747,47904,283843,39165,244678,23957,1179,110634,11850,134591,97058,11964,4091,1620,35086
TAGTACGGAACTCCGG,sample,99050,97530,14970,82560,7453,75107,5396,276,32356,3018,37752,34061,8996,1161,549,3830
TGAGCGCGAACTCCGG,sample,108383,106568,18170,88398,12169,76229,6239,312,32711,3014,38950,33953,8598,1192,430,8979
CAACCGCGAACTCCGG,sample,45128,44209,7443,36766,9491,27275,3812,267,12174,1095,15986,9927,3618,683,441,7713
CAAGGCCTAACTCCGG,sample,133273,131131,17033,114098,5236,108862,7030,336,49756,4867,56786,46873,11352,1632,320,2209
ACCTCGAGAACTCCGG,sample,33839,33039,3648,29391,4864,24527,3207,379,10235,1027,13442,9679,4574,663,1044,3799
GGCCAGAGAACTCCGG,sample,58815,58017,7103,50914,18527,32387,4399,262,13086,1244,17485,13396,5748,845,516,11345
CATGATTCAACTCCGG,sample,114947,113436,21515,91921,26636,65285,8253,467,27773,3246,36026,25546,7231,1355,932,19624
TTGGTACCAACTCCGG,sample,200243,198578,19551,179027,14526,164501,13347,535,74973,7782,88320,67864,14044,2966,681,8669
ACCAATGCAACTCCGG,sample,60824,59864,7927,51937,18253,33684,5447,269,13875,1532,19322,12561,3488,779,819,11914
GTACCGTAAACTCCGG,sample,18795,18368,1851,16517,2211,14306,1356,83,6405,641,7761,5821,3944,500,122,1427
GGAGAGTTCCTGAAGG,sample,121015,118945,20121,98824,22913,75911,10206,635,32570,3328,42776,29172,7844,1535,1372,16806
TCCAACTTCCTGAAGG,Neg_Ctrl,2362,1377,978,399,58,341,58,1,131,16,189,135,164,15,10,13
GGTTGCGTCCTGAAGG,sample,85075,82857,28042,54815,39588,15227,5147,704,4449,316,9596,4611,2041,553,1044,10926
AGTACCATCCTGAAGG,sample,702663,690647,107398,583249,37477,545772,36385,1490,249273,26401,285658,232223,20884,6016,1147,18774
TTCTAATGCCTGAAGG,Neg_Ctrl,2436,1429,1109,320,42,278,44,7,113,13,157,101,140,11,8,7
TAGTACGGCCTGAAGG,sample,424082,417678,67998,349680,39977,309703,19258,752,136707,12923,155965,140063,15564,3526,943,30536
AATGGTAACCTGAAGG,sample,591983,582637,92144,490493,60864,429629,38492,2056,189721,19367,228213,179993,20001,5557,3317,48634
GCCTTGCTCCTGAAGG,sample,721907,713328,101884,611444,42564,568880,44655,1975,262811,26934,307466,232505,23471,7381,1301,27590
CAAGGCCTCCTGAAGG,Neg_Ctrl,2823,1736,1156,580,50,530,58,6,237,23,295,206,252,25,11,11
CCAGAGCGCCTGAAGG,sample,242789,239850,36219,203631,34864,168767,18465,811,73191,7254,91656,69046,12015,2587,904,28065
GGACGTAGCCTGAAGG,Neg_Ctrl,1908,1112,732,380,50,330,35,1,139,14,174,141,152,20,5,12
GACGATAACCTGAAGG,sample,181960,179473,29347,150126,29697,120429,14531,771,50773,5032,65304,49322,9630,2191,1265,23230
GGCCAGAGCCTGAAGG,sample,40502,39342,7285,32057,23970,8087,3546,198,2118,280,5664,1945,1469,350,693,5732
ACGACTTCCCTGAAGG,Neg_Ctrl,2342,1321,783,538,63,475,64,5,228,11,292,167,243,23,9,20
CTAGGACCCCTGAAGG,sample,215310,212439,26904,185535,13814,171721,13219,744,75319,8098,88538,74341,13709,2888,901,7985
GTTAGGACCCTGAAGG,Neg_Ctrl,2258,1240,770,470,56,414,94,6,163,21,257,130,207,41,7,14
AATATATCCCTGAAGG,Neg_Ctrl,1973,1128,636,492,71,421,67,5,164,16,231,169,197,16,9,16
GAAGGCGCCCTGAAGG,sample,83662,82514,10137,72377,20447,51930,5808,587,23174,2261,28982,20100,5072,1094,973,14509
AAGAGCGCCCTGAAGG,sample,209822,207706,31066,176640,38473,138167,19658,1050,59531,6009,79189,51919,11127,2876,1696,29774
TTATTCGACCTGAAGG,sample,26279,25456,2871,22585,5095,17490,2286,162,7894,751,10180,6397,3610,650,421,3683
ATTCTCTTAATATTCG,sample,130972,128811,23620,105191,26454,78737,9698,605,34709,3624,44407,30101,8780,1704,967,19235
ACGTAAGTAATATTCG,sample,363748,358686,48827,309859,25342,284517,20276,960,132451,13883,152727,116947,16953,4138,981,21651
ATGCCTGGAATATTCG,sample,41411,40205,10865,29340,19567,9773,4545,293,2999,363,7544,1573,1285,360,702,6577
TTCCGTCTAATATTCG,sample,175544,173251,32628,140623,23353,117270,9807,475,51870,5273,61677,49845,10462,2044,636,19373
TCGCATCTAATATTCG,sample,111211,109493,20960,88533,28894,59639,7592,270,24185,3378,31777,24214,4899,959,942,21571
CAAGGCCTAATATTCG,sample,178074,175693,25361,150332,29204,121128,11008,478,55432,5665,66440,48545,7935,2263,813,21803
CATAACCTAATATTCG,sample,95866,94284,15220,79064,19131,59933,5760,309,27002,2882,32762,23980,6380,1038,681,13047
GACGGAGAAATATTCG,sample,69332,67957,10831,57126,17598,39528,6212,713,16286,1829,22498,14488,5191,1062,561,11795
TGGACGAGAATATTCG,sample,21199,20331,2639,17692,10888,6804,1713,198,2397,272,4110,2224,1720,354,369,3921
GACGATAAAATATTCG,sample,86166,84563,15296,69267,24701,44566,7891,401,16509,1589,24400,18176,5693,1167,1186,15905
CATTGCAGAATATTCG,sample,48439,47297,7179,40118,10077,30041,3609,337,12628,1172,16237,12295,4633,789,769,6867
CCATGAAGAATATTCG,sample,87978,86432,9407,77025,7318,69707,7750,422,31107,3141,38857,27287,8695,1800,714,5632
AGTCCGCAAATATTCG,sample,187265,185370,27016,158354,33502,124852,10202,635,52658,5057,62860,56300,10297,1922,1266,23996
GCCTGAACAATATTCG,sample,667673,662689,70581,592108,59286,532822,43216,1828,237656,23976,280872,226146,23002,8564,1262,40547
CGTATGAAAATATTCG,sample,413616,409480,54558,354922,47165,307757,30358,1728,136901,13861,167259,124909,16893,5259,1150,35299
AATATATCAATATTCG,sample,69758,68639,11818,56821,21710,35111,5480,518,14594,1412,20074,13107,3256,831,744,12913
GTCTTAGCAATATTCG,sample,68506,67674,6146,61528,3226,58302,3894,201,27672,2949,31566,23586,8859,1241,251,1096
GTACCGTAAATATTCG,Pos_Ctrl,1038093,1030583,47647,982936,107040,875896,549092,50593,205382,25773,754474,45056,6027,6890,14717,80932
TCAATATAAATATTCG,sample,307810,304798,27733,277065,14799,262266,19311,872,117596,11675,136907,112812,13258,3791,848,7841
GGAGAGTTAGTCTCCG,sample,153025,151570,13478,138092,17550,120542,9580,481,55690,5716,65270,49075,12566,2375,633,13175
ACGTAAGTAGTCTCCG,sample,87850,86545,17766,68779,26619,42160,6963,373,16643,1550,23606,16631,6121,927,907,17568
GTTAGCCGAGTCTCCG,sample,78102,76937,11115,65822,5837,59985,5445,369,27154,2617,32599,24400,8546,1104,525,4678
GACGATAAAGTCTCCG,sample,144369,142554,17073,125481,16515,108966,10474,654,47743,4743,58217,45352,10511,1974,1142,14895
CATTGCAGAGTCTCCG,sample,30596,29970,4920,25050,16429,8621,3013,322,2280,277,5293,2729,1565,389,426,5534
CATGATTCAGTCTCCG,sample,167437,165534,21035,144499,16495,128004,11603,511,57828,5701,69431,52361,12347,2261,546,13722
ACCAATGCAGTCTCCG,sample,35515,34802,4582,30220,3210,27010,2185,376,11251,1093,13436,12105,5023,546,226,1747
TGCTTCGCAGTCTCCG,sample,79874,79084,7614,71470,4278,67192,4337,195,31033,3351,35370,28276,10013,1363,197,1800
AGGTCGGAAGTCTCCG,sample,43718,42976,5234,37742,5196,32546,3114,197,14078,1416,17192,13741,6112,994,481,3248
TTATTCGAAGTCTCCG,sample,6862,6498,691,5807,3009,2798,456,42,1164,106,1620,1030,1039,181,97,1336
TCCAACTTTGCCTACG,sample,101652,99981,27141,72840,28901,43939,7300,502,18573,1711,25873,15853,6285,944,1316,20247
AAGTTCGTTGCCTACG,sample,178982,176277,28459,147818,24891,122927,11708,399,54190,5247,65898,51383,9161,1863,746,21844
TCCTCCGTTGCCTACG,sample,113802,111934,14963,96971,4888,92083,6629,254,42522,4169,49151,38509,9924,1432,345,2744
CCTCTAGATGCCTACG,sample,153009,150711,22623,128088,9044,119044,7732,723,53122,5556,60854,51911,11556,1596,371,5249
ATGCCTGGTGCCTACG,sample,109547,107546,18946,88600,9128,79472,5902,221,35676,3411,41578,34262,9551,1260,303,6103
CAACCGCGTGCCTACG,sample,47445,46790,6206,40584,5367,35217,3315,168,15393,1632,18708,14709,5292,835,195,4310
AATGGTAATGCCTACG,sample,168464,166680,24927,141753,21099,120654,9691,589,52110,5325,61801,52939,11669,1843,1068,16939
TTAGAAGTTGCCTACG,sample,79533,78495,15037,63458,16953,46505,6258,358,18476,1853,24734,19560,6982,955,941,12672
TTCCGTCTTGCCTACG,sample,146649,144386,22982,121404,14723,106681,8678,465,47607,4658,56285,45273,11365,1787,769,13100
GACGGAGATGCCTACG,sample,118108,116690,16411,100279,8013,92266,6143,291,40544,3802,46687,41486,9682,1286,536,3958
CCAGAGCGTGCCTACG,sample,111203,109900,15125,94775,6895,87880,8876,365,39510,3840,48386,35289,10961,1683,398,3770
CTTGATAGTGCCTACG,sample,130048,128101,19173,108928,7781,101147,7117,311,45786,4423,52903,43510,10647,1523,599,4470
TGGACGAGTGCCTACG,sample,88258,87110,10886,76224,10926,65298,5777,413,29303,3064,35080,26741,8394,1119,290,8253
AATCCGTCTGCCTACG,sample,106744,105483,16291,89192,11209,77983,7251,554,34790,3732,42041,31656,10735,1624,579,8975
CGTACGTCTGCCTACG,sample,238617,235782,28761,207021,11028,195993,14171,565,89400,9312,103571,82545,15419,2994,442,5076
TTGGTACCTGCCTACG,sample,165642,163698,22430,141268,18506,122762,12217,479,56241,5698,68458,48127,10570,2222,426,14535
GTTAGGACTGCCTACG,sample,88166,87146,12815,74331,11126,63205,6868,361,27209,2843,34077,25924,8654,1297,950,7862
ACCAATGCTGCCTACG,sample,141722,139996,20946,119050,9884,109166,7399,343,47926,4698,55325,48800,10823,1510,313,6091
GAAGGCGCTGCCTACG,sample,19671,19145,3408,15737,10242,5495,2009,133,1550,145,3559,1658,1223,278,494,3493
GGCATATATGCCTACG,Neg_Ctrl,1022,512,290,222,22,200,24,5,91,7,115,73,93,6,6,6
TCCTCCGTCTTAGTTC,sample,163370,160774,23118,137656,20173,117483,10662,1014,51555,4953,62217,49299,8476,2080,853,16482
CCTCTAGACTTAGTTC,sample,393978,390684,55058,335626,47089,288537,27394,1402,127728,12819,155122,119194,19293,5575,2829,35836
TTCGTAATCTTAGTTC,sample,517597,511529,74442,437087,61979,375108,24226,1081,166128,16435,190354,167238,16253,4327,1370,51502
ACGTTATGCTTAGTTC,sample,328864,324228,61502,262726,56557,206169,18960,891,89428,8590,108388,88300,13235,2611,832,44346
TTAGAAGTCTTAGTTC,sample,215848,213027,32435,180592,40697,139895,16106,936,59655,5808,75761,57390,12044,2440,1874,32147
TCGCATCTCTTAGTTC,sample,189967,187016,38497,148519,46373,102146,16070,1079,42679,4298,58749,38020,9926,2445,1778,34872
CATAACCTCTTAGTTC,sample,142104,139706,18059,121647,12394,109253,10491,1163,48310,4822,58801,44467,10073,2087,864,8751
GTTAGCCGCTTAGTTC,sample,241642,238866,36598,202268,34379,167889,17307,928,73126,7626,90433,68902,14596,3354,2204,32217
GGAGGACGCTTAGTTC,sample,51189,49821,8714,41107,10020,31087,6556,378,11785,1191,18341,11177,4362,882,958,7715
GACGATAACTTAGTTC,sample,393218,388773,45871,342902,30450,312452,19644,912,139462,13281,159106,139153,15666,4048,1151,22246
CATTGCAGCTTAGTTC,sample,246523,244148,34356,209792,26629,183163,16708,898,82227,8692,98935,74638,16579,3954,1475,19708
GCCTGAACCTTAGTTC,sample,82201,80392,12046,68346,13925,54421,8711,420,23166,2330,31877,19794,8291,1309,1618,10704
ACGTATTACTTAGTTC,sample,215034,212102,30874,181228,24445,156783,16256,743,66938,6938,83194,65908,12124,2599,1469,18923
TTGGCCTCCTTAGTTC,sample,209500,207018,29274,177744,40343,137401,19499,811,57948,6582,77447,52561,11485,2420,1336,31959
TGCTTCGCCTTAGTTC,sample,246935,244126,29289,214837,15381,199456,13432,570,88452,8626,101884,88376,13586,2855,855,8995
GGCATATACTTAGTTC,sample,353739,350414,44324,306090,45124,260966,31597,3406,109856,11419,141453,104688,15321,3932,1376,31942
TCGCCTGACTTAGTTC,sample,131042,129181,17578,111603,29680,81923,10573,775,34317,3652,44890,32606,8519,1716,952,20857
AGGTCGGACTTAGTTC,sample,136463,133987,27453,106534,48268,58266,14467,893,21126,3083,35593,18697,6266,1638,1326,26767
TTATTCGACTTAGTTC,sample,48750,47586,6953,40633,23398,17235,4232,607,6380,485,10612,5531,2743,568,767,9615
ATGACCGACTTAGTTC,sample,65450,64307,7976,56331,18746,37585,4984,381,15690,1429,20674,15101,4551,978,808,12403
GGAGAGTTCGAGCTTC,sample,125701,124276,13421,110855,24748,86107,12083,670,38674,3797,50757,30883,7213,1855,603,19770
TCCTCCGTCGAGCTTC,sample,100754,98675,19482,79193,14513,64680,7102,1210,26788,2577,33890,27003,7657,1286,970,12923
CCTCTAGACGAGCTTC,sample,79542,78341,11524,66817,18840,47977,6140,413,19802,2010,25942,19612,5498,1033,624,13985
AGTACCATCGAGCTTC,sample,161211,159375,28877,130498,37571,92927,11263,461,38634,3854,49897,38715,7311,1601,1175,26976
CAACCGCGCGAGCTTC,sample,162563,160176,27526,132650,14561,118089,9767,391,54262,5306,64029,48363,11283,2167,500,11005
AATGGTAACGAGCTTC,sample,108212,106685,20017,86668,32041,54627,7595,286,23544,2296,31139,20906,6241,1247,660,20654
ACCTCGAGCGAGCTTC,sample,98555,97293,8920,88373,5746,82627,5475,273,36858,3529,42333,36492,9319,1432,531,2594
CCATGAAGCGAGCTTC,sample,61220,60110,9147,50963,13828,37135,5748,392,15663,1602,21411,13730,5759,916,956,10193
TTGGTACCCGAGCTTC,sample,330401,327515,43929,283586,59142,224444,25382,1188,97581,9773,122963,90520,12195,4189,1517,43968
GTTAGGACCGAGCTTC,sample,46874,46025,7057,38968,16899,22069,5581,294,7267,1463,12848,7464,2730,617,713,10032
GTCTTAGCCGAGCTTC,sample,103292,102238,8966,93272,5049,88223,5795,239,40202,3959,45997,38028,10925,1752,313,1358
CCAATTCCCGAGCTTC,sample,43662,42726,6996,35730,22156,13574,2884,268,5333,582,8217,4507,2867,594,654,8273
AGGTCGGACGAGCTTC,sample,330208,327689,35228,292461,21803,270658,19636,808,121335,12023,140971,116856,17595,4709,813,12585
TTATTCGACGAGCTTC,sample,36627,35979,4670,31309,14614,16695,2756,206,7242,675,9998,5816,3065,647,442,7360
ATGACCGACGAGCTTC,sample,16952,16279,1921,14358,9582,4776,1090,112,1863,189,2953,1522,1044,291,178,2974
GGAGAGTTGTAGAATG,sample,216021,213645,28394,185251,35045,150206,15261,568,66902,6741,82163,60734,12137,2496,1183,26000
ATTCTCTTGTAGAATG,Pos_Ctrl,1556129,1538497,104133,1434364,141801,1292563,791640,64531,323908,47440,1115548,65044,6902,7477,17936,116589
TCCAACTTGTAGAATG,sample,238824,235645,42197,193448,41610,151838,12770,620,66956,6534,79726,64958,12557,2500,1319,33313
AAGTTCGTGTAGAATG,sample,194144,191151,32652,158499,30295,128204,15537,820,53628,5300,69165,52919,11386,2406,1207,24884
CCTCTAGAGTAGAATG,sample,106178,104659,15746,88913,20837,68076,7844,310,30679,3178,38523,26065,8166,1453,598,16576
TTCGTAATGTAGAATG,sample,361426,356587,44018,312569,18490,294079,24212,922,133246,13648,157458,122051,17611,4540,925,12086
TTCTAATGGTAGAATG,sample,526821,519026,74506,444520,35669,408851,32582,1331,185797,17753,218379,171388,19023,5550,1391,28783
TTAGAAGTGTAGAATG,sample,192367,189807,27408,162399,34639,127760,13317,616,58198,5645,71515,49984,7499,2042,931,30394
TTCCGTCTGTAGAATG,sample,109246,107039,17130,89909,13671,76238,7768,441,31309,3352,39077,33368,8424,1372,1198,10696
GGACCTCTGTAGAATG,Pos_Ctrl,1811238,1786730,138803,1647927,168718,1479209,906190,77982,358443,44966,1264633,91628,6930,7785,20160,137270
TCGCATCTGTAGAATG,sample,119155,116978,20741,96237,18628,77609,9171,535,32970,3354,42141,31579,9759,1844,1005,15273
CATAACCTGTAGAATG,sample,114114,112141,16712,95429,11503,83926,7318,359,37973,4008,45291,34268,9855,1538,824,8635
GTTAGCCGGTAGAATG,sample,65068,63697,15918,47779,30977,16802,7499,298,4544,457,12043,4004,2277,636,798,11188
CGAGGCAGGTAGAATG,Pos_Ctrl,1198569,1188828,54787,1134041,103444,1030597,643570,57219,244637,31006,888207,54165,6223,6972,9299,77500
AGTCCGCAGTAGAATG,sample,140829,139183,16200,122983,10472,112511,8844,452,49822,5031,58666,48362,11188,2067,692,6334
TTGGTACCGTAGAATG,sample,503451,499175,54054,445121,40142,404979,31071,1731,182730,18363,213801,171084,20316,6683,1228,27052
CTAGGACCGTAGAATG,sample,49384,48078,9175,38903,25338,13565,5550,434,3781,322,9331,3478,2389,677,916,8825
CGGATTACGTAGAATG,sample,200227,197854,23894,173960,13687,160273,11094,528,69330,7059,80424,72262,12682,2594,506,5946
GTTAGGACGTAGAATG,sample,218548,216223,22383,193840,11491,182349,11468,499,83286,8249,94754,78847,13921,3059,392,4540
ACCAATGCGTAGAATG,Pos_Ctrl,800264,795124,35146,759978,86702,673276,428621,42563,150751,20043,579372,31298,5541,6318,9983,59517
CCAATTCCGTAGAATG,sample,184157,182493,20662,161831,30211,131620,12313,569,57725,5776,70038,55237,12923,2547,537,21822
TCAATATAGTAGAATG,sample,376492,373932,31616,342316,17845,324471,25061,1111,149011,15569,174072,133719,20320,6392,429,5872
ATGACCGAGTAGAATG,sample,56857,55872,5523,50349,10228,40121,4054,298,17993,2060,22047,15716,6381,1286,477,7334
GACCGGAAGTAGAATG,sample,58834,57644,7433,50211,11440,38771,4254,297,16516,1722,20770,15982,6488,1131,561,8277
TATCAGTTCAATAGTC,sample,94605,93258,18349,74909,27129,47780,7280,470,19347,2158,26627,18525,6198,1102,855,17602
AGTACCATCAATAGTC,sample,135623,133882,21914,111968,19271,92697,11204,584,39925,4195,51129,36789,10718,1832,887,16342
CAACCGCGCAATAGTC,sample,13377,13064,4456,8608,6372,2236,989,38,700,41,1689,468,553,189,176,1683
AATGGTAACAATAGTC,sample,12092,11677,1583,10094,488,9606,1321,51,3945,361,5266,3928,1791,198,195,451
TTCCGTCTCAATAGTC,sample,97354,96036,17013,79023,13483,65540,5607,242,29974,2988,35581,26729,8183,1153,450,12131
GCCTTGCTCAATAGTC,sample,194600,192666,30548,162118,18554,143564,11400,664,65403,6567,76803,59530,14023,2562,528,13997
CATAACCTCAATAGTC,sample,56355,55449,9280,46169,10897,35272,4551,519,14418,1514,18969,14270,5524,768,967,8405
GTTAGCCGCAATAGTC,sample,64416,63719,9683,54036,4545,49491,3804,196,22661,2363,26465,20467,8782,955,189,3578
GGCCAGAGCAATAGTC,sample,22012,21637,2524,19113,2583,16530,1468,72,7255,770,8723,6965,4051,481,152,1773
CCATGAAGCAATAGTC,sample,26829,26467,3853,22614,5999,16615,1857,105,7045,683,8902,6925,3904,483,151,4080
GCCTGAACCAATAGTC,sample,68475,67620,11307,56313,13653,42660,3875,222,18172,1819,22047,18572,6490,880,599,10562
ACCAATGCCAATAGTC,sample,65639,64838,8703,56135,8579,47556,3400,168,21657,2002,25057,20329,6353,907,258,6291
GAAGGCGCCAATAGTC,sample,19712,19255,3716,15539,3428,12111,1537,78,4682,460,6219,5354,2873,291,299,2110
GTACCGTACAATAGTC,sample,53202,52552,7089,45463,9776,35687,4043,245,15847,1616,19890,13936,6355,904,517,7911
TCAATATACAATAGTC,sample,63053,62316,7728,54588,6692,47896,4313,215,20869,2046,25182,20453,7304,894,574,5029
ATGACCGACAATAGTC,sample,53247,52558,5991,46567,7840,38727,4027,118,16881,1707,20908,15994,6763,788,381,5499
GACCGGAACAATAGTC,sample,111445,110291,10980,99311,7700,91611,7059,463,42077,4181,49136,37831,10063,1608,340,4635
TCCAACTTCGTTACTC,Neg_Ctrl,2254,1380,700,680,105,575,52,6,356,10,408,151,186,14,11,36
GGTTGCGTCGTTACTC,sample,166671,163151,34854,128297,27089,101208,13933,985,43038,3959,56971,39293,10448,2134,1190,24522
CCTCTAGACGTTACTC,sample,381216,376873,64791,312082,100199,211883,38111,4424,85328,8142,123439,75878,11486,3619,2101,75133
AGTACCATCGTTACTC,sample,375185,371214,59964,311250,96965,214285,26494,2754,90423,8508,116917,86106,11818,3263,3250,70992
TAGTACGGCGTTACTC,sample,86423,84814,22753,62061,36677,25384,8126,564,8724,861,16850,7109,3009,718,869,15682
TTCCGTCTCGTTACTC,sample,229058,226515,75411,151104,85599,65505,11313,780,25864,2581,37177,24967,7560,1560,2328,41130
TCGCATCTCGTTACTC,Neg_Ctrl,1751,1084,638,446,79,367,75,3,147,14,222,128,190,37,10,22
CATAACCTCGTTACTC,sample,84029,82435,25956,56479,35792,20687,8628,260,6046,498,14674,5255,3006,718,967,13893
CCAGAGCGCGTTACTC,sample,181098,178190,29016,149174,15418,133756,12910,645,58340,5658,71250,56203,11594,2078,780,14525
CTTGATAGCGTTACTC,sample,9650,9429,1091,8338,833,7505,673,32,3230,356,3903,3214,2562,246,62,570
GACGATAACGTTACTC,sample,76526,74564,12937,61627,19264,42363,7295,517,17468,1683,24763,15400,6312,1344,1259,14191
GGCCAGAGCGTTACTC,sample,116325,114924,14639,100285,25764,74521,8713,454,29948,2862,38661,32544,8477,1729,923,18101
CATTGCAGCGTTACTC,sample,496307,492290,52418,439872,60695,379177,30049,1413,171846,17666,201895,158203,19542,6335,1341,50620
CGAGGCAGCGTTACTC,sample,127990,125985,20940,105045,24662,80383,12841,534,33191,3396,46032,30421,9822,1906,1929,20537
CCATGAAGCGTTACTC,Neg_Ctrl,5759,4678,1251,3427,775,2652,450,26,1120,143,1570,913,1100,159,71,449
TGCTTCGCCGTTACTC,Neg_Ctrl,2041,1148,623,525,86,439,79,4,182,22,261,152,226,35,12,21
GAAGGCGCCGTTACTC,sample,601874,596757,75691,521066,57173,463893,37332,1660,211993,20850,249325,192058,20607,6749,2290,36369
GTCTTAGCCGTTACTC,sample,195080,193115,18543,174572,17034,157538,13449,1108,70093,7300,83542,65588,14284,3224,1188,10176
TTGGTTAACGTTACTC,sample,605138,598413,73932,524481,41117,483364,33730,1714,221356,22560,255086,204004,19772,5872,1843,31998
GGCATATACGTTACTC,sample,215621,213241,32340,180901,44712,136189,15794,902,58398,5435,74192,55660,9706,2583,1693,31623
CTTCATGACGTTACTC,sample,86015,84545,15161,69384,33019,36365,7417,484,13966,1368,21383,13130,4827,1120,1749,17898
TTATTCGACGTTACTC,sample,160373,158516,15863,142653,11473,131180,12619,583,60205,5882,72824,51891,12328,2599,1119,7752
TATCAGTTTGGACTGC,sample,143494,141786,19683,122103,13212,108891,9032,404,46304,4783,55336,48368,10134,1572,713,10780
AGTACCATTGGACTGC,sample,105583,103900,14428,89472,7221,82251,6020,257,36943,3785,42963,35246,9768,1222,283,4696
ACGTTATGTGGACTGC,sample,26477,25596,4780,20816,2377,18439,2231,128,7648,760,9879,7672,3873,458,327,2127
TTCTAATGTGGACTGC,sample,112827,110936,22755,88181,16626,71555,6968,266,30240,2892,37208,31189,8464,1176,369,14446
TAGTACGGTGGACTGC,sample,146769,144735,26819,117916,22072,95844,10619,487,41130,4689,51749,38919,9919,1806,823,20558
TGAGCGCGTGGACTGC,sample,21572,21092,6182,14910,9941,4969,2432,162,1305,110,3737,960,888,224,294,3445
GGACGTAGTGGACTGC,sample,65790,64957,6738,58219,3707,54512,3662,374,24550,2609,28212,23317,6942,893,163,2164
CTTGATAGTGGACTGC,sample,76753,75610,12311,63299,9298,54001,4432,205,24067,2457,28499,22840,8216,933,448,7133
AATCCGTCTGGACTGC,sample,133589,131778,19231,112547,12668,99879,7530,352,46851,4561,54381,40585,10920,1633,311,11016
AGTCCGCATGGACTGC,sample,39550,38897,5856,33041,5305,27736,3103,141,12053,1216,15156,11223,5145,597,313,4457
GTCCTGCCTGGACTGC,sample,25921,25328,4938,20390,11466,8924,2602,183,3008,328,5610,2803,1817,377,275,5134
TTGGTACCTGGACTGC,sample,133569,131805,18319,113486,13291,100195,7505,319,45593,4780,53098,41998,10711,1641,249,10109
AATATATCTGGACTGC,sample,58568,57875,11813,46062,18056,28006,5531,523,11138,1048,16669,9766,5662,936,1155,11644
CTTCATGATGGACTGC,sample,78830,77866,10133,67733,4152,63581,4556,159,28816,2921,33372,27129,8423,993,267,1640
AGGTCGGATGGACTGC,sample,83914,82826,15648,67178,17538,49640,5061,298,20538,2039,25599,21704,4668,918,723,12831
GGAGAGTTCCTTGAGC,sample,269575,266690,33306,233384,45596,187788,20144,1136,82491,8397,102635,75620,13737,3233,1871,34083
ATTCTCTTCCTTGAGC,sample,545416,540464,94415,446049,100997,345052,33862,5207,152573,15519,186435,137891,17547,5856,2290,77705
AAGTTCGTCCTTGAGC,sample,905994,894484,121852,772632,65925,706707,47598,2441,318133,32362,365731,306173,22728,8114,1895,56324
TCCTCCGTCCTTGAGC,sample,365385,359958,63882,296076,46629,249447,17474,872,108776,10354,126250,111971,13545,3091,880,40210
CCTCTAGACCTTGAGC,sample,207857,204391,45673,158718,45596,113122,19875,1571,46520,5133,66395,40023,11636,2378,1750,35644
TTCGTAATCCTTGAGC,Pos_Ctrl,1513504,1480480,188357,1292123,214392,1077731,661319,57479,260462,37848,921781,60623,7146,7697,16508,181920
TGAGCGCGCCTTGAGC,sample,266603,262829,46975,215854,44938,170916,15859,1364,76119,7938,91978,69636,10938,2852,1129,40951
GGACCTCTCCTTGAGC,sample,215645,212658,45441,167217,46674,120543,12426,953,49547,4571,61973,53046,6371,2018,1004,40876
TCGCATCTCCTTGAGC,sample,180600,177594,34277,143317,29801,113516,10566,716,50856,4884,61422,46494,10496,1748,742,25052
CAAGGCCTCCTTGAGC,sample,586326,578126,79491,498635,43800,454835,32711,1458,208457,21092,241168,191117,19036,5857,1502,39525
GTTAGCCGCCTTGAGC,Pos_Ctrl,1630713,1597710,173833,1423877,178558,1245319,766626,60077,310054,40035,1076680,68527,7080,7662,17327,148317
GGAGGACGCCTTGAGC,sample,151948,150055,28201,121854,65458,56396,10100,656,22140,2205,32240,21295,6170,1663,1981,30594
TGGACGAGCCTTGAGC,sample,514201,509685,62103,447582,57848,389734,32812,1458,170549,16370,203361,168545,18364,5283,1829,43533
CGAGGCAGCCTTGAGC,sample,155328,153235,34287,118948,63514,55434,11905,860,20415,1942,32320,20312,5599,1532,1571,31203
ACGACTTCCCTTGAGC,sample,251470,248629,49804,198825,72885,125940,15443,620,52889,5572,68332,51416,7960,2447,1170,46912
TTGGTACCCCTTGAGC,Pos_Ctrl,1638338,1621406,119066,1502340,162583,1339757,847059,67968,307946,42888,1155005,73896,6941,7713,18505,129420
CTAGGACCCCTTGAGC,sample,160210,158178,26258,131920,60368,71552,13148,821,28768,3624,41916,25191,7083,1975,1796,32913
CGTATGAACCTTGAGC,sample,195538,193149,46637,146512,71431,75081,17310,970,27661,2645,44971,26495,8378,1803,3450,39447
AATATATCCCTTGAGC,sample,317080,314059,36615,277444,25041,252403,17976,902,113274,10878,131250,109373,15262,3593,818,18627
TTGGTTAACCTTGAGC,sample,257037,253981,36527,217454,20133,197321,16426,1182,83581,8169,100007,87963,12975,2898,1441,15095
GGCATATACCTTGAGC,sample,133345,131542,21270,110272,27504,82768,11656,792,33406,3374,45062,33540,8942,1725,1604,20261
AGGTCGGACCTTGAGC,Pos_Ctrl,1846780,1829847,122379,1707468,186450,1521018,934857,81630,388074,48718,1322931,67739,7480,8264,19555,149668
ATGACCGACCTTGAGC,sample,364299,361598,27842,333756,17668,316088,24316,1234,147251,15220,171567,128067,19948,6828,914,8123
GACCGGAACCTTGAGC,sample,70174,68519,9033,59486,5895,53591,5393,369,23430,2476,28823,21923,7862,1311,866,4630
GGAGAGTTCGATATCC,sample,154687,152964,20414,132550,39217,93333,13480,1170,39719,3311,53199,35653,8298,1700,1080,28149
TCCAACTTCGATATCC,sample,118420,116930,25976,90954,37673,53281,8664,652,22383,2238,31047,19344,6368,1158,643,24173
GGACGTAGCGATATCC,sample,109155,108003,10784,97219,10183,87036,7108,392,39031,3716,46139,36789,9948,1798,561,7963
CTTGATAGCGATATCC,sample,985,912,175,737,201,536,70,9,223,14,293,220,233,41,18,131
CATTGCAGCGATATCC,sample,3148,2978,444,2534,688,1846,248,22,756,71,1004,749,744,115,26,446
CGAGGCAGCGATATCC,sample,40830,40213,6772,33441,17286,16155,3456,325,6042,661,9498,5671,3764,894,376,8631
GTCCTGCCCGATATCC,sample,22492,22041,3016,19025,14809,4216,1677,149,1202,140,2879,1048,1075,400,400,3223
CGTATGAACGATATCC,sample,233255,231492,22928,208564,24179,184385,14765,536,83327,8151,98092,77606,15004,3558,511,17811
TGCTTCGCCGATATCC,sample,40177,39604,4704,34900,4112,30788,3850,220,13130,1184,16980,12404,5303,808,375,3066
ATTCTCTTATCTGACC,sample,45031,44099,7747,36352,3708,32644,3004,166,14481,1389,17485,13604,5705,647,352,3329
TCCAACTTATCTGACC,sample,75634,74559,15079,59480,19092,40388,4576,256,16680,1706,21256,17170,6139,783,668,13142
GGTTGCGTATCTGACC,sample,30460,29792,8224,21568,9624,11944,2242,125,4643,392,6885,4542,1897,341,355,5844
TCCTCCGTATCTGACC,sample,37742,36864,7499,29365,10527,18838,2563,449,8269,821,10832,6736,4246,471,269,7041
ACGTTATGATCTGACC,Neg_Ctrl,876,582,287,295,47,248,78,7,74,11,152,78,135,48,7,16
TTCTAATGATCTGACC,sample,62454,61205,12820,48385,7307,41078,3909,171,17353,1628,21262,18017,6452,823,406,6231
CAAGGCCTATCTGACC,sample,141658,139490,20616,118874,7765,111109,7446,311,49524,4789,56970,49039,11504,1599,541,5877
GGAGGACGATCTGACC,Neg_Ctrl,587,323,213,110,21,89,13,1,25,9,38,41,37,4,1,3
CATTGCAGATCTGACC,sample,22828,22475,3318,19157,8136,11021,1680,96,4669,456,6349,4120,2470,409,178,4588
CCATGAAGATCTGACC,sample,10780,10552,1023,9529,2257,7272,866,85,3071,312,3937,2938,1918,297,91,1682
TTGGTACCATCTGACC,sample,46264,45762,6193,39569,5064,34505,3160,123,15455,1568,18615,14199,6746,767,237,3999
CTAGGACCATCTGACC,Neg_Ctrl,305,264,66,198,30,168,52,4,47,9,99,56,81,31,14,20
AACTCGTAATCTGACC,sample,12108,11866,1837,10029,5953,4076,865,84,1438,133,2303,1556,1139,245,129,2366
CGTATGAAATCTGACC,sample,38071,37666,6124,31542,8950,22592,2102,152,8782,828,10884,10728,3798,542,240,6321
TTGGCCTCATCTGACC,sample,25824,25503,3549,21954,10125,11829,2638,159,4464,432,7102,4136,2925,490,473,5351
AATATATCATCTGACC,sample,15907,15602,3039,12563,9153,3410,1481,143,848,103,2329,835,856,273,302,2460
TGCTTCGCATCTGACC,sample,33758,33341,4705,28636,5422,23214,2619,171,10248,1057,12867,9119,5307,502,145,4317
GAAGGCGCATCTGACC,sample,69164,68500,7620,60880,9716,51164,4483,249,22549,2354,27032,21529,8435,1157,219,6625
GGCATATAATCTGACC,sample,16904,16607,3277,13330,7036,6294,1654,103,2129,174,3783,2234,1304,240,227,3379
TCAATATAATCTGACC,sample,88015,87301,9415,77886,9511,68375,6712,294,30944,3458,37656,26967,9776,1524,203,6782
TTATTCGAATCTGACC,Neg_Ctrl,1257,797,224,573,95,478,318,27,74,5,392,54,245,158,62,37
ATTCTCTTCTTCTTAC,sample,108209,107091,18973,88118,26557,61561,7157,428,26241,2503,33398,25232,8972,1505,869,20204
AAGTTCGTCTTCTTAC,sample,24993,24434,3734,20700,12133,8567,1670,126,3268,361,4938,3142,1991,346,298,4976
TCCTCCGTCTTCTTAC,sample,31499,30932,3925,27007,2556,24451,1959,126,11103,1163,13062,10100,5253,624,163,1498
CCTCTAGACTTCTTAC,sample,10827,10407,1302,9105,1587,7518,747,80,3324,372,4071,2995,2405,262,98,1093
TTAGAAGTCTTCTTAC,sample,71946,70795,13365,57430,15101,42329,5009,258,17699,1707,22708,17656,5972,833,638,12135
TTCCGTCTCTTCTTAC,sample,66300,65232,17209,48023,24255,23768,5972,993,7856,939,13828,8008,4174,806,1312,12637
TCGCATCTCTTCTTAC,sample,80046,78712,13315,65397,10642,54755,6681,280,24361,2801,31042,20632,8270,1192,595,9560
CATAACCTCTTCTTAC,sample,39225,38334,10393,27941,19104,8837,4924,245,1971,109,6895,1588,1076,307,443,6161
CCGCAACGCTTCTTAC,sample,211043,208713,27561,181152,17540,163612,12345,605,72909,7097,85254,70656,12669,2528,455,12303
GGCCAGAGCTTCTTAC,sample,15900,15522,2105,13417,8885,4532,1235,69,1470,144,2705,1614,1174,260,209,2895
CATTGCAGCTTCTTAC,sample,61730,61030,7804,53226,8029,45197,3810,386,20279,2067,24089,18655,7180,928,237,5455
CATGATTCCTTCTTAC,sample,14367,13775,2307,11468,886,10582,947,47,4390,450,5337,4748,2659,260,166,543
AATCCGTCCTTCTTAC,sample,100108,98879,14292,84587,9098,75489,5796,443,31554,3057,37350,34639,8347,1189,407,5880
CTAGGACCCTTCTTAC,sample,20794,20389,3779,16610,10882,5728,2823,101,1207,115,4030,1482,1050,297,512,3739
TGCTTCGCCTTCTTAC,sample,88907,87870,13474,74396,13054,61342,4916,253,27677,2582,32593,25914,8742,1169,414,10599
CTTCATGACTTCTTAC,sample,73136,72195,12252,59943,22030,37913,4758,266,15695,2048,20453,15146,5031,861,980,14350
AGGTCGGACTTCTTAC,sample,98998,97715,18419,79296,31551,47745,9220,828,19583,1720,28803,16394,4902,1424,990,20167
GGAGAGTTACTTCTAC,sample,18695,18381,2237,16144,3200,12944,1233,55,5858,567,7091,5231,3655,373,66,2052
ATTCTCTTACTTCTAC,sample,2955,2733,466,2267,223,2044,420,29,788,92,1208,715,858,193,52,132
GGTTGCGTACTTCTAC,sample,213,209,62,147,19,128,23,1,51,4,74,49,62,15,6,12
CCTCTAGAACTTCTAC,sample,428,422,61,361,34,327,150,11,105,12,255,49,191,83,29,29
TGAGCGCGACTTCTAC,sample,39804,39251,6669,32582,3365,29217,2587,205,12674,1264,15261,12487,5560,592,173,2308
GGACCTCTACTTCTAC,sample,61150,60361,8456,51905,4712,47193,3693,142,21285,2103,24978,19970,7702,810,191,3232
TCGCATCTACTTCTAC,sample,40449,39925,6526,33399,9770,23629,3429,191,9774,1003,13203,9232,4713,594,392,6885
GCCTTGCTACTTCTAC,sample,115713,114324,14983,99341,5910,93431,6366,352,41649,3899,48015,41165,9897,1287,210,2961
CATAACCTACTTCTAC,sample,33547,32864,6530,26334,6935,19399,2338,112,8238,788,10576,7923,2759,377,363,5193
GGAGGACGACTTCTAC,sample,44970,44468,6074,38394,4173,34221,3322,171,14863,1477,18185,14388,6479,704,189,2984
CTTGATAGACTTCTAC,sample,23443,22993,5918,17075,9208,7867,1788,99,2648,273,4436,3059,1711,300,308,4378
ACCTCGAGACTTCTAC,sample,3034,2908,351,2557,1326,1231,208,19,492,48,700,464,510,76,36,583
GTCCTGCCACTTCTAC,sample,36660,36238,4145,32093,5346,26747,2692,196,11493,1179,14185,11187,5400,659,311,3803
CGGATTACACTTCTAC,sample,50442,49854,6626,43228,8074,35154,4640,389,14732,1474,19372,13919,6568,812,722,6352
GCCTGAACACTTCTAC,sample,57888,57255,7265,49990,4742,45248,3670,215,19952,1924,23622,19487,7419,818,477,3366
ACGTATTAACTTCTAC,sample,63049,62247,9122,53125,6198,46927,3802,169,20292,2197,24094,20467,6808,849,200,4551
AATATATCACTTCTAC,sample,18822,18479,2785,15694,1181,14513,1115,75,6315,603,7430,6405,3608,331,125,669
TGCTTCGCACTTCTAC,sample,48452,47867,6179,41688,3466,38222,2988,159,17234,1815,20222,16026,7216,742,242,2442
GTACCGTAACTTCTAC,sample,11735,11521,1856,9665,5443,4222,1175,71,1669,155,2844,1152,1124,248,135,2355
AGGTCGGAACTTCTAC,sample,17805,17505,3397,14108,5939,8169,2117,121,2962,329,5079,2640,1818,383,205,3551
TTATTCGAACTTCTAC,sample,55642,55204,5578,49626,6825,42801,3312,161,19107,2060,22419,18161,7964,971,189,4729
AAGTTCGTAGAAGTAA,sample,522,507,102,405,51,354,55,2,155,14,210,128,181,33,12,29
GGTTGCGTAGAAGTAA,sample,291,289,67,222,21,201,25,3,97,9,122,67,109,15,4,15
TTCGTAATAGAAGTAA,sample,601,586,138,448,53,395,88,8,161,8,249,130,205,58,10,31
TAGTACGGAGAAGTAA,sample,7578,7118,953,6165,1502,4663,676,40,1948,220,2624,1779,1472,245,52,1033
CAACCGCGAGAAGTAA,sample,12276,11752,1837,9915,7398,2517,1313,63,616,50,1929,475,613,212,159,1769
GCCTTGCTAGAAGTAA,sample,104288,103197,9168,94029,8330,85699,7194,330,39068,3912,46262,35195,11153,2052,341,5159
CTTGATAGAGAAGTAA,sample,421722,417743,40473,377270,21457,355813,22287,1037,159886,15261,182173,157342,18010,4916,975,11030
GACGATAAAGAAGTAA,sample,128125,126752,13375,113377,9841,103536,7173,481,45746,4461,52919,45675,10267,1588,464,6212
GGCCAGAGAGAAGTAA,sample,28880,28267,3049,25218,2238,22980,1775,95,10175,1082,11950,9853,5074,671,124,1266
CATTGCAGAGAAGTAA,sample,60135,59357,5741,53616,11796,41820,4265,227,19081,2035,23346,16212,6925,1175,276,8142
ACGACTTCAGAAGTAA,sample,83806,82712,9583,73129,11494,61635,5749,273,28024,2761,33773,24828,5790,1252,291,8850
AGTCCGCAAGAAGTAA,sample,174232,172649,14371,158278,11011,147267,10705,532,67336,6797,78041,61897,13872,2871,408,7054
GTCTTAGCAGAAGTAA,sample,17992,17524,1680,15844,2146,13698,1070,57,6191,651,7261,5729,3804,394,72,1301
TTGGTTAAAGAAGTAA,sample,325007,322563,29981,292582,18532,274050,20844,1034,124617,12483,145461,115072,17352,4583,940,11373
GTACCGTAAGAAGTAA,sample,32763,32163,3481,28682,4490,24192,2337,225,10524,982,12861,10124,5025,699,272,2975
TCGCCTGAAGAAGTAA,sample,80793,79981,7892,72089,7374,64715,5581,336,29368,2742,34949,26688,8391,1375,443,5914
AGGTCGGAAGAAGTAA,sample,106248,105183,10886,94297,13638,80659,7035,324,36653,3930,43688,32717,9898,1917,298,9372
Short,Non_sample,0,NA,NA,NA,NA,NA,NA,NA,NA,NA,NA,NA,NA,NA,NA,NA
Unselected,Non_sample,0,NA,NA,NA,NA,NA,NA,NA,NA,NA,NA,NA,NA,NA,NA,NA
Undetermined,Non_sample,273885784,NA,NA,NA,NA,NA,NA,NA,NA,NA,NA,NA,NA,NA,NA,NA
