Barcode,Sample,Barcoded_Reads,Trimmed_Reads,Unmapped_Reads,Mapped_Reads,Multimapped_Reads,Uniquely_Mapped_Reads,Exon_Reads,Ambiguous_Exon_Reads,Intron_Reads,Ambiguous_Intron_Reads,Gene_Reads,Intergenic_Reads,No_of_Genes,No_of_Transcripts,Mitochondrial_Reads,Ribosomal_Reads
TCTAGGTTCGTTGGTT,sample,833075,823461,123688,699773,98300,601473,113038,5936,255029,27701,368067,199769,21541,6612,23696,54373
CTGGTCTTCGTTGGTT,sample,366411,362901,34927,327974,86469,241505,56752,2336,97527,9862,154279,75028,13010,2596,21300,52889
GTCGTTCTCGTTGGTT,sample,587320,582151,54813,527338,112962,414376,84730,4431,172746,18254,257476,134215,15840,4891,33228,72764
GACGTATGCGTTGGTT,sample,194294,192597,26039,166558,54060,112498,39405,1499,40770,4956,80175,25868,6764,1522,21372,30104
GGAGAAGCCGTTGGTT,sample,64121,63225,12654,50571,9845,40726,7341,217,17528,1865,24869,13775,6972,790,3598,5669
GAGCCTCCCGTTGGTT,sample,81619,80755,12246,68509,18853,49656,12045,678,20688,2197,32733,14048,7410,1370,3851,10517
CATACTCCCGTTGGTT,sample,49135,48603,7276,41327,9987,31340,7375,499,13798,1515,21173,8153,5221,1071,2771,5926
CTAGCGACCGTTGGTT,sample,125164,123945,17298,106647,27300,79347,19218,809,32895,3654,52113,22771,8665,1479,8523,16781
TCGAACGACGTTGGTT,sample,114717,113893,15390,98503,22992,75511,14750,637,32830,3238,47580,24056,10292,1713,6010,13448
GGTAGAGACGTTGGTT,sample,38399,37916,3889,34027,11230,22797,5934,225,9314,1009,15248,6315,4074,850,2447,6157
GCAACTAGCGTTGGTT,sample,440,431,77,354,66,288,65,3,125,12,190,83,143,35,28,43
CTAAGCATCGTTGGTT,sample,322041,319032,27031,292001,81215,210786,58268,1866,79994,8821,138262,61837,9327,2107,27979,50209
AAGGTCTGCGTTGGTT,sample,722335,713772,132154,581618,70233,511385,60228,2552,228929,23190,289157,196486,23938,6563,11602,35643
GCTGCTTCCGTTGGTT,sample,66776,65703,13047,52656,9095,43561,8074,454,19473,2040,27547,13520,6924,1192,2675,5314
GCCTATTCCGTTGGTT,sample,86790,86188,21576,64612,13103,51509,8922,388,22318,2337,31240,17544,8221,1274,3269,6752
TGCGCTCCCGTTGGTT,sample,234302,232342,33077,199265,37936,161329,26102,1464,70657,7295,96759,55811,15334,2870,7279,23102
CGTCGAGGCGTTGGTT,sample,64326,63645,9974,53671,12578,41093,9122,609,17336,1831,26458,12195,6036,1114,3606,7483
CGCGAGACCGTTGGTT,sample,146393,145214,13950,131264,41860,89404,25911,1708,34993,3678,60904,23114,8063,1515,8844,23325
CCTAACTACGTTGGTT,sample,267692,265234,35646,229588,63539,166049,36283,1787,68587,7652,104870,51740,11965,2311,14515,35849
TTAACTGACGTTGGTT,sample,184506,183193,16387,166806,45328,121478,31227,2184,49133,5604,80360,33330,9766,1992,13984,28134
TCTAGGTTCTATCGTT,sample,129764,127606,24634,102972,21146,81826,13671,650,35940,3930,49611,27635,9148,1290,5094,12069
AGAGTTCTCTATCGTT,sample,74551,73073,16264,56809,8994,47815,8449,379,20905,2282,29354,15800,7554,1078,2964,4814
GACGTATGCTATCGTT,sample,51571,50603,10022,40581,8080,32501,7387,369,13858,1584,21245,9303,5508,878,3366,4488
CATAATGGCTATCGTT,sample,87272,85758,14881,70877,16332,54545,12530,447,24145,2610,36675,14813,6661,1147,5042,9507
GGAGAAGCCTATCGTT,sample,88534,87300,12904,74396,21157,53239,14906,505,20994,2018,35900,14816,6879,1056,8007,12143
GACTCAAGCTATCGTT,sample,488,464,134,330,59,271,70,2,113,15,183,71,137,32,25,31
CCGCAGTCCTATCGTT,sample,568,551,142,409,105,304,54,4,128,15,182,103,140,22,25,57
CCGTACGCCTATCGTT,sample,18633,18379,3056,15323,2865,12458,2210,110,6025,589,8235,3524,3592,609,636,1625
TCTCAGGACTATCGTT,sample,219272,217534,39446,178088,28547,149541,21518,932,65363,6671,86881,55057,14650,2448,7773,16763
TGGATCAACTATCGTT,sample,64168,63711,4210,59501,23927,35574,12704,724,13284,1309,25988,7553,3952,927,6328,12849
GGCAGGTTCTATCGTT,sample,68038,67336,10504,56832,16671,40161,8091,289,17323,1968,25414,12490,6626,966,3526,9120
CATTCGGTCTATCGTT,sample,114764,111650,30393,81257,10571,70686,8847,359,31678,3415,40525,26387,9836,1207,2634,4898
CTAAGCATCTATCGTT,sample,141084,138766,27716,111050,22023,89027,13367,480,38946,3734,52313,32500,8307,1228,6083,12615
GGCGACGACTATCGTT,sample,53799,52749,11833,40916,6525,34391,7197,300,15174,1685,22371,10035,5420,947,1703,3676
GCCTATTCCTATCGTT,sample,129904,126983,34182,92801,11977,80824,9914,375,36152,3821,46066,30562,11460,1288,3004,5827
GGCGTACCCTATCGTT,sample,382511,375971,81034,294937,46050,248887,38125,1737,108555,11101,146680,89369,18151,3101,12496,27999
CGCGGTCGCTATCGTT,sample,106182,104553,17614,86939,14357,72582,15380,744,30172,3265,45552,23021,8473,1234,5155,8492
ATGAATAGCTATCGTT,sample,47572,46770,10536,36234,7471,28763,5620,177,12383,1253,18003,9330,5623,628,2845,4222
TAACGCCACTATCGTT,sample,99879,98451,19459,78992,11693,67299,10147,777,29902,3231,40049,23242,9795,1546,2114,6689
ATTCTACCCTATCGTT,sample,111040,109795,17043,92752,23404,69348,16930,932,27574,2955,44504,20957,8222,1176,8106,13696
CGCGAGACCTATCGTT,sample,176079,173841,26479,147362,26226,121136,22641,736,51156,5489,73797,41114,11249,1850,8069,16619
AGATACTACTATCGTT,sample,143833,141693,22124,119569,23608,95961,20360,745,40852,3734,61212,30270,9343,1435,7721,15133
GCGCAATACTATCGTT,sample,124720,123563,15141,108422,24720,83702,18719,890,34330,3931,53049,25832,9520,1468,7443,14287
ATATGCAACTATCGTT,sample,171526,170024,26287,143737,26026,117711,19605,994,50777,5695,70382,40640,12659,1949,6165,14713
AACCGGTTGTCTTCTT,sample,268221,265417,43358,222059,36500,185559,29530,1598,80463,9341,109993,64627,15106,2840,8967,21561
CTGGTCTTGTCTTCTT,Pos_Ctrl,96904,95649,8094,87555,4755,82800,70174,6522,4244,526,74418,1334,7079,9021,6226,2624
GTCGTTCTGTCTTCTT,sample,110552,109514,18785,90729,24842,65887,10532,550,28185,3091,38717,23529,9866,1287,3836,13961
AGCTGAATGTCTTCTT,sample,326475,323596,40451,283145,67261,215884,41824,1377,90305,9575,132129,72803,15217,2829,20056,41320
TATACGGAGTCTTCTT,Pos_Ctrl,113065,109778,12088,97690,4839,92851,78033,6460,5770,752,83803,1836,7546,9508,6466,2414
CTAGCGACGTCTTCTT,sample,325767,318602,66945,251657,37586,214071,29444,1115,93481,9470,122925,80561,16998,2841,9190,21214
CGTCGCCAGTCTTCTT,sample,265041,259132,39872,219260,34174,185086,26448,1353,80690,8992,107138,67603,14615,2591,6936,20840
TGATTCCGGTCTTCTT,sample,79958,78449,13147,65302,13554,51748,12912,713,22578,2800,35490,12745,6566,1207,4453,8026
GCAACTAGGTCTTCTT,sample,39682,39214,3370,35844,11916,23928,10478,503,7577,821,18055,4549,3699,1125,3474,6912
ATGGCGTTGTCTTCTT,sample,137883,135849,24814,111035,25129,85906,17837,975,36738,3507,54575,26849,8594,1477,7684,14268
TGCGCGTTGTCTTCTT,sample,56834,55267,14832,40435,5280,35155,5105,316,15975,1653,21080,12106,6294,887,1345,2626
ACGCTTAAGTCTTCTT,sample,84421,82569,15290,67279,11247,56032,11527,642,25386,2655,36913,15822,7477,1419,3133,6662
GAGATTCTGTCTTCTT,sample,165707,163581,25453,138128,33416,104712,19854,928,45403,5041,65257,33486,11210,1891,7033,20052
CCTAGCGGGTCTTCTT,sample,167627,163593,41924,121669,13207,108462,11686,399,49505,5088,61191,41784,13413,1563,2721,6822
CTAACCGGGTCTTCTT,sample,128679,126554,23514,103040,19540,83500,16224,650,36447,3848,52671,26331,10462,1511,6848,11389
GGCGACGAGTCTTCTT,sample,97204,95663,16938,78725,20453,58272,14112,578,24114,2489,38226,16979,7540,1225,5916,11153
ATACCGCCGTCTTCTT,sample,77108,75895,11073,64822,19115,45707,13304,644,16862,1652,30166,13245,5669,872,7127,11074
CGTCGAGGGTCTTCTT,sample,26231,25827,5608,20219,3505,16714,2740,151,7262,780,10002,5781,4333,557,1070,1997
CAGCTTCGGTCTTCTT,sample,23278,22816,5041,17775,2787,14988,2289,133,6727,771,9016,5068,3982,471,756,1534
CGCGGTCGGTCTTCTT,sample,38084,37454,7639,29815,5737,24078,4069,181,10544,1138,14613,8146,5329,657,1559,3277
TTATGACGGTCTTCTT,sample,38005,37192,8151,29041,5241,23800,3983,150,10126,1121,14109,8420,5112,518,1992,2825
ATGAATAGGTCTTCTT,sample,193140,190030,38136,151894,23951,127943,19858,788,57732,5758,77590,43807,13584,1852,5411,14009
AAGTAGAGGTCTTCTT,sample,180624,178179,28742,149437,29933,119504,22974,1295,52469,5215,75443,37551,11152,1869,7929,17758
CGCGAGACGTCTTCTT,sample,70580,69904,6300,63604,21629,41975,21174,1275,12019,1461,33193,6046,3919,1071,8066,12399
CCTAACTAGTCTTCTT,Pos_Ctrl,101349,97716,10410,87306,3702,83604,70112,6035,5178,568,75290,1711,7083,8955,3317,1588
GACGTATGTAGGCTCT,sample,206600,203994,25140,178854,54434,124420,38929,1496,45406,3884,84335,34705,8949,1698,23571,31179
CTAGCGACTAGGCTCT,sample,177534,174754,24150,150604,38688,111916,25070,1112,46833,5953,71903,32948,10281,1795,11584,21980
TCGAACGATAGGCTCT,sample,70616,69993,8636,61357,17833,43524,13031,601,18364,1778,31395,9750,5595,1257,5599,10319
CCGCAGTCTAGGCTCT,sample,390292,376915,88585,288330,38905,249425,30362,1162,113513,11863,143875,92525,17707,3094,8654,20702
GATGCGTTTAGGCTCT,sample,146438,143556,20680,122876,33140,89736,24343,1197,36322,3894,60665,23980,8011,1504,10917,18808
ATGGCGTTTAGGCTCT,sample,264212,259618,36358,223260,57873,165387,44688,1749,65971,6883,110659,46096,12056,2052,23751,34946
CGGTTGGTTAGGCTCT,sample,160377,156646,29537,127109,18402,108707,18279,1030,47974,5124,66253,36300,11143,1761,6275,9924
ACGCTTAATAGGCTCT,sample,158448,156477,14069,142408,51564,90844,35107,1358,29702,3628,64809,21049,5973,1292,19432,28588
TAGCGAGTTAGGCTCT,sample,43279,42169,8319,33850,8135,25715,5794,335,10825,1162,16619,7599,4749,702,2808,4435
GCTCTTCTTAGGCTCT,sample,88052,85287,24745,60542,5379,55163,5367,290,26210,2824,31577,20472,8898,1043,852,2090
GGCGACGATAGGCTCT,sample,150223,147967,15648,132319,32247,100072,27685,1719,40760,3404,68445,26504,6818,1626,9280,21195
GCTGCTTCTAGGCTCT,sample,206705,203275,31430,171845,33064,138781,27037,1268,60528,6637,87565,43311,11745,2021,10480,20234
AGCAGAGCTAGGCTCT,sample,160020,157866,12822,145044,47525,97519,33192,1787,35536,4035,68728,22969,6920,1417,17075,28699
GGCGTACCTAGGCTCT,sample,72335,71169,10364,60805,15695,45110,11324,403,18504,1775,29828,13104,6001,1073,5359,9806
CAGCTTCGTAGGCTCT,sample,156936,154105,29609,124496,14723,109773,14319,695,49380,5180,63699,40199,12523,1831,3854,7738
TCTCCTAGTAGGCTCT,sample,101267,100124,11465,88659,23152,65507,21211,1192,23877,2649,45088,16578,7180,1343,7682,14201
ATTCTACCTAGGCTCT,sample,307588,304780,51570,253210,74595,178615,51365,1594,68577,7984,119942,49095,9831,1968,24797,41742
CGCGAGACTAGGCTCT,sample,263107,260477,34720,225757,50128,175629,43564,1776,71123,7800,114687,51366,12226,2498,15418,31279
CGTAGAACTAGGCTCT,sample,273947,271661,26314,245347,70527,174820,42404,3238,68935,7435,111339,52808,12558,2509,16898,42726
TCTAGGTTTTGACTAT,sample,66189,65142,12616,52526,10201,42325,6823,256,19157,1982,25980,14107,6462,855,2353,5891
CTGGTCTTTTGACTAT,sample,78214,77128,7681,69447,21181,48266,14823,601,18686,1929,33509,12227,5643,958,8070,12505
GTCGTTCTTTGACTAT,Neg_Ctrl,3077,1165,870,295,58,237,49,8,107,11,156,62,119,15,21,8
GGAGAAGCTTGACTAT,Neg_Ctrl,3145,1537,1005,532,81,451,112,10,189,20,301,120,219,38,47,16
GAGCCTCCTTGACTAT,sample,25105,24421,5939,18482,3166,15316,2762,198,6956,758,9718,4642,3660,633,847,1608
TGATTCCGTTGACTAT,Pos_Ctrl,100652,96171,14931,81240,4094,77146,64190,5297,5346,664,69536,1649,7220,8751,4315,2144
GCAACTAGTTGACTAT,sample,31219,30745,5121,25624,7103,18521,4817,226,7750,705,12567,5023,4175,735,2231,4024
CCGCAGTCTTGACTAT,sample,99320,97017,22775,74242,15847,58395,10560,510,24942,2774,35502,19609,9018,1256,4014,8502
TCTCAGGATTGACTAT,sample,103372,101283,20601,80682,16319,64363,15464,566,26261,2884,41725,19188,7365,1194,7094,9757
ATGGCGTTTTGACTAT,Pos_Ctrl,98158,95273,12789,82484,4153,78331,65422,5464,5051,687,70473,1707,7074,8486,4891,2193
CCATTCTTTTGACTAT,sample,71109,69177,16592,52585,8247,44338,7472,515,19180,2226,26652,14945,6787,940,2846,4602
ACGCTTAATTGACTAT,sample,84390,82831,13468,69363,16155,53208,15165,632,20685,2201,35850,14525,6132,1022,7458,9699
TAGCGAGTTTGACTAT,sample,172996,169356,38841,130515,16356,114159,15864,782,51548,5530,67412,40435,12139,1840,4619,8938
AAGGTCTGTTGACTAT,sample,186305,183456,32860,150596,29108,121488,20710,654,49926,4675,70636,45523,10516,1614,8955,18053
CCTAGCGGTTGACTAT,Pos_Ctrl,47379,45970,6392,39578,1894,37684,31399,2741,2450,294,33849,800,5812,6149,1987,949
GGCGACGATTGACTAT,sample,45068,44365,9988,34377,5478,28899,4401,207,12660,1413,17061,10218,5663,667,1936,2849
AGCAGAGCTTGACTAT,sample,89846,88129,18513,69616,12975,56641,11439,479,23427,2516,34866,18780,7970,1108,4745,7142
CGTCGAGGTTGACTAT,Pos_Ctrl,97505,94623,12858,81765,4052,77713,62419,5393,6285,802,68704,2814,7613,8519,3635,2004
CGCGGTCGTTGACTAT,sample,87846,86859,12482,74377,15444,58933,12332,427,24875,2849,37207,18450,7927,1058,5193,9446
ATGAATAGTTGACTAT,sample,236302,232099,46169,185930,30041,155889,21021,1081,68274,7193,89295,58320,14654,2209,6504,16945
TCAATCAGTTGACTAT,sample,159058,156299,29828,126471,20151,106320,15802,625,46422,4576,62224,38895,11299,1524,6487,11535
GCGCAATATTGACTAT,Neg_Ctrl,2104,949,624,325,60,265,62,10,107,6,169,80,134,18,19,10
TTAACTGATTGACTAT,sample,182379,180355,25574,154781,21145,133636,19182,710,60015,6725,79197,47004,12017,2145,5500,13470
TCTAGGTTTGCAGTTG,sample,81667,80145,13704,66441,9956,56485,8138,400,24974,2686,33112,20287,8840,1222,2652,5919
CTGGTCTTTGCAGTTG,sample,66412,65017,11247,53770,7368,46402,7981,377,20841,2367,28822,14836,6991,1124,2231,4343
AGAGTTCTTGCAGTTG,sample,83464,81959,10784,71175,16319,54856,12629,381,23670,2288,36299,15888,6262,1029,5207,10011
GACGTATGTGCAGTTG,sample,33172,32134,7401,24733,3966,20767,3831,215,9438,1011,13269,6272,4722,780,1047,2184
CATAATGGTGCAGTTG,sample,50730,49214,12096,37118,6274,30844,4696,160,13911,1665,18607,10412,6352,630,1921,3349
GAGCCTCCTGCAGTTG,sample,59429,58098,10367,47731,7931,39800,8407,430,18287,1981,26694,10695,6546,1115,2503,4521
CATACTCCTGCAGTTG,sample,92848,90825,15295,75530,21411,54119,14544,732,20728,2227,35272,15888,6309,1070,7739,11132
GGTAGAGATGCAGTTG,sample,110262,106947,22495,84452,14377,70075,11895,585,30749,3475,42644,23371,9522,1340,4452,8324
TGGATCAATGCAGTTG,sample,37459,36985,8251,28734,2955,25779,2681,124,12077,1368,14758,9529,6141,652,517,1487
ATGGCGTTTGCAGTTG,sample,99699,98648,9727,88921,24368,64553,17797,760,24436,3257,42233,18303,7136,1308,8726,15131
AGCGTCTTTGCAGTTG,sample,92315,91369,7871,83498,29255,54243,22189,787,17786,1808,39975,11673,4676,954,12880,16744
CTAAGCATTGCAGTTG,sample,56959,56111,11350,44761,8064,36697,5598,323,16038,1758,21636,12980,6872,938,2026,4711
AAGGTCTGTGCAGTTG,sample,87948,87059,10972,76087,23149,52938,15298,959,20126,1940,35424,14615,6903,1248,6320,13605
TGCGCTCCTGCAGTTG,sample,93693,92594,14266,78328,14224,64104,12754,484,27387,3025,40141,20454,8918,1301,4213,8391
GGCGTACCTGCAGTTG,sample,93189,91957,17488,74469,9768,64701,9645,456,28580,2939,38225,23081,9940,1357,2432,5603
CGCGGTCGTGCAGTTG,sample,132832,131098,20716,110382,14884,95498,12509,497,41929,4711,54438,35852,12450,1739,3773,9158
CGTAGAACTGCAGTTG,sample,115493,114222,10981,103241,29753,73488,17639,796,30852,3175,48491,21026,8903,1287,6966,18555
GCGCAATATGCAGTTG,sample,50936,50468,4697,45771,15548,30223,10440,741,10855,1408,21295,6779,4890,945,4442,8897
AACCGGTTTCATGCTG,sample,15655,15517,1618,13899,4659,9240,2612,146,3770,424,6382,2288,2279,490,1199,2557
AGCTGAATTCATGCTG,sample,121178,119149,19766,99383,24381,75002,15552,424,31040,3424,46592,24562,8170,1281,7895,14302
TATACGGATCATGCTG,sample,76482,75705,10351,65354,12575,52779,10101,389,21898,2387,31999,18004,7240,1040,4976,8201
CTAGCGACTCATGCTG,sample,39499,38232,10618,27614,2738,24876,2672,175,11679,1194,14351,9156,5855,553,618,1203
CGTCGCCATCATGCTG,sample,80865,79107,14874,64233,11986,52247,10928,326,21741,2247,32669,17005,7572,969,5719,7147
TCATACCATCATGCTG,sample,164855,161858,29071,132787,20006,112781,20019,1201,49229,4977,69248,37355,11876,2223,3584,11988
GCAACTAGTCATGCTG,Neg_Ctrl,1373,542,378,164,30,134,23,4,57,7,80,43,63,18,6,4
GACTCAAGTCATGCTG,sample,54525,53514,9911,43603,8870,34733,7165,324,14748,1642,21913,10854,6328,905,3184,5123
CCGCAGTCTCATGCTG,sample,108377,106955,12579,94376,32406,61970,20350,1203,23451,2367,43801,14599,6663,1113,9189,17041
TGCGCGTTTCATGCTG,Neg_Ctrl,1929,969,607,362,75,287,55,4,126,13,181,89,134,22,16,15
ACGCTTAATCATGCTG,sample,110667,108607,21631,86976,14430,72546,12049,511,32038,3178,44087,24770,9973,1401,3571,7958
AAGGTCTGTCATGCTG,sample,66804,65246,12751,52495,9635,42860,8232,336,18279,1980,26511,14033,7205,878,3687,5687
CTAACCGGTCATGCTG,Neg_Ctrl,1509,716,469,247,54,193,48,2,83,7,131,53,94,11,20,9
GGCGACGATCATGCTG,sample,92769,90991,18368,72623,10011,62612,12074,620,27669,2899,39743,19350,9262,1513,2653,6417
TGCGCTCCTCATGCTG,sample,57215,56338,8734,47604,11337,36267,8345,402,14877,1456,23222,11187,5665,782,3482,6633
GGCGTACCTCATGCTG,sample,143811,141520,26724,114796,21119,93677,16930,758,38950,4745,55880,32294,11455,1655,5897,11690
CAGCTTCGTCATGCTG,Neg_Ctrl,1514,643,459,184,37,147,40,3,59,6,99,39,82,14,11,4
TCTCCTAGTCATGCTG,sample,140859,138659,26903,111756,19197,92559,15597,801,39412,4228,55009,32521,10875,1518,5470,11319
TAACGCCATCATGCTG,sample,56024,55261,8997,46264,10071,36193,8519,421,14914,1361,23433,10978,5134,788,4028,5823
GACTAACCTCATGCTG,sample,36361,35656,7526,28130,3735,24395,5066,256,11132,1109,16198,6832,5094,937,864,2090
CGCGAGACTCATGCTG,sample,61105,60162,11095,49067,7489,41578,6498,276,18400,1939,24898,14465,7122,850,1900,4340
AGATACTATCATGCTG,sample,78491,76832,14852,61980,10352,51628,8885,372,22261,2264,31146,17846,7825,949,2792,5534
CCTAACTATCATGCTG,sample,95831,93894,16741,77153,11235,65918,10533,462,28916,3281,39449,22726,9018,1135,3699,6288
AACCGGTTTTAGGCGG,sample,132387,130025,26090,103935,16415,87520,13413,800,38584,4287,51997,30436,10690,1800,3816,9347
TCTAGGTTTTAGGCGG,sample,274874,270555,48195,222360,34857,187503,28473,1095,83763,8513,112236,65659,15501,2551,9277,20344
CTGGTCTTTTAGGCGG,Pos_Ctrl,131797,126632,15171,111461,4647,106814,89282,7298,7177,959,96459,2098,7808,9985,6299,2339
TATACGGATTAGGCGG,Pos_Ctrl,125820,121524,14270,107254,4519,102735,85116,7160,7248,938,92364,2273,7862,9975,6136,2013
GGAGAAGCTTAGGCGG,sample,38581,37955,7948,30007,6360,23647,4016,208,10294,1095,14310,8034,5266,701,1718,3591
CTAGCGACTTAGGCGG,sample,222969,218580,32553,186027,34693,151334,28724,1076,63869,6690,92593,50975,12930,2029,14778,20884
CGTCGCCATTAGGCGG,sample,179519,177088,30976,146112,24739,121373,22797,1212,52877,5854,75674,38633,12290,2108,7597,14576
TCTCAGGATTAGGCGG,sample,210764,207627,33462,174165,45893,128272,29691,1888,51862,5863,81553,38968,8472,1723,12943,27270
GATGCGTTTTAGGCGG,sample,116121,113558,18320,95238,23614,71624,19102,805,28871,3238,47973,19608,7884,1218,9999,14203
TAGCGAGTTTAGGCGG,sample,188408,184550,27523,157027,29501,127526,22396,860,55759,5260,78155,43251,11682,1814,9420,17853
GAGATTCTTTAGGCGG,sample,256460,249941,56141,193800,29129,164671,23188,1129,74091,7614,97279,58649,15251,2550,5540,16648
TAACGAAGTTAGGCGG,sample,82968,81078,17475,63603,8221,55382,10227,574,25071,2905,35298,16605,7804,1187,2471,4513
GCTGCTTCTTAGGCGG,sample,126815,123669,23220,100449,20987,79462,16273,730,33100,3538,49373,25821,8982,1333,6924,12284
GCGTTACCTTAGGCGG,sample,98149,96549,13056,83493,21877,61616,15655,527,25664,2432,41319,17338,6537,1051,7522,13382
GGCGTACCTTAGGCGG,sample,17819,17416,4294,13122,2095,11027,1591,78,4873,521,6464,3964,3025,377,522,1027
CGCGGTCGTTAGGCGG,sample,53321,52250,9386,42864,8632,34232,5937,348,14772,1652,20709,11523,5923,775,1963,5059
TAACGCCATTAGGCGG,sample,136329,133548,27329,106219,12315,93904,12571,439,42223,4443,54794,34228,10706,1486,3456,6207
CGCGAGACTTAGGCGG,sample,119114,117454,14533,102921,27659,75262,18457,1134,30876,3280,49333,21515,8360,1273,8339,16414
CCTAACTATTAGGCGG,sample,104950,103704,11507,92197,24255,67942,18876,821,25953,2995,44829,19297,7025,1214,8026,14621
TTAACTGATTAGGCGG,sample,163588,161397,22177,139220,21881,117339,21261,1419,52187,5026,73448,37446,11062,1925,5710,12872
GACGTATGTCAGATAC,sample,80803,79710,11846,67864,19676,48188,11367,577,19482,2159,30849,14603,6144,884,5819,11227
GGAGAAGCTCAGATAC,sample,95473,93982,17649,76333,14440,61893,10257,287,27041,2655,37298,21653,8661,1016,4915,8244
GGTAGAGATCAGATAC,sample,162817,157347,37666,119681,16239,103442,12641,588,47527,5042,60168,37644,11729,1520,3256,8740
TCATCGAATCAGATAC,sample,91067,88993,18864,70129,15053,55076,12061,499,23632,2461,35693,16423,7988,1074,5359,8762
ATTCAAGGTCAGATAC,sample,98684,97359,11097,86262,22851,63411,17747,929,24676,2506,42423,17553,5795,1072,9481,13906
TGATTCCGTCAGATAC,sample,177284,174084,40955,133129,25524,107605,22117,1098,41989,4505,64106,37896,9238,1492,10199,13536
GACTCAAGTCAGATAC,sample,179361,174462,41165,133297,14180,119117,13237,557,53255,5665,66492,46403,13579,1765,3363,7563
CCGCAGTCTCAGATAC,sample,57090,55645,13714,41931,5854,36077,4385,239,16670,1624,21055,13159,6688,718,1362,3174
ACGCTTAATCAGATAC,sample,121692,119036,21718,97318,15847,81471,13153,648,35131,3569,48284,28970,9135,1296,4714,9532
TAGCGAGTTCAGATAC,sample,92096,90586,16617,73969,12906,61063,12129,524,25936,2654,38065,19820,7781,1018,5494,7394
CTAAGCATTCAGATAC,sample,36782,35631,12800,22831,1296,21535,1511,64,10294,1116,11805,8550,5458,285,95,441
GCGTTACCTCAGATAC,sample,44130,43311,10057,33254,5391,27863,5146,232,12003,1225,17149,9257,5845,710,1985,2886
GGCGTACCTCAGATAC,sample,34911,34414,5249,29165,8038,21127,5358,290,8496,865,13854,6118,3806,593,2336,4696
CGCGGTCGTCAGATAC,sample,12754,12484,3151,9333,1599,7734,1318,70,3301,351,4619,2694,2208,222,638,970
TCTCCTAGTCAGATAC,sample,7086,6892,2119,4773,524,4249,544,24,1943,207,2487,1531,1530,136,180,238
ATTCTACCTCAGATAC,sample,43801,42734,12361,30373,2899,27474,3720,175,12653,1366,16373,9560,6015,701,618,1348
CCTAACTATCAGATAC,sample,69885,68631,13746,54885,9656,45229,8180,408,19140,2098,27320,15403,7187,993,2846,5526
TCTAGGTTTCGCTAGG,sample,248219,244846,29984,214862,26033,188829,28120,1534,82275,8855,110395,68045,14442,2911,8942,14936
GTCGTTCTTCGCTAGG,Neg_Ctrl,3465,1341,1105,236,46,190,58,4,77,15,135,36,100,13,29,4
GACGTATGTCGCTAGG,sample,60315,59127,9642,49485,12600,36885,10635,659,14291,1632,24926,9668,5016,829,5194,7708
CATAATGGTCGCTAGG,sample,75842,74012,18765,55247,8505,46742,7989,518,19613,2238,27602,16384,7594,1002,3143,4580
TATACGGATCGCTAGG,sample,49852,48678,11258,37420,5292,32128,4889,256,14098,1427,18987,11458,6043,737,1994,2660
GGAGAAGCTCGCTAGG,Neg_Ctrl,2133,1212,680,532,77,455,102,4,187,13,289,149,219,37,33,20
CGTCGCCATCGCTAGG,sample,52164,51016,8111,42905,9743,33162,11027,429,11923,1254,22950,8529,5009,1058,3831,6095
TGATTCCGTCGCTAGG,sample,62819,60701,15296,45405,6997,38408,5928,323,16660,1673,22588,13824,7292,855,2031,3913
GCAACTAGTCGCTAGG,sample,37327,36704,7560,29144,4520,24624,3762,141,10935,1084,14697,8702,6078,718,1330,2647
TACGCGAGTCGCTAGG,sample,127377,123637,27661,95976,16402,79574,14550,947,33278,3497,47828,27302,9592,1264,7094,9954
GGCAGGTTTCGCTAGG,sample,39103,38387,5945,32442,8230,24212,7125,421,9355,1069,16480,6242,4174,819,3216,4871
GATGCGTTTCGCTAGG,sample,62515,60184,16428,43756,5554,38202,5258,231,17185,1818,22443,13710,7214,760,1729,2953
CCATTCTTTCGCTAGG,sample,69507,68226,13364,54862,12180,42682,10250,377,17583,1950,27833,12522,6015,823,5692,7298
GAGATTCTTCGCTAGG,sample,226400,220986,40863,180123,25488,154635,24048,966,69958,7357,94006,52306,12325,2079,4131,15432
TAACGAAGTCGCTAGG,sample,75015,73078,19686,53392,5745,47647,5962,239,20809,2236,26771,18401,8228,842,2000,2806
GCCTATTCTCGCTAGG,sample,62902,61043,17148,43895,5372,38523,5316,222,16966,1753,22282,14266,7969,719,1951,2608
TGCGCTCCTCGCTAGG,sample,100593,98519,20304,78215,9653,68562,9744,607,30146,3445,39890,24620,10128,1254,2821,5128
GTCGCGAATCGCTAGG,sample,15070,14478,4720,9758,1355,8403,1120,76,3694,380,4814,3133,2660,238,434,641
TCTCCTAGTCGCTAGG,sample,18171,17648,4873,12775,2144,10631,1808,108,4698,527,6506,3490,3050,355,596,1070
ATGAATAGTCGCTAGG,sample,19180,18720,4651,14069,3006,11063,2291,78,4687,519,6978,3488,3142,372,1098,1619
AAGTAGAGTCGCTAGG,sample,16346,15956,3995,11961,1947,10014,1617,65,4259,447,5876,3626,2942,267,811,1078
ATTCTACCTCGCTAGG,Pos_Ctrl,42951,42019,5097,36922,1741,35181,29605,2445,2238,234,31843,659,5664,5909,1858,911
CGTAGAACTCGCTAGG,sample,65222,63762,13793,49969,8432,41537,7175,244,17724,1719,24899,14675,7102,731,2890,4710
AGATACTATCGCTAGG,sample,136472,133630,30317,103313,12588,90725,11509,433,40240,4117,51749,34426,11750,1383,3239,6595
AACCGGTTCCGTTGCG,sample,134413,133479,12333,121146,36947,84199,26001,1179,32452,3910,58453,20657,8576,1779,13019,21496
GAGCCTCCCCGTTGCG,sample,68641,67769,9315,58454,14460,43994,11778,683,18510,1751,30288,11272,5859,1116,5745,8552
TCATACCACCGTTGCG,sample,98368,96141,18796,77345,18197,59148,13656,589,23636,2780,37292,18487,7380,1140,6245,10510
CCGTACGCCCGTTGCG,sample,152959,149229,33201,116028,17853,98175,14007,784,44200,4626,58207,34558,11338,1609,4799,10092
TGCGCGTTCCGTTGCG,sample,161609,158484,29862,128622,24037,104585,19920,741,44491,4686,64411,34747,10811,1480,8812,14464
CCATTCTTCCGTTGCG,sample,59852,58336,16729,41607,4277,37330,4611,217,17023,1747,21634,13732,6771,804,1201,1683
CATTCGGTCCGTTGCG,sample,177595,173737,44708,129029,20698,108331,17962,755,45937,5012,63899,38665,11510,1746,6683,10703
TAGCGAGTCCGTTGCG,sample,39526,38831,7915,30916,6332,24584,5740,286,10765,1131,16505,6662,4716,819,2207,3717
GCTCTTCTCCGTTGCG,sample,129028,126374,31657,94717,14281,80436,12485,545,36283,4059,48768,27064,10857,1510,4258,7480
CTAAGCATCCGTTGCG,sample,125243,122826,28382,94444,15022,79422,14157,772,34979,3598,49136,25916,9380,1414,5507,7886
AAGGTCTGCCGTTGCG,sample,114038,112450,19759,92691,24153,68538,16884,636,27513,2821,44397,20684,8248,1194,9361,13666
CCTAGCGGCCGTTGCG,sample,167204,162978,44115,118863,14043,104820,12247,514,47167,5178,59414,39714,13309,1600,3389,6939
GGCGACGACCGTTGCG,sample,79848,78687,15515,63172,15576,47596,11888,407,19273,1984,31161,14044,6181,964,6477,8900
AGCAGAGCCCGTTGCG,sample,65029,63726,15646,48080,10470,37610,8153,450,15992,1588,24145,11427,5898,857,3557,5664
TGCGCTCCCCGTTGCG,sample,36615,36014,8279,27735,4972,22763,3448,192,10265,1170,13713,7688,5057,626,1204,2761
AAGTAGAGCCGTTGCG,sample,64069,63222,17865,45357,7619,37738,6026,297,16373,1836,22399,13206,6663,902,2260,3717
ATTCTACCCCGTTGCG,sample,196060,194205,29856,164349,31697,132652,25252,1341,56616,6159,81868,43284,13132,2157,8529,20295
TCTAGGTTAGGCCAAG,sample,251115,246541,39746,206795,33646,173149,31226,1374,73489,7303,104715,59757,14159,2546,12749,20310
GACGTATGAGGCCAAG,sample,51805,50282,11376,38906,5661,33245,6793,362,14614,1572,21407,9904,5330,975,2085,3284
CATACTCCAGGCCAAG,sample,71669,69711,15171,54540,8272,46268,8494,386,20992,2378,29486,14018,7056,1078,2838,4548
GGTAGAGAAGGCCAAG,sample,134736,129862,34341,95521,8130,87391,12880,733,40480,4242,53360,29056,10688,1548,1786,3128
TCATACCAAGGCCAAG,sample,113354,111186,18320,92866,18955,73911,17506,875,29955,3023,47461,22552,8047,1332,6858,11640
TGATTCCGAGGCCAAG,sample,137741,134473,26048,108425,26205,82220,20190,524,31216,3567,51406,26723,8969,1151,11218,14191
GACTCAAGAGGCCAAG,sample,81059,79659,12564,67095,14529,52566,13252,648,22488,2128,35740,14050,7316,1401,4591,8473
ATACGTTCAGGCCAAG,sample,199600,195251,46632,148619,18604,130015,18552,1012,57306,6137,75858,47008,13344,2104,5744,10050
TCTCAGGAAGGCCAAG,sample,100873,99528,15243,84285,19395,64890,14163,467,26766,2856,40929,20638,8040,1117,7445,11673
GGCAGGTTAGGCCAAG,sample,90516,89643,9521,80122,28955,51167,20478,1032,16862,1725,37340,11070,5365,1107,11003,16189
TGCGCGTTAGGCCAAG,sample,161557,160019,23439,136580,31256,105324,22144,876,43669,4558,65813,34077,10195,1499,10614,18716
CCATTCTTAGGCCAAG,sample,67837,67240,8747,58493,14329,44164,9994,400,18452,1929,28446,13389,6852,1091,4558,8139
CGGTTGGTAGGCCAAG,sample,38972,38080,7418,30662,5086,25576,5507,261,11348,1282,16855,7178,5040,843,1983,3053
ACGCTTAAAGGCCAAG,sample,236820,231936,47330,184606,19364,165242,26354,1198,74441,8005,100795,55244,14693,2657,5366,10575
CATTCGGTAGGCCAAG,sample,70042,68213,15669,52544,8667,43877,7712,340,19721,2321,27433,13783,6993,996,2945,4791
TAGCGAGTAGGCCAAG,sample,262100,257570,43042,214528,41230,173298,31586,911,73746,7463,105332,59592,13430,2146,13878,24729
CTAACCGGAGGCCAAG,sample,154314,150392,30597,119795,15772,104023,17109,1061,45103,4689,62212,36061,11038,1696,5002,8841
GGCGACGAAGGCCAAG,sample,92892,90986,18212,72774,14961,57813,11736,559,24212,2721,35948,18585,7803,1080,5269,8504
TAACGAAGAGGCCAAG,sample,211107,206506,40188,166318,26375,139943,22921,933,60353,6117,83274,49619,12955,1885,8284,15715
GGCGTACCAGGCCAAG,sample,323322,315352,71430,243922,25699,218223,28560,1486,98864,10376,127424,78937,17006,3149,4916,12591
ATGAATAGAGGCCAAG,sample,296590,289629,67268,222361,31007,191354,28633,1253,82831,9118,111464,69519,16527,2542,10791,17126
TCAATCAGAGGCCAAG,sample,105600,103381,22110,81271,12990,68281,12071,628,29713,3318,41784,22551,8885,1260,4457,7278
GACTAACCAGGCCAAG,Neg_Ctrl,3182,1693,1042,651,112,539,143,10,202,23,345,161,260,59,47,36
CCTAACTAAGGCCAAG,sample,116808,114255,19852,94403,16868,77535,16325,702,33376,3227,49701,23905,8498,1185,5705,10149
TTAACTGAAGGCCAAG,sample,217603,214288,35705,178583,20244,158339,20636,1052,70856,7175,91492,58620,13031,2056,5603,11622
TCTAGGTTAGAACCGC,sample,127875,126286,20028,106258,20418,85840,18255,671,35901,3821,54156,27192,9222,1600,7765,12318
CTGGTCTTAGAACCGC,sample,261537,256589,44344,212245,40796,171449,33620,1072,70690,7231,104310,58836,13145,2286,16810,24380
GTCGTTCTAGAACCGC,sample,99648,97569,18090,79479,18510,60969,14800,475,25539,2624,40339,17531,7000,1090,7070,10224
AGAGTTCTAGAACCGC,sample,80958,79705,22576,57129,5348,51781,5330,275,23382,2587,28712,20207,8547,994,981,2195
TATACGGAAGAACCGC,sample,57614,56227,13962,42265,7018,35247,6033,300,14911,1591,20944,12412,6360,979,2315,3856
GGAGAAGCAGAACCGC,sample,150175,147822,18537,129285,30067,99218,26061,1520,39380,3736,65441,28521,8465,1404,9517,17839
TCATACCAAGAACCGC,sample,236672,234192,27161,207031,42419,164612,41529,1788,67322,7303,108851,46670,12121,2191,18805,26436
GACTCAAGAGAACCGC,sample,115317,113163,23568,89595,17902,71693,16255,944,30172,3248,46427,21074,9079,1529,7212,10352
TGGATCAAAGAACCGC,sample,139669,137892,19023,118869,30233,88636,20521,897,35617,4199,56138,27402,8839,1416,9729,17904
TGCGCGTTAGAACCGC,sample,192170,190469,27974,162495,39715,122780,32405,1639,49905,5898,82310,32933,8907,1814,10860,23217
CCATTCTTAGAACCGC,sample,210443,207512,32646,174866,31755,143111,29483,1119,59385,6729,88868,46395,10999,1993,12427,18904
AAGGTCTGAGAACCGC,sample,200394,196051,35842,160209,32071,128138,24884,1111,53213,5481,78097,43449,12189,1822,10741,19220
GCCTATTCAGAACCGC,sample,140742,137433,30523,106910,20412,86498,17358,919,36748,3874,54106,27599,10842,1619,6000,11140
GCGTTACCAGAACCGC,sample,50605,48958,13662,35296,5205,30091,4821,232,13137,1361,17958,10540,5575,768,1507,2783
GGCGTACCAGAACCGC,sample,83433,80916,21159,59757,9829,49928,7854,257,21513,2198,29367,18106,7630,869,3312,5047
CGTCGAGGAGAACCGC,sample,29113,28430,7407,21023,3471,17552,2809,126,7785,872,10594,5960,4251,519,1088,1809
GACTAACCAGAACCGC,sample,84711,83233,15623,67610,10339,57271,11758,831,25975,3419,37733,15288,7364,1275,3719,6259
CGCGAGACAGAACCGC,sample,103037,101141,19960,81181,10295,70886,13537,733,31328,3310,44865,21978,9392,1524,3828,5401
GCGCAATAAGAACCGC,sample,95726,94170,21199,72971,6897,66074,11646,686,30368,3251,42014,20123,9281,1582,2134,3468
TTAACTGAAGAACCGC,sample,322611,316386,67840,248546,28297,220249,28797,894,99115,9684,127912,81759,17369,2964,9011,14338
ATATGCAAAGAACCGC,sample,135786,133783,21928,111855,24902,86953,20797,1410,34691,3605,55488,26450,8546,1476,7510,13425
AGAGTTCTCATCAAGC,sample,101078,99290,15640,83650,23594,60056,16691,893,23526,2825,40217,16121,7233,1245,8231,13614
GACGTATGCATCAAGC,sample,142761,139134,24861,114273,27398,86875,21471,956,34526,3801,55997,26121,9205,1381,10885,15906
GGAGAAGCCATCAAGC,sample,76324,74019,19457,54562,6371,48191,6101,357,22064,2329,28165,17340,7781,984,1652,2992
CATACTCCCATCAAGC,sample,108509,105608,22256,83352,16418,66934,14029,620,28549,3048,42578,20688,8271,1309,5216,9718
CTAGCGACCATCAAGC,sample,157442,153637,29521,124116,22478,101638,18768,1200,42969,4922,61737,33779,10038,1615,5824,12877
CGTCGCCACATCAAGC,sample,127364,125337,15488,109849,36429,73420,25992,1111,27827,2748,53819,15742,5143,1168,13236,20843
ATTCAAGGCATCAAGC,sample,98751,93874,18204,75670,16435,59235,13265,491,24672,2841,37937,17966,7906,1209,6274,9536
TGGATCAACATCAAGC,sample,57411,56053,15197,40856,6503,34353,6395,476,15621,1894,22016,9967,6350,975,1964,3479
TGCGCGTTCATCAAGC,sample,135695,133427,21347,112080,28443,83637,24259,1443,33368,3655,57627,20912,8150,1421,12333,17045
AGCGTCTTCATCAAGC,sample,164944,162869,21397,141472,37481,103991,31881,1407,40644,4061,72525,25998,7820,1568,14869,22784
ACGCTTAACATCAAGC,sample,228507,225017,45187,179830,35914,143916,27202,1223,61070,6393,88272,48028,13483,2138,10823,20522
CATTCGGTCATCAAGC,sample,144398,142435,23825,118610,26972,91638,20419,950,38088,4273,58507,27908,9628,1504,9948,15340
TAGCGAGTCATCAAGC,sample,97712,96396,15701,80695,21786,58909,14906,614,24074,2766,38980,16549,7100,1099,6537,12382
GCTCTTCTCATCAAGC,sample,109466,107330,27445,79885,13034,66851,8480,370,30377,3038,38857,24586,9075,1143,2244,6979
GAGATTCTCATCAAGC,sample,191445,187197,30232,156965,29618,127347,28365,1057,53756,5581,82121,38588,10343,2057,10611,17994
TAACGAAGCATCAAGC,sample,148798,145155,35200,109955,11645,98310,14204,927,45446,4605,59650,33128,10692,1708,2733,5731
ATACCGCCCATCAAGC,sample,329461,322158,67337,254821,32923,221898,31433,1366,97373,10307,128806,81419,17695,3161,9938,19371
GCGTTACCCATCAAGC,sample,161635,159636,28889,130747,25057,105690,23479,1289,43154,4729,66633,33039,10985,1807,9161,14574
GGCGTACCCATCAAGC,sample,126964,125401,21397,104004,29086,74918,20539,857,28088,3005,48627,22429,6135,1126,10837,16017
CGTCGAGGCATCAAGC,Pos_Ctrl,82268,79914,10155,69759,3177,66582,56188,4652,3968,531,60156,1243,6831,8230,3793,1711
ATGAATAGCATCAAGC,sample,179971,177533,31659,145874,30792,115082,20385,986,49470,5239,69855,39002,10786,1641,7128,17296
CGCGAGACCATCAAGC,sample,123457,121577,21082,100495,14855,85640,14694,768,38182,4051,52876,27945,10741,1722,3388,8658
CGTAGAACCATCAAGC,sample,232292,228350,42781,185569,31378,154191,27421,941,65791,6946,93212,53092,14322,2209,9846,18564
CCTAACTACATCAAGC,sample,218425,214506,45923,168583,23688,144895,19686,787,64326,6751,84012,53345,13710,2037,5642,13620
GCGCAATACATCAAGC,sample,119474,117593,21488,96105,13057,83048,12091,577,37624,3723,49715,29033,10378,1306,4332,7823
TTAACTGACATCAAGC,sample,144619,143085,16759,126326,28284,98042,23529,1385,37608,4875,61137,30645,8301,1453,10180,17304
ATATGCAACATCAAGC,sample,76302,75395,13282,62113,13426,48687,9565,685,20791,2310,30356,15336,7172,1220,3151,7935
TATACGGAAGAGAGCC,sample,145354,141720,32838,108882,14622,94260,14801,552,40902,4156,55703,33849,11477,1608,5732,7738
GCAACTAGAGAGAGCC,sample,32220,31788,5409,26379,5188,21191,4293,224,9524,1087,13817,6063,4850,876,1490,2901
TACGCGAGAGAGAGCC,sample,81384,80362,7969,72393,25483,46910,16525,779,17089,1605,33614,10912,4036,902,9064,14635
TGGATCAAAGAGAGCC,sample,132159,129241,20741,108500,19386,89114,19295,744,37086,3490,56381,28499,9284,1471,7990,12805
CCATTCTTAGAGAGCC,sample,166409,163133,29118,134015,20721,113294,18873,727,50796,4814,69669,38084,11128,1785,6542,12088
CGGTTGGTAGAGAGCC,sample,74226,72947,12294,60653,11146,49507,9121,344,21680,2509,30801,15853,7644,1077,3408,6124
ACGCTTAAAGAGAGCC,sample,89012,87851,11404,76447,19285,57162,14781,693,22524,2644,37305,16520,6067,1053,7428,11380
GCTCTTCTAGAGAGCC,sample,69426,67825,15486,52339,8952,43387,7150,382,19389,2128,26539,14338,7349,1121,2149,4460
TAACGAAGAGAGAGCC,sample,31119,30717,4890,25827,4633,21194,4456,336,9328,1006,13784,6068,4624,918,1051,2770
GCGTTACCAGAGAGCC,sample,43097,42530,7882,34648,5225,29423,5990,450,13375,1518,19365,8090,5352,892,1643,3092
GTCGCGAAAGAGAGCC,sample,109741,108014,16951,91063,12734,78329,16377,989,35072,4139,51449,21752,8912,1517,3916,8295
TCTCCTAGAGAGAGCC,sample,73812,72992,9301,63691,17529,46162,13601,592,17966,2270,31567,11733,5726,975,6015,10044
ATGAATAGAGAGAGCC,sample,84725,83871,12974,70897,18185,52712,14491,682,19758,2041,34249,15740,6202,1084,6523,10542
AAGTAGAGAGAGAGCC,sample,56616,55732,9937,45795,10256,35539,6876,211,15283,1673,22159,11496,6279,785,2883,5860
GCGCAATAAGAGAGCC,sample,14092,13984,1329,12655,2653,10002,2922,174,4394,425,7316,2087,2620,706,681,1598
GTCGTTCTAGCATTGA,sample,133539,131217,24583,106634,28977,77657,20133,1023,30215,3618,50348,22668,7983,1368,9928,15267
CATAATGGAGCATTGA,sample,135246,132372,20316,112056,27799,84257,21839,927,35554,4085,57393,21852,8035,1326,9009,16893
GGAGAAGCAGCATTGA,sample,216265,210423,41407,169016,24431,144585,21724,879,63840,7079,85564,51063,13886,2254,7438,13157
TCGAACGAAGCATTGA,sample,84025,81338,21935,59403,7441,51962,6171,261,23375,2553,29546,19602,8181,884,1944,3621
GGTAGAGAAGCATTGA,sample,268017,261342,49411,211931,45193,166738,34627,1259,65900,7158,100527,57794,12564,2080,17440,25444
GCAACTAGAGCATTGA,sample,59818,58967,8537,50430,14086,36344,9304,345,15320,1567,24624,9808,6112,960,4659,7937
TACGCGAGAGCATTGA,sample,272302,265649,53650,211999,40992,171007,29094,1491,75473,7779,104567,57170,15029,2293,11660,22743
ATGGCGTTAGCATTGA,sample,318766,313713,41969,271744,64585,207159,49065,2615,82994,9410,132059,63075,14191,2685,21998,39422
TGCGCGTTAGCATTGA,sample,47364,46158,13130,33028,2762,30266,2542,146,13867,1425,16409,12286,6185,499,458,1004
CATTCGGTAGCATTGA,sample,173368,170870,20352,150518,41114,109404,31414,2118,42204,4535,73618,29133,9388,1499,14858,24287
GCTGCTTCAGCATTGA,sample,422586,414407,76563,337844,44964,292880,41427,1513,127785,13144,169212,109011,19423,4018,12388,24309
GGCGTACCAGCATTGA,sample,148210,147012,8812,138200,48262,89938,31478,1798,32695,3412,64173,20555,7020,1530,11754,28834
CAGCTTCGAGCATTGA,Neg_Ctrl,2986,1206,805,401,81,320,99,1,115,12,214,93,165,27,24,11
TCTCCTAGAGCATTGA,sample,220328,218513,21643,196870,49874,146996,33084,1323,61086,6478,94170,45025,9921,2098,13653,31501
AAGTAGAGAGCATTGA,sample,198036,196438,26322,170116,33727,136389,32555,1188,56453,6705,89008,39488,12509,2241,14376,19735
ATTCTACCAGCATTGA,sample,122198,121004,11694,109310,42751,66559,25053,1400,23835,2504,48888,13767,6298,1158,11698,23368
CCTAACTAAGCATTGA,sample,328606,324992,48359,276633,51021,225612,41201,1544,95303,9795,136504,77769,17107,3262,16007,30818
AGCTGAATAATTACCA,sample,124383,120148,28857,91291,12956,78335,13025,568,34126,3532,47151,27084,9390,1210,4660,7034
CTAGCGACAATTACCA,sample,292782,287962,56030,231932,35274,196658,32378,1491,84839,10190,117217,67760,15902,2634,12576,19587
CGTCGCCAAATTACCA,sample,62545,61620,10104,51516,17143,34373,9161,643,13243,1395,22404,9931,5749,1165,3971,9074
ATTCAAGGAATTACCA,sample,170787,168738,25269,143469,28121,115348,27949,937,46846,5049,74795,34567,10002,1710,11259,17394
GACTCAAGAATTACCA,sample,253523,250303,39109,211194,33638,177556,30232,1321,79408,8474,109640,58121,14269,2613,9671,19850
CCGCAGTCAATTACCA,sample,303073,297701,51146,246555,37086,209469,34507,1337,91966,10127,126473,71532,14163,2583,11146,21784
GATGCGTTAATTACCA,sample,97630,95444,24726,70718,9781,60937,8650,348,27445,2723,36095,21771,8913,1109,2549,5295
GCTCTTCTAATTACCA,sample,160393,158031,28003,130028,30527,99501,23160,889,39649,4443,62809,31360,9531,1396,10831,16765
GCTGCTTCAATTACCA,sample,164647,160990,37578,123412,16513,106899,16701,880,47396,5271,64097,36651,11303,1778,4388,8445
AGCAGAGCAATTACCA,sample,160390,158036,30999,127037,19202,107835,20824,1148,46103,5093,66927,34667,11386,1866,6834,11020
TGCGCTCCAATTACCA,sample,231454,227050,52504,174546,23955,150591,23682,866,65520,6800,89202,53723,14134,2004,8890,14532
GCGTTACCAATTACCA,sample,83498,80942,23871,57071,7268,49803,6621,285,22508,2332,29129,18057,7961,962,2005,3381
CGCGAGACAATTACCA,sample,222554,218911,40208,178703,25843,152860,25894,825,64322,6178,90216,55641,12683,2179,8270,15515
CGTAGAACAATTACCA,sample,112883,110987,22465,88522,18673,69849,13909,703,28951,3090,42860,23196,8229,1240,4796,10791
AGATACTAAATTACCA,sample,109382,107682,20916,86766,17162,69604,12508,696,30024,3417,42532,22959,8255,1104,4951,9953
AACCGGTTTAGATGAC,sample,45322,45016,3725,41291,15225,26066,10171,415,9180,989,19351,5311,3681,828,5616,8354
TCTAGGTTTAGATGAC,sample,169164,167691,14061,153630,35143,118487,29950,925,47680,5711,77630,34221,9724,1801,15811,23495
CTGGTCTTTAGATGAC,Pos_Ctrl,146592,142504,17207,125297,5724,119573,100501,8387,7298,995,107799,2392,7697,10239,7688,3025
TATACGGATAGATGAC,sample,83334,82163,14313,67850,17338,50512,11735,754,21069,2397,32804,14557,7307,1363,4462,9728
GGAGAAGCTAGATGAC,sample,238037,234927,42165,192762,35109,157653,27586,1674,66205,6782,93791,55406,12213,2378,11833,20557
CATACTCCTAGATGAC,Pos_Ctrl,128632,122671,16987,105684,5404,100280,83715,6984,6685,870,90400,2026,7558,9712,6157,2888
ATTCAAGGTAGATGAC,sample,223099,219916,41492,178424,29207,149217,26291,947,64358,7343,90649,50278,13315,2315,9510,16592
TGATTCCGTAGATGAC,Pos_Ctrl,103257,100260,13347,86913,4349,82564,69641,5655,5065,603,74706,1600,7158,8896,5256,2130
TACGCGAGTAGATGAC,sample,155109,151180,38927,112253,14973,97280,14470,788,42873,4661,57343,34488,11352,1747,3934,6984
ATACGTTCTAGATGAC,sample,83287,81800,15662,66138,11858,54280,13007,795,24382,2634,37389,13462,6806,1377,3542,7240
TGGATCAATAGATGAC,sample,161811,158724,26729,131995,24450,107545,20226,909,44954,5026,65180,36430,10764,1582,8148,14765
GATGCGTTTAGATGAC,sample,108462,106437,17986,88451,20593,67858,18821,795,25635,3243,44456,19364,7745,1297,8214,12051
CGGTTGGTTAGATGAC,sample,72658,71419,13586,57833,8279,49554,11597,723,21644,2575,33241,13015,6981,1300,2756,4895
CATTCGGTTAGATGAC,sample,159197,156653,28215,128438,27756,100682,22705,1357,41912,4222,64617,30486,9284,1609,9490,16219
TAGCGAGTTAGATGAC,sample,248619,244980,43071,201909,36004,165905,35178,1477,71043,7498,106221,50709,12413,2476,13581,21750
CCTAGCGGTAGATGAC,sample,43080,42129,9880,32249,6245,26004,5187,215,10818,1154,16005,8630,5090,621,2390,3351
GGCGACGATAGATGAC,sample,45113,43836,10884,32952,4188,28764,4479,257,13161,1426,17640,9441,5586,831,1092,2226
TAACGAAGTAGATGAC,sample,57947,56730,10977,45753,6889,38864,7184,354,17154,1766,24338,12406,6340,841,3003,4247
AGCAGAGCTAGATGAC,sample,137123,133331,31843,101488,12016,89472,12442,487,39820,4210,52262,32513,12041,1500,4657,6155
TGCGCTCCTAGATGAC,sample,40608,39428,10960,28468,4347,24121,3412,151,10563,1089,13975,8906,4965,587,1017,2100
GGCGTACCTAGATGAC,sample,31300,30289,9892,20397,2411,17986,1946,84,8009,818,9955,7129,4513,357,676,1043
GTCGCGAATAGATGAC,sample,19923,19154,5954,13200,1590,11610,1296,54,5371,576,6667,4313,3404,251,445,718
AAGTAGAGTAGATGAC,sample,40739,39625,11641,27984,3487,24497,3253,141,11017,1145,14270,8941,5795,609,1060,1668
GACTAACCTAGATGAC,sample,297911,291614,57296,234318,34868,199450,33525,1781,87564,9359,121089,67221,15461,2882,11095,20702
CGTAGAACTAGATGAC,sample,198674,194975,40643,154332,28303,126029,25099,1245,54604,5846,79703,39235,11944,1929,8341,15451
GACGTATGGTTCAGAA,sample,53988,51917,13376,38541,4643,33898,5405,328,15517,1747,20922,10901,6397,901,1407,2386
GAGCCTCCGTTCAGAA,sample,39594,38142,12097,26045,2190,23855,2821,147,11250,1210,14071,8427,5418,643,505,937
TCATACCAGTTCAGAA,sample,81230,80638,6664,73974,20441,53533,16343,742,20265,2294,36608,13889,6929,1342,8180,12730
GCAACTAGGTTCAGAA,sample,45990,45406,4970,40436,10289,30147,8070,386,12216,1499,20286,7976,5569,997,3570,6427
TACGCGAGGTTCAGAA,sample,110685,109739,10496,99243,31283,67960,22331,745,25778,3042,48109,16064,6991,1361,9971,17927
ATACGTTCGTTCAGAA,sample,145797,144177,22113,122064,22504,99560,21076,824,43365,4871,64441,29424,10191,1756,9751,13729
CCGTACGCGTTCAGAA,sample,190028,186964,28531,158433,29329,129104,22745,938,55469,5867,78214,44085,11962,2133,9153,17867
ATGGCGTTGTTCAGAA,sample,282184,279018,45783,233235,45916,187319,34402,1470,79157,7625,113559,64665,14461,2514,15320,26168
TGCGCGTTGTTCAGAA,sample,143035,141269,22691,118578,24128,94450,18910,682,40456,4107,59366,30295,10013,1613,7958,14346
CCATTCTTGTTCAGAA,sample,108685,106650,19242,87408,15640,71768,13310,616,31709,3182,45019,22951,8768,1315,5876,8971
AGCGTCTTGTTCAGAA,sample,192688,190281,19400,170881,36834,134047,31756,1542,52543,5569,84299,42637,8865,1811,13357,22037
GGCGACGAGTTCAGAA,sample,60110,58549,16522,42027,6300,35727,6042,256,15431,1790,21473,12208,6570,949,1648,3104
GCTGCTTCGTTCAGAA,sample,48626,47688,9557,38131,8705,29426,6490,461,12640,1415,19130,8420,5917,968,2557,4828
TTATGACGGTTCAGAA,sample,21360,20742,5410,15332,2504,12828,2248,82,5616,634,7864,4248,3396,421,994,1298
CCTAACTAGTTCAGAA,Pos_Ctrl,101987,98021,10986,87035,3807,83228,70310,5771,4969,619,75279,1559,7078,8792,4352,1822
TTAACTGAGTTCAGAA,sample,50553,50008,2146,47862,19733,28129,16858,872,7452,708,24310,2239,1566,581,8523,10950
GTCGTTCTTTCTGGTT,Neg_Ctrl,3344,1149,912,237,56,181,44,1,68,4,112,64,86,18,18,4
TATACGGATTCTGGTT,sample,173610,171424,26635,144789,22318,122471,20657,834,53928,5515,74585,41537,12283,1980,7624,13300
GAGCCTCCTTCTGGTT,sample,103368,101064,27890,73174,6456,66718,7518,387,30930,3284,38448,24599,10483,1384,1466,2622
CTAGCGACTTCTGGTT,Neg_Ctrl,2690,1248,842,406,63,343,90,6,148,15,238,84,177,46,29,10
GGTAGAGATTCTGGTT,sample,237078,233617,22845,210772,47140,163632,41198,2191,65476,6620,106674,48147,11743,2485,16329,30959
GCAACTAGTTCTGGTT,Neg_Ctrl,2170,689,528,161,31,130,27,3,72,3,99,25,80,21,13,3
ATACGTTCTTCTGGTT,sample,39164,38508,7970,30538,5933,24605,4571,247,10733,1045,15304,8009,5012,754,1814,3365
GGCAGGTTTTCTGGTT,sample,101220,98825,24381,74444,13925,60519,9836,461,26221,2865,36057,21136,8523,1112,3608,7806
CGGTTGGTTTCTGGTT,sample,118684,116880,17519,99361,18116,81245,16609,582,33963,3654,50572,26437,9831,1501,6765,10626
CATTCGGTTTCTGGTT,sample,72395,70728,15079,55649,8026,47623,6700,292,21381,2288,28081,16962,7982,972,2251,4333
CTAACCGGTTCTGGTT,sample,68399,67140,11766,55374,15758,39616,10614,357,15387,1648,26001,11610,5870,897,5523,8778
AGCAGAGCTTCTGGTT,sample,23949,23477,4547,18930,4241,14689,3037,156,6397,680,9434,4419,3732,568,1317,2425
ATACCGCCTTCTGGTT,sample,13184,12720,4241,8479,919,7560,957,41,3509,407,4466,2646,2519,237,261,411
GTCGCGAATTCTGGTT,sample,163578,160832,28634,132198,16848,115350,15481,845,51913,5736,67394,41375,12065,1716,3906,10116
TCTCCTAGTTCTGGTT,sample,23998,23320,5446,17874,3129,14745,3055,105,5978,686,9033,4921,3464,557,1225,1716
TAACGCCATTCTGGTT,sample,198218,194131,38715,155416,20341,135075,21128,1485,58032,6527,79160,47903,13559,1967,6960,11413
TCTAGGTTGTTCGGTT,sample,236553,234852,33627,201225,46997,154228,36480,1427,61649,6167,98129,48505,12042,2473,17196,28254
TCGAACGAGTTCGGTT,sample,223545,217472,51661,165811,24086,141725,20379,657,61728,6519,82107,52442,14784,1975,7346,12996
ATTCAAGGGTTCGGTT,sample,143943,141224,21207,120017,28951,91066,22381,887,36233,3958,58614,27607,9614,1577,10479,17375
ATACGTTCGTTCGGTT,sample,196833,192344,36755,155589,29225,126364,23083,916,53440,5762,76523,43163,11335,1855,8799,17261
TCTCAGGAGTTCGGTT,sample,131877,129125,22976,106149,17908,88241,13365,704,39192,3986,52557,30994,10547,1453,5019,10474
AGCGTCTTGTTCGGTT,sample,116564,113971,20206,93765,18558,75207,13755,771,32515,3270,46270,24896,9027,1511,4630,10957
CGGTTGGTGTTCGGTT,sample,43887,42728,9225,33503,5931,27572,5008,183,11899,1245,16907,9237,5532,654,2297,3223
ACGCTTAAGTTCGGTT,sample,138964,136357,19721,116636,23118,93518,19744,882,40095,4416,59839,28381,9152,1456,7375,14037
TAGCGAGTGTTCGGTT,sample,166732,164589,21037,143552,41191,102361,31563,1290,38660,5261,70223,25587,8279,1567,14897,25068
GCTCTTCTGTTCGGTT,sample,233438,229256,36454,192802,40528,152274,32004,1103,62918,7071,94922,49178,12442,1962,14024,23800
GCGTTACCGTTCGGTT,sample,104265,101295,26646,74649,11266,63383,9920,391,27166,2941,37086,22965,9936,1089,3992,6059
TTATGACGGTTCGGTT,sample,33919,33368,6485,26883,4998,21885,4332,229,9680,1147,14012,6497,4675,701,1727,2928
TCTCCTAGGTTCGGTT,sample,70765,69450,12971,56479,9519,46960,8447,370,20743,2286,29190,15114,7730,1111,3204,5400
TCAATCAGGTTCGGTT,sample,149936,148404,20102,128302,19255,109047,24739,1605,46797,5530,71536,30376,10816,2003,5975,11340
TAACGCCAGTTCGGTT,sample,83977,83280,7225,76055,21494,54561,19978,1016,20756,2358,40734,10453,5518,1064,9688,12750
CGCGAGACGTTCGGTT,sample,185007,182876,19124,163752,41534,122218,31321,1594,50325,5271,81646,33707,11018,1982,13672,24529
CCTAACTAGTTCGGTT,sample,271090,267380,42779,224601,35605,188996,30104,1325,82581,8375,112685,66611,16549,2882,8907,21488
GCGCAATAGTTCGGTT,Neg_Ctrl,2292,1068,638,430,82,348,92,6,139,9,231,102,187,36,29,16
AACCGGTTTGGCGGTT,sample,270080,266356,33145,233211,60848,172363,51930,2258,67216,8161,119146,42798,11318,2171,26034,36489
AGAGTTCTTGGCGGTT,sample,85330,83341,17932,65409,8837,56572,7115,321,25498,2874,32613,20764,9138,1176,1700,5063
GGAGAAGCTGGCGGTT,sample,950431,932910,166034,766876,61059,705817,69826,3320,320761,34131,390587,277779,26549,9084,10542,30703
CGTCGCCATGGCGGTT,sample,324622,319278,41497,277781,78448,199333,47931,2892,82083,8784,130014,57643,12200,2368,18211,45667
GCAACTAGTGGCGGTT,sample,37535,36988,4694,32294,6391,25903,6489,386,11419,1218,17908,6391,5151,1156,1944,3893
GACTCAAGTGGCGGTT,sample,245245,240201,42376,197825,28397,169428,22907,976,74466,7781,97373,63298,15310,2596,7831,16366
CCGTACGCTGGCGGTT,sample,188081,185294,26406,158888,41073,117815,32730,1733,48665,5615,81395,29072,9597,1867,14989,23810
GATGCGTTTGGCGGTT,sample,253020,250416,17420,232996,97767,135229,50284,1851,46863,4789,97147,31442,7466,1540,27754,51752
AGCGTCTTTGGCGGTT,sample,98285,97525,7774,89751,23211,66540,19210,725,26779,2956,45989,16870,7419,1375,9612,14206
AAGGTCTGTGGCGGTT,sample,157136,151992,35598,116394,14162,102232,13233,505,46623,4619,59856,37252,11830,1519,3816,7698
CTAACCGGTGGCGGTT,sample,132645,130136,21476,108660,18407,90253,19928,1034,38086,4571,58014,26634,9445,1803,5359,10694
CGTCGAGGTGGCGGTT,sample,79852,78582,12881,65701,12879,52822,10436,397,22645,2267,33081,17077,8367,1159,4798,7796
TTATGACGTGGCGGTT,sample,100586,98436,16060,82376,13538,68838,14604,927,30542,3559,45146,19206,7777,1285,4555,8012
ATTCTACCTGGCGGTT,sample,340645,334061,55955,278106,46459,231647,38145,1906,98509,11446,136654,81641,16763,3037,13613,28608
CCTAACTATGGCGGTT,sample,189630,188122,19995,168127,41619,126508,23764,1141,53682,6052,77446,41869,12285,2296,8953,24707
AACCGGTTTCCTTATT,sample,145592,143009,28959,114050,15940,98110,14004,698,43096,4940,57100,35372,11402,1738,5025,9418
CTGGTCTTTCCTTATT,sample,98605,97187,10639,86548,25647,60901,18444,899,22448,2135,40892,16975,5537,1113,9661,15042
AGAGTTCTTCCTTATT,sample,61958,61111,6200,54911,18598,36313,15674,567,11664,1168,27338,7240,3648,808,9612,10668
CATAATGGTCCTTATT,sample,140792,136871,33223,103648,12034,91614,10993,463,39991,4345,50984,35822,11919,1513,3117,5716
TATACGGATCCTTATT,sample,72627,71273,13466,57807,11753,46054,10512,480,19669,2242,30181,13151,6733,1012,4733,6687
GAGCCTCCTCCTTATT,sample,107480,105360,20747,84613,10372,74241,11909,512,32458,3404,44367,25958,9580,1317,4141,5560
ATTCAAGGTCCTTATT,sample,55816,55329,7089,48240,11005,37235,9623,461,14879,1562,24502,10710,5935,1102,4227,6661
GCAACTAGTCCTTATT,sample,41742,41314,8451,32863,4754,28109,3532,180,12575,1292,16107,10530,6861,761,1049,2214
GGCAGGTTTCCTTATT,sample,53609,53102,6898,46204,10472,35732,10304,411,14977,1578,25281,8462,4981,900,4285,6574
AAGGTCTGTCCTTATT,sample,51050,50417,8229,42188,7674,34514,7713,385,14818,1777,22531,9821,5546,1030,2965,4545
CCTAGCGGTCCTTATT,sample,33166,32809,2831,29978,9659,20319,7095,218,7743,741,14838,4522,3457,626,3658,5683
CTAACCGGTCCTTATT,sample,77959,77167,9452,67715,17380,50335,15307,602,19529,2230,34836,12667,5636,1022,6850,10328
GGCGACGATCCTTATT,sample,105637,104089,19356,84733,14255,70478,13010,422,30543,3384,43553,23119,10073,1350,5153,8281
TAACGAAGTCCTTATT,sample,59279,58645,6280,52365,11095,41270,9587,374,16617,1667,26204,13025,6609,968,4583,7123
GCGTTACCTCCTTATT,sample,63308,62490,11654,50836,9311,41525,7294,416,17176,1741,24470,14898,6680,991,2574,5564
CGTCGAGGTCCTTATT,Pos_Ctrl,45570,44433,5253,39180,1780,37400,31704,2608,2136,289,33840,663,5582,6153,1722,920
CAGCTTCGTCCTTATT,sample,103423,101397,20896,80501,10989,69512,11052,405,30941,3277,41993,23837,9310,1219,3687,5936
CGCGGTCGTCCTTATT,sample,65798,64801,9762,55039,11417,43622,9859,419,18307,2196,28166,12841,7473,1099,3269,6892
TCTCCTAGTCCTTATT,sample,77892,76706,12982,63724,13054,50670,9898,342,21376,2157,31274,16897,7392,839,4693,7722
CCTAACTATCCTTATT,sample,75709,74791,11749,63042,13463,49579,13295,941,19384,2173,32679,13786,6590,1279,4505,8443
TCTAGGTTAATAAGGT,sample,44564,44323,4213,40110,9419,30691,7316,462,12617,1518,19933,8778,6028,1088,3166,5677
GAGCCTCCAATAAGGT,sample,247907,245377,37341,208036,36226,171810,31015,1221,74065,7765,105080,57744,13675,2483,13989,22472
CATACTCCAATAAGGT,sample,203949,201382,34724,166658,24868,141790,20898,1050,63128,6719,84026,49995,12056,1860,8064,15738
CGTCGCCAAATAAGGT,sample,231681,229165,31306,197859,52749,145110,37864,1499,57168,5488,95032,43091,9788,1875,20472,31677
CCGTACGCAATAAGGT,sample,85404,83192,22374,60818,7119,53699,6683,337,24426,2743,31109,19510,8248,1017,1969,3635
TGGATCAAAATAAGGT,sample,168371,166750,29670,137080,28707,108373,23523,1103,43499,4413,67022,35835,10828,2113,9713,16060
GATGCGTTAATAAGGT,sample,209467,205509,43679,161830,21358,140472,20221,951,62586,6537,82807,50177,13271,2124,6370,11659
ATGGCGTTAATAAGGT,Pos_Ctrl,128378,125241,13639,111602,5059,106543,89448,7505,6720,745,96168,2125,7533,9793,5701,2311
CATTCGGTAATAAGGT,sample,100335,98203,18077,80126,21104,59022,14066,875,24190,2415,38256,17476,8208,1308,5762,11910
GCTCTTCTAATAAGGT,sample,217843,214954,26660,188294,44494,143800,30305,1288,58379,6181,88684,47647,11340,1733,15588,27480
GAGATTCTAATAAGGT,sample,192763,190075,18481,171594,58597,112997,42285,1866,38636,3782,80921,26428,7810,1601,22830,33006
CCTAGCGGAATAAGGT,Pos_Ctrl,40725,39613,4536,35077,1563,33514,28123,2400,2098,278,30221,615,5479,5693,1981,821
GGCGTACCAATAAGGT,sample,271553,265805,43366,222439,33606,188833,28497,1090,82399,8707,110896,68140,14541,2494,10017,20677
TTATGACGAATAAGGT,sample,159119,157307,18273,139034,32967,106067,26051,1315,44658,4983,70709,29060,10145,1719,9653,19473
GACTAACCAATAAGGT,sample,125936,123958,23767,100191,16141,84050,12482,828,36453,4064,48935,30223,10526,1545,3391,9270
CGCGAGACAATAAGGT,sample,90337,88428,18939,69489,11133,58356,10214,526,25727,2783,35941,19106,8057,1194,3102,5730
CCTAACTAAATAAGGT,sample,323067,317481,59105,258376,42160,216216,35762,1288,91598,8961,127360,78607,17007,2991,13060,23697
CTGGTCTTCAGGACCA,sample,128798,125808,19393,106415,25989,80426,26393,1386,30004,3281,56397,19362,7400,1580,10144,15642
AGAGTTCTCAGGACCA,sample,215810,208706,55973,152733,14730,138003,14642,705,64187,6992,78829,51477,13200,1935,3049,7562
TATACGGACAGGACCA,sample,209325,204383,38307,166076,28777,137299,26054,1272,58251,6132,84305,45590,11423,2021,8859,17478
TCGAACGACAGGACCA,sample,174515,171078,28711,142367,29370,112997,24323,1215,47520,5001,71843,34938,10657,1751,10977,17491
GGTAGAGACAGGACCA,sample,383636,372789,80140,292649,39068,253581,32593,1341,112371,11308,144964,95968,17336,3094,8832,22594
CGTCGCCACAGGACCA,sample,366050,359010,63622,295388,49648,245740,45586,1778,104523,11352,150109,82501,14684,2945,19898,32388
TACGCGAGCAGGACCA,sample,179096,174733,32038,142695,31678,111017,22529,1091,46052,5556,68581,35789,11661,1700,10648,17829
GACTCAAGCAGGACCA,sample,88530,86424,15734,70690,15317,55373,12109,728,24037,2727,36146,15772,7317,1277,4687,8870
CCGCAGTCCAGGACCA,sample,356714,350923,42173,308750,56194,252556,68905,3439,103776,11344,172681,65092,12599,3178,15677,38262
TGGATCAACAGGACCA,sample,180246,176636,31287,145349,33623,111726,25718,1375,46486,4692,72204,33455,10364,1723,10365,19585
ATGGCGTTCAGGACCA,sample,259639,255137,39259,215878,38679,177199,34688,2739,72998,7947,107686,58827,12395,2249,12833,23797
TGCGCGTTCAGGACCA,sample,291530,287407,48067,239340,50391,188949,42192,2206,78019,7256,120211,59276,11559,2318,18733,30118
CCATTCTTCAGGACCA,sample,51944,49720,16629,33091,2687,30404,2402,104,14134,1538,16536,12226,6335,406,469,896
AGCGTCTTCAGGACCA,sample,179851,176948,25766,151182,28695,122487,25446,1104,52495,5399,77941,38043,10430,1747,8735,17491
CCTAGCGGCAGGACCA,sample,137908,135543,22694,112849,21907,90942,17900,823,39047,3855,56947,29317,10079,1467,7691,12841
TAACGAAGCAGGACCA,sample,165064,162241,24103,138138,28997,109141,27652,1651,45087,4388,72739,30363,9158,1530,11236,18313
TGCGCTCCCAGGACCA,sample,281501,276777,51963,224814,27064,197750,28589,1270,85516,9447,114105,72928,15366,2634,10026,15780
CAGCTTCGCAGGACCA,Neg_Ctrl,3278,1756,1140,616,84,532,131,4,244,15,375,138,245,51,42,33
TTATGACGCAGGACCA,sample,114807,113458,17412,96046,18267,77779,17236,1123,33385,3823,50621,22212,8703,1491,5450,11666
TCTCCTAGCAGGACCA,sample,302076,298651,44354,254297,42212,212085,37850,1544,90501,10583,128351,71607,14545,3092,12768,23901
AAGTAGAGCAGGACCA,sample,351008,346513,63855,282658,31415,251243,29808,1207,112755,11968,142563,95505,18504,3830,5647,14873
GACTAACCCAGGACCA,sample,52073,51514,3509,48005,20724,27281,10073,455,10074,1230,20147,5449,4115,882,4148,10208
CCTAACTACAGGACCA,sample,103509,101784,14520,87264,15723,71541,18990,807,30181,3131,49171,18432,7749,1426,7394,9672
TCGAACGACCTCGTTG,sample,115277,113141,28331,84810,10809,74001,8655,378,32985,3486,41640,28497,10534,1187,2737,5646
GGTAGAGACCTCGTTG,sample,102337,99258,33993,65265,5478,59787,4969,202,28095,2744,33064,23777,9477,931,693,2200
CGTCGCCACCTCGTTG,sample,143069,140034,35402,104632,12904,91728,12297,642,40926,4473,53223,33390,11044,1542,3274,6778
TCATCGAACCTCGTTG,sample,188553,184105,47477,136628,16093,120535,14793,754,52854,5760,67647,46374,12283,1622,5057,8172
TCATACCACCTCGTTG,sample,300868,295603,60125,235478,38434,197044,34407,1145,83373,8512,117780,69607,14626,2752,13678,21891
ATTCAAGGCCTCGTTG,sample,77977,75794,21579,54215,6504,47711,7577,335,22082,2148,29659,15569,8498,1182,2049,3377
GACTCAAGCCTCGTTG,sample,135713,133493,19479,114014,20899,93115,19841,875,41148,4049,60989,27202,8969,1524,5407,12365
CCGCAGTCCCTCGTTG,sample,150381,146298,37745,108553,8945,99608,12155,676,44978,5068,57133,36731,10766,1593,2047,3874
TCTCAGGACCTCGTTG,sample,334997,330155,56578,273577,28953,244624,34499,2285,107710,12346,142209,87784,15595,3244,7378,15386
GGCAGGTTCCTCGTTG,sample,208738,204762,38017,166745,32856,133889,25409,1415,56393,6638,81802,44034,11642,1894,10140,20766
TGCGCGTTCCTCGTTG,Neg_Ctrl,4684,2342,1481,861,150,711,162,7,283,26,445,233,327,62,54,28
CGGTTGGTCCTCGTTG,sample,122983,120361,21382,98979,19578,79401,19766,1339,34030,3636,53796,20630,7158,1253,7994,11465
ACGCTTAACCTCGTTG,sample,190405,187937,22791,165146,30363,134783,26696,1165,58366,6643,85062,41913,11462,2157,9701,18963
GCTCTTCTCCTCGTTG,sample,205178,202316,30388,171928,34221,137707,29692,1250,59181,6241,88873,41343,10517,2093,13087,21206
GAGATTCTCCTCGTTG,sample,84457,83674,9420,74254,17685,56569,14727,932,24062,2888,38789,13960,6612,1162,5624,10453
CTAAGCATCCTCGTTG,sample,140855,138031,24324,113707,24378,89329,21083,817,37170,4028,58253,26231,8980,1309,10381,14247
AAGGTCTGCCTCGTTG,sample,207921,204614,35979,168635,38545,130090,27645,1257,55895,6181,83540,39112,11124,2061,8082,22167
CTAACCGGCCTCGTTG,Neg_Ctrl,3990,1906,1263,643,112,531,124,6,220,13,344,168,256,33,44,21
GGCGACGACCTCGTTG,sample,133491,130983,29752,101231,12432,88799,12325,608,39779,3967,52104,32120,10466,1580,3617,6784
GCGTTACCCCTCGTTG,sample,282163,278713,46908,231805,39103,192702,33119,1419,79223,8564,112342,70377,14940,2871,13440,22777
GTCGCGAACCTCGTTG,sample,161989,159481,24518,134963,30054,104909,22321,872,42783,4815,65104,34118,10385,1649,9861,17803
TTATGACGCCTCGTTG,sample,203005,199899,29316,170583,26281,144302,24240,960,60627,6493,84867,51982,13350,2424,7182,14834
TCTCCTAGCCTCGTTG,sample,198344,194813,32786,162027,25001,137026,24532,1267,60572,7089,85104,43566,12266,2014,8653,14881
AAGTAGAGCCTCGTTG,sample,247211,243001,43778,199223,25811,173412,23584,1090,78334,8326,101918,62078,15216,2601,6452,15329
ATTCTACCCCTCGTTG,Pos_Ctrl,76535,74657,9187,65470,3233,62237,51799,4426,4147,452,55946,1413,6672,7777,2831,1692
GACTAACCCCTCGTTG,sample,151546,149288,26073,123215,30388,92827,19382,1286,40208,4319,59590,27632,9468,1492,6766,17989
AGAGTTCTTTGCGGAC,sample,192264,190493,24136,166357,34871,131486,33585,1537,53363,5818,86948,37183,12449,2208,14532,21997
AGCTGAATTTGCGGAC,sample,304964,299121,48372,250749,53694,197055,41811,1608,80638,8695,122449,64303,15020,2504,19311,32001
GACGTATGTTGCGGAC,sample,353337,343751,86771,256980,25368,231612,26260,1041,103443,11075,129703,89793,18804,3398,6006,11974
TATACGGATTGCGGAC,sample,245694,241269,41132,200137,26971,173166,28848,1198,75303,8247,104151,59570,14792,2798,7820,15965
GGTAGAGATTGCGGAC,sample,306788,303001,51510,251491,47582,203909,37318,1971,84988,9683,122306,69949,16656,3040,14807,29424
TGATTCCGTTGCGGAC,sample,330272,324052,56103,267949,42851,225098,38345,1827,96135,10085,134480,78706,17315,3181,15336,25255
ATACGTTCTTGCGGAC,sample,114071,112466,13805,98661,27499,71162,22869,1009,29438,3504,52307,14342,6226,1300,11335,16353
TCTCAGGATTGCGGAC,sample,96339,95356,10667,84689,24681,60008,18460,671,23854,2358,42314,14665,6169,1117,10200,14719
TGGATCAATTGCGGAC,sample,216194,212677,37087,175590,37473,138117,25070,1120,58623,6267,83693,47037,12405,1891,10460,22126
ATGGCGTTTTGCGGAC,sample,91794,89975,17398,72577,12731,59846,12265,739,25732,2945,37997,18165,7460,1212,4540,7468
CCATTCTTTTGCGGAC,sample,202714,198210,44064,154146,20074,134072,17736,797,59581,6500,77317,49458,14253,2201,4435,10082
AGCGTCTTTTGCGGAC,sample,55254,54277,9380,44897,8386,36511,9254,559,15426,1964,24680,9308,5130,1002,3095,4753
AAGGTCTGTTGCGGAC,sample,189771,184663,46290,138373,13964,124409,13252,643,57299,5888,70551,47327,14202,1907,2026,6444
AAGTAGAGTTGCGGAC,sample,150977,148404,21815,126589,28049,98540,22662,865,40993,4328,63655,29692,9613,1582,9031,16889
TAACGCCATTGCGGAC,sample,68226,66949,12085,54864,10020,44844,9830,638,19630,2362,29460,12384,6543,1083,2331,5596
ATTCTACCTTGCGGAC,sample,159018,156861,21567,135294,33013,102281,25089,1233,41691,4730,66780,29538,9615,1679,9012,19924
CGCGAGACTTGCGGAC,sample,138185,135800,24099,111701,20613,91088,17987,767,37964,4214,55951,30156,10458,1539,6693,11859
TTAACTGATTGCGGAC,sample,185440,183281,31202,152079,26944,125135,24553,1057,52495,5552,77048,41478,12255,2039,8585,16029
TATACGGATCCATTGG,sample,89024,86967,18965,68002,9135,58867,9900,375,25238,2693,35138,20661,8304,1067,4348,4891
GGAGAAGCTCCATTGG,sample,269266,261889,68401,193488,14022,179466,16982,649,82161,8538,99143,71136,17266,2595,2577,5886
GGTAGAGATCCATTGG,sample,134670,131244,28286,102958,12406,90552,15664,769,38562,4190,54226,31367,10877,1751,3975,6447
ATACGTTCTCCATTGG,sample,72778,70926,17366,53560,3952,49608,6566,427,23466,2655,30032,16494,8565,1191,783,1780
CCGCAGTCTCCATTGG,sample,91911,90130,15058,75072,10247,64825,11696,643,27941,2808,39637,21737,8334,1234,3985,5950
TGGATCAATCCATTGG,sample,138167,134303,35913,98390,10059,88331,10348,495,39060,4196,49408,34232,12218,1420,2844,5140
GGCAGGTTTCCATTGG,sample,264392,258666,65387,193279,22561,170718,22063,949,74328,7752,96391,65626,15990,2425,6568,11916
GATGCGTTTCCATTGG,sample,233945,229062,53346,175716,21850,153866,20719,716,68282,6694,89001,57455,15531,2227,5188,12647
CATTCGGTTCCATTGG,sample,99308,97779,14161,83618,14545,69073,17339,1266,27182,2927,44521,20359,8109,1390,6730,8254
CTAAGCATTCCATTGG,sample,38057,37229,8857,28372,3393,24979,3986,210,11567,1425,15553,7791,5423,724,808,1808
GGCGTACCTCCATTGG,sample,68601,67936,8330,59606,10005,49601,10231,681,20985,2422,31216,15282,7162,1112,2419,6398
CAGCTTCGTCCATTGG,sample,5631,5533,972,4561,1246,3315,1018,64,1212,141,2230,880,1088,260,481,697
ATGAATAGTCCATTGG,sample,28799,28515,4348,24167,7225,16942,5236,205,6411,718,11647,4372,2867,522,3106,4128
ATTCTACCTCCATTGG,sample,67150,66597,6749,59848,16013,43835,13412,764,17250,1827,30662,10582,5701,933,7014,9897
GACTAACCTCCATTGG,Neg_Ctrl,2159,948,555,393,53,340,81,4,144,15,225,96,172,30,26,10
AGATACTATCCATTGG,sample,52394,51761,10037,41724,5864,35860,5760,377,16102,1800,21862,11821,6343,844,1468,3256
TTAACTGATCCATTGG,sample,114948,113927,13666,100261,13364,86897,15023,734,38273,3939,53296,28928,11018,1777,4674,8220
CTGGTCTTCATAGGCG,sample,348997,339211,93487,245724,21816,223908,24042,1144,101027,10491,125069,87204,16941,3013,5014,9717
AGCTGAATCATAGGCG,sample,191344,187649,30095,157554,41472,116082,32115,1445,45716,5159,77831,31647,9365,1614,16735,23727
TATACGGACATAGGCG,sample,177059,175460,29202,146258,26188,120070,25237,1083,52602,6404,77839,34744,10497,1923,9867,15465
GGAGAAGCCATAGGCG,sample,237734,233965,53883,180082,37443,142639,31879,1208,61140,5808,93019,42604,10116,1934,14091,20582
TGATTCCGCATAGGCG,sample,90056,88017,24200,63817,7613,56204,7253,462,25556,2853,32809,20080,9098,1206,2011,3771
GACTCAAGCATAGGCG,sample,7218,7135,1071,6064,1835,4229,1068,104,1820,200,2888,1037,1523,368,401,949
TCTCAGGACATAGGCG,sample,91506,90367,12117,78250,18923,59327,17325,1126,23781,2610,41106,14485,6915,1323,8045,11349
ATGGCGTTCATAGGCG,sample,219447,216378,32372,184006,31152,152854,28216,1195,67656,6806,95872,48981,12084,2134,11863,18816
CGGTTGGTCATAGGCG,sample,44253,43640,7413,36227,5335,30892,6213,304,13641,1455,19854,9279,5370,866,2237,3101
ACGCTTAACATAGGCG,sample,152916,149769,39810,109959,15279,94680,13209,455,40999,4145,54208,35872,11119,1453,5445,7811
GAGATTCTCATAGGCG,sample,124419,122045,22571,99474,20035,79439,16956,595,32872,3368,49828,25648,9357,1259,8643,11534
CTAAGCATCATAGGCG,sample,86305,83705,23293,60412,10973,49439,8880,490,20637,2208,29517,17224,7493,1034,3829,5146
CTAACCGGCATAGGCG,sample,32818,32045,7962,24083,3737,20346,3413,193,8993,1016,12406,6731,4419,602,1391,2073
AGCAGAGCCATAGGCG,sample,102739,100262,23651,76611,11458,65153,10087,451,28696,2928,38783,22991,8717,1150,3873,6215
CGCGAGACCATAGGCG,sample,130135,127602,25397,102205,16051,86154,13430,733,37336,4029,50766,30626,10154,1374,4617,8460
AGATACTACATAGGCG,sample,203076,197986,40910,157076,18636,138440,18036,1223,62585,5992,80621,50604,11967,1882,3973,11324
CCTAACTACATAGGCG,sample,196836,193710,29786,163924,21652,142272,21619,1194,63263,6664,84882,49532,13397,2259,6708,13003
GCGCAATACATAGGCG,sample,99816,98751,13075,85676,15999,69677,15136,855,29266,2893,44402,21527,7508,1180,5735,9448
AACCGGTTTTGGAGAG,sample,51210,50722,5313,45409,12130,33279,10036,645,13498,1461,23534,7639,4646,1145,4479,7454
TCTAGGTTTTGGAGAG,sample,229232,225754,38191,187563,31292,156271,28595,1474,67277,6852,95872,52073,13245,2380,10718,18721
CTGGTCTTTTGGAGAG,Pos_Ctrl,210580,204188,22862,181326,8253,173073,145545,11973,10812,1329,156357,3414,8201,11740,11708,4188
CATAATGGTTGGAGAG,sample,186729,183277,30303,152974,31807,121167,28261,908,49959,4625,78220,37414,11150,1710,14536,18841
CATACTCCTTGGAGAG,sample,63256,61613,13444,48169,7058,41111,7732,508,17708,1985,25440,13178,6898,1375,2040,3835
ATTCAAGGTTGGAGAG,sample,83286,81871,16639,65232,9857,55375,11112,622,23262,2526,34374,17853,8547,1556,3989,5410
TGATTCCGTTGGAGAG,Pos_Ctrl,107118,103757,13416,90341,4517,85824,72160,6090,5257,580,77417,1737,7191,8906,5897,2377
CCGTACGCTTGGAGAG,sample,41864,41087,9335,31752,6807,24945,5621,287,10195,1187,15816,7655,4625,812,2459,3641
TCTCAGGATTGGAGAG,sample,118087,116346,17221,99125,26889,72236,21281,652,28143,2844,49424,19316,6543,1170,11638,15371
TGCGCGTTTTGGAGAG,sample,150950,148763,28499,120264,13141,107123,14693,722,47590,4776,62283,39342,10880,1522,4499,7659
CCATTCTTTTGGAGAG,sample,66438,64851,15759,49092,8061,41031,7251,436,17408,1914,24659,14022,6654,1110,2665,4767
GCTCTTCTTTGGAGAG,sample,240751,236135,40734,195401,32229,163172,30353,1356,68231,7819,98584,55413,12239,2146,13096,19172
CTAAGCATTTGGAGAG,sample,212773,207301,42629,164672,22169,142503,23127,1123,60865,6103,83992,51285,12677,2161,6652,12967
GCTGCTTCTTGGAGAG,sample,168388,163833,36300,127533,18321,109212,16139,636,49544,5366,65683,37527,11547,1840,4716,9807
GCCTATTCTTGGAGAG,sample,181447,176836,35702,141134,17929,123205,17155,926,53966,5722,71121,45436,12351,1922,5225,9117
AGCAGAGCTTGGAGAG,sample,61979,60378,13532,46846,8423,38423,7397,342,16536,1730,23933,12418,7103,1099,2368,4610
ATGAATAGTTGGAGAG,sample,221068,215936,45550,170386,25941,144445,23717,1035,64395,6787,88112,48511,13326,2066,6776,14112
TCAATCAGTTGGAGAG,sample,60402,59130,10665,48465,7993,40472,8661,569,17819,1930,26480,11493,5914,995,3452,4472
GACTAACCTTGGAGAG,sample,73926,71968,17464,54504,7714,46790,7573,509,20419,2217,27992,16072,7264,952,2857,3799
CGCGAGACTTGGAGAG,sample,144658,141545,23257,118288,23387,94901,17388,1561,41363,3756,58751,30833,9730,1511,5471,13694
AACCGGTTTTCAAGCC,sample,118941,117132,23144,93988,17652,76336,13230,802,33398,3560,46628,25346,9553,1490,4994,9893
TCTAGGTTTTCAAGCC,sample,76429,75271,15242,60029,7556,52473,8342,330,23489,2525,31831,17787,7922,1191,2858,3893
AGAGTTCTTTCAAGCC,sample,148109,144720,32683,112037,14931,97106,13457,520,42713,4675,56170,35741,11149,1388,5355,8623
CATAATGGTTCAAGCC,sample,276218,271283,55599,215684,36433,179251,33402,1424,76643,8226,110045,59556,13171,2469,13746,21348
CGTCGCCATTCAAGCC,sample,202470,198599,30222,168377,31249,137128,29428,1454,57780,6558,87208,41908,11429,1973,9994,18841
TCATACCATTCAAGCC,sample,233022,230398,29567,200831,35774,165057,34183,1728,68954,7221,103137,52971,12404,2187,13859,22695
CCGCAGTCTTCAAGCC,sample,69168,67985,9213,58772,17656,41116,14727,570,13867,1271,28594,10681,3877,880,8682,10431
CCGTACGCTTCAAGCC,sample,30508,29838,5847,23991,5107,18884,4668,225,8037,762,12705,5192,3979,720,2186,2896
ATGGCGTTTTCAAGCC,sample,250752,245364,56376,188988,25310,163678,23167,817,71785,7287,94952,60622,15270,2284,8472,12930
CCATTCTTTTCAAGCC,sample,41445,40522,9758,30764,4586,26178,3663,159,11741,1157,15404,9458,5380,673,1259,2277
CTAAGCATTTCAAGCC,sample,104735,103333,11031,92302,31700,60602,23016,974,20435,1772,43451,14405,4350,1005,13981,18016
AAGGTCTGTTCAAGCC,sample,149127,145252,34327,110925,15771,95154,15504,546,41286,4308,56790,33510,11069,1453,6000,8649
TGCGCTCCTTCAAGCC,sample,123174,121520,23588,97932,19765,78167,17405,804,31541,3706,48946,24711,9083,1276,8395,11498
GTCGCGAATTCAAGCC,sample,29732,28891,7703,21188,2963,18225,2789,136,8188,869,10977,6243,4511,561,937,1509
CGTCGAGGTTCAAGCC,Pos_Ctrl,30451,29294,4536,24758,1390,23368,19608,1484,1540,207,21148,529,4801,4310,1667,829
CAGCTTCGTTCAAGCC,sample,92805,91579,10069,81510,22832,58678,19440,1018,20985,2413,40425,14822,5761,1129,9580,14029
CGCGGTCGTTCAAGCC,sample,95080,93844,10566,83278,21420,61858,17990,613,24690,2642,42680,15923,6099,1109,8834,13676
TCTCCTAGTTCAAGCC,sample,35032,34128,8163,25965,3326,22639,3549,209,10252,1091,13801,7538,4771,641,1138,1799
TCAATCAGTTCAAGCC,sample,48116,47270,10007,37263,4978,32285,5311,240,14083,1535,19394,11116,5703,760,1992,2721
ATTCTACCTTCAAGCC,sample,163640,160590,29417,131173,25471,105702,21981,973,45186,4690,67167,32872,11260,1727,8499,15083
AGATACTATTCAAGCC,sample,414172,401344,98237,303107,22496,280611,25645,1040,129801,13725,155446,110400,18685,3277,3431,11589
CCTAACTATTCAAGCC,sample,139822,138285,18172,120113,19933,100180,16189,631,43875,4411,60064,35074,11049,1756,5898,12031
GTCGTTCTAACTTAAC,Neg_Ctrl,2921,1279,913,366,84,282,76,1,103,17,179,85,130,23,29,12
AGCTGAATAACTTAAC,sample,272329,268515,50216,218299,31652,186647,32209,1220,81749,9200,113958,62269,14742,2491,13961,18832
CATAATGGAACTTAAC,sample,56507,55716,9147,46569,9014,37555,5417,291,17106,1616,22523,13125,6742,787,1993,5299
GAGCCTCCAACTTAAC,sample,243028,239504,40601,198903,27148,171755,44146,2456,73013,9361,117159,42779,12851,2498,9508,15715
GGTAGAGAAACTTAAC,sample,90176,88511,16890,71621,10453,61168,11818,574,27885,3090,39703,17801,8030,1357,4114,6141
TCATCGAAAACTTAAC,sample,111694,110592,14662,95930,22931,72999,20886,1176,27944,3104,48830,19889,7402,1478,10040,14001
TCATACCAAACTTAAC,sample,128076,125873,24866,101007,15095,85912,14690,694,37211,3931,51901,29386,10403,1635,5732,8256
GCAACTAGAACTTAAC,Neg_Ctrl,2366,881,596,285,60,225,67,8,79,7,146,64,111,31,28,9
TACGCGAGAACTTAAC,sample,99077,97562,12943,84619,20593,64026,20361,1013,23972,2855,44333,15825,6486,1245,10176,12561
CCGTACGCAACTTAAC,sample,129066,127374,18774,108600,25306,83294,19603,982,32718,3717,52321,26274,8653,1445,10116,15526
TGGATCAAAACTTAAC,sample,89741,87988,20550,67438,10268,57170,8423,358,24788,2385,33211,21216,8951,1007,3476,5705
GATGCGTTAACTTAAC,sample,40663,39845,7453,32392,4823,27569,5170,279,11960,1297,17130,8863,4223,703,1949,3054
TGCGCGTTAACTTAAC,sample,233747,230173,44036,186137,26051,160086,25207,896,70360,8071,95567,55552,14067,2243,9234,15512
AGCGTCTTAACTTAAC,sample,114320,112113,22778,89335,15558,73777,13927,481,30720,3173,44647,25476,8613,1192,6005,8322
TAACGAAGAACTTAAC,sample,59632,58208,11827,46381,8359,38022,8762,525,15354,1641,24116,11740,6307,1082,2855,4357
GCTGCTTCAACTTAAC,sample,47683,46636,9420,37216,6185,31031,6424,340,13838,1485,20262,8944,5393,881,2354,3612
GCGTTACCAACTTAAC,sample,113883,111712,22633,89079,14248,74831,14840,869,32000,3584,46840,23538,9461,1416,4450,8051
GGCGTACCAACTTAAC,sample,47456,46567,7023,39544,10915,28629,7821,462,11089,1329,18910,7928,4465,729,4129,6553
CGCGGTCGAACTTAAC,sample,60039,59210,6579,52631,14790,37841,10399,377,15113,1489,25512,10463,5892,968,4952,9028
ATGAATAGAACTTAAC,sample,122692,121583,10913,110670,34085,76585,23571,634,28851,2823,52422,20706,6472,1182,13138,20723
TCAATCAGAACTTAAC,sample,195056,191672,38642,153030,25432,127598,21115,984,54449,5825,75564,45225,14049,2027,7226,15056
TAACGCCAAACTTAAC,sample,238784,234589,49899,184690,25333,159357,25424,930,69775,7262,95199,55966,15154,2255,9176,14389
GACTAACCAACTTAAC,sample,122157,120106,19089,101017,18629,82388,17547,839,35870,4013,53417,24119,8790,1511,7423,11806
CGTAGAACAACTTAAC,sample,117372,115529,18133,97396,21987,75409,17095,1127,31464,3510,48559,22213,8373,1218,7276,13709
AGATACTAAACTTAAC,sample,106832,105450,13694,91756,18939,72817,18470,1625,30339,3678,48809,18705,7323,1224,8524,11730
CCTAACTAAACTTAAC,sample,200862,196817,38394,158423,17634,140789,18424,924,63450,6771,81874,51220,13241,2075,5211,9644
ATATGCAAAACTTAAC,sample,239339,235334,44255,191079,21258,169821,23657,1342,74442,8232,98099,62148,14176,2539,4726,10630
AGAGTTCTATACTTGA,sample,117478,115508,19882,95626,19360,76266,13614,723,32625,3503,46239,25801,9739,1342,6260,10890
AGCTGAATATACTTGA,sample,331209,324615,60049,264566,48181,216385,43636,1645,90785,10464,134421,69855,15439,2978,18398,28973
TATACGGAATACTTGA,sample,271235,267417,42488,224929,39291,185638,35881,1999,76180,8048,112061,63530,13049,2621,15913,24448
GGAGAAGCATACTTGA,sample,204546,201166,37213,163953,24785,139168,20528,731,60255,6630,80783,51024,12571,1925,7218,14167
ATTCAAGGATACTTGA,sample,89022,87932,13599,74333,14695,59638,14261,474,25596,2556,39857,16751,7223,1143,6529,9130
TGATTCCGATACTTGA,sample,175912,174263,17415,156848,41931,114917,36791,1165,46044,4818,82835,26099,9213,2035,19167,27166
TACGCGAGATACTTGA,sample,245251,242808,35116,207692,52990,154702,48783,1813,59093,6712,107876,38301,9748,1864,25166,32131
ATACGTTCATACTTGA,sample,5890,5817,823,4994,1254,3740,1020,55,1558,201,2578,906,1412,336,366,731
TGGATCAAATACTTGA,sample,285288,279020,57478,221542,26553,194989,26113,1097,86024,8577,112137,73178,16573,2953,7815,14741
TGCGCGTTATACTTGA,sample,265298,260962,51415,209547,29771,179776,28204,1004,76864,7803,105068,65901,12606,2316,9254,17618
AGCGTCTTATACTTGA,sample,193392,191441,21598,169843,39279,130564,29439,1355,54223,5804,83662,39743,9299,1807,13081,25342
AAGGTCTGATACTTGA,sample,146553,143412,27539,115873,22217,93656,22109,1028,38351,3505,60460,28663,10037,1820,7563,12596
CTAACCGGATACTTGA,sample,126470,124274,22837,101437,16123,85314,14938,618,37566,4088,52504,28104,9604,1473,5113,9350
GGCGACGAATACTTGA,sample,83233,81206,16250,64956,9775,55181,8992,393,23984,2761,32976,19051,8100,1070,2875,5358
TGCGCTCCATACTTGA,sample,117009,114181,25127,89054,11235,77819,13624,654,34165,4087,47789,25289,9361,1447,3716,6443
GGCGTACCATACTTGA,sample,127560,126051,15010,111041,41232,69809,25495,1515,23766,2203,49261,16830,5307,1026,14317,21654
CAGCTTCGATACTTGA,Neg_Ctrl,2822,1240,825,415,87,328,78,6,121,19,199,104,155,30,22,16
CGTAGAACATACTTGA,sample,252545,249200,39806,209394,28609,180785,32937,1402,77433,8205,110370,60808,13049,2458,13269,17716
CCTAACTAATACTTGA,sample,365201,358750,68984,289766,31568,258198,45606,3383,121323,13265,166929,74621,16281,3073,8235,18073
GCGCAATAATACTTGA,sample,131548,130269,19258,111011,25191,85820,21237,1100,34324,4144,55561,25015,8956,1349,10164,14168
CATACTCCATCCGCGA,sample,180056,176727,34430,142297,25611,116686,25800,1179,48108,5149,73908,36450,10470,1774,10923,14515
CTAGCGACATCCGCGA,sample,267698,263033,45591,217442,34945,182497,35556,1558,76672,8136,112228,60575,13444,2561,13995,21078
TCATACCAATCCGCGA,sample,308009,303180,48326,254854,33980,220874,41432,2906,97832,9250,139264,69454,14431,2968,11810,20497
ATACGTTCATCCGCGA,sample,427690,416448,121676,294772,33362,261410,32925,1399,115819,12148,148744,99119,18684,3347,9348,17122
TGCGCGTTATCCGCGA,sample,232526,229602,29615,199987,42023,157964,41100,2326,59055,5887,100155,49596,10296,2090,18232,25511
AGCGTCTTATCCGCGA,sample,153836,151857,23287,128570,24411,104159,24500,1212,42865,5025,67365,30557,9025,1557,8651,14488
CGGTTGGTATCCGCGA,sample,136153,134503,18146,116357,24433,91924,17939,1000,39204,4178,57143,29603,9975,1603,6718,15103
GCTCTTCTATCCGCGA,sample,145601,143515,29276,114239,15192,99047,15855,620,46183,5011,62038,31378,10289,1609,5069,8280
GGCGACGAATCCGCGA,sample,338957,330183,89994,240189,18421,221768,20611,927,101240,10451,121851,88539,18276,3051,3181,8072
TAACGAAGATCCGCGA,sample,81271,79374,22163,57211,6055,51156,6686,354,23593,2357,30279,18166,8360,1063,1792,2987
AGCAGAGCATCCGCGA,sample,304680,296993,65639,231354,29626,201728,23927,1297,89693,9684,113620,77127,15525,2439,7676,15553
ATGAATAGATCCGCGA,sample,123205,121101,22178,98923,22641,76282,17885,758,31862,3334,49747,22443,8730,1370,7226,12876
TAACGCCAATCCGCGA,sample,241207,238456,33048,205408,43604,161804,34785,2299,67866,7126,102651,49728,12183,2505,11651,27668
TCTAGGTTAGGACTCA,sample,150316,148130,17835,130295,29476,100819,25378,1289,40094,4228,65472,29830,8714,1494,13188,17844
GAGCCTCCAGGACTCA,sample,68174,66961,10725,56236,10578,45658,11125,681,19737,2127,30862,11988,6038,1344,3591,6524
TGATTCCGAGGACTCA,sample,222716,218976,32329,186647,50256,136391,30183,1415,55471,6331,85654,42991,11844,2164,11034,29174
GCAACTAGAGGACTCA,sample,40631,40023,5671,34352,7972,26380,7535,559,10995,1191,18530,6100,5057,1125,2710,4758
GACTCAAGAGGACTCA,sample,139621,137282,18173,119109,17064,102045,23267,1266,46570,5211,69837,25731,8666,1661,5239,10031
TCTCAGGAAGGACTCA,sample,225689,222720,24646,198074,37128,160946,55861,3573,56172,6371,112033,38969,10199,2700,9134,23369
GATGCGTTAGGACTCA,sample,171025,167689,33110,134579,21335,113244,16731,602,49269,5031,66000,41611,11156,1566,6694,12094
CCATTCTTAGGACTCA,sample,252826,249463,52884,196579,30315,166264,29978,1337,75123,9115,105101,50711,10057,1899,10402,16992
ACGCTTAAAGGACTCA,sample,492357,483832,81819,402013,50394,351619,52740,2739,153411,16130,206151,126599,20099,4768,16209,29887
CTAAGCATAGGACTCA,sample,123224,120892,19547,101345,23064,78281,21482,836,30891,3834,52373,21238,7749,1401,7597,13284
CCTAGCGGAGGACTCA,sample,187736,184420,31820,152600,28919,123681,24311,1187,51600,5952,75911,40631,11595,1917,8353,16375
GGCGACGAAGGACTCA,sample,171589,169128,20584,148544,35896,112648,32153,1392,42442,4472,74595,32189,8472,1619,16175,21864
GCTGCTTCAGGACTCA,sample,161259,158991,22213,136778,34874,101904,26271,1466,40562,4630,66833,28975,10369,1782,12184,19555
ATACCGCCAGGACTCA,sample,268568,262501,51483,211018,30949,180069,27983,1121,76974,8262,104957,65729,14647,2379,11030,16584
GGCGTACCAGGACTCA,sample,156309,153883,18484,135399,32795,102604,24859,734,41793,4406,66652,30812,8500,1470,11392,20059
CGCGGTCGAGGACTCA,sample,73415,72107,11797,60310,12620,47690,9990,564,21146,2321,31136,13669,6966,1090,3791,7282
TCTCCTAGAGGACTCA,sample,164021,161633,25338,136295,21429,114866,21898,1325,48877,4966,70775,37800,11419,2011,6578,12968
ATTCTACCAGGACTCA,sample,175263,173018,26362,146656,29141,117515,23970,1420,48398,5199,72368,38528,11223,1842,7456,17121
GACTAACCAGGACTCA,sample,247274,242914,40518,202396,31921,170475,36850,2047,72008,8718,108858,50852,13900,2820,8446,17524
CGTAGAACAGGACTCA,sample,188291,185181,29697,155484,21592,133892,23747,1028,57663,6182,81410,45272,12783,2172,7129,12425
AGATACTAAGGACTCA,sample,351947,347268,59398,287870,44409,243461,41310,1472,106448,10955,147758,83276,17491,3358,11289,24589
CCTAACTAAGGACTCA,Pos_Ctrl,117737,112960,12445,100515,3949,96566,80587,6912,6352,721,86939,1994,7144,9167,4602,2037
TTAACTGAAGGACTCA,sample,38592,38292,5360,32932,5595,27337,6310,367,12442,1199,18752,7019,4730,908,1524,3154
GTCGTTCTTATTGAAC,sample,91117,90138,15106,75032,14906,60126,10900,595,25473,2632,36373,20526,8468,1346,4363,9018
AGCTGAATTATTGAAC,sample,194259,190848,38938,151910,21955,129955,20875,1173,56312,5963,77187,45632,12478,2115,6856,11890
GGAGAAGCTATTGAAC,sample,116735,115421,15880,99541,23504,76037,21209,907,30686,3084,51895,20151,8310,1326,10326,14576
GAGCCTCCTATTGAAC,sample,98034,97103,10758,86345,21787,64558,19252,435,24802,3127,44054,16942,7339,1265,9997,13537
CATACTCCTATTGAAC,sample,176408,174504,16489,158015,39572,118443,36220,1273,48214,5344,84434,27392,6244,1271,18335,26531
CTAGCGACTATTGAAC,sample,119823,117997,19584,98413,19477,78936,16062,736,33737,3410,49799,24991,8957,1447,6580,11524
TCGAACGATATTGAAC,sample,229285,225907,40409,185498,38167,147331,31937,1137,59816,6574,91753,47867,11726,1953,14046,22541
GGTAGAGATATTGAAC,sample,82079,80079,22338,57741,6353,51388,6984,404,23555,2574,30539,17871,7867,1181,1453,2939
CGTCGCCATATTGAAC,sample,159632,157345,25753,131592,25248,106344,22084,726,44996,4950,67080,33588,10695,1587,9392,15260
GACTCAAGTATTGAAC,sample,66174,64962,10466,54496,14940,39556,11453,338,15053,1548,26506,11164,5386,782,6685,8247
CCGTACGCTATTGAAC,sample,57629,56201,13550,42651,6625,36026,6114,290,15575,1673,21689,12374,6095,638,3168,3562
CCATTCTTTATTGAAC,sample,80435,78635,15951,62684,12266,50418,12113,620,20428,2304,32541,14953,6979,1118,5576,7028
AGCGTCTTTATTGAAC,sample,256244,250600,60511,190089,16306,173783,23552,1183,79477,8933,103029,60638,15077,2455,5226,7403
ACGCTTAATATTGAAC,sample,212167,207717,41214,166503,25261,141242,25313,1288,62529,6509,87842,45603,13085,2131,8346,14463
GCTCTTCTTATTGAAC,sample,128322,125346,25744,99602,19077,80525,15480,565,33836,3726,49316,26918,9333,1228,5937,10548
CTAAGCATTATTGAAC,sample,88013,86616,10490,76126,18826,57300,20096,710,21927,2193,42023,12374,5448,1085,9076,11586
GGCGACGATATTGAAC,sample,29123,28392,5524,22868,3334,19534,4725,255,8157,892,12882,5505,4072,809,1508,1955
TAACGAAGTATTGAAC,sample,61203,59584,13379,46205,5136,41069,6660,321,18104,2071,24764,13913,6903,1051,1473,2759
TGCGCTCCTATTGAAC,sample,115546,112991,23747,89244,16072,73172,13082,736,31123,3343,44205,24888,9422,1156,5843,9548
ATACCGCCTATTGAAC,sample,107829,105286,21007,84279,13389,70890,11273,522,31158,3098,42431,24839,8782,1117,4388,7096
ATGAATAGTATTGAAC,sample,278721,273344,53092,220252,28445,191807,25877,993,84410,8830,110287,71697,15350,2775,6618,15517
TAACGCCATATTGAAC,sample,135293,133459,14157,119302,32250,87052,23015,1209,35095,3109,58110,24624,6948,1330,9720,20465
CGCGAGACTATTGAAC,sample,239823,234549,46856,187693,24726,162967,24551,1626,72218,8312,96769,56260,14239,2467,5361,13444
AGCTGAATGTTCAACT,sample,120067,116596,24269,92327,16442,75885,14985,561,31755,3336,46740,25248,9070,1109,7343,8597
GACGTATGGTTCAACT,sample,55525,54236,10527,43709,9485,34224,7353,409,14582,1565,21935,10315,5650,769,3077,5523
CATAATGGGTTCAACT,sample,52856,51289,14564,36725,3708,33017,3991,227,15172,1705,19163,11922,6447,722,1104,1677
GGAGAAGCGTTCAACT,sample,42340,41536,8363,33173,4386,28787,6216,206,13269,1484,19485,7612,5417,920,1925,2475
CATACTCCGTTCAACT,sample,102553,100022,19707,80315,11426,68889,10330,473,30452,3166,40782,24468,8826,1098,3933,6661
GGTAGAGAGTTCAACT,sample,155896,152617,32895,119722,16540,103182,13694,576,45638,4731,59332,38543,12064,1591,4232,8739
CGTCGCCAGTTCAACT,sample,58631,57563,11041,46522,6900,39622,8662,631,17712,1993,26374,10624,5741,1051,2418,3768
TCATCGAAGTTCAACT,sample,45051,43893,12353,31540,3166,28374,3671,203,13093,1407,16764,10000,6167,828,771,1299
TCATACCAGTTCAACT,sample,78637,76314,22070,54244,4870,49374,4899,229,22635,2470,27534,19141,9129,837,935,2147
ATTCAAGGGTTCAACT,sample,69709,68136,11035,57101,12426,44675,9675,392,18524,1845,28199,14239,6837,871,4690,7469
GATGCGTTGTTCAACT,sample,38422,37681,8112,29569,4085,25484,5454,366,11124,1218,16578,7322,4430,860,1785,2138
AGCGTCTTGTTCAACT,sample,39945,39346,5223,34123,10377,23746,8241,339,9080,900,17321,5186,3669,743,4150,5649
CGGTTGGTGTTCAACT,sample,58553,57400,12732,44668,5144,39524,6499,280,18543,1899,25042,12303,6848,1054,1485,2509
GCTCTTCTGTTCAACT,sample,55260,54628,5270,49358,10124,39234,9392,406,15799,1517,25191,12120,4196,713,5253,6834
AAGGTCTGGTTCAACT,sample,150653,147680,32201,115479,9177,106302,11082,502,48894,5156,59976,40668,12182,1461,3035,4337
CTAACCGGGTTCAACT,sample,69423,68454,10755,57699,9872,47827,9971,370,20702,2201,30673,14583,6818,950,4454,5930
TAACGAAGGTTCAACT,sample,74920,74140,16972,57168,9441,47727,9426,325,19860,2084,29286,16032,5266,892,4565,4973
AGCAGAGCGTTCAACT,sample,24258,23925,2297,21628,3160,18468,5892,423,7815,856,13707,3482,2992,760,1888,2160
CGTCGAGGGTTCAACT,sample,52838,51870,9536,42334,5523,36811,4964,303,16517,1756,21481,13271,7114,783,1508,3055
CAGCTTCGGTTCAACT,sample,74885,73639,8358,65281,11016,54265,12034,537,22281,2423,34315,16990,5588,875,5300,7434
ATTCTACCGTTCAACT,sample,86568,85597,14256,71341,17192,54149,14313,673,21178,2356,35491,15629,6669,1133,6314,9941
GACTAACCGTTCAACT,sample,71302,70365,8174,62191,15778,46413,16820,794,16662,1885,33482,10252,5878,995,7693,9505
CGTAGAACGTTCAACT,sample,65268,64211,11026,53185,7492,45693,8659,454,20867,2230,29526,13483,7028,1065,2833,4519
GCGCAATAGTTCAACT,Neg_Ctrl,813,411,190,221,40,181,44,0,67,10,111,60,82,18,19,9
CATAATGGCTGAGGTT,sample,188531,184989,28377,156612,30896,125716,30036,1253,52087,5580,82123,36760,11437,1949,14464,19661
GAGCCTCCCTGAGGTT,sample,160941,158405,22160,136245,31994,104251,31327,1326,39107,4038,70434,28453,7353,1454,17674,19463
CCGCAGTCCTGAGGTT,sample,107341,104568,19912,84656,12755,71901,11697,587,31652,3393,43349,24572,9278,1389,4508,7405
TGGATCAACTGAGGTT,sample,127084,124188,18305,105883,5088,100795,12119,448,46317,4983,58436,36928,10602,1621,2028,1854
GGCAGGTTCTGAGGTT,sample,180106,175872,33328,142544,17880,124664,26127,1539,52918,5363,79045,38717,11581,2254,6781,10334
ATGGCGTTCTGAGGTT,sample,137008,134133,26624,107509,14286,93223,16807,1139,41490,4405,58297,29382,9558,1536,6067,7840
TGCGCGTTCTGAGGTT,sample,284323,278949,53987,224962,22749,202213,27123,1238,91668,9147,118791,73037,15221,2863,6701,13224
AAGGTCTGCTGAGGTT,sample,103568,102514,11956,90558,21192,69366,20938,934,26852,3037,47790,17605,6122,1195,10680,13117
CTAACCGGCTGAGGTT,sample,73138,72493,11771,60722,13750,46972,11100,403,19354,2027,30454,14088,6106,994,5717,7952
TGCGCTCCCTGAGGTT,sample,230266,228364,34360,194004,24907,169097,28522,1562,73742,9134,102264,56137,13274,2555,9118,15624
ATACCGCCCTGAGGTT,sample,303124,298851,41657,257194,40675,216519,60346,3403,84395,10133,144741,58242,13913,2882,16429,26133
GCGTTACCCTGAGGTT,sample,135090,133336,16249,117087,21265,95822,26461,1629,38397,4693,64858,24642,8131,1502,9683,13990
CGTCGAGGCTGAGGTT,sample,179898,177919,20282,157637,31314,126323,27879,1740,52405,5562,80284,38737,10911,1870,11737,19756
TCTCCTAGCTGAGGTT,sample,344396,339239,62067,277172,44166,233006,39434,1199,99168,9771,138602,83434,16722,3083,13815,26143
AAGTAGAGCTGAGGTT,sample,165745,163869,17293,146576,37589,108987,30742,1585,45108,4068,75850,27484,8384,1647,12744,22636
TAACGCCACTGAGGTT,sample,129351,128042,12308,115734,33990,81744,26153,1172,31950,3925,58103,18544,7411,1555,11399,20370
CCTAACTACTGAGGTT,sample,160498,158751,15908,142843,39403,103440,35651,1456,38722,3867,74373,23744,8436,1647,16664,23749
GCGCAATACTGAGGTT,sample,327693,324465,46240,278225,40679,237546,38804,1969,102226,10743,141030,83804,15740,3472,14714,23208
AGCTGAATAGACCGTT,sample,180717,176592,28952,147640,28951,118689,24469,1420,50435,5537,74904,36828,9858,1636,10245,17091
GACGTATGAGACCGTT,sample,570792,555265,127055,428210,40506,387704,43174,1637,174927,18092,218101,149874,20898,4479,12029,19850
CATAATGGAGACCGTT,sample,185735,183197,23660,159537,40043,119494,34300,1585,44182,5755,78482,33672,7877,1556,17748,24699
TATACGGAAGACCGTT,sample,209041,205867,25699,180168,35139,145029,36501,1310,57981,5875,94482,43362,10909,2179,17553,22682
GGTAGAGAAGACCGTT,sample,270163,264211,45626,218585,33661,184924,32304,1127,82352,9105,114656,60036,14211,2468,13370,20360
CGTCGCCAAGACCGTT,sample,49352,48150,8020,40130,7047,33083,9193,467,14222,1435,23415,7766,4746,1029,3447,4443
TCATCGAAAGACCGTT,sample,240593,237988,31769,206219,45474,160745,39231,879,62117,7207,101348,51311,8201,1631,21914,28901
TCATACCAAGACCGTT,sample,141983,140204,18738,121466,32771,88695,25201,1394,34592,4012,59793,23496,7494,1302,12757,19521
GCAACTAGAGACCGTT,sample,67184,66357,13303,53054,8128,44926,7265,364,19969,2130,27234,15198,7633,1167,2760,4371
TACGCGAGAGACCGTT,sample,355425,347772,57984,289788,43317,246471,43082,1491,104149,11378,147231,86371,14904,2981,19440,26668
ATACGTTCAGACCGTT,sample,269488,265580,43145,222435,45406,177029,39595,2091,71066,7329,110661,56948,11903,2291,18556,27492
CTAACCGGAGACCGTT,sample,197176,195070,28481,166589,29221,137368,28475,1007,57969,5617,86444,44300,12147,2085,13699,18146
AGCAGAGCAGACCGTT,sample,190731,188599,22791,165808,22746,143062,31111,1521,61343,7636,92454,41451,11859,2427,11241,13691
GTCGCGAAAGACCGTT,sample,341125,338106,40334,297772,37559,260213,43627,1942,113801,12100,157428,88743,17092,3941,15652,22794
CAGCTTCGAGACCGTT,sample,626516,618527,100821,517706,45675,472031,57933,2928,210661,21226,268594,179283,23343,6994,12153,23365
TTATGACGAGACCGTT,sample,161660,160465,16278,144187,32606,111581,29274,1372,43529,4589,72803,32817,9534,1841,14527,21033
TCAATCAGAGACCGTT,sample,157586,156360,17067,139293,28065,111228,21338,1252,47375,5160,68713,36103,11041,2026,8315,16628
CGTAGAACAGACCGTT,sample,445883,438150,76050,362100,48844,313256,50786,2008,134630,13959,185416,111873,19201,4273,17108,27973
CCTAACTAAGACCGTT,sample,126627,124936,15438,109498,18596,90902,22609,1095,38926,4943,61535,23329,8398,1503,6434,11871
GCGCAATAAGACCGTT,sample,175865,174325,15714,158611,41293,117318,35905,2526,41236,5826,77141,31825,8461,1851,18279,25282
TATACGGACTTGAGTT,sample,192934,191099,18571,172528,38255,134273,37504,1315,51793,5208,89297,38453,10252,1980,20228,24424
CTAGCGACCTTGAGTT,sample,234474,232738,26385,206353,43724,162629,34132,1399,68336,7054,102468,51708,10284,2287,16813,28915
TCGAACGACTTGAGTT,sample,90169,89264,12964,76300,15803,60497,13715,497,23558,2190,37273,20537,7133,1266,6246,10115
GGTAGAGACTTGAGTT,sample,295806,292659,52809,239850,44497,195353,43533,1078,81147,7868,124680,61727,12937,2385,22244,26509
GACTCAAGCTTGAGTT,sample,352154,344796,83400,261396,20715,240681,23507,1104,110466,11833,133973,93771,18262,3421,3412,7798
TCTCAGGACTTGAGTT,sample,227840,225156,31301,193855,41537,152318,31033,1836,64372,6576,95405,48501,13168,2574,12829,24827
TGGATCAACTTGAGTT,sample,198577,195858,28848,167010,26096,140914,27283,1334,61101,6135,88384,45061,12290,2012,12898,16895
AGCGTCTTCTTGAGTT,sample,341555,337218,44425,292793,42892,249901,64969,2804,113143,13425,178112,55560,12821,2458,19414,28263
CATTCGGTCTTGAGTT,sample,48269,47356,10152,37204,4541,32663,5239,284,14971,1520,20210,10649,6074,937,1705,2439
GAGATTCTCTTGAGTT,sample,258637,254337,40191,214146,31774,182372,33499,1593,80020,8302,113519,58958,14464,2796,12385,20316
CTAAGCATCTTGAGTT,sample,332660,327017,53847,273170,38163,235007,33596,1129,101221,10649,134817,88412,15490,2820,12669,23242
CTAACCGGCTTGAGTT,sample,78922,77626,16170,61456,9378,52078,9511,571,22493,2380,32004,17123,8416,1222,3280,5301
GCTGCTTCCTTGAGTT,sample,152094,149253,29739,119514,17847,101667,19769,1055,43655,4684,63424,32504,10652,1854,6950,10553
ATACCGCCCTTGAGTT,sample,340691,335346,54854,280492,44215,236277,51548,2239,98414,9699,149962,74377,14670,3091,20451,25943
GCGTTACCCTTGAGTT,sample,205832,202623,27101,175522,30221,145301,34864,1531,58795,7202,93659,42909,11807,2008,13794,19179
ATGAATAGCTTGAGTT,sample,210815,207402,33128,174274,25918,148356,31663,1124,64839,7122,96502,43608,10144,2000,11221,16467
AAGTAGAGCTTGAGTT,sample,171233,168016,27912,140104,16422,123682,22602,1318,55167,5841,77769,38754,10998,1995,7264,9387
ATATGCAACTTGAGTT,sample,314985,310655,48765,261890,51264,210626,47133,1907,86560,7668,133693,67358,12149,2416,20846,31130
TCTAGGTTTCGGAGTT,sample,132374,129547,26965,102582,14451,88131,12931,565,37717,4030,50648,32888,11569,1476,4812,8539
GTCGTTCTTCGGAGTT,sample,62922,61706,7299,54407,15762,38645,13118,763,14095,1331,27213,9338,5298,1016,6323,9518
GACGTATGTCGGAGTT,sample,49068,48101,6643,41458,11439,30019,9099,521,11390,1132,20489,7877,4655,819,5248,6805
TATACGGATCGGAGTT,sample,82434,80943,11755,69188,12503,56685,13687,521,23072,2633,36759,16772,7382,1038,7027,7816
GAGCCTCCTCGGAGTT,sample,39750,38931,5131,33800,7065,26735,6763,297,10977,1235,17740,7463,4760,735,3271,4606
CATACTCCTCGGAGTT,sample,62238,60837,9960,50877,8217,42660,9000,483,17676,2074,26676,13427,6880,1237,3190,5127
TCGAACGATCGGAGTT,sample,24447,23933,3993,19940,3595,16345,3882,245,7081,801,10963,4336,3659,655,1582,2015
ATTCAAGGTCGGAGTT,sample,48159,47435,7463,39972,8091,31881,6978,282,13580,1463,20558,9578,5832,907,3307,4833
TACGCGAGTCGGAGTT,sample,58325,57214,7221,49993,11283,38710,9992,382,15866,1374,25858,11096,5377,795,4951,7343
ATACGTTCTCGGAGTT,sample,96392,94748,14029,80719,16690,64029,14088,713,26036,2471,40124,20721,7930,1139,7792,9738
GCCTATTCTCGGAGTT,sample,107498,105808,13600,92208,15889,76319,16530,1155,33001,3403,49531,22230,8267,1301,6239,10264
CGTCGAGGTCGGAGTT,Pos_Ctrl,83624,81602,6957,74645,2788,71857,60721,5317,4031,504,64752,1284,6695,8458,4014,991
CGCGGTCGTCGGAGTT,sample,83833,82721,9989,72732,10946,61786,14131,557,25130,2671,39261,19297,8227,1186,5630,6957
TCTCCTAGTCGGAGTT,sample,62959,62144,4564,57580,15650,41930,15170,412,15980,2010,31150,8358,4552,836,8935,10138
TAACGCCATCGGAGTT,sample,103718,102377,13293,89084,16540,72544,15191,828,30067,2978,45258,23480,8688,1272,7082,10896
AGATACTATCGGAGTT,sample,90749,89661,10862,78799,16807,61992,17127,1240,25566,2621,42693,15438,6785,1080,6631,10228
ATATGCAATCGGAGTT,sample,73683,72901,10031,62870,11233,51637,8928,512,22859,2251,31787,17087,7904,1048,3589,6841
AACCGGTTTGAACCTT,sample,181223,177325,29666,147659,16354,131305,21204,840,56383,5994,77587,46884,12703,1911,8811,9401
CTGGTCTTTGAACCTT,Pos_Ctrl,86604,83620,9205,74415,3215,71200,59605,4738,4898,566,64503,1393,6963,8073,5165,1523
AGAGTTCTTGAACCTT,sample,111497,109373,19366,90007,14427,75580,14454,722,32312,3461,46766,24631,7954,1337,6393,8941
GACGTATGTGAACCTT,sample,71392,68962,20199,48763,3772,44991,4842,281,21074,2372,25916,16422,8184,991,793,1457
CATAATGGTGAACCTT,sample,145988,142964,30710,112254,12337,99917,15932,1017,44766,4707,60698,33495,12066,1857,4025,6574
GAGCCTCCTGAACCTT,sample,27104,26476,4851,21625,3328,18297,3931,128,7882,806,11813,5550,4109,634,1822,1935
GGTAGAGATGAACCTT,Pos_Ctrl,143558,137656,16625,121031,5738,115293,95741,7889,8113,1031,103854,2519,7985,10236,6986,2524
TGATTCCGTGAACCTT,sample,250374,245489,46152,199337,25074,174263,26384,1062,75821,7602,102205,63394,14494,2480,9744,14376
GCAACTAGTGAACCTT,sample,144370,142415,33493,108922,9184,99738,8558,367,45840,4875,54398,40098,13523,1766,1531,3341
TACGCGAGTGAACCTT,sample,136804,133615,25173,108442,16053,92389,16169,909,40675,4333,56844,30303,10099,1524,6662,9728
CCGTACGCTGAACCTT,sample,215194,210580,39043,171537,18833,152704,25447,835,67133,6768,92580,52521,13277,2308,7257,11513
ATGGCGTTTGAACCTT,Pos_Ctrl,96235,95171,7600,87571,4630,82941,70392,6593,3989,565,74381,1402,7113,8964,6043,2380
TGCGCGTTTGAACCTT,sample,128978,126940,29255,97685,9297,88388,10094,457,41159,4271,51253,32407,11324,1532,2492,4551
CCATTCTTTGAACCTT,sample,238499,235210,36297,198913,27655,171258,28540,1078,74699,7709,103239,59232,14367,2663,11243,17348
AGCGTCTTTGAACCTT,sample,81276,80251,12497,67754,9372,58382,13143,642,24762,2634,37905,17201,6428,1211,4878,5032
GCTCTTCTTGAACCTT,sample,356931,352430,58072,294358,35318,259040,41703,1908,113158,11127,154861,91144,17195,3577,14037,20205
CCTAGCGGTGAACCTT,Pos_Ctrl,83081,80789,8863,71926,3091,68835,57763,5050,4215,540,61978,1267,6785,8263,3573,1314
AGCAGAGCTGAACCTT,sample,192002,189570,21524,168046,26902,141144,31792,924,58900,6320,90692,43208,11702,2361,16197,17515
ATGAATAGTGAACCTT,sample,133439,131906,11742,120164,30510,89654,34831,1704,31501,3245,66332,18373,6848,1404,16611,20028
AAGTAGAGTGAACCTT,sample,400188,394540,67088,327452,33274,294178,37807,1861,129843,14249,167650,110418,17617,3709,12002,17944
TCAATCAGTGAACCTT,sample,147847,146203,19189,127014,20047,106967,24111,1226,45827,5338,69938,30465,10159,1747,7868,12761
ATTCTACCTGAACCTT,Pos_Ctrl,147731,143637,15493,128144,5281,122863,103191,8352,7743,1016,110934,2561,7747,10435,6900,2494
GACTAACCTGAACCTT,sample,74064,72390,18290,54100,5981,48119,7793,445,21173,2349,28966,16359,8185,1404,1368,2843
AGATACTATGAACCTT,sample,316546,311415,50948,260467,35639,224828,37797,1130,97668,9785,135465,78448,16233,3051,11348,21111
CATAATGGACCGAATT,sample,101392,99001,20370,78631,12776,65855,12963,658,27522,2780,40485,21932,8368,1198,5528,7237
TATACGGAACCGAATT,sample,26895,25719,9357,16362,1177,15185,1097,46,7202,797,8299,6043,4186,225,125,355
GAGCCTCCACCGAATT,sample,179045,174032,38918,135114,15290,119824,16549,504,53622,5424,70171,43725,13027,1669,6343,8519
GGCAGGTTACCGAATT,sample,196316,191584,39065,152519,19556,132963,26589,1591,57532,6495,84121,40756,12484,2282,8334,11142
GATGCGTTACCGAATT,sample,483678,475521,81989,393532,52582,340950,62692,1935,141801,14364,204493,120158,17623,3900,30276,29935
ATGGCGTTACCGAATT,sample,315889,310383,55683,254700,32023,222677,31715,1482,96945,9765,128660,82770,15819,2958,10169,18883
TAGCGAGTACCGAATT,sample,410149,403602,64575,339027,48168,290859,50621,2281,122428,13361,173049,102168,16390,3463,22509,29144
GCTCTTCTACCGAATT,sample,260372,257367,34224,223143,49199,173944,48698,2201,66201,8290,114899,48554,9310,2020,28312,30805
CTAAGCATACCGAATT,sample,189096,186978,19278,167700,35505,132195,49118,2433,50447,5538,99565,24659,7080,1865,15377,22592
CTAACCGGACCGAATT,sample,137601,136097,20103,115994,24133,91861,21838,1143,37089,4660,58927,27131,8935,1600,8390,15267
GCCTATTCACCGAATT,sample,199459,196891,23124,173767,29621,144146,33521,1653,59842,5680,93363,43450,11015,2029,15540,19805
AGCAGAGCACCGAATT,sample,187129,184872,23285,161587,24652,136935,31953,1533,59231,6303,91184,37915,11224,2098,11634,15829
ATACCGCCACCGAATT,sample,72654,71728,8868,62860,15522,47338,16525,1032,18046,2260,34571,9475,5384,1035,8781,9746
CAGCTTCGACCGAATT,Neg_Ctrl,3762,1372,992,380,62,318,85,3,114,15,199,101,159,28,31,7
TCTCCTAGACCGAATT,sample,233717,231629,27204,204425,37468,166957,48056,2233,65891,7413,113947,43364,11533,2327,23171,23140
CGTAGAACACCGAATT,sample,252830,250268,31678,218590,41301,177289,38423,2311,75518,8302,113941,52735,13556,2556,14029,25635
AGATACTAACCGAATT,sample,259062,257293,25168,232125,40808,191317,39896,1992,81459,9930,121355,58040,13062,3022,12582,25770
CTGGTCTTGGTCTGGT,sample,124268,123131,10007,113124,24880,88244,21090,663,36783,3940,57873,25768,8504,1578,10595,16307
GTCGTTCTGGTCTGGT,Neg_Ctrl,2691,1146,755,391,86,305,64,2,133,8,197,98,151,20,28,16
AGAGTTCTGGTCTGGT,sample,130307,129367,12802,116565,33948,82617,32255,1577,26801,2971,59056,19013,5681,1229,18620,19960
CATACTCCGGTCTGGT,sample,93343,91913,16313,75600,10387,65213,14355,912,28819,3220,43174,17907,7622,1420,5032,5895
CTAGCGACGGTCTGGT,sample,171733,169739,20107,149632,37691,111941,35861,1497,44518,4587,80379,25478,7123,1490,18640,23317
CGTCGCCAGGTCTGGT,Neg_Ctrl,3698,2092,1225,867,160,707,170,3,300,25,470,209,341,52,61,60
TCATCGAAGGTCTGGT,sample,246528,243588,32807,210781,38355,172426,37705,1542,69854,6414,107559,56911,11930,2310,17257,24484
ATTCAAGGGGTCTGGT,sample,228452,225567,31281,194286,36898,157388,26700,1296,71252,7040,97952,51100,13511,2514,9636,23435
GCAACTAGGGTCTGGT,sample,19695,19403,3802,15601,2275,13326,2010,101,6259,649,8269,4307,4027,573,544,1150
ATACGTTCGGTCTGGT,sample,171292,169438,13223,156215,46986,109229,33135,1162,41140,4921,74275,28871,6762,1351,18070,29469
CCGCAGTCGGTCTGGT,sample,239588,234888,37432,197456,31050,166406,29396,999,71693,6763,101089,57555,12959,2281,12462,19136
CCGTACGCGGTCTGGT,sample,132580,130444,16266,114178,25916,88262,21872,807,35473,3524,57345,26586,8906,1332,11776,15163
ATGGCGTTGGTCTGGT,sample,182324,180078,18875,161203,42404,118799,37468,1714,43637,5023,81105,30957,9592,1956,18452,25815
TGCGCGTTGGTCTGGT,Neg_Ctrl,2914,1725,1048,677,126,551,113,5,227,37,340,169,248,39,37,46
ACGCTTAAGGTCTGGT,sample,266131,261362,38489,222873,32973,189900,37836,2052,81907,9068,119743,59037,13469,2602,13947,19255
CTAACCGGGGTCTGGT,Neg_Ctrl,2365,1125,616,509,88,421,93,7,163,20,256,138,188,32,42,23
GCTGCTTCGGTCTGGT,sample,70898,69775,8529,61246,7927,53319,12889,1003,24021,2845,36910,12561,6300,1224,3832,4750
GCCTATTCGGTCTGGT,sample,168936,166554,21951,144603,22918,121685,22781,1054,52351,5243,75132,40256,10619,1590,10279,14504
CGTCGAGGGGTCTGGT,sample,216119,212423,35838,176585,29653,146932,27256,983,62041,6612,89297,50040,11849,2001,11236,18660
AAGTAGAGGGTCTGGT,sample,206554,203463,21603,181860,24642,157218,28966,1446,65954,7776,94920,53076,12481,2268,11523,17073
TCAATCAGGGTCTGGT,sample,162764,160877,13307,147570,23959,123611,28360,1142,54109,5675,82469,34325,8658,1888,12117,16811
TAACGCCAGGTCTGGT,sample,193603,190800,20839,169961,27443,142518,31775,1926,57499,6002,89274,45316,11844,2215,8351,18541
GACTAACCGGTCTGGT,Neg_Ctrl,2847,1505,862,643,104,539,116,6,225,36,341,156,250,45,44,37
CGCGAGACGGTCTGGT,sample,213565,208880,30387,178493,26794,151699,27990,1717,64810,6842,92800,50340,12765,2347,9984,15837
TTAACTGAGGTCTGGT,sample,273406,268993,38257,230736,22613,208123,32955,1296,91336,9734,124291,72802,15344,2842,12929,12903
AGAGTTCTCGACGTTA,sample,117315,114654,18493,96161,17685,78476,15687,570,32032,3359,47719,26828,8902,1219,7152,10766
GAGCCTCCCGACGTTA,sample,86413,84215,17371,66844,9643,57201,9791,300,23978,2683,33769,20449,8040,960,4682,5737
GGTAGAGACGACGTTA,sample,90403,87703,16863,70840,13465,57375,12307,687,23948,2328,36255,18105,7429,1077,5570,7768
ATGGCGTTCGACGTTA,sample,296380,292014,54771,237243,42358,194885,38655,1386,83142,9393,121797,62309,13212,2423,16441,24302
TGCGCGTTCGACGTTA,sample,207683,204843,29978,174865,32812,142053,34645,1526,58945,6153,93590,40784,10423,1731,18762,20782
TAGCGAGTCGACGTTA,sample,447419,437997,93772,344225,34794,309431,40871,1613,138575,14888,179446,113484,19503,3887,11194,18689
GGCGACGACGACGTTA,sample,125411,124048,11506,112542,27365,85177,35739,1997,28546,3172,64285,15723,6542,1508,15389,18134
TAACGAAGCGACGTTA,sample,146553,144880,21702,123178,24221,98957,25184,985,39860,4212,65044,28716,9269,1602,11592,15278
GCTGCTTCCGACGTTA,sample,256936,253880,34829,219051,35806,183245,37043,1423,75912,8588,112955,60279,12691,2373,17457,21916
GCCTATTCCGACGTTA,sample,232249,229570,34792,194778,32084,162694,32407,1491,67242,6916,99649,54638,12641,2432,13175,19588
AGCAGAGCCGACGTTA,sample,196031,193967,20162,173805,36976,136829,40118,1898,49714,5157,89832,39942,9423,1703,22660,25067
GCGTTACCCGACGTTA,sample,136839,135439,10994,124445,30697,93748,28832,1560,37645,4498,66477,21213,7534,1356,14812,19790
GGCGTACCCGACGTTA,sample,220194,218106,18094,200012,55730,144282,52400,1904,50957,5430,103357,33591,9335,1871,29385,36142
CGTCGAGGCGACGTTA,sample,243150,240931,25448,215483,47299,168184,47170,2144,63560,7588,110730,47722,11491,2299,21933,30542
ATTCTACCCGACGTTA,sample,175737,174258,15039,159219,61990,97229,48174,3184,31365,2429,79539,12077,3961,1063,20789,34000
CGTAGAACCGACGTTA,sample,139315,138144,12578,125566,30479,95087,28856,1790,37430,3843,66286,23168,8431,1528,13015,18808
AGATACTACGACGTTA,sample,169195,167950,17369,150581,29215,121366,26432,1522,50534,5235,76966,37643,10719,2003,11516,18399
TTAACTGACGACGTTA,sample,53331,52818,5131,47687,11257,36430,9567,647,14611,1662,24178,9943,4875,952,3987,7023
ATATGCAACGACGTTA,sample,138220,137221,11782,125439,24573,100866,26135,1150,41099,4701,67234,27781,10057,1846,9520,15563
CTGGTCTTTACTAAGT,sample,24983,24315,5238,19077,2859,16218,3973,152,6574,643,10547,4876,3617,528,1758,1667
CATAATGGTACTAAGT,sample,27920,26965,5830,21135,2996,18139,3564,122,7608,774,11172,6071,4230,425,1863,1650
GAGCCTCCTACTAAGT,sample,42567,41746,4731,37015,8756,28259,8008,271,11132,1118,19140,7730,4052,658,4755,5516
TCGAACGATACTAAGT,sample,29495,28796,5974,22822,3055,19767,3893,161,8453,893,12346,6367,4377,565,1493,1694
ATTCAAGGTACTAAGT,sample,122296,119711,24429,95282,10189,85093,12730,521,36426,3994,49156,31422,10999,1381,4873,5803
GCAACTAGTACTAAGT,sample,55289,54587,8346,46241,5214,41027,6174,258,18850,2241,25024,13504,7837,1123,1807,2695
ATACGTTCTACTAAGT,sample,239353,234440,41068,193372,21712,171660,24468,944,76467,7346,100935,62435,14835,2389,8945,12668
TGGATCAATACTAAGT,sample,60495,59697,7585,52112,12199,39913,12029,679,15608,1616,27637,9981,5495,1062,5686,7455
CATTCGGTTACTAAGT,sample,87759,86427,11537,74890,11074,63816,14736,536,25833,2577,40569,20134,7879,1101,8172,7989
AAGGTCTGTACTAAGT,sample,79985,78616,13717,64899,10091,54808,9774,419,23748,2286,33522,18581,7955,1048,4333,6061
CTAACCGGTACTAAGT,sample,104337,102933,14009,88924,12820,76104,12257,599,32445,3275,44702,27528,10049,1449,4293,7952
GCTGCTTCTACTAAGT,sample,62520,61452,11705,49747,5134,44613,7340,419,19721,2132,27061,15001,7092,1053,2103,2690
TGCGCTCCTACTAAGT,sample,66809,65917,7530,58387,16827,41560,13214,494,15241,1820,28455,10791,5614,922,6795,9924
CGTCGAGGTACTAAGT,sample,49118,47831,13251,34580,3461,31119,3774,175,14088,1573,17862,11509,6891,731,844,1471
CGCGGTCGTACTAAGT,sample,126638,124378,23764,100614,12019,88595,12958,430,38626,3942,51584,32639,11788,1580,4174,6564
AAGTAGAGTACTAAGT,sample,45202,44557,5581,38976,6098,32878,9510,742,13714,1506,23224,7406,4709,946,2638,4106
CGCGAGACTACTAAGT,sample,110324,108918,9774,99144,21720,77424,23068,817,29203,2529,52271,21807,6115,1237,12021,14648
CCTAACTATACTAAGT,sample,142842,140362,24513,115849,17515,98334,19889,1079,41606,4539,61495,31221,9795,1559,7685,10403
TTAACTGATACTAAGT,sample,76845,75700,13645,62055,10124,51931,11495,460,21546,2259,33041,16171,7507,1009,5491,5790
TATACGGATTGCCGCT,sample,193467,190433,20439,169994,52922,117072,43580,2448,41486,4371,85066,25187,7459,1696,21840,31679
GGAGAAGCTTGCCGCT,sample,272829,268691,32909,235782,40024,195758,51895,2241,78004,8124,129899,55494,13284,2889,21305,24900
CTAGCGACTTGCCGCT,sample,161947,159104,27090,132014,24882,107132,26339,762,44276,4633,70615,31122,8268,1523,13228,14666
TCGAACGATTGCCGCT,sample,232974,229282,36633,192649,36147,156502,38520,1759,60766,6207,99286,49250,11261,2043,19991,23052
TCATACCATTGCCGCT,sample,176693,172668,27067,145601,24178,121423,23599,1174,50398,5367,73997,40885,12618,2102,9996,14667
CCGTACGCTTGCCGCT,sample,152409,150259,18915,131344,29943,101401,28666,1292,39375,4732,68041,27336,8900,1611,13930,18181
TGGATCAATTGCCGCT,sample,351832,347633,40665,306968,61255,245713,71655,2109,90406,10889,162061,70654,12291,2629,41327,40984
GATGCGTTTTGCCGCT,sample,332155,328559,50615,277944,47657,230287,57574,2902,91121,9847,148695,68843,12833,3040,27208,31296
ATGGCGTTTTGCCGCT,sample,212941,210921,26370,184551,53846,130705,44601,2889,45597,5705,90198,31913,8723,1923,21926,31016
TGCGCGTTTTGCCGCT,sample,202511,199590,30518,169072,33048,136024,34884,1160,56361,5874,91245,37745,10420,1803,15755,19941
GGCGACGATTGCCGCT,sample,38724,37691,8061,29630,5064,24566,5126,266,10355,1103,15481,7716,5287,811,2034,2906
GCGTTACCTTGCCGCT,sample,267759,264454,32010,232444,36387,196057,44193,2348,84789,9349,128982,55378,13199,2496,17862,22664
GTCGCGAATTGCCGCT,sample,240978,238590,29309,209281,33190,176091,37587,1433,73496,8543,111083,55032,12234,2353,15549,22381
TTATGACGTTGCCGCT,sample,263687,261500,24810,236690,59349,177341,58611,2354,67926,7755,126537,40695,10963,2504,26200,35485
TCTCCTAGTTGCCGCT,sample,191522,189995,17683,172312,36385,135927,41431,1687,55667,5377,97098,31765,9669,1811,18041,23936
AAGTAGAGTTGCCGCT,sample,178457,177012,17660,159352,28817,130535,31307,1162,57051,5890,88358,35125,10970,2200,12206,18575
CGTAGAACTTGCCGCT,sample,173657,171334,24744,146590,19168,127422,30812,1972,55296,5940,86108,33402,11093,2378,6718,11225
AACCGGTTTTCGACCT,sample,629017,617627,118225,499402,67585,431817,64303,1980,188382,19435,252685,157717,20771,4744,25265,37999
TCTAGGTTTTCGACCT,sample,191871,186454,51296,135158,11990,123168,14765,655,56579,5672,71344,45497,13105,1898,3696,5234
AGAGTTCTTTCGACCT,sample,409077,401471,72561,328910,48156,280754,50779,2209,115979,13529,166758,98258,16515,3245,23745,26615
AGCTGAATTTCGACCT,sample,183490,179936,30379,149557,33204,116353,24953,1124,49324,4839,74277,36113,9771,1534,12537,19140
TATACGGATTCGACCT,sample,158677,155307,30120,125187,15934,109253,23928,1465,48841,5379,72769,29640,10689,2166,5119,9494
GAGCCTCCTTCGACCT,sample,186204,183852,19024,164828,41504,123324,33338,1575,47211,5233,80549,35967,9437,1846,19186,26391
TCGAACGATTCGACCT,sample,312053,306286,61612,244674,36698,207976,38110,1603,88555,9443,126665,70265,13894,2626,15528,21983
TACGCGAGTTCGACCT,sample,94308,91469,23810,67659,6508,61151,8617,529,28324,3062,36941,20619,8851,1390,1406,3167
ATACGTTCTTCGACCT,sample,256094,250953,50178,200775,30778,169997,28834,1359,73498,8299,102332,58007,13733,2356,10569,17373
CCGCAGTCTTCGACCT,sample,212307,209717,29733,179984,37630,142354,42759,2920,52751,5695,95510,38229,8912,2205,15431,23858
CCGTACGCTTCGACCT,sample,422251,415629,72622,343007,40402,302605,49072,1787,134289,13783,183361,103674,17863,3693,19045,24238
CTAAGCATTTCGACCT,sample,260602,254595,51513,203082,27505,175577,25739,1323,77621,8095,103360,62799,13879,2288,8955,16504
CTAACCGGTTCGACCT,sample,40433,39624,10527,29097,3849,25248,3711,185,11074,1081,14785,9197,5057,588,1548,1949
GCTGCTTCTTCGACCT,sample,43345,42800,7383,35417,7536,27881,6221,306,11243,1136,17464,8975,4566,671,3327,4552
AAGTAGAGTTCGACCT,sample,260861,258134,34596,223538,34070,189468,36163,1778,82568,9049,118731,59910,14089,2833,10344,21561
AGATACTATTCGACCT,sample,205991,204120,25787,178333,35338,142995,38809,2242,60748,6590,99557,34606,10772,2181,13290,21363
GCGCAATATTCGACCT,sample,138844,137645,14698,122947,20198,102749,25727,1784,43119,5035,68846,27084,9517,1835,9349,12648
AGCTGAATTCCAGACT,sample,65893,65214,7046,58168,11163,47005,15249,832,18942,2410,34191,9572,4936,1144,5261,7360
GACGTATGTCCAGACT,sample,68683,67746,8904,58842,15620,43222,11661,553,16831,1701,28492,12476,6216,915,6431,9297
CTAGCGACTCCAGACT,sample,23612,23299,3223,20076,3747,16329,3957,204,7057,736,11014,4375,3358,649,1623,2269
TCGAACGATCCAGACT,sample,30153,29787,2592,27195,9565,17630,7015,267,5758,624,12773,3966,2573,675,4081,5445
GGTAGAGATCCAGACT,sample,61666,60765,7713,53052,13136,39916,12982,626,14957,1481,27939,9870,5279,933,6368,8106
TGATTCCGTCCAGACT,sample,95473,94087,16317,77770,16942,60828,12293,473,24558,2673,36851,20831,7971,1209,5343,9671
TCTCAGGATCCAGACT,sample,70822,69605,11737,57868,9071,48797,11005,542,19932,2091,30937,15227,6944,1074,5166,5557
GGCAGGTTTCCAGACT,sample,46136,45290,6945,38345,10216,28129,7817,453,10876,1385,18693,7598,4427,797,4103,6275
ATGGCGTTTCCAGACT,sample,124723,122440,20950,101490,16545,84945,16887,553,35966,3458,52853,28081,9344,1299,8248,10371
CCATTCTTTCCAGACT,sample,37255,36457,8079,28378,3823,24555,4121,129,10956,1250,15077,8099,5202,569,1825,2131
ACGCTTAATCCAGACT,sample,21319,20952,3629,17323,2815,14508,3820,199,6290,657,10110,3542,3025,702,1310,1639
GGCGACGATCCAGACT,sample,16304,15982,2611,13371,3273,10098,3108,124,3776,543,6884,2547,2295,460,1495,1950
TAACGAAGTCCAGACT,sample,24595,23902,5861,18041,2120,15921,2263,118,6939,776,9202,5825,4138,396,889,1130
TGCGCTCCTCCAGACT,Pos_Ctrl,76434,74032,8039,65993,2475,63518,53208,4541,4093,464,57301,1212,6503,7983,3252,946
CGTCGAGGTCCAGACT,Pos_Ctrl,59077,56980,6421,50559,1953,48606,40945,3441,2938,380,43883,902,6081,7069,2556,738
CAGCTTCGTCCAGACT,sample,92413,90398,15907,74491,10908,63583,12205,614,27090,2899,39295,20775,8247,1229,4215,6269
ATGAATAGTCCAGACT,sample,106042,104033,17180,86853,15561,71292,15985,630,29382,3183,45367,22112,9078,1400,5924,9246
GACTAACCTCCAGACT,sample,120813,118001,23742,94259,11783,82476,15197,862,35733,3839,50930,26845,10193,1497,4489,6507
CGTAGAACTCCAGACT,sample,72757,70919,13888,57031,6724,50307,9935,509,22023,2340,31958,15500,7193,1153,2642,3793
CCTAACTATCCAGACT,sample,141535,138977,23581,115396,20703,94693,21211,1196,39927,3846,61138,28513,7252,1489,8239,10965
GAGCCTCCACCATTAT,sample,134427,131911,20575,111336,20899,90437,21983,994,37782,4375,59765,25303,9040,1617,10007,12869
CTAGCGACACCATTAT,sample,416225,407345,77693,329652,54352,275300,50104,2272,114704,12949,164808,95271,18017,3471,20329,32375
GACTCAAGACCATTAT,sample,141994,138268,29014,109254,13435,95819,12235,540,43238,4257,55473,35549,10270,1450,4454,6697
GGCAGGTTACCATTAT,sample,265284,262534,35181,227353,50419,176934,51747,2295,70111,6983,121858,45798,10298,2068,24658,30680
GATGCGTTACCATTAT,sample,402610,398056,57430,340626,57859,282767,53263,2465,116689,12694,169952,97656,15746,3273,23587,36533
ACGCTTAAACCATTAT,sample,212526,209117,31451,177666,21770,155896,29333,1522,66267,6737,95600,52037,12158,2245,12114,12627
TAGCGAGTACCATTAT,sample,143961,141514,27002,114512,19031,95481,18676,878,41050,4216,59726,30661,9824,1498,9321,11219
GCTCTTCTACCATTAT,sample,179003,176140,31865,144275,26846,117429,26236,1386,49322,4650,75558,35835,10369,1719,13109,17003
GAGATTCTACCATTAT,sample,89719,88228,15981,72247,11415,60832,12897,601,27238,2903,40135,17193,7909,1479,4378,7032
CCTAGCGGACCATTAT,sample,272829,269090,37771,231319,39927,191392,45158,1464,76664,8033,121822,60073,14227,2424,23774,25608
GGCGACGAACCATTAT,sample,262031,258933,26057,232876,45466,187410,52243,1857,72777,7914,125020,52619,10574,2347,21227,28729
GCCTATTCACCATTAT,sample,299854,296100,29148,266952,55701,211251,55742,4380,85078,8319,140820,57732,12166,2485,25974,37328
TGCGCTCCACCATTAT,sample,404279,399100,47916,351184,53849,297335,72090,3574,119320,14215,191410,88136,15278,3548,26791,36304
GGCGTACCACCATTAT,sample,175053,172952,16468,156484,41461,115023,44540,2194,39603,5099,84143,23587,7875,1500,23583,25776
GTCGCGAAACCATTAT,sample,212218,209825,22590,187235,38258,148977,52729,2533,55893,5740,108622,32082,8803,1701,21486,26562
CGCGGTCGACCATTAT,sample,250518,247021,35532,211489,38394,173095,35115,1686,73931,7038,109046,55325,12855,2505,14137,24060
TCAATCAGACCATTAT,sample,201190,197911,36954,160957,19289,141668,28702,1340,61655,7084,90357,42887,11740,2246,10072,11290
ATTCTACCACCATTAT,sample,352172,344580,62602,281978,39621,242357,53891,3078,98603,10716,152494,76069,14991,3037,16011,23581
GACTAACCACCATTAT,sample,369708,361790,62940,298850,50464,248386,50920,2781,106069,12709,156989,75907,14168,3020,17765,30104
CTGGTCTTCAATGGAT,sample,178349,174445,30015,144430,20908,123522,21544,812,52458,5450,74002,43258,11924,1854,8531,12525
AGCTGAATCAATGGAT,sample,321745,315516,54019,261497,37548,223949,43091,2198,97767,10645,140858,70248,13971,2901,16846,22798
CATAATGGCAATGGAT,sample,205196,202128,30434,171694,32860,138834,33363,2102,56902,5114,90265,41353,10877,2026,13827,19894
CTAGCGACCAATGGAT,sample,170654,165257,37845,127412,15841,111571,17355,721,49342,4896,66697,39257,13273,1724,7010,8691
CGTCGCCACAATGGAT,sample,198080,196130,24921,171209,36713,134496,40294,2038,52113,5298,92407,34753,10585,2097,18161,22407
TGATTCCGCAATGGAT,sample,488924,480451,87440,393011,46417,346594,52109,2033,149738,15926,201847,126788,19824,4403,16931,28074
GCAACTAGCAATGGAT,sample,56565,55848,11119,44729,4839,39890,6722,445,18384,1891,25106,12448,7255,1267,1543,2301
GGCAGGTTCAATGGAT,sample,282678,279297,41754,237543,47782,189761,53986,2582,73965,8491,127951,50737,11697,2197,26722,31006
GATGCGTTCAATGGAT,sample,200597,198380,22793,175587,41535,134052,32430,1241,54921,6036,87351,39424,9943,1906,14685,24558
TGCGCGTTCAATGGAT,sample,283987,280189,48311,231878,40807,191071,36931,1619,80587,8422,117518,63512,12890,2190,16903,25622
CCATTCTTCAATGGAT,sample,324966,320583,42892,277691,57271,220420,50343,3256,88624,9832,138967,68365,13937,2570,22402,35443
ATACCGCCCAATGGAT,Neg_Ctrl,4630,2169,1523,646,117,529,131,6,204,22,335,166,245,41,44,19
GGCGTACCCAATGGAT,sample,306381,302897,39373,263524,56140,207384,59825,3289,77731,8161,137556,58378,11583,2711,29472,35918
CAGCTTCGCAATGGAT,Neg_Ctrl,3939,1654,1230,424,71,353,106,4,132,18,238,93,186,32,30,11
AAGTAGAGCAATGGAT,sample,230588,227702,30585,197117,31264,165853,30713,1799,75110,7877,105823,50354,12769,2290,10764,20134
ATTCTACCCAATGGAT,sample,454502,447954,72598,375356,43375,331981,59040,3110,144779,15216,203819,109836,16137,3788,18254,28052
CCTAACTACAATGGAT,Pos_Ctrl,188287,181496,17378,164118,6199,157919,132998,11534,9168,1075,142166,3144,7530,11072,8184,2037
CTGGTCTTAGATTCAT,sample,236975,232448,37004,195444,28324,167120,32037,1323,69877,7068,101914,56815,12402,2296,14366,17748
AGAGTTCTAGATTCAT,sample,167160,164933,23369,141564,28970,112594,26170,1155,45601,4893,71771,34775,8931,1560,13706,18566
GGTAGAGAAGATTCAT,sample,181535,176269,40915,135354,14123,121231,19896,1089,54172,6284,74068,39790,11643,1844,5773,7855
CGTCGCCAAGATTCAT,sample,167647,162406,40250,122156,10948,111208,13613,614,51100,5354,64713,40527,12700,1923,3002,5293
TCATCGAAAGATTCAT,sample,300254,294292,57874,236418,33847,202571,37438,1506,84385,8886,121823,70356,16454,2745,16619,19061
ATACGTTCAGATTCAT,sample,209862,206392,29669,176723,31294,145429,32885,1772,60218,6396,93103,44158,10130,1876,14545,18716
TCTCAGGAAGATTCAT,sample,161336,158473,25303,133170,16343,116827,21341,1395,50776,5285,72117,38030,11260,1978,6698,9614
CGGTTGGTAGATTCAT,sample,103732,102236,12984,89252,20627,68625,18895,1108,27359,3023,46254,18240,7657,1283,9299,13086
ACGCTTAAAGATTCAT,sample,247399,243149,50967,192182,26624,165558,29148,803,68361,6988,97509,60258,12454,1898,12830,14933
GAGATTCTAGATTCAT,sample,181761,179040,26905,152135,26872,125263,30827,1861,51075,4974,81902,36526,10294,1662,13843,16772
CTAAGCATAGATTCAT,sample,217103,213557,27999,185558,42412,143146,35878,1596,56618,6813,92496,42241,11069,1988,15452,25422
AAGGTCTGAGATTCAT,sample,270029,267016,31519,235497,51729,183768,52163,2303,68375,7659,120538,53268,11777,2353,25223,32912
CTAACCGGAGATTCAT,sample,177166,175275,19106,156169,36809,119360,35328,1390,47708,4527,83036,30407,7908,1617,16647,23621
AGCAGAGCAGATTCAT,sample,162178,159613,22420,137193,29351,107842,27326,1288,44120,4673,71446,30435,9508,1686,11623,17103
ATACCGCCAGATTCAT,sample,366099,359680,62041,297639,39700,257939,43435,1462,112476,11789,155911,88777,16483,3330,14466,22698
GCGTTACCAGATTCAT,sample,171862,169653,24639,145014,22137,122877,24244,1121,51885,5480,76129,40147,11863,2154,8591,13455
CGTCGAGGAGATTCAT,sample,104417,103495,9035,94460,20061,74399,21156,1553,29573,3674,50729,18443,8468,1539,9982,12759
CGCGGTCGAGATTCAT,sample,79732,78992,5118,73874,27025,46849,25947,1323,12009,2245,37956,5325,2465,697,14597,16148
ATGAATAGAGATTCAT,sample,67253,66224,11696,54528,7098,47430,9101,576,20741,2581,29842,14431,7213,1271,2389,3799
ATTCTACCAGATTCAT,sample,496370,489844,77257,412587,57009,355578,60840,2493,151566,16655,212406,124024,20144,4921,19706,36624
CGCGAGACAGATTCAT,sample,409420,403008,75920,327088,30730,296358,39630,1871,132327,14234,171957,108296,19660,4178,10013,17159
ATATGCAAAGATTCAT,sample,173728,172300,21021,151279,16804,134475,28083,2793,60791,6729,88874,36079,10893,2110,6737,10569
AACCGGTTCAATCTTG,sample,32766,32478,2971,29507,8447,21060,7891,306,8384,1018,16275,3461,3035,720,4041,4919
TATACGGACAATCTTG,sample,171812,169897,23064,146833,34393,112440,26793,1646,45498,4443,72291,34060,9669,1674,13816,20565
GGAGAAGCCAATCTTG,sample,83361,82430,10653,71777,12217,59560,15674,931,26268,3081,41942,13606,6304,1417,5345,8094
CATACTCCCAATCTTG,sample,169772,167801,25763,142038,24909,117129,26148,1277,50144,5788,76292,33772,10608,2105,9578,15695
CTAGCGACCAATCTTG,sample,68784,67553,15680,51873,5923,45950,6777,344,20973,2170,27750,15686,7163,1026,2263,2825
TCGAACGACAATCTTG,sample,77791,76645,11992,64653,11721,52932,11249,877,23115,2554,34364,15137,7261,1326,4333,7182
TACGCGAGCAATCTTG,sample,108107,105759,22296,83463,12637,70826,11790,754,31235,3605,43025,23442,8847,1373,3900,7231
CCGTACGCCAATCTTG,sample,126664,124362,25244,99118,13420,85698,15289,650,37204,4125,52493,28430,10008,1622,5921,7447
TGCGCGTTCAATCTTG,sample,328252,324346,48292,276054,41240,234814,52589,1792,101390,11497,153979,67546,12699,2858,19623,25007
CCATTCTTCAATCTTG,sample,239548,236075,24366,211709,45082,166627,50067,1823,63326,6754,113393,44657,10515,2163,23655,29442
AGCGTCTTCAATCTTG,sample,292150,287118,60269,226849,23330,203519,35260,1887,88265,9510,123525,68597,15290,3403,6058,12109
GAGATTCTCAATCTTG,sample,157164,155088,19956,135132,41662,93470,27356,1780,35775,3522,63131,25037,8259,1286,15962,23797
GGCGACGACAATCTTG,sample,228633,225764,22166,203598,57514,146084,51620,3024,50933,5034,102553,35473,8914,1768,24499,36871
TAACGAAGCAATCTTG,sample,261248,257242,36575,220667,29450,191217,35006,1369,79250,8846,114256,66746,13084,2287,15734,18567
GCCTATTCCAATCTTG,sample,111777,109111,26967,82144,6037,76107,9937,621,35566,3660,45503,26323,9400,1578,1174,2161
ATACCGCCCAATCTTG,sample,342384,335963,52244,283719,43002,240717,38840,1511,102609,10247,141449,87510,16461,3210,14309,25154
CAGCTTCGCAATCTTG,sample,260063,255505,38157,217348,38033,179315,34604,1648,73628,8057,108232,61378,11240,2184,13269,23041
CGCGAGACCAATCTTG,sample,202403,198027,32546,165481,23065,142416,30254,1852,56891,5809,87145,47610,12160,2418,7992,13842
GCGCAATACAATCTTG,Neg_Ctrl,3561,1717,1128,589,100,489,138,8,181,22,319,140,239,53,54,22
ATATGCAACAATCTTG,sample,332075,324762,64620,260142,24100,236042,34820,1979,105651,11025,140471,82567,16413,3384,7451,10621
TCTAGGTTCGTTCCGA,sample,162106,159580,30644,128936,20660,108276,19634,934,45709,4520,65343,37479,9688,1588,9636,11249
AGAGTTCTCGTTCCGA,sample,242446,236717,48759,187958,20430,167528,22703,922,73665,7556,96368,62682,13730,2049,8186,11375
AGCTGAATCGTTCCGA,sample,356520,346758,77536,269222,29760,239462,34231,1251,104966,10437,139197,88577,16358,2640,11978,17480
GGAGAAGCCGTTCCGA,sample,74729,73121,15654,57467,9631,47836,9873,514,20199,2363,30072,14887,7356,1220,4066,5147
TCATACCACGTTCCGA,sample,628082,616029,139558,476471,56544,419927,57944,2167,183685,19982,241629,156149,21256,4844,19164,29142
ATACGTTCCGTTCCGA,sample,141725,139304,27107,112197,26886,85311,16099,986,36862,4116,52961,27248,9674,1723,6152,14630
GATGCGTTCGTTCCGA,sample,157423,155438,18655,136783,41901,94882,33562,1780,33306,4037,66868,22197,7651,1537,17989,24982
ATGGCGTTCGTTCCGA,sample,296800,289617,89374,200243,14459,185784,17772,824,86051,9211,103823,71926,16532,2616,2723,5071
AGCGTCTTCGTTCCGA,sample,403188,398156,62568,335588,52980,282608,53394,2788,119413,12021,172807,94992,16843,3640,18845,31962
GCTCTTCTCGTTCCGA,sample,212377,209054,41046,168008,18040,149968,25628,1509,69659,7988,95287,45184,12005,2262,5517,10962
CTAACCGGCGTTCCGA,sample,342080,338076,57750,280326,33142,247184,36902,1805,109869,11153,146771,87455,16895,3379,12162,20021
GTCGCGAACGTTCCGA,sample,202933,201148,19299,181849,62792,119057,49873,2373,42666,3951,92539,20194,5849,1191,27237,36217
TCTCCTAGCGTTCCGA,sample,292015,288604,47830,240774,35792,204982,34595,2117,91643,9702,126238,66925,14838,2711,13107,22117
GACTAACCCGTTCCGA,sample,492089,486194,90753,395441,41134,354307,50080,2096,155947,17247,206027,128937,19269,4369,12346,19841
CGCGAGACCGTTCCGA,sample,226227,223539,34605,188934,32991,155943,33758,1758,64371,6651,98129,49405,11559,1842,14229,21067
CGTAGAACCGTTCCGA,sample,188973,187169,23419,163750,29070,134680,32583,1409,54911,6945,87494,38832,10230,1743,16265,16929
GCGCAATACGTTCCGA,sample,349032,345836,49830,296006,33045,262961,41830,1763,116003,12398,157833,90967,18078,4116,12063,17381
TTAACTGACGTTCCGA,sample,8661,8579,957,7622,1500,6122,1326,93,2662,258,3988,1783,2036,399,378,878
CTGGTCTTCAATTCGG,Pos_Ctrl,58273,55565,6900,48665,2062,46603,39232,2788,3085,398,42317,1100,6194,6483,3264,946
CATACTCCCAATTCGG,Pos_Ctrl,75455,71814,8561,63253,2685,60568,50526,4182,4117,445,54643,1298,6701,7805,4104,1144
CGTCGCCACAATTCGG,sample,62681,60566,13840,46726,4637,42089,6760,431,19194,2034,25954,13670,7174,1241,1397,2037
TCATACCACAATTCGG,sample,561671,545529,125768,419761,37975,381786,43911,1860,170793,17967,214704,147255,21808,4910,9464,18173
ATTCAAGGCAATTCGG,sample,165156,159608,26421,133187,22540,110647,27616,1392,46221,4814,73837,30604,10066,1949,8416,14384
TACGCGAGCAATTCGG,sample,233049,229299,31934,197365,52390,144975,35392,2288,58592,6072,93984,42631,10481,1912,17621,30546
GACTCAAGCAATTCGG,Pos_Ctrl,149793,145211,14849,130362,5614,124748,104980,8970,7482,1052,112462,2264,7736,10594,7980,2270
ATACGTTCCAATTCGG,sample,149047,146375,23238,123137,27883,95254,20521,1032,39065,4458,59586,30178,8978,1493,9351,15793
TCTCAGGACAATTCGG,sample,242736,239838,34054,205784,41830,163954,40646,1343,69398,6304,110044,46263,11602,2339,18577,25117
ATGGCGTTCAATTCGG,Pos_Ctrl,124468,120798,12199,108599,4559,104040,87448,7336,6409,851,93857,1996,7434,9593,6750,1945
CCATTCTTCAATTCGG,sample,150258,148030,15375,132655,33035,99620,32657,1131,37184,4093,69841,24555,8153,1505,17882,21458
GAGATTCTCAATTCGG,Pos_Ctrl,118481,116023,9945,106078,4542,101536,86227,7514,5461,618,91688,1716,7349,9782,6545,1776
CTAAGCATCAATTCGG,sample,123720,122346,12726,109620,18196,91424,30618,1685,38319,4437,68937,16365,6541,1727,8528,12159
AGCAGAGCCAATTCGG,Pos_Ctrl,129956,127954,9820,118134,4879,113255,96529,8928,5241,729,101770,1828,7430,10430,7211,1914
GGCGTACCCAATTCGG,sample,91929,91082,9175,81907,24485,57422,19952,822,21057,2270,41009,13321,6385,1087,11059,14723
GTCGCGAACAATTCGG,sample,95541,94771,14730,80041,11526,68515,13104,704,28890,3284,41994,22533,9904,1810,4130,6536
CGTCGAGGCAATTCGG,Pos_Ctrl,41904,41400,2552,38848,1762,37086,31319,3424,1507,201,32826,635,5457,6445,2112,734
TCTCCTAGCAATTCGG,sample,3252,3183,387,2796,515,2281,623,33,957,131,1580,537,999,288,140,301
TAACGCCACAATTCGG,sample,55144,54707,3280,51427,14086,37341,11059,549,14745,1842,25804,9146,5111,1097,3856,8584
ATTCTACCCAATTCGG,sample,14726,14479,1465,13014,2829,10185,2370,160,4249,374,6619,3032,3063,696,584,1702
ATATGCAACAATTCGG,sample,65987,65432,4506,60926,16022,44904,14197,737,17217,1851,31414,10902,5981,1239,4979,10521
AGAGTTCTAACTCCGG,sample,10565,10474,1551,8923,1680,7243,1459,125,3192,308,4651,2159,2291,394,624,1004
GAGCCTCCAACTCCGG,sample,130158,127673,21468,106205,15943,90262,15961,566,38268,4359,54229,31108,11252,1610,6553,9748
TCGAACGAAACTCCGG,sample,89445,88208,15742,72466,11460,61006,12397,493,26469,2746,38866,18901,8685,1267,4766,6832
TGATTCCGAACTCCGG,sample,72440,71372,10565,60807,11713,49094,11146,695,21363,2553,32509,13337,7050,1215,4369,7216
CCATTCTTAACTCCGG,sample,212544,209373,28317,181056,25632,155424,28044,832,64673,6533,92717,55342,13104,2346,11106,16879
GCTCTTCTAACTCCGG,sample,180736,179096,21077,158019,22333,135686,32350,1880,58264,6417,90614,36775,10195,2077,11231,14504
CTAAGCATAACTCCGG,sample,160171,158604,13484,145120,25356,119764,37883,1749,50865,5803,88748,23464,6777,1594,13062,17042
TAACGAAGAACTCCGG,sample,226127,222977,36775,186202,20367,165835,21744,991,73439,7851,95183,61810,15115,2592,7440,11691
CGTCGAGGAACTCCGG,sample,248984,246426,32373,214053,40732,173321,34678,2352,70827,7142,105505,58322,14034,2626,13077,24975
CAGCTTCGAACTCCGG,sample,198574,195706,27383,168323,28399,139924,29990,1200,58068,6156,88058,44510,11421,1673,13126,18288
ATGAATAGAACTCCGG,sample,325784,320605,55009,265596,35022,230574,43200,1903,99828,10243,143028,75400,15740,3452,13535,20290
ATTCTACCAACTCCGG,sample,394309,388803,51813,336990,41044,295946,48775,2252,131628,14384,180403,98907,17814,4470,13442,26723
GACTAACCAACTCCGG,sample,221486,217548,35155,182393,31774,150619,31504,1405,63740,6854,95244,47116,12263,1955,12104,20002
CGCGAGACAACTCCGG,sample,237891,234732,30897,203835,44231,159604,37069,1404,66178,7083,103247,47870,11010,2428,15640,27930
CGTAGAACAACTCCGG,sample,209441,206240,24514,181726,35149,146577,51430,2973,51291,5585,102721,35298,10551,2267,12951,21195
AGATACTAAACTCCGG,sample,328401,322938,55009,267929,35730,232199,36754,1689,99344,10511,136098,83901,14439,3010,13024,19620
GCGCAATAAACTCCGG,sample,178610,176185,17825,158360,29125,129235,28989,1445,52323,6148,81312,40330,10718,1929,12755,19708
ATATGCAAAACTCCGG,sample,115104,113595,12674,100921,22909,78012,26507,1467,29772,3375,56279,16891,7089,1476,8040,14096
TCTAGGTTCCTGAAGG,sample,389473,381716,64195,317521,40904,276617,45728,1960,117597,12123,163325,99209,16381,3380,17861,24065
GTCGTTCTCCTGAAGG,Neg_Ctrl,4714,2550,1809,741,116,625,139,23,300,27,439,136,203,40,47,31
AGCTGAATCCTGAAGG,sample,207226,202663,38613,164050,29941,134109,26771,1164,57346,5795,84117,43033,11593,1961,11962,17165
CTAGCGACCCTGAAGG,Neg_Ctrl,4531,2529,1581,948,130,818,185,8,338,35,523,252,398,70,68,31
TCGAACGACCTGAAGG,sample,137279,134267,19535,114732,22251,92481,20868,725,36158,3352,57026,31378,8550,1476,10098,14399
CGTCGCCACCTGAAGG,sample,158808,152509,44879,107630,10088,97542,9898,495,43594,4520,53492,39035,11847,1335,2560,4408
TCATCGAACCTGAAGG,sample,186079,182939,30291,152648,31407,121241,31603,1277,48357,4803,79960,35201,10560,2019,15600,19131
ATTCAAGGCCTGAAGG,sample,30839,29694,8043,21651,3430,18221,2825,155,8194,891,11019,6156,4418,561,935,1842
ATACGTTCCCTGAAGG,Neg_Ctrl,4571,2761,1753,1008,152,856,183,22,360,41,543,250,402,64,78,42
CCGTACGCCCTGAAGG,sample,568200,554361,112727,441634,37209,404425,46731,1695,183060,18466,229791,154473,21980,5359,10096,19695
TCTCAGGACCTGAAGG,sample,81371,79723,14822,64901,8568,56333,11406,660,24653,2878,36059,16736,7645,1420,3272,5053
GATGCGTTCCTGAAGG,sample,373923,366306,75768,290538,28498,262040,35872,1992,115742,12156,151614,96278,17406,3451,11221,15696
ATGGCGTTCCTGAAGG,sample,252581,247829,48998,198831,34708,164123,29585,952,69840,7337,99425,56409,12298,2057,12513,20351
TGCGCGTTCCTGAAGG,Neg_Ctrl,4264,2663,1618,1045,159,886,204,11,347,35,551,289,413,78,66,46
CCATTCTTCCTGAAGG,sample,173281,169305,32045,137260,20127,117133,20960,1337,50389,5348,71349,39099,11211,1762,8558,12146
CGGTTGGTCCTGAAGG,sample,404722,397797,74810,322987,32553,290434,38233,1443,128572,13125,166805,109061,19174,4151,11389,16932
ACGCTTAACCTGAAGG,sample,180002,177620,24332,153288,32024,121264,33802,1735,46195,4588,79997,34944,8898,1882,14000,20384
TAGCGAGTCCTGAAGG,sample,616189,603065,113505,489560,38161,451399,49591,1982,203170,20938,252761,175718,21583,5346,11155,20628
CTAAGCATCCTGAAGG,Neg_Ctrl,3710,2662,1394,1268,183,1085,258,8,458,43,716,318,475,108,84,106
TAACGAAGCCTGAAGG,sample,74696,73505,11603,61902,13050,48852,9526,335,20440,2122,29966,16429,6153,815,5082,8236
TGCGCTCCCCTGAAGG,Neg_Ctrl,3489,2003,1266,737,92,645,145,10,246,30,391,214,285,61,54,24
GCGTTACCCCTGAAGG,sample,148124,144509,30082,114427,11815,102612,17896,796,44808,4524,62704,34588,10310,1683,6341,6095
CAGCTTCGCCTGAAGG,Neg_Ctrl,3502,1919,1355,564,76,488,98,4,212,26,310,148,232,44,41,20
TCTCCTAGCCTGAAGG,sample,253542,250967,31431,219536,36392,183144,35845,1382,76513,7800,112358,61604,14143,2869,14788,23479
TAACGCCACCTGAAGG,sample,213770,211419,20342,191077,38032,153045,43787,1543,59712,5989,103499,42014,10311,2061,23205,25038
ATTCTACCCCTGAAGG,sample,170306,168477,20648,147829,33780,114049,33360,1401,45175,5491,78535,28622,9405,1597,14865,21076
CGTAGAACCCTGAAGG,sample,175569,173119,21191,151928,29491,122437,29506,2073,50022,6063,79528,34773,10489,2139,9673,18536
AGCTGAATAATATTCG,sample,508036,498758,75002,423756,67829,355927,65825,3219,152890,16357,218715,117636,18018,4294,22279,42640
CATACTCCAATATTCG,sample,134304,131760,18779,112981,22168,90813,20164,662,38201,3783,58365,28003,8434,1450,10133,14321
CTAGCGACAATATTCG,sample,51496,50318,8684,41634,7660,33974,7645,293,14610,1577,22255,9849,5567,954,3276,4586
TCATCGAAAATATTCG,sample,319828,314813,46297,268516,48410,220106,44341,1496,91801,8462,136142,74006,14578,2736,19829,29714
GCAACTAGAATATTCG,sample,93284,92299,10432,81867,18547,63320,16122,920,25630,2323,41752,18325,7799,1453,7923,11435
TACGCGAGAATATTCG,sample,138466,136152,20078,116074,31041,85033,22717,935,34747,3763,57464,22871,9159,1758,10643,17890
CCGTACGCAATATTCG,sample,145621,142566,25594,116972,26667,90305,20203,1024,36152,4387,56355,28539,8818,1693,9490,15848
TGGATCAAAATATTCG,sample,185629,184130,25838,158292,33617,124675,29085,1278,47867,5226,76952,41219,8927,1725,14012,21070
GATGCGTTAATATTCG,sample,158782,156248,28070,128178,21423,106755,19630,889,45493,5516,65123,35227,9887,1678,7827,12575
CCATTCTTAATATTCG,sample,84218,81659,17145,64514,9324,55190,8080,424,25218,2428,33298,19040,8255,1140,2750,4939
CGGTTGGTAATATTCG,sample,278336,274469,50831,223638,31030,192608,28717,1142,83307,8477,112024,70965,15015,2555,11042,18162
CTAAGCATAATATTCG,sample,162441,158044,34825,123219,16610,106609,16324,581,46521,4741,62845,38442,11327,1571,6511,9157
CGCGGTCGAATATTCG,sample,86767,85972,9462,76510,16459,60051,15296,666,24266,2350,39562,17473,7176,1232,6006,9974
TCTCCTAGAATATTCG,sample,459351,452682,77819,374863,48377,326486,58623,2728,136239,16057,194862,112839,17795,4531,18974,28926
AAGTAGAGAATATTCG,sample,264030,260578,33733,226845,38247,188598,42285,2510,78913,8392,121198,56498,13045,2627,16658,24536
TCAATCAGAATATTCG,sample,181519,179181,16180,163001,42376,120625,45430,2158,42214,5213,87644,25610,8238,1629,18375,26055
ATTCTACCAATATTCG,Pos_Ctrl,239046,232997,20941,212056,7801,204255,172226,14615,12105,1630,184331,3679,8264,12537,11016,3043
TCTAGGTTAGTCTCCG,sample,201855,199805,22197,177608,31913,145695,34268,1729,62485,6379,96753,40834,10721,2362,13207,20207
CTGGTCTTAGTCTCCG,sample,664585,655617,128953,526664,66377,460287,62618,2977,202735,20344,265353,171613,20282,4675,22605,34981
TATACGGAAGTCTCCG,sample,125988,123477,22965,100512,17318,83194,14241,627,36062,3847,50303,28417,9172,1459,5576,9800
CGTCGCCAAGTCTCCG,sample,383339,376577,61127,315450,45725,269725,41915,1820,116086,12778,158001,97126,18415,3860,15791,26756
ATGGCGTTAGTCTCCG,sample,318034,313509,50889,262620,46830,215790,40499,1909,91680,9894,132179,71808,15248,2954,17619,27793
CCATTCTTAGTCTCCG,sample,253786,250865,23256,227609,48171,179438,40542,2105,70895,8005,111437,57891,11897,2419,18550,29696
CGGTTGGTAGTCTCCG,sample,158112,156176,22616,133560,27501,106059,14417,808,46814,4735,61231,39285,11127,1786,4384,16280
ACGCTTAAAGTCTCCG,sample,483289,476885,74656,402229,41781,360448,49232,2628,159831,17268,209063,131489,20931,5454,13844,22636
TAGCGAGTAGTCTCCG,sample,99673,98776,10018,88758,27228,61530,22317,971,20832,1981,43149,15429,6382,1194,13808,16662
CCTAGCGGAGTCTCCG,sample,177451,175895,21734,154161,27384,126777,28575,1656,50696,4940,79271,40910,12315,2494,12393,17038
GGCGACGAAGTCTCCG,sample,128408,127396,15376,112020,20503,91517,19540,990,38305,4366,57845,28316,10314,1841,7270,12244
TAACGAAGAGTCTCCG,sample,95782,94985,6547,88438,20080,68358,20661,632,26286,2683,46947,18096,6168,1281,11358,13295
GCCTATTCAGTCTCCG,sample,220128,217933,18581,199352,34516,164836,40200,1661,67718,7498,107918,47759,11392,2822,15903,22648
GCGCAATAAGTCTCCG,sample,84175,83068,4434,78634,31027,47607,27821,1235,13333,1879,41154,3339,2097,687,15527,17467
CTGGTCTTTGCCTACG,sample,29338,28677,5782,22895,2975,19920,3186,94,8777,865,11963,6998,4687,508,1318,1603
AGAGTTCTTGCCTACG,sample,54843,53539,9830,43709,8043,35666,8364,347,14567,1576,22931,10812,5774,852,4026,4782
GGAGAAGCTGCCTACG,sample,93050,90902,18153,72749,8334,64415,8119,382,28190,3327,36309,24397,9937,1137,2526,5030
CGTCGCCATGCCTACG,sample,185848,181726,38599,143127,19050,124077,19507,664,53467,5474,72974,44965,13712,2018,6302,10484
TCATACCATGCCTACG,sample,109580,106382,26540,79842,9400,70442,10035,411,32239,3426,42274,24331,9896,1370,3228,4811
GCAACTAGTGCCTACG,sample,45697,45105,5723,39382,7533,31849,8104,505,13199,1414,21303,8627,5325,1000,2835,4595
TACGCGAGTGCCTACG,sample,104923,102625,19664,82961,12469,70492,14658,940,30393,3210,45051,21291,9120,1436,6059,7655
GACTCAAGTGCCTACG,sample,71652,70600,10244,60356,13754,46602,10956,335,18528,2074,29484,14709,6289,885,5470,8257
ATACGTTCTGCCTACG,sample,53442,52408,9556,42852,10700,32152,8632,449,12522,1363,21154,9186,5487,993,4289,6118
TCTCAGGATGCCTACG,sample,104966,102916,20752,82164,9243,72921,9593,385,32827,3281,42420,26835,10183,1287,3161,5345
GATGCGTTTGCCTACG,sample,111571,109565,23974,85591,9984,75607,11978,829,32981,3537,44959,26282,9982,1709,2648,4929
CCATTCTTTGCCTACG,sample,107220,105992,9825,96167,21070,75097,21472,667,27692,3058,49164,22208,5980,1243,10446,13547
CCTAGCGGTGCCTACG,sample,1129,1103,198,905,218,687,181,16,288,28,469,174,333,90,62,107
CTAACCGGTGCCTACG,sample,67339,66566,7282,59284,13057,46227,11270,640,18113,1751,29383,14453,6180,979,5397,8029
GGCGACGATGCCTACG,sample,72154,71070,7416,63654,19530,44124,17221,585,14656,1630,31877,10032,4401,889,9767,11803
TAACGAAGTGCCTACG,sample,92532,91627,12511,79116,12381,66735,12835,695,29745,2979,42580,20481,8942,1450,4723,8094
GCCTATTCTGCCTACG,sample,221404,218525,31810,186715,17236,169479,26036,1269,77496,7937,103532,56741,14336,2691,5209,9812
CGCGGTCGTGCCTACG,sample,92476,90668,14985,75683,11894,63789,11355,547,27274,2724,38629,21889,8283,1088,4615,6984
AAGTAGAGTGCCTACG,sample,80344,79235,9628,69607,16663,52944,15848,956,19773,2372,35621,13995,7029,1277,6246,10318
GACTAACCTGCCTACG,Neg_Ctrl,2700,1364,919,445,75,370,90,6,146,20,236,108,186,32,30,28
CCTAACTATGCCTACG,sample,195063,191078,33733,157345,14484,142861,17826,924,64009,6853,81835,53249,13454,2142,4535,7900
GCGCAATATGCCTACG,sample,137524,135776,15236,120540,19930,100610,26793,919,41531,3718,68324,27649,9187,1643,10165,13039
TCTAGGTTCTTAGTTC,sample,232339,229163,37289,191874,43048,148826,35165,992,59157,6054,94322,47458,10426,2043,18283,26118
CTGGTCTTCTTAGTTC,sample,71285,70448,4158,66290,26820,39470,21122,904,11216,1138,32338,5090,3215,1107,12349,15049
GTCGTTCTCTTAGTTC,sample,173890,170945,18913,152032,38476,113556,32052,1532,45140,5625,77192,29207,7709,1506,17045,24811
AGCTGAATCTTAGTTC,sample,100190,98191,13137,85054,23959,61095,19678,947,22144,2971,41822,15355,6477,1250,8367,14045
CATAATGGCTTAGTTC,sample,150310,146699,25552,121147,19710,101437,18163,568,42495,4421,60658,35790,11473,1590,8726,11107
TCATACCACTTAGTTC,sample,127441,125589,15017,110572,38723,71849,24055,1047,26313,2828,50368,17606,6980,1321,12653,21015
GCAACTAGCTTAGTTC,sample,69882,68949,7704,61245,15898,45347,13794,725,17370,1837,31164,11621,6512,1268,6801,9745
TACGCGAGCTTAGTTC,sample,148378,147051,12756,134295,57268,77027,39077,1430,22999,3044,62076,10477,3471,1007,23742,29424
ATACGTTCCTTAGTTC,sample,77986,76075,17453,58622,6811,51811,7021,327,22974,2269,29995,19220,8407,1038,2435,3771
CCGTACGCCTTAGTTC,sample,133491,131519,18751,112768,20392,92376,24637,878,38532,3921,63169,24408,9254,1556,13014,12165
AGCGTCTTCTTAGTTC,sample,165173,163115,17685,145430,27752,117678,29284,1453,49711,5319,78995,31911,7593,1543,13717,19252
TAGCGAGTCTTAGTTC,sample,443904,434248,81658,352590,29044,323546,37672,1426,144887,16017,182559,123544,19580,4087,9593,14462
GCTCTTCTCTTAGTTC,sample,122481,121083,10646,110437,26756,83681,33090,1564,29904,3884,62994,15239,6531,1396,16545,17188
GAGATTCTCTTAGTTC,sample,313684,308814,45468,263346,37503,225843,33991,1012,96196,9737,130187,84907,14901,2817,13576,21409
AGCAGAGCCTTAGTTC,sample,253274,250000,32278,217722,44770,172952,34397,1268,70456,7176,104853,59655,12569,2204,15343,27291
TGCGCTCCCTTAGTTC,sample,462141,456307,60806,395501,63246,332255,65307,2832,138333,13439,203640,112344,16556,3705,26912,38608
GGCGTACCCTTAGTTC,sample,183776,181402,18105,163297,51131,112166,39885,1562,39787,3552,79672,27380,6459,1525,20316,31227
CGTCGAGGCTTAGTTC,sample,157223,155361,17820,137541,26002,111539,28820,1594,47232,4903,76052,28990,10210,1884,11658,17087
ATGAATAGCTTAGTTC,sample,308587,304684,43325,261359,43501,217858,42715,2054,90906,10733,133621,71450,15222,3215,16295,25402
TCAATCAGCTTAGTTC,sample,173759,171537,20545,150992,28715,122277,30947,1975,50778,5287,81725,33290,10750,2156,9008,17167
AGATACTACTTAGTTC,sample,298497,294956,41555,253401,31858,221543,33789,1258,98375,10916,132164,77205,15194,3013,9528,18964
ATATGCAACTTAGTTC,sample,329219,326436,35963,290473,46231,244242,38975,1805,103538,11668,142513,88256,16608,3910,13150,28380
CTGGTCTTCGAGCTTC,sample,231532,229441,18188,211253,58870,152383,48644,1591,56421,6464,105065,39263,10258,2108,27478,37333
AGCTGAATCGAGCTTC,sample,497244,487209,79444,407765,61530,346235,51400,1918,149240,15573,200640,128104,18402,3911,18684,35869
GACGTATGCGAGCTTC,sample,298775,294985,34678,260307,68666,191641,49018,2077,75712,7266,124730,57568,12267,2654,21794,41969
CTAGCGACCGAGCTTC,sample,242079,238030,35380,202650,40874,161776,36140,1613,65484,7426,101624,51113,12209,2336,17141,25965
GGTAGAGACGAGCTTC,sample,242748,237776,37585,200191,50035,150156,40122,2026,60758,7111,100880,40139,11798,2488,16371,28289
CGTCGCCACGAGCTTC,sample,219405,216616,18866,197750,57082,140668,41399,1276,51668,5260,93067,41065,7585,1749,22443,35800
GCAACTAGCGAGCTTC,sample,65115,64244,6426,57818,21764,36054,14952,666,12083,1192,27035,7161,4095,874,8367,11908
GATGCGTTCGAGCTTC,sample,599854,591554,79733,511821,68639,443182,81602,3962,189992,20233,271594,147393,20098,5113,24550,44052
AGCGTCTTCGAGCTTC,sample,344965,339106,54403,284703,54899,229804,42967,2925,97663,10732,140630,75517,16255,3161,16229,30701
CATTCGGTCGAGCTTC,sample,134191,132384,15964,116420,23805,92615,27343,1229,34387,3411,61730,26245,9130,1699,14618,15124
TAGCGAGTCGAGCTTC,sample,348576,344597,35375,309222,61841,247381,58013,2449,99654,10530,157667,76735,15230,3369,28374,41362
GAGATTCTCGAGCTTC,sample,216440,213469,21185,192284,47059,145225,46017,1928,58843,5817,104860,32620,9746,2089,21927,29059
GGCGACGACGAGCTTC,sample,225360,222650,24193,198457,29543,168914,31519,1355,71966,7413,103485,56661,12713,2423,13115,18664
ATACCGCCCGAGCTTC,sample,228868,225094,27576,197518,46573,150945,42301,2088,59061,5671,101362,41824,11007,1801,21685,30777
GTCGCGAACGAGCTTC,sample,371512,367261,48928,318333,59572,258761,55659,2577,102945,11534,158604,86046,14230,3193,22308,37287
TCTCCTAGCGAGCTTC,sample,243666,241428,21829,219599,52686,166913,49532,2231,62044,5802,111576,47304,9658,2269,23838,34667
TCAATCAGCGAGCTTC,sample,369338,366101,39301,326800,39231,287569,66528,3309,125344,14277,191872,78111,17297,4281,11876,25651
TAACGCCACGAGCTTC,sample,199965,198022,20394,177628,32918,144710,40013,2375,56740,6090,96753,39492,10518,1944,14194,21619
GACTAACCCGAGCTTC,sample,234063,231544,25744,205800,28743,177057,37694,3017,79024,9073,116718,48249,12430,2553,10266,17847
CGTAGAACCGAGCTTC,sample,375749,369901,49761,320140,41758,278382,48841,2268,124853,13162,173694,89258,17219,3971,14575,26000
AGATACTACGAGCTTC,sample,283945,280495,32337,248158,49762,198396,42850,2187,84501,8760,127351,60098,12305,2311,17707,31604
TCTAGGTTGTAGAATG,sample,158114,156473,18558,137915,41818,96097,34672,1251,33704,3860,68376,22610,7065,1476,20155,25263
CTGGTCTTGTAGAATG,Pos_Ctrl,182836,175841,19609,156232,6841,149391,125368,9986,9725,1340,135093,2972,8134,11135,10395,2718
GAGCCTCCGTAGAATG,sample,120324,117012,23562,93450,9151,84299,11007,437,37895,3962,48902,30998,10989,1502,3236,4821
TCATACCAGTAGAATG,sample,185218,181926,26384,155542,27814,127728,29843,1381,54410,5242,84253,36852,11655,2033,12114,18060
GCAACTAGGTAGAATG,Pos_Ctrl,15062,14684,1118,13566,695,12871,10623,917,905,106,11528,320,3779,3609,1014,395
ATACGTTCGTAGAATG,sample,121406,118239,26600,91639,10099,81540,12106,441,36624,3940,48730,28429,11003,1656,3335,5039
TGGATCAAGTAGAATG,sample,121265,119017,22239,96778,21801,74977,19230,587,28299,3248,47529,23613,7946,1287,11247,12963
GATGCGTTGTAGAATG,sample,103525,102252,8422,93830,31088,62742,29306,1625,19668,2199,48974,9944,5208,1361,14733,18803
CCATTCTTGTAGAATG,sample,236820,233427,22063,211364,54153,157211,50818,2312,57301,6489,108119,40291,10352,2196,27756,34476
AGCGTCTTGTAGAATG,sample,238259,235087,24621,210466,47038,163428,46023,1942,61392,6916,107415,47155,9794,2184,24400,31067
CATTCGGTGTAGAATG,sample,157872,155616,18705,136911,24729,112182,29124,1557,43916,5499,73040,32086,9662,1720,13021,15032
TAGCGAGTGTAGAATG,sample,207390,204936,19349,185587,48056,137531,44622,2578,50083,5135,94705,35113,9472,2110,21492,30504
GCTCTTCTGTAGAATG,Pos_Ctrl,146087,141513,13819,127694,5130,122564,103453,8616,7177,944,110630,2374,7760,10468,7331,2059
CTAAGCATGTAGAATG,sample,208673,206270,25540,180730,45828,134902,47768,1970,48030,4890,95798,32244,8380,1793,26509,27938
AAGGTCTGGTAGAATG,sample,137851,134695,28494,106201,14819,91382,14476,1080,41561,4312,56037,29953,10914,1888,3746,8142
CTAACCGGGTAGAATG,sample,267071,263717,35417,228300,35024,193276,36263,1924,81568,8689,117831,64832,14421,2822,13337,21646
GGCGACGAGTAGAATG,sample,205689,203030,21556,181474,41432,140042,42110,2119,53169,5361,95279,37283,10919,2079,22434,26846
TAACGAAGGTAGAATG,sample,90866,89525,12470,77055,14704,62351,12503,663,27002,2794,39505,19389,7857,1191,5085,8635
ATACCGCCGTAGAATG,sample,130669,128655,16346,112309,21513,90796,23104,891,36319,3767,59423,26715,8830,1561,9706,13637
GCGTTACCGTAGAATG,sample,207182,204781,21726,183055,34732,148323,34818,2112,63229,6114,98047,42050,11789,2190,14342,23108
CGCGGTCGGTAGAATG,Pos_Ctrl,147320,144732,10417,134315,5288,129027,109555,9968,6690,721,116245,2093,7577,11009,7998,1677
ATGAATAGGTAGAATG,sample,263324,260316,33473,226843,38650,188193,41336,2468,76960,7172,118296,60257,13063,2598,16749,23373
AAGTAGAGGTAGAATG,sample,274991,272039,25175,246864,54049,192815,44538,2728,76835,8266,121373,60448,13441,3192,19360,34552
TCAATCAGGTAGAATG,sample,173036,171154,19229,151925,34209,117716,28657,1898,47224,5306,75881,34631,10191,1804,12633,20682
GACTAACCGTAGAATG,sample,242910,240302,29819,210483,28563,181920,35438,1631,76254,8401,111692,60196,12868,2681,12344,18064
ATATGCAAGTAGAATG,sample,235501,233562,23132,210430,29492,180938,46860,2998,79841,9335,126701,41904,11185,2438,9450,18564
AGAGTTCTCAATAGTC,sample,104541,102454,16820,85634,15154,70480,14454,418,29218,2868,43672,23522,7728,1122,6734,9014
AGCTGAATCAATAGTC,sample,107178,104792,20714,84078,15813,68265,15782,884,28365,3133,44147,20101,8540,1411,5816,8853
CATACTCCCAATAGTC,sample,105437,101862,22258,79604,10603,69001,11840,388,29558,3099,41398,24116,9608,1146,4811,5775
TGATTCCGCAATAGTC,sample,120172,117398,25978,91420,11622,79798,11946,517,35290,3669,47236,28376,10694,1383,4480,6016
GCAACTAGCAATAGTC,sample,48571,47876,4981,42895,11916,30979,11042,469,11624,1135,22666,6709,4706,977,5093,7010
ATACGTTCCAATAGTC,sample,245807,240938,46146,194792,31014,163778,32420,1191,69583,8832,102003,51752,12121,2260,14899,18818
CCGCAGTCCAATAGTC,sample,94369,92549,15114,77435,13493,63942,15138,832,27087,3085,42225,17800,7983,1401,6241,8440
TGGATCAACAATAGTC,sample,142107,140275,18374,121901,27287,94614,24518,1150,38239,4624,62757,26083,8367,1424,13058,17276
ATGGCGTTCAATAGTC,sample,82349,81659,4924,76735,31759,44976,27164,877,11030,1045,38194,4860,2435,686,18048,17158
CCATTCTTCAATAGTC,sample,133894,131172,17737,113435,21604,91831,19610,735,38286,4213,57896,28987,8845,1349,9302,12865
TAGCGAGTCAATAGTC,sample,224160,221855,28609,193246,32811,160435,36865,1526,62735,6605,99600,52704,12053,2490,18200,20471
GAGATTCTCAATAGTC,sample,133034,131324,13199,118125,29964,88161,27856,1570,34866,3904,62722,19965,8332,1641,13325,18372
CTAACCGGCAATAGTC,sample,102994,101735,10395,91340,23044,68296,13360,714,28817,2960,42177,22445,7632,1214,4668,14888
GGCGACGACAATAGTC,sample,380158,375757,56263,319494,46896,272598,46961,1898,114817,11658,161778,97264,16869,4211,15172,29358
TGCGCTCCCAATAGTC,sample,256787,254177,31279,222898,38016,184882,50502,1884,75648,8205,126150,48643,11935,2385,23495,24515
GCGTTACCCAATAGTC,sample,87810,86969,9746,77223,10939,66284,15896,1047,28643,3263,44539,17435,7746,1350,5104,7410
GTCGCGAACAATAGTC,sample,98444,97639,9648,87991,17507,70484,19635,1395,27952,2741,47587,18761,7447,1335,8043,11524
TCTCCTAGCAATAGTC,sample,70290,69711,6743,62968,15700,47268,14424,689,18820,1853,33244,11482,6108,1031,6773,9325
ATGAATAGCAATAGTC,sample,137836,136855,12186,124669,29921,94748,30788,1614,35632,3492,66420,23222,8739,1758,13117,18305
TAACGCCACAATAGTC,sample,108670,107835,9224,98611,19412,79199,19952,1360,31736,3424,51688,22727,9780,1992,6436,12355
ATTCTACCCAATAGTC,sample,113859,113200,11933,101267,15897,85370,16306,1363,38461,4370,54767,24870,11326,2392,2872,9279
GCGCAATACAATAGTC,sample,60230,59487,3726,55761,16272,39489,13276,557,13914,1727,27190,10015,4849,922,6570,9963
GTCGTTCTCGTTACTC,Neg_Ctrl,2316,1288,745,543,131,412,119,11,153,17,272,112,191,37,57,32
TATACGGACGTTACTC,sample,118928,117811,15368,102443,23496,78947,20441,901,30439,3208,50880,23958,8675,1504,11503,14715
GGAGAAGCCGTTACTC,sample,83420,82447,10198,72249,18842,53407,15629,844,20401,2370,36030,14163,6647,1378,6458,11295
TCATACCACGTTACTC,sample,172149,169563,26413,143150,22546,120604,24605,1447,51004,5096,75609,38452,10534,1861,7465,14412
ATTCAAGGCGTTACTC,sample,256668,253103,27950,225153,48545,176608,54578,1984,63631,6172,118209,50243,9692,1965,31970,32884
GCAACTAGCGTTACTC,sample,51624,50943,3688,47255,19272,27983,17772,429,6241,977,24013,2564,1590,662,11235,10250
CCGCAGTCCGTTACTC,sample,407927,401949,63183,338766,57339,281427,54255,2359,121082,13219,175337,90512,16762,3739,19914,33236
CCGTACGCCGTTACTC,sample,444172,438199,59069,379130,68234,310896,61117,1857,128264,13906,189381,105752,17088,3788,25940,42406
GGCAGGTTCGTTACTC,sample,343945,340903,29644,311259,119823,191436,66725,3267,70734,6067,137459,44643,8352,2039,34790,65317
GATGCGTTCGTTACTC,sample,284791,281852,44673,237179,55545,181634,50122,3036,69300,7752,119422,51424,11166,2427,21426,33021
ATGGCGTTCGTTACTC,sample,551032,544881,93308,451573,86645,364928,76834,3475,148570,15644,225404,120405,19851,4443,35868,52075
AGCGTCTTCGTTACTC,sample,436490,429949,65600,364349,52670,311679,52239,2676,135741,13563,187980,107460,17201,3696,18089,31884
GAGATTCTCGTTACTC,Neg_Ctrl,4050,2351,1477,874,149,725,174,17,276,26,450,232,278,76,65,73
CTAAGCATCGTTACTC,sample,140978,137682,20234,117448,27340,90108,29876,1239,33414,3804,63290,21775,8562,1985,11602,17435
CTAACCGGCGTTACTC,sample,72189,70072,17235,52837,8488,44349,6316,378,20028,2066,26344,15561,7744,940,2498,4700
GCGTTACCCGTTACTC,sample,147682,145142,23416,121726,21301,100425,25964,1759,42286,4357,68250,26059,9102,1725,9088,12332
TTATGACGCGTTACTC,Neg_Ctrl,3764,1582,1102,480,113,367,113,10,140,16,253,88,178,27,49,16
ATGAATAGCGTTACTC,sample,409007,403290,45969,357321,61657,295664,68793,3743,124906,13911,193699,84311,14347,3399,26947,39914
GACTAACCCGTTACTC,sample,400033,394635,46794,347841,72642,275199,76099,3057,104507,12160,180606,79376,13844,3003,37735,45077
AGATACTACGTTACTC,sample,298501,292975,45130,247845,43484,204361,52165,2875,83530,9829,135695,55962,12792,2617,19416,26239
ATATGCAACGTTACTC,sample,195656,191606,44546,147060,15634,131426,16572,952,59691,6378,76263,47833,12460,2037,3605,7543
AGAGTTCTTGGACTGC,sample,245335,240972,37257,203715,34275,169440,33071,1074,70263,9077,103334,55955,11274,2225,14240,21061
AGCTGAATTGGACTGC,sample,82063,79269,19712,59557,6503,53054,8266,524,23955,2630,32221,17679,8717,1457,1690,3400
TATACGGATGGACTGC,sample,193850,191533,26307,165226,41584,123642,36775,1536,46716,4965,83491,33650,8705,1789,21018,26063
GGAGAAGCTGGACTGC,sample,178504,174900,28355,146545,19186,127359,45348,2493,44770,5004,90118,29744,11282,3208,6074,11767
GGTAGAGATGGACTGC,sample,211445,203592,55116,148476,12762,135714,16251,712,61641,6809,77892,50301,14984,2197,3633,6269
TCATCGAATGGACTGC,sample,93198,90366,19286,71080,13516,57564,11776,389,23718,2456,35494,19225,7867,1071,5424,7385
ATTCAAGGTGGACTGC,sample,142485,140470,21929,118541,22268,96273,19640,755,40107,4294,59747,31477,10458,1953,7448,13343
GACTCAAGTGGACTGC,sample,79610,78348,11173,67175,21496,45679,17093,793,15197,1634,32290,10962,5343,1325,8263,12187
CCGCAGTCTGGACTGC,sample,161885,158654,25771,132883,22917,109966,22731,1304,45892,4605,68623,35434,10226,1791,7578,13734
TGGATCAATGGACTGC,sample,207107,204552,28535,176017,34747,141270,35506,1455,58077,6092,93583,40140,11425,2125,16865,22461
GGCAGGTTTGGACTGC,sample,54180,53436,7020,46416,14538,31878,9879,589,12403,1502,22282,7505,4932,916,5392,7959
ATGGCGTTTGGACTGC,sample,321055,316063,56134,259929,42492,217437,38143,1592,91705,10360,129848,75637,16762,3062,15538,25440
CCATTCTTTGGACTGC,sample,164186,161924,21997,139927,24001,115926,32949,1907,49041,5182,81990,26847,10267,2259,7793,15035
CATTCGGTTGGACTGC,sample,112846,111549,6529,105020,41955,63065,38202,837,15541,1896,53743,6589,2459,789,21319,23977
TAGCGAGTTGGACTGC,sample,135561,133709,17317,116392,18687,97705,28732,1541,40927,4799,69659,21706,8456,1713,11330,11900
CTAAGCATTGGACTGC,sample,96407,93976,19607,74369,10384,63985,10543,476,27887,2826,38430,22253,8414,1154,4314,5854
AAGGTCTGTGGACTGC,sample,80995,79387,17311,62076,11029,51047,9186,320,21078,2240,30264,18223,7387,950,4562,6493
ATACCGCCTGGACTGC,sample,147036,145598,10953,134645,34694,99951,37991,2785,35939,3106,73930,20130,7382,1686,11904,22468
CAGCTTCGTGGACTGC,sample,126373,124888,14034,110854,20115,90739,26842,1290,36898,4477,63740,21232,7371,1391,8512,13492
TTATGACGTGGACTGC,sample,142355,140940,15586,125354,30491,94863,32584,1029,36258,3770,68842,21222,8058,1394,18916,19171
TCTCCTAGTGGACTGC,sample,116654,115308,14280,101028,23047,77981,23018,1514,29655,3635,52673,20159,8112,1430,11262,13974
ATGAATAGTGGACTGC,sample,225342,222959,30119,192840,36653,156187,36774,1225,62966,6570,99740,48652,12087,2185,18804,22615
TAACGCCATGGACTGC,sample,122341,121170,15947,105223,17512,87711,21203,1121,39935,4380,61138,21072,8446,1505,6852,11200
ATTCTACCTGGACTGC,sample,255966,254062,30063,223999,50292,173707,44274,1629,67474,7428,111748,52902,10157,2433,20338,31892
CATAATGGCCTTGAGC,sample,163657,161042,25678,135364,30001,105363,23974,798,42831,4358,66805,33402,9910,1667,12165,17911
GAGCCTCCCCTTGAGC,Pos_Ctrl,131519,125475,17424,108051,5127,102924,85798,7061,6909,918,92707,2238,7706,9651,7188,2593
ATTCAAGGCCTTGAGC,sample,232878,228415,38720,189695,34359,155336,30830,1126,65008,7219,95838,51153,12423,2130,14325,22057
GACTCAAGCCTTGAGC,sample,78665,77509,9706,67803,16648,51155,17362,889,20350,2269,37712,10285,5612,1344,7299,10399
ATACGTTCCCTTGAGC,sample,155761,153488,25943,127545,26810,100735,24726,945,42266,4559,66992,28239,9129,1754,9923,15885
CCGCAGTCCCTTGAGC,sample,97798,95526,20678,74848,11617,63231,12295,792,28308,3159,40603,18677,8366,1383,4816,6746
CCGTACGCCCTTGAGC,sample,410989,401776,87083,314693,33291,281402,36269,1565,125448,12990,161717,105130,19088,4017,10309,17362
GGCAGGTTCCTTGAGC,Pos_Ctrl,213600,208894,23119,185775,8757,177018,149238,12420,10613,1348,159851,3399,8379,12035,12594,4036
ATGGCGTTCCTTGAGC,sample,177678,174979,31365,143614,21724,121890,25260,1246,54728,5869,79988,34787,10218,2011,8320,12822
TGCGCGTTCCTTGAGC,sample,283208,278881,63268,215613,38974,176639,35367,1200,74386,7246,109753,58440,12360,2318,16621,20984
AGCGTCTTCCTTGAGC,sample,171639,169202,24375,144827,34035,110792,33914,1074,43750,4723,77664,27331,8933,1711,14968,20474
ACGCTTAACCTTGAGC,sample,165814,163274,32686,130588,17996,112592,18374,664,49816,5314,68190,38424,11239,1838,7511,9311
TAGCGAGTCCTTGAGC,sample,400503,391732,89647,302085,32367,269718,29974,1144,121242,12957,151216,104401,17787,3257,7511,16075
AAGGTCTGCCTTGAGC,sample,237793,235028,29147,205881,45310,160571,44805,2560,63198,6367,108003,43641,11446,2110,20495,27987
GGCGACGACCTTGAGC,sample,108003,106494,14764,91730,21246,70484,22937,1254,25689,2664,48626,17940,6901,1799,8975,13102
GCTGCTTCCCTTGAGC,Pos_Ctrl,137122,131413,17735,113678,5586,108092,90156,7338,7275,962,97431,2361,7893,9935,7411,2605
GGCGTACCCCTTGAGC,sample,278588,275755,34996,240759,52914,187845,49039,2430,77990,7289,127029,51097,12220,2418,18361,31651
AAGTAGAGCCTTGAGC,sample,412550,408127,53709,354418,58055,296363,63692,2308,121190,13738,184882,95435,18112,4433,28866,34763
ATTCTACCCCTTGAGC,sample,311666,308461,27148,281313,72897,208416,62276,2708,79802,9242,142078,54388,10198,2765,31291,47164
CGCGAGACCCTTGAGC,sample,147841,145482,25018,120464,23757,96707,22376,1098,39775,4612,62151,28846,9775,1575,9749,14148
CGTAGAACCCTTGAGC,sample,244917,242895,27464,215431,50403,165028,46307,2762,65137,7462,111444,43360,11265,2159,22554,30068
AGATACTACCTTGAGC,sample,202507,200167,23566,176601,47698,128903,38053,1379,51987,5090,90040,32394,10386,1808,18673,28874
CCTAACTACCTTGAGC,Pos_Ctrl,195791,190398,19604,170794,7086,163708,139773,11761,8390,948,148163,2836,8021,11758,9492,3110
GCGCAATACCTTGAGC,sample,323721,320439,42127,278312,38460,239852,39124,1800,105573,10760,144697,82595,16634,3649,13768,23673
AACCGGTTCGATATCC,sample,2123,2063,230,1833,682,1151,332,14,491,61,823,253,510,141,123,358
AGCTGAATCGATATCC,sample,225112,221395,30070,191325,48279,143046,37429,1737,55072,6456,92501,42352,10602,1940,18672,28537
CGTCGCCACGATATCC,sample,221986,218432,25066,193366,41744,151622,40739,2239,63248,6898,103987,38498,9913,2078,17785,27079
TCATACCACGATATCC,sample,183985,180754,25643,155111,30628,124483,28760,1048,50561,4859,79321,39255,10424,1822,13896,20029
GACTCAAGCGATATCC,sample,106958,105496,10960,94536,26799,67737,23412,1135,26325,3024,49737,13841,6777,1298,10920,16250
CCGTACGCCGATATCC,sample,146201,143720,18717,125003,28610,96393,25761,1245,38383,3932,64144,27072,8670,1673,13071,17331
TGGATCAACGATATCC,sample,165262,163411,19814,143597,31638,111959,35739,2118,45560,5922,81299,22620,8540,2028,13350,19044
GGCAGGTTCGATATCC,sample,228346,223461,56763,166698,18441,148257,17632,935,67141,7106,84773,55443,15046,2288,4335,8865
GGCGACGACGATATCC,sample,291850,288987,32349,256638,63508,193130,51765,2867,73515,8227,125280,56756,11908,2547,26437,39379
GCTGCTTCCGATATCC,sample,192005,190281,19534,170747,25761,144986,28354,995,63274,6424,91628,45939,12394,2386,11567,15861
GTCGCGAACGATATCC,sample,24648,24299,1767,22532,8092,14440,5738,353,5505,668,11243,2176,2498,751,2246,4463
CGTCGAGGCGATATCC,sample,6002,5879,498,5381,1287,4094,1513,131,1678,213,3191,559,1229,458,411,788
TTATGACGCGATATCC,sample,28835,28595,1370,27225,12234,14991,7291,718,4721,672,12012,1589,2047,842,2514,6125
TAACGCCACGATATCC,sample,4485,4376,510,3866,1072,2794,580,32,1139,113,1719,930,1080,245,141,637
ATTCTACCCGATATCC,sample,1260,1231,258,973,211,762,310,21,247,30,557,154,390,157,120,119
GCGCAATACGATATCC,sample,2553,2509,232,2277,488,1789,708,56,596,70,1304,359,752,334,154,283
AACCGGTTATCTGACC,sample,932,895,182,713,179,534,126,7,220,20,346,161,254,61,41,95
CTGGTCTTATCTGACC,sample,36412,35007,10675,24332,2317,22015,2515,87,9991,1057,12506,8365,5323,440,775,968
TATACGGAATCTGACC,sample,129520,126644,24710,101934,21714,80220,17263,793,32910,3481,50173,25773,9367,1450,7419,12105
GGAGAAGCATCTGACC,sample,62602,60428,14546,45882,4878,41004,5554,257,18449,1812,24003,14932,7904,776,2005,2431
GAGCCTCCATCTGACC,sample,144362,141154,27412,113742,14902,98840,15277,621,42128,4313,57405,36501,12184,1638,5930,8312
CATACTCCATCTGACC,Neg_Ctrl,1898,1162,630,532,86,446,149,10,157,26,306,104,227,65,47,27
GGTAGAGAATCTGACC,sample,371015,362081,63204,298877,20591,278286,69621,3645,132970,15117,202591,56933,14743,3119,6763,11465
ATTCAAGGATCTGACC,sample,160067,157021,25770,131251,20772,110479,22326,920,46986,5017,69312,35230,10898,1820,9237,12252
GCAACTAGATCTGACC,sample,53425,52636,5838,46798,11653,35145,11576,453,12500,1265,24076,9351,4712,985,6417,7601
ATACGTTCATCTGACC,sample,86346,83290,27113,56177,4659,51518,5571,288,23891,2688,29462,19080,8994,985,1107,1772
GGCAGGTTATCTGACC,sample,189410,185892,30500,155392,25981,129411,26511,1036,53936,5493,80447,42435,12233,2044,10877,15749
GATGCGTTATCTGACC,Neg_Ctrl,3565,2001,1027,974,154,820,211,23,304,36,515,246,375,98,78,47
CGGTTGGTATCTGACC,sample,156237,153901,20825,133076,23227,109849,23135,944,44962,5026,68097,35782,11036,1756,10747,15301
ACGCTTAAATCTGACC,sample,243539,240054,41748,198306,27374,170932,28446,1246,74219,8216,102665,58805,13405,2494,11502,15554
TAGCGAGTATCTGACC,sample,83734,82623,11230,71393,13552,57841,16962,996,23750,2735,40712,13398,6618,1247,7268,8016
GCTCTTCTATCTGACC,sample,116763,114735,24123,90612,11448,79164,14392,682,34094,3554,48486,26442,9084,1512,4823,6570
CTAAGCATATCTGACC,sample,161827,158472,26181,132291,21573,110718,21631,704,46378,4765,68009,37240,10220,1525,9711,13430
CCTAGCGGATCTGACC,sample,104783,103792,8377,95415,25195,70220,23460,932,24659,2984,48119,18185,7161,1254,13614,16452
TGCGCTCCATCTGACC,sample,1615,1549,232,1317,430,887,356,17,283,44,639,187,351,118,165,229
ATACCGCCATCTGACC,sample,47616,47156,3948,43208,10490,32718,10329,489,12822,1370,23151,7708,4949,1014,4803,6625
GCGTTACCATCTGACC,sample,120847,119573,11898,107675,26739,80936,25738,1526,30120,3539,55858,20013,7956,1359,12725,17328
GGCGTACCATCTGACC,sample,145521,144047,19501,124546,23699,100847,15013,488,44140,5003,59153,36203,11794,1851,5575,14532
GTCGCGAAATCTGACC,sample,88519,87766,9446,78320,26427,51893,15988,886,18974,2213,34962,13832,6336,1079,8322,14664
CGTCGAGGATCTGACC,sample,170927,168890,27126,141764,20362,121402,23260,1096,51950,5345,75210,39751,12272,2221,8608,12310
TTATGACGATCTGACC,sample,308991,306350,43766,262584,39190,223394,36882,1383,95802,9660,132684,79667,16630,3416,15538,24796
TCTCCTAGATCTGACC,sample,158451,156789,15443,141346,29887,111459,24650,992,45474,4951,70124,35392,10712,1997,9281,19505
AAGTAGAGATCTGACC,sample,160479,159108,15828,143280,45975,97305,33537,1289,33737,4283,67274,24459,7582,1583,17764,27021
TAACGCCAATCTGACC,sample,95486,94792,4745,90047,37497,52550,31707,1000,13879,1409,45586,4555,2717,782,18608,20037
GCGCAATAATCTGACC,Neg_Ctrl,2487,1196,663,533,103,430,133,9,161,14,294,113,215,50,47,22
GTCGTTCTCTTCTTAC,sample,245902,243107,24615,218492,60615,157877,44914,1626,61530,6569,106444,43238,9379,2109,23937,36895
GGAGAAGCCTTCTTAC,sample,42952,41809,9698,32111,3869,28242,3920,147,12359,1202,16279,10614,5702,597,1823,1911
GAGCCTCCCTTCTTAC,sample,193794,191204,28084,163120,24892,138228,24168,1021,58255,6337,82423,48447,12951,2161,10436,14942
CTAGCGACCTTCTTAC,sample,48056,46636,9793,36843,6659,30184,5768,265,12444,1289,18212,10418,5525,676,2913,3350
GGTAGAGACTTCTTAC,sample,211940,207263,37028,170235,34006,136229,30624,1363,55088,5950,85712,43204,12040,2276,12415,19766
TGATTCCGCTTCTTAC,sample,151396,149587,18056,131531,36035,95496,32991,2102,34935,4067,67926,21401,7029,1387,17263,21925
TCTCAGGACTTCTTAC,sample,59977,58684,12592,46092,5646,40446,7208,346,18083,1898,25291,12911,6743,1097,2076,3170
ACGCTTAACTTCTTAC,sample,146371,144349,22526,121823,21017,100806,21357,1088,43528,4374,64885,30459,9898,1591,8783,12883
GCCTATTCCTTCTTAC,sample,134414,131967,22875,109092,15037,94055,21585,964,41261,4514,62846,25731,9199,1718,7207,9292
TGCGCTCCCTTCTTAC,sample,214352,211208,34372,176836,32942,143894,31866,1027,59255,6999,91121,44747,11302,1953,12706,20173
GGCGTACCCTTCTTAC,sample,174445,172437,20049,152388,33621,118767,31335,1376,46666,4915,78001,34475,9933,1683,13621,21009
GTCGCGAACTTCTTAC,sample,526863,518557,81407,437150,47934,389216,57075,2497,172990,18228,230065,138426,20799,5351,18745,27478
ATGAATAGCTTCTTAC,sample,344791,339215,58891,280324,29103,251221,40057,2540,111833,11361,151890,85430,16910,3714,10651,16555
TAACGCCACTTCTTAC,sample,231508,228667,29385,199282,31534,167748,37633,1653,68561,7588,106194,52313,12115,2320,14648,21589
CGTAGAACCTTCTTAC,sample,341568,336927,46585,290342,46870,243472,48505,2841,106138,11167,154643,74821,15414,3411,15933,28218
AGATACTACTTCTTAC,sample,408158,404477,51776,352701,63566,289135,59829,3306,119591,12997,179420,93412,16061,3813,22570,42387
TCTAGGTTACTTCTAC,sample,9697,9424,1430,7994,2145,5849,1185,46,2489,273,3674,1856,2027,343,465,1174
GTCGTTCTACTTCTAC,sample,138707,137535,15025,122510,25295,97215,18712,801,40476,4390,59188,32836,11405,1789,8306,15350
AGCTGAATACTTCTAC,sample,410663,405559,84032,321527,38568,282959,38205,1749,125255,13491,163460,104259,19458,4104,12941,20401
GACGTATGACTTCTAC,sample,253607,250365,42671,207694,37072,170622,33657,906,70654,7151,104311,58254,15288,2551,15864,22436
CATAATGGACTTCTAC,sample,336073,329602,59525,270077,40507,229570,36843,1290,97393,10434,134236,83610,16172,2904,16781,23117
GAGCCTCCACTTCTAC,sample,103577,101942,15909,86033,14224,71809,16575,631,31575,3403,48150,19625,8373,1481,5425,8286
TCGAACGAACTTCTAC,sample,44783,43739,9654,34085,5327,28758,4325,188,12744,1486,17069,10015,6151,757,1552,2844
TCATACCAACTTCTAC,sample,131960,130314,14619,115695,38043,77652,29038,1072,28058,2679,57096,16805,5721,1231,16491,22045
ATTCAAGGACTTCTAC,sample,158251,155910,25199,130711,25756,104955,24079,796,42444,4371,66523,33265,10719,1604,12618,14840
TGATTCCGACTTCTAC,sample,223894,221291,26894,194397,39036,155361,39353,1666,61705,6030,101058,46607,10364,2049,21673,26271
GCAACTAGACTTCTAC,sample,95576,94412,12151,82261,20314,61947,16890,737,23565,2611,40455,18144,7594,1208,9291,12222
ATACGTTCACTTCTAC,sample,133684,131340,20493,110847,26073,84774,22850,633,32415,3378,55265,25498,8804,1238,12908,15827
CCGCAGTCACTTCTAC,sample,125731,123513,19770,103743,19175,84568,17217,1217,34933,3996,52150,27205,10328,1617,7894,11856
ATGGCGTTACTTCTAC,sample,299337,296634,38311,258323,55137,203186,50887,1819,78317,8416,129204,63747,11925,2608,23497,33383
CGGTTGGTACTTCTAC,sample,104991,103259,16638,86621,12376,74245,16221,922,32739,3163,48960,21200,8611,1586,5058,7105
GCTCTTCTACTTCTAC,sample,118365,116677,17438,99239,20187,79052,24010,1078,29125,2938,53135,21901,8624,1790,6892,11984
CTAAGCATACTTCTAC,sample,416820,408258,79288,328970,34127,294843,38898,1690,131568,13263,170466,109424,18386,3820,11029,20049
AAGGTCTGACTTCTAC,sample,121489,119729,19837,99892,20942,78950,16585,1006,33103,3760,49688,24496,9856,1614,6912,12134
CTAACCGGACTTCTAC,sample,131205,129587,15510,114077,22990,91087,21718,718,37216,3881,58934,27554,9201,1484,10359,14564
GGCGACGAACTTCTAC,sample,359658,352985,55693,297292,36397,260895,45242,2903,111871,11177,157113,89702,16512,3657,13867,22254
GGCGTACCACTTCTAC,sample,105049,103950,11961,91989,22332,69657,21798,913,26463,3261,48261,17222,7347,1324,9888,14203
CGTCGAGGACTTCTAC,sample,318134,313549,53516,260033,32958,227075,33435,1847,100512,10758,133947,80523,17760,3563,10115,19505
TTATGACGACTTCTAC,sample,116250,114739,18255,96484,14885,81599,15783,962,35685,3939,51468,25230,9478,1601,4027,8225
TCTCCTAGACTTCTAC,sample,252549,249461,32935,216526,30840,185686,32243,1092,79703,8123,111946,64525,14401,2604,14028,18531
TCAATCAGACTTCTAC,sample,343286,339569,53016,286553,32307,254246,35923,1296,110623,11671,146546,94733,17910,3806,13742,19653
ATTCTACCACTTCTAC,sample,317846,314006,45902,268104,30421,237683,38580,2046,104705,11459,143285,80893,17253,3583,9960,18824
GACTAACCACTTCTAC,sample,264336,261170,36346,224824,32652,192172,37473,1503,77794,8786,115267,66616,13888,2998,16138,18371
CGTAGAACACTTCTAC,sample,125749,124238,19233,105005,17420,87585,18451,755,36676,3802,55127,27901,9776,1391,9067,10370
AGATACTAACTTCTAC,sample,545253,538410,90510,447900,41833,406067,52965,2026,178066,19285,231031,153725,21079,5394,15493,23673
AACCGGTTAGAAGTAA,sample,833,812,195,617,123,494,132,5,214,20,346,123,246,52,46,69
TCTAGGTTAGAAGTAA,sample,1848,1782,354,1428,327,1101,308,16,402,47,710,328,475,127,130,182
AGCTGAATAGAAGTAA,sample,4570,4419,686,3733,1327,2406,813,60,852,97,1665,584,903,278,348,664
CATAATGGAGAAGTAA,sample,216764,214672,34687,179985,33769,146216,31611,1557,59734,6197,91345,47117,14356,2317,15259,20148
GGAGAAGCAGAAGTAA,sample,45964,45202,5916,39286,12154,27132,8027,386,11100,1179,19127,6440,4574,867,4475,6918
CATACTCCAGAAGTAA,sample,160655,157157,26611,130546,21716,108830,18216,718,46637,4849,64853,38410,11131,1485,8677,13516
TCGAACGAAGAAGTAA,sample,116674,115144,14979,100165,31596,68569,23478,1096,22189,2440,45667,19366,5895,1254,12916,17896
TGATTCCGAGAAGTAA,sample,230742,226605,38626,187979,19671,168308,24137,1123,74608,7631,98745,60809,14678,2517,7880,11764
TACGCGAGAGAAGTAA,sample,104111,102401,12937,89464,21951,67513,20771,676,26801,2534,47572,16731,6985,1182,11078,13030
GACTCAAGAGAAGTAA,sample,212480,208876,32255,176621,27089,149532,26842,1169,63273,7047,90115,51201,12832,2519,9865,16059
GGCAGGTTAGAAGTAA,sample,217234,214549,35642,178907,30150,148757,33224,1505,62555,6316,95779,45157,12246,2509,10785,17865
GATGCGTTAGAAGTAA,sample,105626,104468,19120,85348,12198,73150,11753,538,32180,3397,43933,25282,8917,1309,4845,6737
TGCGCGTTAGAAGTAA,sample,512194,506080,105147,400933,40017,360916,42700,1666,162145,17911,204845,136494,21120,4748,12049,19489
CCATTCTTAGAAGTAA,sample,214258,212345,11072,201273,84548,116725,63184,3394,30295,3514,93479,16338,4736,1078,43523,44939
AGCGTCTTAGAAGTAA,sample,171570,169872,20156,149716,32188,117528,31805,2129,46739,4812,78544,32043,9600,2003,12405,19474
TAGCGAGTAGAAGTAA,sample,226735,224312,31113,193199,35395,157804,30611,1198,66239,7008,96850,52748,12482,2243,14074,22218
CTAAGCATAGAAGTAA,sample,550118,543418,87924,455494,61717,393777,58416,2651,170657,18614,229073,143439,20603,5058,20310,37999
CCTAGCGGAGAAGTAA,sample,116709,115453,11697,103756,30611,73145,29027,1107,25653,2619,54680,14739,6617,1235,14274,18286
GCCTATTCAGAAGTAA,sample,200489,198482,23017,175465,51161,124304,38423,1704,45853,5234,84276,33090,10005,1813,19788,29683
CAGCTTCGAGAAGTAA,sample,294790,291702,42109,249593,44907,204686,41153,1401,84662,9455,125815,68015,14961,2794,18000,26506
AAGTAGAGAGAAGTAA,sample,333222,330016,40729,289287,51486,237801,55510,2268,94378,10356,149888,75289,15049,3155,25540,32436
ATTCTACCAGAAGTAA,sample,206109,204584,17158,187426,45593,141833,47684,3569,53374,5180,101058,32026,9688,1936,17145,28012
CGTAGAACAGAAGTAA,sample,347806,344830,24173,320657,65852,254805,70772,2132,100226,12045,170998,69630,12345,3459,32633,44361
AGATACTAAGAAGTAA,sample,236891,234324,33815,200509,29435,171074,39345,1997,74543,7735,113888,47454,12047,2369,12785,18373
GCGCAATAAGAAGTAA,sample,190241,188396,21380,167016,29732,137284,35512,1660,54561,6472,90073,39079,10505,1910,13958,18807
ATATGCAAAGAAGTAA,sample,205703,204434,22967,181467,32750,148717,31750,1149,62792,7066,94542,45960,14649,3309,12062,20121
Short,Non_sample,0,NA,NA,NA,NA,NA,NA,NA,NA,NA,NA,NA,NA,NA,NA,NA
Unselected,Non_sample,2702054,NA,NA,NA,NA,NA,NA,NA,NA,NA,NA,NA,NA,NA,NA,NA
Undetermined,Non_sample,274514264,NA,NA,NA,NA,NA,NA,NA,NA,NA,NA,NA,NA,NA,NA,NA
