Barcode,Sample,Barcoded_Reads,Trimmed_Reads,Unmapped_Reads,Mapped_Reads,Multimapped_Reads,Uniquely_Mapped_Reads,Exon_Reads,Ambiguous_Exon_Reads,Intron_Reads,Ambiguous_Intron_Reads,Gene_Reads,Intergenic_Reads,No_of_Genes,No_of_Transcripts,Mitochondrial_Reads,Ribosomal_Reads
TCTAGGTTCGTTGGTT,sample,1853663,1832388,244280,1588108,102309,1485799,293895,14315,687896,81644,981791,408049,27788,10853,24564,55420
GACGTATGCGTTGGTT,sample,297796,293843,25086,268757,76118,192639,76315,5561,69757,8129,146072,32877,8290,2062,14734,48024
TATACGGACGTTGGTT,sample,240541,236480,54750,181730,20625,161105,18949,1243,72290,7933,91239,60690,13671,2484,2360,10971
CGTCGCCACGTTGGTT,sample,756,715,171,544,183,361,93,5,159,13,252,91,186,49,33,85
TCATCGAACGTTGGTT,sample,470,449,106,343,68,275,81,2,102,12,183,78,130,37,25,39
GACTCAAGCGTTGGTT,sample,424,397,107,290,73,217,65,2,78,8,143,64,117,37,13,36
TCTCAGGACGTTGGTT,sample,663,613,140,473,174,299,91,9,111,18,202,70,153,51,25,78
GATGCGTTCGTTGGTT,sample,7035,6874,1391,5483,987,4496,698,48,2042,238,2740,1470,1723,276,125,528
ACGCTTAACGTTGGTT,sample,70788,69611,18660,50951,8101,42850,3828,253,19685,2176,23513,16908,7026,788,322,4357
TAGCGAGTCGTTGGTT,sample,34859,34541,1140,33401,17300,16101,11013,704,3370,381,14383,633,1103,740,4969,7699
GAGATTCTCGTTGGTT,sample,37496,37139,2200,34939,13857,21082,8532,823,7110,825,15642,3792,3394,1033,2289,7688
GCCTATTCCGTTGGTT,sample,398,356,114,242,36,206,40,6,96,8,136,56,111,24,14,21
GTCGCGAACGTTGGTT,sample,383,363,119,244,38,206,44,4,100,4,144,54,115,24,7,25
CGTCGAGGCGTTGGTT,sample,448,429,145,284,54,230,79,3,67,9,146,72,121,29,16,34
ATGAATAGCGTTGGTT,sample,312,274,81,193,27,166,38,0,71,5,109,52,89,15,9,13
AAGTAGAGCGTTGGTT,sample,475,417,157,260,45,215,70,3,79,10,149,53,110,32,27,23
CCTAACTACGTTGGTT,sample,333,307,111,196,33,163,44,2,72,9,116,36,97,21,11,21
TTAACTGACGTTGGTT,sample,127,113,31,82,13,69,24,1,22,3,46,19,35,8,3,6
AACCGGTTCTATCGTT,sample,547,526,129,397,90,307,67,7,112,13,179,108,128,24,34,57
TCTAGGTTCTATCGTT,sample,129881,128677,10238,118439,43578,74861,30306,1384,24232,2262,54538,16677,5609,1309,14222,24561
CTGGTCTTCTATCGTT,sample,58310,56333,12648,43685,8909,34776,7294,523,14410,1515,21704,11034,6076,1154,1776,4903
CATAATGGCTATCGTT,sample,287703,282006,63103,218903,29399,189504,27714,1337,81823,8498,109537,70132,12767,1912,8630,17377
GGAGAAGCCTATCGTT,sample,43152,42658,4212,38446,24548,13898,3033,248,5871,693,8904,4053,3139,685,379,7891
CATACTCCCTATCGTT,sample,70057,67738,17828,49910,7165,42745,6621,423,18853,2019,25474,14829,6315,923,1797,3808
TCTCAGGACTATCGTT,sample,76105,74245,15922,58323,10362,47961,9507,514,20052,2063,29559,15825,6901,1065,2909,6158
GGCAGGTTCTATCGTT,sample,24553,23889,5869,18020,3698,14322,3813,226,5450,454,9263,4379,3113,675,1630,1997
GATGCGTTCTATCGTT,sample,59495,57566,17509,40057,5917,34140,4570,204,15154,1501,19724,12711,5795,590,1807,2860
AGCGTCTTCTATCGTT,sample,366031,353131,116126,237005,16350,220655,18479,814,101694,10542,120173,89126,17548,2329,1396,7149
CGGTTGGTCTATCGTT,sample,153822,150366,29859,120507,19958,100549,18393,1068,40491,4294,58884,36303,7948,1398,6486,12035
ACGCTTAACTATCGTT,sample,40896,40314,2761,37553,17464,20089,13105,676,4618,361,17723,1329,1265,684,6378,8827
GCTCTTCTCTATCGTT,sample,48071,46961,9472,37489,10735,26754,6838,380,10489,1204,17327,7843,5068,951,2414,5765
CCTAGCGGCTATCGTT,sample,31031,30627,2062,28565,12202,16363,10139,353,3808,555,13947,1508,1552,701,4745,6702
CTAACCGGCTATCGTT,sample,140826,137295,32389,104906,16750,88156,14693,696,38195,3900,52888,30672,10069,1308,4659,9441
TGCGCTCCCTATCGTT,sample,76419,75665,12689,62976,6634,56342,8841,516,24780,2836,33621,19369,9266,1367,2331,3887
ATACCGCCCTATCGTT,sample,7512,7227,517,6710,2834,3876,1159,116,1612,176,2771,813,1318,437,225,1364
GTCGCGAACTATCGTT,sample,196,186,49,137,26,111,29,2,38,2,67,40,51,19,13,16
CGCGGTCGCTATCGTT,sample,145,131,37,94,26,68,22,2,19,4,41,21,32,8,7,12
TTATGACGCTATCGTT,sample,223,206,68,138,37,101,25,0,41,5,66,30,55,10,9,17
TCTCCTAGCTATCGTT,sample,191,178,51,127,44,83,22,1,32,5,54,23,38,11,11,20
AAGTAGAGCTATCGTT,sample,321,289,71,218,37,181,43,3,74,10,117,51,84,18,20,21
ATTCTACCCTATCGTT,sample,188,178,49,129,25,104,40,4,34,9,74,17,57,23,17,17
ATATGCAACTATCGTT,sample,125,119,24,95,17,78,13,2,33,4,46,26,35,7,8,11
AACCGGTTGTCTTCTT,sample,47593,47181,5428,41753,11819,29934,8518,658,12237,1483,20755,7038,5117,1307,2239,7288
CTGGTCTTGTCTTCTT,Pos_Ctrl,211804,204931,26868,178063,9299,168764,141481,12178,10513,1374,151994,3218,8110,11506,9367,4792
TATACGGAGTCTTCTT,Pos_Ctrl,162824,157940,20840,137100,7566,129534,108540,9495,8135,1052,116675,2312,7786,10520,8292,4235
GGAGAAGCGTCTTCTT,sample,132678,130164,19440,110724,20937,89787,18594,1123,36924,4170,55518,28976,9692,1882,4094,13108
GAGCCTCCGTCTTCTT,sample,102451,100723,12749,87974,30305,57669,17201,713,20057,2382,37258,17316,5326,1117,7046,17612
CTAGCGACGTCTTCTT,sample,129591,126290,23378,102912,19369,83543,15688,953,37990,3558,53678,25354,8877,1414,4300,12113
CGTCGCCAGTCTTCTT,sample,103701,102735,5799,96936,49432,47504,28932,2008,12214,1282,41146,3068,2069,962,11904,23419
TGATTCCGGTCTTCTT,sample,215265,211269,39417,171852,33938,137914,27903,1033,57072,5688,84975,46218,12119,1974,9609,20328
TGGATCAAGTCTTCTT,sample,50590,49653,6027,43626,13768,29858,11405,499,10212,1307,21617,6435,4607,1072,4584,8025
GATGCGTTGTCTTCTT,sample,38576,37318,8064,29254,5575,23679,5208,300,9850,1173,15058,7148,4584,785,1790,3305
TGCGCGTTGTCTTCTT,sample,93603,90497,27549,62948,8387,54561,6550,432,24473,2563,31023,20543,8239,1237,920,4261
TAGCGAGTGTCTTCTT,sample,97043,95554,10685,84869,26609,58260,22491,1869,20402,1978,42893,11520,4609,1125,9746,15939
GCTCTTCTGTCTTCTT,sample,170483,166934,28286,138648,20008,118640,22895,1267,49500,4965,72395,40013,11499,2113,6052,12386
GCCTATTCGTCTTCTT,sample,103398,101184,14866,86318,18807,67511,20310,1215,25702,2920,46012,17364,6130,1359,6503,11746
GGCGTACCGTCTTCTT,sample,35985,35537,1552,33985,14923,19062,10597,626,5284,730,15881,1825,1950,593,3346,7746
CAGCTTCGGTCTTCTT,sample,980,932,96,836,271,565,158,14,208,17,366,168,268,84,27,136
AAGTAGAGGTCTTCTT,sample,116848,115878,12755,103123,24836,78287,17316,1465,32062,3244,49378,24200,8639,1450,4523,14898
CGCGAGACGTCTTCTT,sample,189,180,36,144,33,111,40,3,41,3,81,24,64,24,11,19
CCTAACTAGTCTTCTT,Pos_Ctrl,2043,1691,221,1470,571,899,699,87,67,6,766,40,447,421,59,238
AGAGTTCTTAGGCTCT,sample,200644,197922,21037,176885,65006,111879,44159,2723,35804,3756,79963,25437,7908,2054,12311,35096
GACGTATGTAGGCTCT,sample,261001,254250,43453,210797,52530,158267,37982,1882,63881,6510,101863,48012,9737,2003,15186,30972
CATACTCCTAGGCTCT,sample,53796,52530,7576,44954,13552,31402,9662,822,12605,1381,22267,6932,4333,1217,2899,8199
TCATCGAATAGGCTCT,sample,249354,247084,20809,226275,82533,143742,58216,4806,48706,4786,106922,27228,7905,2466,14495,47104
TCATACCATAGGCTCT,sample,5421,5320,569,4751,2445,2306,1064,120,689,79,1753,354,839,397,186,1029
TGATTCCGTAGGCTCT,sample,297226,292066,33491,258575,81252,177323,58227,2615,61593,6965,119820,47923,10734,2264,22658,47824
TACGCGAGTAGGCTCT,sample,256811,248972,40528,208444,41359,167085,37983,2406,68074,7315,106057,51307,11955,2407,9306,25296
AGCGTCTTTAGGCTCT,sample,41422,40383,6874,33509,7371,26138,8913,504,9693,1040,18606,5988,3789,1088,2102,4579
CGGTTGGTTAGGCTCT,sample,13617,13258,2270,10988,4238,6750,2160,190,2457,260,4617,1683,1518,357,853,2067
ACGCTTAATAGGCTCT,sample,155442,153247,14214,139033,44342,94691,40939,2799,31814,3114,72753,16025,5386,1525,14492,27678
GCTGCTTCTAGGCTCT,sample,170733,164867,33838,131029,19319,111710,19070,916,48258,5100,67328,38366,10358,1690,4319,11036
AGCAGAGCTAGGCTCT,sample,295321,286916,47771,239145,40133,199012,40056,2479,82733,8845,122789,64899,13292,2381,10308,24418
ATACCGCCTAGGCTCT,sample,129934,126839,23516,103323,28042,75281,21318,1345,28615,3144,49933,20859,7200,1601,7065,15982
CGTCGAGGTAGGCTCT,sample,132337,128338,27017,101321,12549,88772,17277,929,38254,4306,55531,28006,9364,1714,3670,7341
TCTCCTAGTAGGCTCT,sample,196876,192875,28682,164193,34458,129735,31799,2340,51648,4694,83447,39254,9307,1869,10481,20900
AAGTAGAGTAGGCTCT,sample,684732,667535,122062,545473,59883,485590,66222,3679,213215,22812,279437,179662,22588,5599,12498,34476
TCAATCAGTAGGCTCT,sample,85473,82930,19059,63871,7604,56267,6327,289,25380,2475,31707,21796,8000,961,1483,4163
ATTCTACCTAGGCTCT,sample,166366,165236,8314,156922,56211,100711,52414,4301,27360,3369,79774,13267,6311,1711,13278,32851
GACTAACCTAGGCTCT,sample,66029,65554,3461,62093,27697,34396,18805,2235,8005,1030,26810,4321,4351,1918,2150,14150
TTAACTGATAGGCTCT,sample,145,142,44,98,19,79,22,0,28,9,50,20,35,11,11,15
AACCGGTTTTGACTAT,sample,99394,98358,15881,82477,17829,64648,14959,1276,25810,2779,40769,19824,7680,1340,5545,10544
GTCGTTCTTTGACTAT,Neg_Ctrl,5863,2916,1895,1021,148,873,259,20,318,21,577,255,305,95,44,48
AGAGTTCTTTGACTAT,sample,58981,57843,8082,49761,13861,35900,11344,626,13089,1468,24433,9373,5039,963,4976,8526
TATACGGATTGACTAT,sample,112390,110511,11323,99188,33100,66088,24862,1604,20435,2502,45297,16685,4203,1126,11670,20044
GGAGAAGCTTGACTAT,Neg_Ctrl,3800,1840,1511,329,65,264,97,3,82,11,179,71,130,27,34,14
CGTCGCCATTGACTAT,sample,50265,48549,14763,33786,3506,30280,3911,237,13474,1418,17385,11240,5611,676,1085,1868
TGATTCCGTTGACTAT,Pos_Ctrl,154331,148424,23444,124980,7081,117899,99086,8511,7104,929,106190,2269,7610,10084,6603,4185
GCAACTAGTTGACTAT,sample,105136,103681,17082,86599,16367,70232,12444,674,28926,3157,41370,25031,9667,1566,3429,10288
TACGCGAGTTGACTAT,sample,81538,79272,14080,65192,11851,53341,11167,627,22095,2458,33262,16994,7800,1243,3464,7254
CCGTACGCTTGACTAT,sample,52008,51140,6691,44449,15923,28526,11362,700,9565,951,20927,5948,3888,905,4495,8823
GATGCGTTTTGACTAT,sample,156996,152621,30334,122287,20790,101497,18445,1053,43756,4715,62201,33528,9536,1558,5248,12788
ATGGCGTTTTGACTAT,Pos_Ctrl,147259,142019,21816,120203,7190,113013,94843,8299,6747,1012,101590,2112,7409,9711,7138,3808
CCATTCTTTTGACTAT,sample,60895,59046,13977,45069,6591,38478,8318,621,15610,1849,23928,12080,5940,1295,1434,3855
AAGGTCTGTTGACTAT,sample,82740,80513,18510,62003,9389,52614,8702,618,22809,2383,31511,18102,6809,1102,1825,5040
CCTAGCGGTTGACTAT,Pos_Ctrl,114987,111372,16981,94391,5243,89148,74235,6697,5632,793,79867,1791,7038,8846,4158,3111
CTAACCGGTTGACTAT,sample,155292,151775,29028,122747,22302,100445,24426,1508,40135,4017,64561,30359,8862,1744,5132,13670
GCCTATTCTTGACTAT,sample,28809,28200,3655,24545,6484,18061,8040,527,5421,801,13461,3272,2555,936,2079,3957
AGCAGAGCTTGACTAT,sample,27799,27246,3741,23505,7171,16334,7622,537,4641,544,12263,2990,2570,785,3307,4143
ATACCGCCTTGACTAT,sample,273732,265052,68434,196618,16105,180513,20558,1255,80889,8259,101447,69552,16478,2592,3247,7509
GTCGCGAATTGACTAT,sample,43499,42600,5292,37308,9567,27741,10927,682,8825,1078,19752,6229,3877,919,4387,6083
CGTCGAGGTTGACTAT,Pos_Ctrl,81490,78547,11950,66597,3495,63102,52734,4791,3778,491,56512,1308,6334,7473,2940,1987
AAGTAGAGTTGACTAT,sample,59517,57893,12804,45089,7101,37988,7750,630,15503,1597,23253,12508,5904,980,1706,4152
CGCGAGACTTGACTAT,sample,142568,140803,21968,118835,19394,99441,20369,1305,41036,4189,61405,32542,10747,1891,4827,12638
GCGCAATATTGACTAT,Neg_Ctrl,2920,1324,1081,243,50,193,54,3,81,8,135,47,104,15,23,22
GGAGAAGCTGCAGTTG,sample,72131,70724,6928,63796,23282,40514,15110,869,13102,1552,28212,9881,4288,1069,5742,13248
TCGAACGATGCAGTTG,sample,62460,61436,5832,55604,21060,34544,14592,1012,11412,1293,26004,6235,3563,925,5422,11738
TCATCGAATGCAGTTG,sample,59457,58508,5313,53195,19728,33467,13421,605,11259,1230,24680,6952,4139,901,5781,11375
TCATACCATGCAGTTG,sample,42051,41308,3911,37397,16184,21213,9872,639,6078,642,15950,3982,3220,994,3969,8226
GCAACTAGTGCAGTTG,sample,26399,25878,3519,22359,5659,16700,5033,380,6542,798,11575,3947,3590,917,1529,3416
ATACGTTCTGCAGTTG,sample,80515,78240,15163,63077,15909,47168,12253,778,18893,1712,31146,13532,6425,1084,4118,9268
CATTCGGTTGCAGTTG,sample,51076,49922,7735,42187,8967,33220,8341,355,12646,1338,20987,10540,5270,801,3537,5448
TAGCGAGTTGCAGTTG,sample,61879,60985,6222,54763,15449,39314,14291,1084,12475,1247,26766,10217,4552,1029,5530,9423
CTAAGCATTGCAGTTG,sample,83436,82119,8574,73545,18961,54584,20113,995,19014,1824,39127,12638,5958,1151,8159,11822
GCTGCTTCTGCAGTTG,sample,45005,44307,5417,38890,7305,31585,13410,963,9651,994,23061,6567,4657,1422,2829,4797
CGTCGAGGTGCAGTTG,sample,91059,89511,14190,75321,11067,64254,11142,511,27518,2949,38660,22134,8914,1264,3565,6489
CAGCTTCGTGCAGTTG,sample,77824,76957,8942,68015,12744,55271,12920,911,22469,2313,35389,16658,7505,1120,5101,8489
CGCGGTCGTGCAGTTG,sample,17760,17587,1022,16565,6165,10400,4843,336,3023,367,7866,1831,1719,538,1602,3505
ATGAATAGTGCAGTTG,sample,29101,28633,2644,25989,12524,13465,6010,415,4628,417,10638,1995,2468,892,1658,5865
TAACGCCATGCAGTTG,sample,68272,66530,9813,56717,11218,45499,12265,1036,17439,1829,29704,12930,6110,1129,3605,7184
GACTAACCTGCAGTTG,sample,53689,52485,5987,46498,13977,32521,11834,615,11570,1217,23404,7285,4500,877,3328,8510
GTCGTTCTTCATGCTG,sample,30173,29729,4126,25603,7516,18087,5465,457,7216,716,12681,4233,3486,933,1546,4286
TCGAACGATCATGCTG,sample,38337,37515,6290,31225,7261,23964,7415,498,8556,875,15971,6620,4440,1083,1632,4325
GCAACTAGTCATGCTG,Neg_Ctrl,2464,965,765,200,23,177,38,1,117,1,155,20,46,11,8,7
GACTCAAGTCATGCTG,sample,91229,88690,21721,66969,5857,61112,5876,299,28136,2923,34012,23878,9921,1072,877,2927
TGCGCGTTTCATGCTG,Neg_Ctrl,1909,887,695,192,42,150,31,1,88,0,119,30,67,12,14,11
TAGCGAGTTCATGCTG,sample,51494,50633,8429,42204,10540,31664,8442,569,11740,1138,20182,9775,5524,1234,1881,6107
AAGGTCTGTCATGCTG,sample,57100,56325,5302,51023,15129,35894,15188,975,11364,1380,26552,6987,3784,1008,4897,9616
CTAACCGGTCATGCTG,Neg_Ctrl,1636,688,555,133,27,106,14,5,58,1,72,28,39,5,6,7
GGCGACGATCATGCTG,sample,20778,20424,1732,18692,7692,11000,7212,467,2353,260,9565,708,1022,544,2697,4248
AGCAGAGCTCATGCTG,sample,32843,31906,6819,25087,3541,21546,4575,364,8769,891,13344,6947,4336,712,1257,2044
ATACCGCCTCATGCTG,sample,24123,23544,4133,19411,4330,15081,5587,391,4881,535,10468,3687,2970,829,1272,2583
CGTCGAGGTCATGCTG,sample,37384,36595,6742,29853,5552,24301,5691,304,9732,1049,15423,7525,4377,668,1835,3287
CAGCTTCGTCATGCTG,Neg_Ctrl,1801,948,847,101,25,76,11,1,23,2,34,39,29,4,2,9
CGCGGTCGTCATGCTG,sample,39457,38480,7969,30511,4425,26086,3947,229,11324,1194,15271,9392,5392,569,1028,2407
TTATGACGTCATGCTG,sample,26278,25895,1590,24305,10035,14270,8836,647,3514,400,12350,873,1141,524,3427,5632
GCGCAATATCATGCTG,sample,18231,17933,1584,16349,6607,9742,6640,439,1764,186,8404,713,1092,671,2076,3765
CTGGTCTTTTAGGCGG,Pos_Ctrl,248111,237969,31588,206381,10137,196244,164577,13932,12342,1802,176919,3591,8312,12240,12447,5416
AGAGTTCTTTAGGCGG,sample,11849,11452,1420,10032,6409,3623,1602,43,1235,91,2837,652,592,204,648,1996
TATACGGATTAGGCGG,Pos_Ctrl,208834,201273,25545,175728,8122,167606,141445,12211,9700,1443,151145,2807,8035,11609,10272,4072
CTAGCGACTTAGGCGG,sample,154810,153029,12408,140621,46758,93863,46428,1855,27445,3554,73873,14581,5717,1660,15015,29106
TCATCGAATTAGGCGG,sample,34641,33522,10474,23048,2770,20278,2063,117,9308,993,11371,7797,5121,465,209,1364
GATGCGTTTTAGGCGG,sample,74868,72736,15902,56834,12958,43876,11916,805,17300,1880,29216,11975,6116,1363,3411,7314
TGCGCGTTTTAGGCGG,sample,34140,33462,3478,29984,9729,20255,9617,766,6108,946,15725,2818,2965,1259,2038,5878
CTAAGCATTTAGGCGG,sample,235093,227318,48997,178321,13399,164922,17646,772,76487,7633,94133,62384,15118,2391,2189,6613
GCGTTACCTTAGGCGG,sample,120927,117560,20522,97038,17675,79363,19624,1379,32147,3173,51771,23040,8243,1361,5996,10880
CAGCTTCGTTAGGCGG,sample,38860,38113,4081,34032,12507,21525,10146,548,6482,719,16628,3630,2701,742,4167,7217
GACGTATGTCAGATAC,sample,48253,46870,12081,34789,5969,28820,5019,286,12378,1467,17397,9670,5252,750,1372,3187
CTAGCGACTCAGATAC,sample,11965,11512,3823,7689,714,6975,793,38,3224,356,4017,2564,2184,188,171,344
CGTCGCCATCAGATAC,sample,52501,50968,12046,38922,6360,32562,6351,429,13964,1309,20315,10509,5103,880,1772,3643
GACTCAAGTCAGATAC,sample,91354,89214,15694,73520,13163,60357,13818,614,25402,2916,39220,17607,7288,1234,4475,8612
GCTCTTCTTCAGATAC,sample,63967,62339,13802,48537,6506,42031,8290,572,17596,1728,25886,13845,6422,865,2990,4127
CTAAGCATTCAGATAC,sample,22155,21562,6356,15206,2101,13105,2237,181,5532,581,7769,4574,3195,498,513,1092
CCTAGCGGTCAGATAC,sample,26915,26475,3037,23438,7686,15752,7354,282,4811,619,12165,2686,2190,575,3144,4574
GCCTATTCTCAGATAC,sample,107600,104707,24040,80667,11183,69484,12573,693,29315,3050,41888,23853,7821,1195,3794,6739
AGCAGAGCTCAGATAC,sample,46418,44918,13165,31753,2645,29108,3027,128,12925,1347,15952,11681,5843,519,710,1225
TGCGCTCCTCAGATAC,sample,9440,9131,2458,6673,1626,5047,1195,91,1982,188,3177,1591,1563,291,454,827
GCGTTACCTCAGATAC,sample,66379,64966,12453,52513,8450,44063,9271,624,18163,1959,27434,14046,6351,844,3156,5525
GGCGTACCTCAGATAC,sample,124793,122040,27706,94334,16588,77746,16438,1221,31100,3408,47538,25579,8637,1391,4124,9104
ATGAATAGTCAGATAC,sample,121432,118428,30174,88254,12919,75335,15766,1003,30193,2898,45959,25475,9433,1444,3903,7510
TAACGCCATCAGATAC,sample,84292,82831,17839,64992,10800,54192,10679,571,21973,2260,32652,18709,7999,1280,3098,5234
ATTCTACCTCAGATAC,sample,56512,55231,11588,43643,5453,38190,9754,595,15058,1576,24812,11207,5077,956,2758,3028
CGTAGAACTCAGATAC,sample,105028,102567,16176,86391,13804,72587,18883,948,29237,3159,48120,20360,5723,1377,4644,9189
GTCGTTCTTCGCTAGG,Neg_Ctrl,4239,2444,1897,547,89,458,82,6,219,12,301,139,152,30,27,31
GGAGAAGCTCGCTAGG,Neg_Ctrl,1781,897,724,173,37,136,50,2,47,10,97,27,65,10,6,7
TCATCGAATCGCTAGG,sample,72263,70946,6871,64075,22019,42056,20238,1364,12238,1075,32476,7141,3476,920,8585,13483
ATTCAAGGTCGCTAGG,sample,57040,55213,10814,44399,8414,35985,9235,743,13676,1494,22911,10837,6642,1384,1894,4991
TACGCGAGTCGCTAGG,sample,11008,10690,2248,8442,1870,6572,2662,243,2096,217,4758,1354,2093,851,410,1187
CCGCAGTCTCGCTAGG,sample,13123,12621,3360,9261,1584,7677,1168,61,3295,317,4463,2836,2296,240,417,859
TGGATCAATCGCTAGG,sample,7060,6801,1968,4833,666,4167,612,31,1714,182,2326,1628,1270,183,168,307
GGCAGGTTTCGCTAGG,sample,5723,5544,907,4637,1653,2984,1088,53,996,90,2084,757,754,191,598,919
GATGCGTTTCGCTAGG,sample,110825,107957,25527,82430,9047,73383,9649,605,32963,3312,42612,26854,9785,1362,2522,5078
TGCGCGTTTCGCTAGG,sample,14038,13834,1597,12237,4244,7993,3484,162,2471,249,5955,1627,1637,468,1764,2420
CATTCGGTTCGCTAGG,sample,24879,24474,2450,22024,7709,14315,8649,331,3740,264,12389,1331,1549,567,4108,4681
GAGATTCTTCGCTAGG,sample,15054,14598,2667,11931,2204,9727,3034,281,3729,424,6763,2259,2182,666,620,1365
AAGGTCTGTCGCTAGG,sample,51425,49946,10560,39386,4918,34468,6601,346,14227,1499,20828,11795,5654,843,1947,3188
CCTAGCGGTCGCTAGG,sample,40922,39509,9714,29795,4346,25449,4831,432,11099,1215,15930,7872,5079,824,1034,2415
GCCTATTCTCGCTAGG,sample,34120,33100,6907,26193,4449,21744,4609,230,8889,977,13498,7039,4513,609,1488,2604
TGCGCTCCTCGCTAGG,sample,40154,38821,10652,28169,3836,24333,3425,180,10606,1204,14031,8918,5189,637,774,1854
GTCGCGAATCGCTAGG,sample,70188,67931,15085,52846,6619,46227,7601,306,19783,1962,27384,16575,6731,763,1948,3619
TCTCCTAGTCGCTAGG,sample,27285,26187,6598,19589,2331,17258,2420,184,7620,836,10040,6198,4069,514,471,1147
ATTCTACCTCGCTAGG,Pos_Ctrl,78483,75094,11263,63831,3285,60546,50835,4350,3794,462,54629,1105,6213,7441,2482,1761
AGAGTTCTCCGTTGCG,sample,156188,152174,34480,117694,21191,96503,14868,834,42581,4551,57449,33669,10977,1759,4101,11918
AGCTGAATCCGTTGCG,sample,64616,62674,16014,46660,8866,37794,8654,510,14807,1696,23461,12127,5103,1078,2746,4966
GACGTATGCCGTTGCG,sample,67888,66009,15239,50770,10841,39929,7934,567,15925,1611,23859,13892,5645,990,2713,6264
CATAATGGCCGTTGCG,sample,659526,642315,145189,497126,47280,449846,49464,2750,206278,21481,255742,169873,20072,4759,7016,25731
CGTCGCCACCGTTGCG,sample,148233,142694,32646,110048,17629,92419,13669,687,40532,4191,54201,33340,9861,1538,3251,9251
TCATACCACCGTTGCG,sample,70533,69522,5471,64051,26284,37767,21867,1181,9636,1180,31503,3903,2104,743,12316,14664
GACTCAAGCCGTTGCG,sample,94941,92940,17145,75795,17145,58650,14363,1086,22752,2902,37115,17547,6809,1243,4843,10099
CCGCAGTCCCGTTGCG,sample,40323,38549,12150,26399,3361,23038,3308,218,10283,1016,13591,8213,4573,675,685,1656
CCGTACGCCCGTTGCG,sample,41271,40402,5740,34662,11848,22814,9460,346,7609,875,17069,4524,2717,791,4438,6565
GATGCGTTCCGTTGCG,sample,8730,8520,1575,6945,1907,5038,1373,109,2033,231,3406,1292,1446,380,399,1089
ATGGCGTTCCGTTGCG,sample,70962,70001,7579,62422,23785,38637,17250,1291,12590,1391,29840,6115,3778,1016,7382,13403
AGCGTCTTCCGTTGCG,sample,29885,29493,3008,26485,8877,17608,8274,459,5825,559,14099,2491,2382,967,2912,5273
CCTAGCGGCCGTTGCG,sample,70444,68610,16269,52341,9399,42942,8484,473,17611,1896,26095,14478,6544,1104,2086,5071
GCTGCTTCCCGTTGCG,sample,166394,161793,38889,122904,17826,105078,18480,1511,45577,5111,64057,34399,9525,1619,5497,10875
TGCGCTCCCCGTTGCG,sample,88417,86544,15560,70984,16268,54716,15304,762,21666,1950,36970,15034,6490,1152,5233,9712
GCGTTACCCCGTTGCG,sample,95949,93567,20820,72747,12650,60097,15534,1039,23183,2429,38717,17912,6866,1415,4220,7151
GTCGCGAACCGTTGCG,sample,182988,178261,32854,145407,21156,124251,23917,1463,50718,5749,74635,42404,10225,1678,4731,11890
TTATGACGCCGTTGCG,sample,655843,637026,201835,435191,23389,411802,45557,2805,189817,20830,235374,152793,21793,4384,3310,9142
ATGAATAGCCGTTGCG,sample,147742,143223,34840,108383,13196,95187,13575,944,41346,4459,54921,34863,10104,1532,3356,7481
TCAATCAGCCGTTGCG,sample,304297,295824,63678,232146,23765,208381,27384,1739,91663,9352,119047,78243,14448,2280,6517,13336
AACCGGTTAGGCCAAG,sample,335489,326264,77040,249224,35224,214000,41267,2785,90180,9879,131447,69889,14031,3225,8353,20009
GTCGTTCTAGGCCAAG,sample,84782,82848,14633,68215,20850,47365,13332,830,17522,1926,30854,13755,6909,1642,4070,11699
GACGTATGAGGCCAAG,sample,78787,76429,16564,59865,10088,49777,12115,793,20392,2552,32507,13925,6302,1390,2757,6177
CATAATGGAGGCCAAG,sample,49853,47806,15079,32727,4281,28446,3739,261,12863,1354,16602,10229,5737,753,933,2031
CTAGCGACAGGCCAAG,sample,28705,27940,3976,23964,6686,17278,5801,440,6923,659,12724,3455,2970,796,2203,4005
TCGAACGAAGGCCAAG,sample,110448,106398,27188,79210,8874,70336,8073,414,32148,3298,40221,26403,9876,1292,1077,4192
ATACGTTCAGGCCAAG,sample,147291,144839,25410,119429,19900,99529,19042,1137,41449,4391,60491,33510,10864,1865,4735,12381
CCGCAGTCAGGCCAAG,sample,139579,134721,28521,106200,18523,87677,16024,908,37881,3977,53905,28887,9583,1574,4145,10380
TGGATCAAAGGCCAAG,sample,60933,59458,12429,47029,10561,36468,9546,657,14062,1494,23608,10709,6040,1193,3241,5845
TGCGCGTTAGGCCAAG,sample,181715,177963,29541,148422,28382,120040,28436,2436,47268,4641,75704,37259,9822,2051,7556,17177
CCATTCTTAGGCCAAG,sample,166546,163469,26349,137120,28318,108802,20610,1231,44347,4579,64957,38035,10148,1706,6915,16657
AGCGTCTTAGGCCAAG,sample,59127,57976,10457,47519,10610,36909,9279,433,14564,1656,23843,10977,5871,1198,2676,6267
CGGTTGGTAGGCCAAG,sample,36374,35676,5779,29897,9750,20147,7309,342,6951,692,14260,4853,3817,791,3109,5218
GAGATTCTAGGCCAAG,sample,235269,229308,42747,186561,28718,157843,27306,1958,65855,7335,93161,55389,12501,2081,7568,17047
CCTAGCGGAGGCCAAG,sample,93601,91524,18885,72639,11930,60709,11849,776,25279,2622,37128,20183,8023,1189,3942,7242
CTAACCGGAGGCCAAG,sample,95486,93329,17731,75598,15528,60070,12793,991,24375,2577,37168,19334,7207,1186,4165,9082
TGCGCTCCAGGCCAAG,sample,123009,120585,18326,102259,23322,78937,26753,1088,28347,3109,55100,19640,7340,1229,11035,14500
ATACCGCCAGGCCAAG,sample,124202,120974,22327,98647,16898,81749,20198,1788,31915,3698,52113,24150,7642,1328,5892,9867
TTATGACGAGGCCAAG,sample,416653,405019,85360,319659,26688,292971,44105,2395,132629,14391,176734,99451,18757,3882,5211,13593
ATGAATAGAGGCCAAG,sample,78236,76499,11749,64750,12101,52649,15713,1151,21289,1903,37002,12593,4756,1172,3999,7486
GACTAACCAGGCCAAG,Neg_Ctrl,6534,4049,3362,687,122,565,92,4,193,16,285,260,174,30,33,46
CCTAACTAAGGCCAAG,sample,266302,259656,42626,217030,33606,183424,40341,2500,71275,7767,111616,61541,12590,2206,11757,20048
TCTAGGTTAGAACCGC,sample,83268,80775,20303,60472,13416,47056,7589,572,20174,2036,27763,16685,6518,1034,2124,6667
AGCTGAATAGAACCGC,sample,184871,180635,33021,147614,46876,100738,29404,2352,37458,4058,66862,27466,7265,1640,9353,24892
ATTCAAGGAGAACCGC,sample,73433,72820,5023,67797,38036,29761,20795,1047,5881,589,26676,1449,1460,866,9310,15922
TACGCGAGAGAACCGC,sample,123856,120753,18434,102319,26513,75806,22929,1123,30194,2979,53123,18581,6276,1427,5604,15282
AGCGTCTTAGAACCGC,sample,115192,113087,16503,96584,23973,72611,21504,1063,27800,2787,49304,19457,6962,1320,7830,15117
GAGATTCTAGAACCGC,sample,208508,204469,30305,174164,50735,123429,35361,2950,47215,5511,82576,32392,7414,1950,10548,29067
CTAAGCATAGAACCGC,sample,133547,131008,20249,110759,26827,83932,31543,2343,28453,2716,59996,18877,7442,1587,10064,16702
CTAACCGGAGAACCGC,sample,38393,37416,6975,30441,8465,21976,6364,521,8383,1012,14747,5696,3789,699,2121,4685
GGCGACGAAGAACCGC,sample,134547,131737,26123,105614,13704,91910,15896,1128,40113,4060,56009,30713,9885,1714,4086,8069
AGCAGAGCAGAACCGC,sample,92175,90086,16108,73978,12815,61163,17909,1062,23286,2584,41195,16322,6244,1286,5024,7975
TGCGCTCCAGAACCGC,sample,251203,243222,65196,178026,17379,160647,20155,1346,73059,7433,93214,58654,13257,2060,3674,8064
ATACCGCCAGAACCGC,sample,119353,117153,19842,97311,24641,72670,23146,1530,26111,3008,49257,18875,7128,1422,7877,14381
CGCGGTCGAGAACCGC,sample,134780,129676,26745,102931,10878,92053,10148,451,40854,4007,51002,36593,10379,1356,1618,5992
CGTAGAACAGAACCGC,sample,193631,189761,30626,159135,31576,127559,40785,2735,44456,4874,85241,34709,8545,1574,9147,20065
CCTAACTAAGAACCGC,sample,95379,94405,6221,88184,35392,52792,32645,2718,12140,1256,44785,4033,2508,866,9444,20530
TCATACCACATCAAGC,sample,56155,54989,7134,47855,16274,31581,14264,1335,9408,1054,23672,5520,3921,1200,4203,9534
GCAACTAGCATCAAGC,sample,101903,100445,17710,82735,13564,69171,13152,721,29095,2920,42247,23283,9149,1357,4494,8888
TACGCGAGCATCAAGC,sample,99118,97179,13542,83637,25776,57861,21401,1708,19885,2280,41286,12587,5869,1460,5009,14685
GACTCAAGCATCAAGC,sample,73295,70958,17826,53132,6128,47004,9298,630,20335,2021,29633,14720,6790,1193,2133,3501
TGCGCGTTCATCAAGC,sample,152205,149582,25920,123662,32692,90970,30369,1614,32929,2711,63298,23347,5373,1375,12148,18912
TAGCGAGTCATCAAGC,sample,296511,287674,67410,220264,22789,197475,28736,1383,87592,8746,116328,71018,14151,2270,7022,12598
AAGGTCTGCATCAAGC,sample,176463,173628,24493,149135,39976,109159,38562,2057,39138,4066,77700,25336,6780,1377,13197,24113
TAACGAAGCATCAAGC,sample,262592,256609,46992,209617,35186,174431,30941,2258,74371,7929,105312,58932,12300,2059,6954,21018
CGTCGAGGCATCAAGC,Pos_Ctrl,137633,133583,17367,116216,5869,110347,93322,8269,6172,694,99494,1890,7044,9447,5187,3155
TAACGCCACATCAAGC,sample,234297,229530,48990,180540,21339,159201,28272,1640,67826,6904,96098,54559,12703,2102,6431,11955
ATTCTACCCATCAAGC,sample,35654,34815,5987,28828,6966,21862,7528,489,7871,1038,15399,4936,3472,846,2131,4230
CCTAACTACATCAAGC,sample,166204,163797,19266,144531,35736,108795,33062,2250,42849,4598,75911,26036,8120,1531,9192,22759
TCTAGGTTAGAGAGCC,sample,122973,121144,18910,102234,20515,81719,16683,918,33747,3244,50430,27127,8718,1536,5416,13107
GACGTATGAGAGAGCC,sample,153635,150454,24734,125720,25991,99729,28319,1908,37616,3797,65935,28089,9502,2087,7315,15088
TATACGGAAGAGAGCC,sample,72903,71404,12949,58455,15128,43327,10877,1078,16976,1956,27853,12440,6395,1112,4291,8609
GAGCCTCCAGAGAGCC,sample,59181,57830,9059,48771,14167,34604,13009,884,11794,1463,24803,7454,5132,1322,3844,7941
CATACTCCAGAGAGCC,sample,12444,11888,3293,8595,1508,7087,1069,71,3075,329,4144,2543,1989,265,295,745
TCATCGAAAGAGAGCC,sample,50433,49281,7915,41366,14209,27157,7956,554,10638,1018,18594,6991,4474,1020,2416,7416
GCAACTAGAGAGAGCC,sample,30750,30228,4892,25336,5615,19721,4548,376,8321,837,12869,5639,4081,890,1070,3291
GACTCAAGAGAGAGCC,sample,108329,105778,18257,87521,19421,68100,19516,1058,25447,2557,44963,19522,8033,1501,5840,12264
GATGCGTTAGAGAGCC,sample,87433,84307,29410,54897,3128,51769,4467,233,24709,2605,29176,19755,8951,780,391,1232
ATGGCGTTAGAGAGCC,sample,134453,131240,27185,104055,20637,83418,17485,1120,33108,3520,50593,28185,8781,1283,6171,12212
TGCGCGTTAGAGAGCC,sample,145704,142469,26292,116177,19546,96631,18436,1201,41613,4433,60049,30948,9429,1665,4679,11798
CCATTCTTAGAGAGCC,sample,33871,32867,7388,25479,5320,20159,5337,354,7830,735,13167,5903,3934,1018,1116,3001
AGCGTCTTAGAGAGCC,sample,108693,106226,21531,84695,16203,68492,14157,837,27520,2978,41677,23000,7942,1195,4904,9356
GCTGCTTCAGAGAGCC,sample,33576,32583,7456,25127,3152,21975,4243,178,9473,1070,13716,7011,4322,693,969,1569
GCCTATTCAGAGAGCC,sample,62895,60913,14358,46555,8275,38280,7910,560,15794,1827,23704,12189,5724,840,2228,4719
ATACCGCCAGAGAGCC,sample,52308,51003,9215,41788,12316,29472,6589,415,11790,1486,18379,9192,4532,596,1990,6746
GTCGCGAAAGAGAGCC,sample,112312,108766,22736,86030,13009,73021,15827,1357,30532,3562,46359,21743,8454,1279,4307,7689
TCTCCTAGAGAGAGCC,sample,27016,26598,3217,23381,8311,15070,6799,547,4331,365,11130,3028,2277,686,2060,4668
ATGAATAGAGAGAGCC,sample,137583,134508,25108,109400,16934,92466,23199,1835,35320,3741,58519,28371,8472,1390,6535,10328
AAGTAGAGAGAGAGCC,sample,65600,63816,12628,51188,10261,40927,9489,537,16010,1586,25499,13305,5931,880,3113,5660
TCAATCAGAGAGAGCC,sample,107165,104404,20045,84359,13097,71262,14605,797,28177,2733,42782,24950,8040,1252,3961,7475
GCGCAATAAGAGAGCC,sample,82124,79926,15412,64514,11324,53190,8832,465,22911,2285,31743,18697,7034,884,2214,6505
TTAACTGAAGAGAGCC,sample,31255,30310,6764,23546,4034,19512,4343,322,8230,737,12573,5880,3708,646,1117,2212
AACCGGTTAGCATTGA,sample,174327,172778,10285,162493,83516,78977,43855,4063,19428,2723,63283,8908,2725,1200,20239,39385
CTGGTCTTAGCATTGA,sample,154226,151450,18865,132585,38657,93928,40462,3228,29038,3373,69500,17827,6640,2475,8878,24186
AGCTGAATAGCATTGA,sample,63703,62817,5227,57590,24800,32790,17969,1541,8362,940,26331,3978,3435,1553,5855,13099
GACGTATGAGCATTGA,sample,151687,149791,17324,132467,40306,92161,27696,1925,34544,3638,62240,24358,8421,1905,7728,24551
GAGCCTCCAGCATTGA,sample,128813,127102,12635,114467,35942,78525,35987,2059,23032,2788,59019,14659,6871,2021,10515,22340
TCATACCAAGCATTGA,sample,95349,93843,9131,84712,37168,47544,21869,1566,13596,1644,35465,8869,5056,1742,5318,18932
ATTCAAGGAGCATTGA,sample,189209,184482,36551,147931,23527,124404,23582,1100,53109,5533,76691,41080,10616,1699,7884,13883
TGATTCCGAGCATTGA,sample,90780,89089,11134,77955,18708,59247,29503,3073,15288,2058,44791,9325,6024,2998,2112,12595
ATACGTTCAGCATTGA,sample,332654,326297,45596,280701,67926,212775,52368,3931,86553,9152,138921,60771,11525,2252,19075,41150
CCATTCTTAGCATTGA,sample,146161,143034,19156,123878,35337,88541,23478,1894,35773,3528,59251,23868,7736,1445,6919,20745
AGCGTCTTAGCATTGA,sample,170659,167821,25248,142573,29892,112681,28560,1587,43403,5057,71963,34074,10010,2103,7864,18344
CATTCGGTAGCATTGA,sample,168659,166431,11863,154568,51649,102919,49433,3638,30692,4085,80125,15071,3504,1256,21211,32481
CTAAGCATAGCATTGA,sample,331969,325185,49499,275686,45233,230453,50643,1784,92092,11268,142735,74666,13333,2498,15835,28138
GCTGCTTCAGCATTGA,sample,69217,68376,3579,64797,27912,36885,24006,1433,8074,1083,32080,2289,2393,1399,7148,14735
CAGCTTCGAGCATTGA,Neg_Ctrl,6852,4361,2992,1369,85,1284,65,3,826,5,891,385,87,16,30,83
ATTCTACCAGCATTGA,sample,105979,104443,9155,95288,23673,71615,31456,2846,24333,2853,55789,10127,5024,1382,5951,16206
GACGTATGAATTACCA,sample,152557,149645,21290,128355,31576,96779,28838,2371,35530,4414,64368,25626,9277,1814,9430,19423
CATAATGGAATTACCA,sample,158961,155763,25754,130009,32525,97484,30621,2169,35024,3765,65645,25905,8454,1500,12410,18814
TATACGGAAATTACCA,sample,385664,375868,78600,297268,31958,265310,41171,1882,112944,11629,154115,97684,16042,3107,10592,18465
GAGCCTCCAATTACCA,sample,257431,253111,34707,218404,42260,176144,53696,5169,64709,6280,118405,46290,11853,2861,9536,26527
CTAGCGACAATTACCA,sample,115219,112372,21356,91016,17919,73097,18464,1248,27765,2828,46229,22792,8046,1745,3989,9985
TCGAACGAAATTACCA,sample,103599,102663,6678,95985,39882,56103,35020,1742,13838,1470,48858,4033,2008,819,12893,21846
GGTAGAGAAATTACCA,sample,200979,196727,28766,167961,39809,128152,43894,3543,43018,4449,86912,33248,9069,2164,6267,24592
TCATCGAAAATTACCA,sample,82722,80670,14732,65938,17766,48172,16843,1175,16471,1891,33314,11792,5933,1699,2878,10120
CATTCGGTAATTACCA,sample,27524,26780,6297,20483,3511,16972,2992,195,6979,617,9971,6189,3433,508,810,1795
GAGATTCTAATTACCA,sample,130723,127529,28250,99279,13455,85824,15930,695,35575,3670,51505,29954,8704,1249,4888,8445
AAGGTCTGAATTACCA,sample,89294,87441,13028,74413,17484,56929,15672,942,21403,2261,37075,16651,6280,1087,5265,11141
TAACGAAGAATTACCA,sample,29582,29052,2109,26943,11909,15034,9069,274,3893,780,12962,1018,1033,456,4540,6366
ATGAATAGAATTACCA,sample,283498,274776,67652,207124,18664,188460,24082,1488,83147,8277,107229,71466,13965,2123,4423,10063
AGATACTAAATTACCA,sample,133930,130404,24230,106174,17727,88447,28341,2727,28311,3685,56652,25383,8267,2018,3595,10993
GCGCAATAAATTACCA,sample,74016,71622,21054,50568,3437,47131,4299,218,21590,2310,25889,18714,7194,744,630,1607
AACCGGTTTAGATGAC,sample,98507,97414,13436,83978,21939,62039,14415,764,24258,2661,38673,19941,7583,1174,5870,12680
CTGGTCTTTAGATGAC,Pos_Ctrl,230247,222727,30481,192246,9803,182443,153892,13075,10680,1454,164572,3342,8126,11647,11623,5546
GTCGTTCTTAGATGAC,sample,96935,95900,6726,89174,43612,45562,27509,2804,10711,1124,38220,3414,2631,1057,10952,21095
TATACGGATAGATGAC,sample,334020,328023,52672,275351,48100,227251,47018,2581,92345,8918,139363,76389,12740,2562,12935,28951
GAGCCTCCTAGATGAC,sample,186561,181858,43533,138325,20970,117355,18430,1312,50967,5334,69397,41312,11338,1735,4953,11195
CATACTCCTAGATGAC,Pos_Ctrl,241032,230321,33399,196922,10249,186673,157104,13658,10712,1514,167816,3685,8050,11813,10748,5674
ATTCAAGGTAGATGAC,sample,49945,48924,10044,38880,8237,30643,6941,451,12430,1305,19371,9516,6147,1209,1600,4991
TGATTCCGTAGATGAC,Pos_Ctrl,201037,193118,29811,163307,9017,154290,129482,10736,9811,1191,139293,3070,7892,10832,7983,4983
GACTCAAGTAGATGAC,sample,156666,153282,25921,127361,26003,101358,27719,1818,38945,4102,66664,28774,8766,2090,5919,16440
ATACGTTCTAGATGAC,sample,60580,59226,12661,46565,11809,34756,10326,574,12774,1342,23100,9740,4884,894,3480,6766
TGGATCAATAGATGAC,sample,464257,452473,91163,361310,50540,310770,51561,3056,132995,14569,184556,108589,16576,3443,14410,27751
GATGCGTTTAGATGAC,sample,134082,132205,15382,116823,27483,89340,31013,1656,32391,2886,63404,21394,6660,1310,11515,17832
ATGGCGTTTAGATGAC,sample,277127,270734,57841,212893,31392,181501,27896,1797,80069,9069,107965,62670,12983,2200,6648,17732
AGCGTCTTTAGATGAC,sample,171847,168863,26666,142197,28496,113701,27942,2073,42466,5486,70408,35734,8784,1662,10229,17271
CGGTTGGTTAGATGAC,sample,209266,204630,39128,165502,22570,142932,24691,1162,59395,5900,84086,51784,11917,1762,8370,12749
CATTCGGTTAGATGAC,sample,219700,213118,42045,171073,24447,146626,32160,1940,57998,5938,90158,48590,12927,2603,5492,14750
GCTCTTCTTAGATGAC,sample,267275,260188,56845,203343,23867,179476,29163,1616,77962,8958,107125,61777,13314,2191,5373,12958
GAGATTCTTAGATGAC,sample,38345,37101,9592,27509,3437,24072,4085,279,10179,1089,14264,8440,4840,783,771,1644
CTAAGCATTAGATGAC,sample,136775,134363,19373,114990,25486,89504,29723,2361,31070,2859,60793,23491,7913,2092,6903,16030
CCTAGCGGTAGATGAC,sample,103106,100005,21987,78018,10392,67626,14682,853,27714,2979,42396,21398,8380,1655,2243,6011
ATACCGCCTAGATGAC,sample,534799,516101,136124,379977,29842,350135,41929,1607,156945,16661,198874,132993,20619,3970,6778,12639
GGCGTACCTAGATGAC,sample,113292,110317,18545,91772,18397,73375,18577,1400,30221,3184,48798,19993,8089,1241,4814,11086
AAGTAGAGTAGATGAC,sample,113937,110884,20679,90205,14256,75949,22563,1751,26595,2846,49158,22194,8165,1539,4321,8392
TCAATCAGTAGATGAC,sample,107152,105620,11970,93650,26094,67556,31471,3068,18370,1978,49841,12669,3521,1193,10653,16929
TAACGCCATAGATGAC,sample,48984,47488,11180,36308,6011,30297,5515,397,12470,1239,17985,10676,5268,956,782,3223
GACTAACCTAGATGAC,sample,514719,498669,116023,382646,27246,355400,60861,4534,162785,18870,223646,108350,19073,3927,4930,13611
GCGCAATATAGATGAC,sample,57312,55667,12787,42880,4856,38024,9460,864,14998,1631,24458,11071,6156,1402,1195,2794
TTAACTGATAGATGAC,sample,31560,30981,4050,26931,6737,20194,8373,712,6765,610,15138,3734,2565,719,3328,4248
TCTAGGTTGTTCAGAA,sample,68177,66504,11985,54519,12295,42224,10384,762,16823,1911,27207,12344,5565,1188,3230,6675
GTCGTTCTGTTCAGAA,sample,301627,296610,32259,264351,56909,207442,57003,3542,81159,9355,138162,56383,8160,2390,12376,39828
GACGTATGGTTCAGAA,sample,321311,314224,51327,262897,46399,216498,51018,3198,86115,8796,137133,67371,12163,2741,13739,28534
GGTAGAGAGTTCAGAA,sample,92722,90097,15079,75018,22571,52447,14831,1117,19840,2081,34671,14578,7060,1496,3445,12010
TGATTCCGGTTCAGAA,sample,81555,78149,21752,56397,7336,49061,7189,396,20826,2072,28015,18578,7982,1153,1734,3448
ATACGTTCGTTCAGAA,sample,99923,96666,21975,74691,9931,64760,10454,545,28804,2984,39258,21973,9110,1274,3017,5808
CCGCAGTCGTTCAGAA,sample,58211,55963,12422,43541,7730,35811,6283,393,15414,1694,21697,12027,6213,901,1753,4275
GGCAGGTTGTTCAGAA,sample,20591,19916,3379,16537,5218,11319,3994,226,4062,457,8056,2580,2153,575,1605,2897
ATGGCGTTGTTCAGAA,sample,147998,146125,15066,131059,39506,91553,34379,2823,32062,3601,66441,18688,6694,1526,12272,23556
TGCGCGTTGTTCAGAA,sample,53160,52332,5334,46998,15530,31468,15411,1134,8660,762,24071,5501,2592,825,7314,9484
GAGATTCTGTTCAGAA,sample,3072,3026,287,2739,1238,1501,684,56,447,64,1131,250,570,254,193,598
TAACGAAGGTTCAGAA,sample,36053,35796,2347,33449,10327,23122,9716,753,7308,682,17024,4663,3593,936,4663,6159
TGCGCTCCGTTCAGAA,sample,36490,35863,6267,29596,6697,22899,5457,375,9221,945,14678,6901,4787,879,1720,3776
CGCGGTCGGTTCAGAA,sample,88860,88037,7088,80949,21649,59300,21330,1646,20597,1981,41927,13746,6155,1149,7743,13834
TTATGACGGTTCAGAA,sample,49820,49291,9021,40270,9257,31013,6083,585,12266,1172,18349,10907,5194,792,2045,4769
ATTCTACCGTTCAGAA,sample,129299,128115,9781,118334,33723,84611,37871,2610,26470,2775,64341,14885,5251,1380,16583,22421
AGATACTAGTTCAGAA,sample,83470,82685,6051,76634,31230,45404,22435,1773,13023,1867,35458,6306,2907,763,9189,16953
CCTAACTAGTTCAGAA,Pos_Ctrl,120923,116742,13102,103640,4745,98895,83709,7483,5406,674,89115,1623,6717,9185,4434,2511
GCGCAATAGTTCAGAA,sample,164268,162164,17476,144688,19417,125271,21286,1097,53288,5962,74574,43638,9949,1778,5024,13328
AACCGGTTTTCTGGTT,sample,119132,116764,17613,99151,31843,67308,24586,1428,22855,2761,47441,15678,5746,1433,8872,17809
TCTAGGTTTTCTGGTT,sample,216130,210927,43223,167704,21890,145814,23439,1185,62400,6337,85839,52453,11992,1992,7295,13254
GTCGTTCTTTCTGGTT,Neg_Ctrl,5343,3321,2698,623,118,505,109,4,198,22,307,172,215,46,32,57
CTAGCGACTTCTGGTT,Neg_Ctrl,4585,2786,2290,496,111,385,81,4,129,31,210,140,142,39,28,67
TCGAACGATTCTGGTT,sample,79135,76747,18692,58055,6798,51257,8004,368,21921,2340,29925,18624,7846,1029,2084,3962
GGTAGAGATTCTGGTT,sample,68435,65849,19849,46000,4728,41272,4503,265,18781,2006,23284,15717,6953,831,847,2154
ATTCAAGGTTCTGGTT,sample,40331,39284,7670,31614,7470,24144,6262,436,9035,966,15297,7445,4714,1025,1684,4290
TGATTCCGTTCTGGTT,sample,52472,50880,14718,36162,4301,31861,6118,468,13570,1431,19688,10274,5875,1064,1159,2430
GCAACTAGTTCTGGTT,Neg_Ctrl,2464,1275,951,324,36,288,52,4,136,7,188,89,77,29,16,20
TCTCAGGATTCTGGTT,sample,17862,17361,3525,13836,3480,10356,2826,148,3872,446,6698,3064,2592,489,1116,1965
TGCGCGTTTTCTGGTT,sample,44902,44303,4245,40058,14301,25757,12824,801,7728,787,20552,3617,2582,807,5349,8255
CCATTCTTTTCTGGTT,sample,22762,22053,4477,17576,4530,13046,3648,254,4953,508,8601,3683,2737,551,1199,2603
AGCGTCTTTTCTGGTT,sample,174487,171071,34476,136595,16844,119751,20083,1389,49466,5615,69549,43198,11120,2016,3516,9616
CATTCGGTTTCTGGTT,sample,50935,49699,8530,41169,9400,31769,8809,454,12449,1242,21258,8815,4435,989,2935,5457
TAGCGAGTTTCTGGTT,sample,41718,40927,5316,35611,9929,25682,9578,517,8507,944,18085,6136,3417,763,4446,6117
GAGATTCTTTCTGGTT,sample,24068,23598,2441,21157,6577,14580,7790,433,3711,394,11501,2252,2026,695,3774,3987
AAGGTCTGTTCTGGTT,sample,29544,28515,6968,21547,3023,18524,2986,184,8095,845,11081,6414,3793,476,1033,1769
CCTAGCGGTTCTGGTT,sample,21874,21413,2955,18458,5780,12678,4913,270,4360,470,9273,2665,2560,665,1562,3317
GCCTATTCTTCTGGTT,sample,15286,14850,3942,10908,2139,8769,1458,84,3818,438,5276,2971,2706,454,181,1090
GTCGCGAATTCTGGTT,sample,114459,112495,16631,95864,12465,83399,17330,1721,33995,3587,51325,26766,8361,1299,4387,7914
CGTCGAGGTTCTGGTT,sample,153986,151445,23826,127619,18832,108787,24235,1770,43095,4349,67330,35338,11144,1952,6848,11607
CGCGGTCGTTCTGGTT,sample,23633,23311,2229,21082,3824,17258,9111,771,4555,539,13666,2282,2584,1147,1035,2674
CGCGAGACTTCTGGTT,sample,3035,2951,210,2741,1192,1549,913,92,377,35,1290,132,438,261,251,602
TCTAGGTTGTTCGGTT,sample,82027,80650,10363,70287,23087,47200,17166,1193,16052,2248,33218,10541,5590,1513,5744,12909
CATAATGGGTTCGGTT,sample,96623,94767,11380,83387,28482,54905,19754,1296,19455,2055,39209,12345,6201,1227,8080,16833
TATACGGAGTTCGGTT,sample,61068,59962,7986,51976,16474,35502,15687,1158,10791,1163,26478,6703,4514,1601,3414,9113
GAGCCTCCGTTCGGTT,sample,38545,37476,5951,31525,10259,21266,6772,422,8366,783,15138,4923,3644,811,3027,5816
CATACTCCGTTCGGTT,sample,50648,49830,4392,45438,22768,22670,12414,900,6008,701,18422,2647,2227,839,5549,10416
GGTAGAGAGTTCGGTT,sample,111408,110307,7647,102660,44485,58175,38977,1922,11412,1726,50389,4138,1947,1026,18579,23956
CGTCGCCAGTTCGGTT,sample,70363,69339,6928,62411,23720,38691,12703,662,14020,1436,26723,9870,4765,872,5536,12787
ATTCAAGGGTTCGGTT,sample,129931,125484,27182,98302,14700,83602,13457,730,37114,4001,50571,28300,9860,1396,4690,8669
TGATTCCGGTTCGGTT,sample,67591,65222,15550,49672,8391,41281,7627,451,17541,1950,25168,13712,6967,1054,2051,4693
CCGTACGCGTTCGGTT,sample,26505,25910,2973,22937,7595,15342,6489,361,5286,458,11775,2748,2000,618,3074,4495
GATGCGTTGTTCGGTT,sample,39181,37690,10101,27589,3697,23892,3550,191,10314,1059,13864,8778,4790,533,1227,1930
GCCTATTCGTTCGGTT,sample,199576,195248,29529,165719,23213,142506,30455,2178,57450,5924,87905,46499,11600,1977,9328,14877
TGCGCTCCGTTCGGTT,sample,90414,88121,15649,72472,12020,60452,16007,1061,24581,2569,40588,16234,6645,1203,5696,7562
CAGCTTCGGTTCGGTT,sample,156657,152979,22839,130140,19153,110987,24626,1699,46626,4515,71252,33521,9401,1391,5806,13040
AAGTAGAGGTTCGGTT,sample,34708,34177,3417,30760,8126,22634,10722,709,7301,952,18023,2950,2864,1036,2448,5309
CGTAGAACGTTCGGTT,sample,156115,152964,22203,130761,26755,104006,36355,2588,36180,4083,72535,24800,5238,1294,10464,16380
GCGCAATAGTTCGGTT,Neg_Ctrl,2705,1194,902,292,68,224,75,4,59,6,134,80,107,24,23,13
TCTAGGTTTGGCGGTT,sample,108064,105052,20993,84059,12023,72036,13128,673,32674,3506,45802,22055,8307,1380,3391,6836
AGAGTTCTTGGCGGTT,sample,77868,76531,8458,68073,23737,44336,23817,1552,10712,978,34529,7277,4956,2270,6392,13961
CATACTCCTGGCGGTT,sample,77978,76811,12506,64305,14363,49942,14507,1019,20095,2253,34602,12068,5565,1274,3882,10477
CGTCGCCATGGCGGTT,sample,171972,167310,26202,141108,32837,108271,25201,1954,43653,4657,68854,32806,8892,1716,8661,19986
ATTCAAGGTGGCGGTT,sample,112590,110777,14923,95854,28509,67345,22390,1533,23132,2408,45522,17882,6604,1782,7101,16883
TGCGCGTTTGGCGGTT,sample,120655,118757,12758,105999,35302,70697,27218,1945,25646,2533,52864,13355,6105,1463,9282,20049
CCATTCTTTGGCGGTT,sample,55165,53943,7207,46736,11169,35567,11505,894,13591,1316,25096,8261,5426,1711,2229,6665
CGGTTGGTTGGCGGTT,sample,89157,86273,18585,67688,11170,56518,10341,561,23634,2666,33975,19316,8266,1196,3040,6081
CTAAGCATTGGCGGTT,sample,181154,177327,25791,151536,30860,120676,34953,3300,45929,4492,80882,32002,9452,1838,8884,18921
CCTAGCGGTGGCGGTT,sample,43036,41846,9559,32287,5667,26620,4697,291,10536,1149,15233,9947,5190,861,1317,2906
GGCGACGATGGCGGTT,sample,353922,341899,83714,258185,22493,235692,36056,1735,110026,12634,146082,75241,16992,2953,6458,11996
GCTGCTTCTGGCGGTT,sample,257672,253041,34318,218723,43637,175086,48675,2232,66229,7568,114904,50382,10413,2546,12975,26175
GCCTATTCTGGCGGTT,sample,53401,52129,7401,44728,10486,34242,9562,628,14324,1517,23886,8211,4824,1001,2883,6509
CGTCGAGGTGGCGGTT,sample,341391,335957,46305,289652,49308,240344,60094,3623,97124,9143,157218,70360,13205,2921,15292,31004
AAGTAGAGTGGCGGTT,sample,251577,246133,37112,209021,28970,180051,39622,1978,73058,7499,112680,57894,12883,2587,11130,18761
GACTAACCTGGCGGTT,sample,311916,302896,56916,245980,33820,212160,40046,2776,89587,9130,129633,70621,14656,2586,10927,20982
CGTAGAACTGGCGGTT,sample,196672,194366,18725,175641,35925,139716,53381,3302,46254,4511,99635,32268,9497,2137,9700,23821
CTGGTCTTTCCTTATT,sample,56170,54459,14316,40143,5106,35037,4336,185,15484,1536,19820,13496,6011,697,1266,2512
AGCTGAATTCCTTATT,sample,29395,28638,5391,23247,5375,17872,3743,307,7294,719,11037,5809,3645,728,1041,3075
GGAGAAGCTCCTTATT,sample,9306,8955,2093,6862,1597,5265,1316,118,2010,221,3326,1600,1571,300,528,879
TCATACCATCCTTATT,sample,55961,54274,12488,41786,5572,36214,6797,383,15143,1749,21940,12142,6185,814,2174,3447
TGATTCCGTCCTTATT,sample,47724,46323,11893,34430,5977,28453,5094,141,11606,1108,16700,10504,4725,657,1639,3055
TACGCGAGTCCTTATT,sample,23064,22652,2198,20454,7311,13143,6607,409,3854,516,10461,1757,1889,589,2580,4389
CCGTACGCTCCTTATT,sample,48056,47051,7347,39704,11099,28605,9618,471,10704,1268,20322,6544,3234,763,4029,6813
ATGGCGTTTCCTTATT,sample,50863,49438,15183,34255,3378,30877,3939,238,13889,1437,17828,11374,5859,742,892,1463
CCATTCTTTCCTTATT,sample,49910,49136,4392,44744,16336,28408,17498,1616,5504,1020,23002,2770,1988,912,6279,9854
CTAAGCATTCCTTATT,sample,100489,98142,19628,78514,10379,68135,11486,849,28953,3060,40439,23787,8404,1292,2458,6002
AAGGTCTGTCCTTATT,sample,81026,79631,13482,66149,9470,56679,15690,1076,21975,2818,37665,15120,5944,1188,3254,5979
TAACGAAGTCCTTATT,sample,126439,123595,24166,99429,10050,89379,13523,555,41561,4236,55084,29504,11116,1629,2823,5702
TGCGCTCCTCCTTATT,sample,62848,61675,12053,49622,6302,43320,9100,716,17356,1944,26456,14204,6360,1085,1973,3625
GGCGTACCTCCTTATT,sample,79373,77983,13335,64648,10244,54404,11798,690,21947,2125,33745,17844,6608,1073,3804,5794
CGTCGAGGTCCTTATT,Pos_Ctrl,62588,60623,8059,52564,2843,49721,41966,3541,2911,393,44877,910,5913,6794,2238,1670
TCTCCTAGTCCTTATT,sample,11178,11005,699,10306,4473,5833,3563,293,1270,178,4833,529,1007,608,1029,2282
ATGAATAGTCCTTATT,sample,138719,136827,18842,117985,18106,99879,20106,1292,40189,3949,60295,34343,10861,1857,3885,11655
AAGTAGAGTCCTTATT,sample,80891,79662,13317,66345,7693,58652,9527,808,24332,2626,33859,21359,7839,1126,2970,4228
TAACGCCATCCTTATT,sample,63536,62852,9360,53492,7309,46183,9509,565,18547,2032,28056,15530,6990,898,3695,4424
ATTCTACCTCCTTATT,sample,72266,71276,11922,59354,10356,48998,12857,393,19509,1958,32366,14281,6825,891,4942,6698
CGCGAGACTCCTTATT,sample,60129,59495,7273,52222,8318,43904,10106,598,16804,1960,26910,14436,6447,1048,2322,5334
GCGCAATATCCTTATT,sample,72792,71277,11306,59971,12076,47895,13688,528,18438,1758,32126,13483,4799,1006,3716,7653
GTCGTTCTAATAAGGT,sample,191457,187253,31067,156186,33353,122833,29625,1315,48405,5340,78030,38148,10234,1945,11878,19898
TATACGGAAATAAGGT,sample,192625,187987,30073,157914,32587,125327,24432,1275,53201,5228,77633,41191,9174,1789,7765,19914
GAGCCTCCAATAAGGT,sample,243570,236396,49615,186781,24752,162029,22606,1159,71602,7638,94208,59024,13198,2255,5376,14161
TCATCGAAAATAAGGT,sample,272814,268700,28022,240678,69971,170707,73573,4123,52208,6714,125781,34089,8745,2145,28270,45015
TACGCGAGAATAAGGT,sample,166486,163000,25343,137657,32936,104721,29492,1419,39602,3825,69094,30383,9104,1980,7515,19855
GACTCAAGAATAAGGT,sample,56360,55185,8578,46607,17241,29366,10488,569,9993,978,20481,7338,4048,797,4980,8762
CCGTACGCAATAAGGT,sample,170857,167541,26724,140817,29485,111332,29937,1970,43003,4789,72940,31633,9228,1927,8193,17646
TCTCAGGAAATAAGGT,sample,206422,202788,29769,173019,48152,124867,37942,2756,44942,5671,82884,33556,9439,1942,11382,28644
ATGGCGTTAATAAGGT,Pos_Ctrl,191120,184789,25457,159332,8524,150808,126589,10859,9341,1113,135930,2906,7835,10624,8489,5504
CCATTCTTAATAAGGT,sample,30391,29830,2855,26975,11255,15720,8648,650,3805,385,12453,2232,2509,1209,3218,5995
CATTCGGTAATAAGGT,sample,147609,143131,26544,116587,20431,96156,21202,1334,39818,4156,61020,29646,9703,1729,5992,11942
GAGATTCTAATAAGGT,sample,180681,177287,19324,157963,34910,123053,49448,3125,39193,3979,88641,27308,7176,2190,11106,22518
AAGGTCTGAATAAGGT,sample,125716,123447,14270,109177,30217,78960,33186,1667,27415,2183,60601,14509,5957,1506,8772,19021
CCTAGCGGAATAAGGT,Pos_Ctrl,104197,100444,13930,86514,4728,81786,68491,5915,5089,668,73580,1623,6831,8462,4130,2887
CTAACCGGAATAAGGT,sample,75276,73837,11203,62634,12793,49841,15715,1191,19048,1988,34763,11899,5695,1410,2677,7780
GGCGACGAAATAAGGT,sample,174707,169617,31595,138022,20586,117436,21147,1205,49769,5319,70916,39996,10699,1876,5661,12366
TAACGAAGAATAAGGT,sample,766178,750190,142157,608033,31358,576675,140553,9126,275632,34104,416185,117260,18749,4147,10903,16089
AGCAGAGCAATAAGGT,sample,245719,237969,46581,191388,22387,169001,28475,1586,71138,7537,99613,60265,13375,2464,5344,12539
TTATGACGAATAAGGT,sample,2632,2591,338,2253,624,1629,464,43,625,93,1089,404,682,205,122,355
TAACGCCAAATAAGGT,sample,164958,163465,13641,149824,50558,99266,53863,3922,24069,2796,77932,14616,4212,1142,21347,30137
CGCGAGACAATAAGGT,sample,179507,176587,25998,150589,24304,126285,29840,1751,51043,5376,80883,38275,9931,2094,7398,15937
AGATACTAAATAAGGT,sample,206112,203795,20530,183265,59695,123570,46735,3588,43186,4528,89921,25533,5274,1239,19817,36304
GTCGTTCTCAGGACCA,sample,74769,73760,6029,67731,30330,37401,18820,1331,10465,1054,29285,5731,4232,1610,6951,15046
AGAGTTCTCAGGACCA,sample,173785,169866,24431,145435,38751,106684,30685,1732,41290,4266,71975,28711,9133,1745,10430,22617
TATACGGACAGGACCA,sample,241190,236404,35163,201241,39144,162097,43844,2552,65210,8304,109054,42187,10973,2237,11578,25206
GAGCCTCCCAGGACCA,sample,317302,312244,33629,278615,75834,202781,59887,3348,76068,7682,135955,55796,8000,2145,22543,47085
CGTCGCCACAGGACCA,sample,179148,174819,26683,148136,29548,118588,32247,1948,45612,5216,77859,33565,8030,1947,7985,17740
TCATCGAACAGGACCA,sample,135003,132233,21927,110306,20695,89611,24059,1923,37343,3571,61402,22715,8399,2040,4529,12850
TGATTCCGCAGGACCA,sample,474889,462393,80586,381807,52060,329747,57695,3093,139848,14488,197543,114623,15539,3277,18183,31589
GCAACTAGCAGGACCA,sample,130202,128281,16716,111565,23324,88241,26106,1417,35378,4277,61484,21063,7564,1701,6534,14656
GACTCAAGCAGGACCA,sample,251817,247319,35076,212243,46088,166155,44445,2458,63344,6532,107789,49376,9215,1791,15770,29525
ATACGTTCCAGGACCA,sample,254893,252159,16764,235395,89106,146289,84630,5334,38507,4654,123137,13164,3382,1158,43318,51054
CCGCAGTCCAGGACCA,sample,256174,249496,43253,206243,45321,160922,32478,3071,67534,7520,100012,50319,10907,2010,7307,26262
CCGTACGCCAGGACCA,sample,182726,178578,28072,150506,31733,118773,36233,2245,41843,3963,78076,34489,8562,2196,7855,18279
GATGCGTTCAGGACCA,sample,130230,128230,16148,112082,22991,89091,39961,3780,26784,3271,66745,15295,6253,2151,6832,15332
ACGCTTAACAGGACCA,sample,706179,684568,160353,524215,50279,473936,64337,2969,207812,21239,272149,177579,22072,5141,11259,25924
TAGCGAGTCAGGACCA,sample,424219,414593,71461,343132,47933,295199,54368,2136,122220,14200,176588,102275,14507,2876,13314,27984
GAGATTCTCAGGACCA,sample,228557,222009,44039,177970,29086,148884,25079,1622,63371,6038,88450,52774,10579,1670,7027,16466
CTAAGCATCAGGACCA,sample,230181,224282,39183,185099,31671,153428,37673,2091,59938,6458,97611,47268,9519,1628,12400,18595
CTAACCGGCAGGACCA,sample,103311,102067,7785,94282,30466,63816,34355,3032,20191,1326,54546,4912,3246,1030,13271,19259
TAACGAAGCAGGACCA,sample,244359,237378,46869,190509,23414,167095,26733,1473,72505,7343,99238,59041,11889,1938,7915,13685
CAGCTTCGCAGGACCA,Neg_Ctrl,4216,2468,2053,415,75,340,77,3,204,8,281,48,108,24,33,36
CGCGGTCGCAGGACCA,sample,117818,114650,17330,97320,19235,78085,18245,2019,30815,3422,49060,23584,8503,1445,4387,11540
AGATACTACAGGACCA,sample,533029,519415,92618,426797,49730,377067,60057,2910,163597,17918,223654,132585,17150,3467,13570,30240
TCTAGGTTCCTCGTTG,sample,120333,117171,36531,80640,8845,71795,8484,405,31588,3101,40072,28217,8758,1034,2749,4795
AGCTGAATCCTCGTTG,sample,121907,118198,29587,88611,15893,72718,14556,838,29656,2845,44212,24823,8477,1416,3851,8878
GACGTATGCCTCGTTG,sample,251331,245893,45909,199984,45590,154394,30205,1891,63609,7323,93814,51366,11849,1960,10654,25212
GGAGAAGCCCTCGTTG,sample,89624,87712,16458,71254,20304,50950,10561,704,20580,2082,31141,17023,6501,974,4008,11122
CTAGCGACCCTCGTTG,sample,225832,220759,41679,179080,32412,146668,37687,1967,60935,5506,98622,40573,9510,1998,11400,19433
TCATCGAACCTCGTTG,sample,276889,270846,56610,214236,27966,186270,28930,1418,81436,8492,110366,65994,13023,2104,9747,16820
GCAACTAGCCTCGTTG,sample,30665,30133,5001,25132,6500,18632,4559,346,7035,886,11594,5806,4191,844,1482,3804
ATACGTTCCCTCGTTG,sample,220056,215484,44157,171327,32566,138761,22727,1491,59888,6126,82615,48529,10939,1834,5545,18066
CCGCAGTCCCTCGTTG,sample,31737,30944,5422,25522,10843,14679,4860,265,5156,500,10016,3898,2830,640,2038,4873
GATGCGTTCCTCGTTG,sample,124452,121854,24664,97190,19668,77522,18053,1121,31077,3582,49130,23689,8453,1742,4688,11783
TGCGCGTTCCTCGTTG,Neg_Ctrl,5408,2421,2001,420,98,322,96,7,114,9,210,96,137,26,40,24
ACGCTTAACCTCGTTG,sample,84017,82786,8034,74752,23065,51687,22229,1259,17239,1893,39468,9067,3973,890,9470,13996
CATTCGGTCCTCGTTG,sample,96620,94652,12989,81663,17017,64646,22360,1766,23601,2370,45961,14549,6463,1638,4744,10763
CTAACCGGCCTCGTTG,Neg_Ctrl,4866,2532,2119,413,90,323,80,2,155,8,235,78,159,26,30,22
GCTGCTTCCCTCGTTG,sample,150864,146749,42991,103758,7809,95949,12861,851,43033,4575,55894,34629,10909,1766,1598,3367
AGCAGAGCCCTCGTTG,sample,72001,70550,9208,61342,20860,40482,18262,685,12937,1453,31199,7145,3276,869,5311,12334
CGTCGAGGCCTCGTTG,sample,68067,66867,9264,57603,13584,44019,13328,916,16737,1654,30065,11384,5626,1035,4502,8949
TCTCCTAGCCTCGTTG,sample,88132,86257,14711,71546,13125,58421,15168,1120,22070,2502,37238,17561,6022,1118,5176,7214
AAGTAGAGCCTCGTTG,sample,174670,171121,34279,136842,17611,119231,23075,2114,50873,4874,73948,38295,9309,1794,5332,10540
TAACGCCACCTCGTTG,sample,77830,75501,23206,52295,5605,46690,3992,265,21282,2145,25274,19006,7193,762,422,2045
ATTCTACCCCTCGTTG,Pos_Ctrl,102968,101827,8529,93298,5131,88167,74461,7940,3895,494,78356,1377,6484,8902,3848,2962
AGATACTACCTCGTTG,sample,160733,158348,17680,140668,37054,103614,42402,3323,33626,3587,76028,20676,4939,1163,16029,24463
TCTAGGTTTTGCGGAC,sample,104352,103385,15305,88080,17935,70145,17001,931,28001,2837,45002,21375,9486,1749,5289,11033
GAGCCTCCTTGCGGAC,sample,292395,288240,34013,254227,52034,202193,48017,3526,78695,8796,126712,63159,12441,2683,10701,31906
GGTAGAGATTGCGGAC,sample,257166,251845,42073,209772,38212,171560,41977,2714,68754,7525,110731,50590,10928,2110,14160,23229
TCATCGAATTGCGGAC,sample,147119,145646,12593,133053,53488,79565,35610,2345,24811,2919,60421,13880,6065,1430,11928,28205
TCATACCATTGCGGAC,sample,118740,117432,10415,107017,42974,64043,30483,1579,19264,1962,49747,10755,4145,1099,11284,23196
TGATTCCGTTGCGGAC,sample,130904,128803,15120,113683,31329,82354,34968,1160,26427,2522,61395,17277,3679,1171,13676,19583
CCGTACGCTTGCGGAC,sample,70109,68552,11549,57003,16037,40966,10755,733,16272,1779,27027,11427,6245,1188,3165,9086
GGCAGGTTTTGCGGAC,sample,119903,116473,29566,86907,14424,72483,16151,1282,28728,3117,44879,23205,8749,1325,5817,7610
GATGCGTTTTGCGGAC,sample,45348,44238,7444,36794,11828,24966,9307,503,8228,900,17535,6028,3377,880,4158,6568
AGCGTCTTTTGCGGAC,sample,119921,117835,21356,96479,18673,77806,16427,992,31610,3417,48037,25360,9470,1580,4320,11141
CATTCGGTTTGCGGAC,sample,125739,122617,22300,100317,21507,78810,19885,1170,31352,3434,51237,22969,8632,1635,6253,13145
CTAAGCATTTGCGGAC,sample,38235,37557,5305,32252,12890,19362,6939,520,6762,798,13701,4343,3485,1002,1974,6397
AAGGTCTGTTGCGGAC,sample,72795,71406,11966,59440,14360,45080,13814,937,17424,1984,31238,10921,5646,1177,4679,8475
GGCGACGATTGCGGAC,sample,27865,27309,3049,24260,6767,17493,7917,421,5957,768,13874,2430,2472,971,2250,4235
TAACGAAGTTGCGGAC,sample,85719,83800,13876,69924,13549,56375,21302,1223,17688,1714,38990,14448,6544,1889,4289,8535
GCCTATTCTTGCGGAC,sample,72557,71658,5246,66412,29210,37202,23912,1609,8902,1121,32814,1658,1610,802,11179,15807
ATACCGCCTTGCGGAC,sample,63797,62683,6754,55929,19011,36918,17994,1257,10277,1254,28271,6136,3581,1264,6302,11020
TCTCCTAGTTGCGGAC,sample,168297,165202,20372,144830,24439,120391,29660,2065,50978,5525,80638,32163,8998,1742,8938,17011
TCTAGGTTTCCATTGG,sample,359022,352728,54629,298099,48330,249769,51516,1552,101033,10515,152549,85153,9596,2475,16582,31645
GTCGTTCTTCCATTGG,sample,201698,198599,15681,182918,59169,123749,55242,3483,38431,3841,93673,22752,4595,1399,19605,36926
TATACGGATCCATTGG,sample,307753,302180,47541,254639,35061,219578,54777,3144,85662,8589,140439,67406,13088,2642,8716,22638
CGTCGCCATCCATTGG,sample,87856,85035,18830,66205,9721,56484,11365,551,22600,2480,33965,19488,7460,1221,2965,5687
TCATACCATCCATTGG,sample,57160,55795,11354,44441,7585,36856,10387,642,14577,1611,24964,9639,5222,1097,3275,4614
TGGATCAATCCATTGG,sample,16574,15983,4317,11666,1419,10247,1755,94,4513,416,6268,3469,2706,402,397,669
TGCGCGTTTCCATTGG,sample,82277,80253,16759,63494,7328,56166,11266,649,22701,2393,33967,19157,8191,1313,2666,4285
AGCGTCTTTCCATTGG,sample,52598,51778,7987,43791,9044,34747,8912,915,13376,1468,22288,10076,4788,914,3259,5569
CTAAGCATTCCATTGG,sample,44209,43080,8710,34370,5538,28832,8130,528,11156,1069,19286,7949,3902,815,2761,3283
AAGGTCTGTCCATTGG,sample,26754,26097,4660,21437,5486,15951,5529,262,5692,589,11221,3879,3036,694,2347,3096
GGCGACGATCCATTGG,sample,81809,79588,18483,61105,7331,53774,8228,488,23672,2405,31900,18981,8461,1059,2073,3920
TAACGAAGTCCATTGG,sample,24917,24422,4603,19819,3713,16106,4483,310,6012,624,10495,4677,3863,917,825,2116
ATACCGCCTCCATTGG,sample,70382,68995,11135,57860,8413,49447,12203,565,20569,2208,32772,13902,6502,1203,3270,5345
GCGTTACCTCCATTGG,sample,56205,55188,10215,44973,7616,37357,8063,587,15011,1509,23074,12187,6649,1206,1681,4441
GTCGCGAATCCATTGG,sample,22624,22305,2727,19578,4432,15146,5219,516,4992,585,10211,3834,2951,714,1070,2771
CGTCGAGGTCCATTGG,sample,55814,54794,11120,43674,3968,39706,5362,362,17187,1746,22549,15049,6964,786,1245,2263
TTATGACGTCCATTGG,sample,53624,52363,10393,41970,5112,36858,6524,333,15566,1526,22090,12909,6769,907,1412,3155
ATGAATAGTCCATTGG,sample,30702,30085,4876,25209,6860,18349,7005,464,5775,621,12780,4484,2424,656,2652,4212
TCAATCAGTCCATTGG,sample,34841,33926,5800,28126,3803,24323,7042,530,8765,1009,15807,6977,4014,945,1190,2276
GACTAACCTCCATTGG,Neg_Ctrl,3000,1568,1130,438,51,387,55,7,258,14,313,53,98,20,19,19
CGTAGAACTCCATTGG,sample,105232,101111,26746,74365,6140,68225,8485,414,30229,3193,38714,25904,9167,1130,1957,2640
TCTAGGTTCATAGGCG,sample,100765,98881,21398,77483,15161,62322,19731,1638,21229,2217,40960,17507,7507,2596,2163,8344
GTCGTTCTCATAGGCG,sample,204063,197068,52786,144282,15873,128409,12113,618,58800,5962,70913,50916,11006,1614,1623,7884
GACGTATGCATAGGCG,sample,141584,138392,24856,113536,33351,80185,27627,1120,27800,2876,55427,20762,4458,1135,12329,18482
CATACTCCCATAGGCG,sample,80933,78272,18526,59746,13601,46145,8589,547,19253,2122,27842,15634,6249,941,2468,7290
CGTCGCCACATAGGCG,sample,71922,70815,4887,65928,29033,36895,22259,1561,9995,817,32254,2263,1845,792,9887,15455
TCATCGAACATAGGCG,sample,121016,117204,30286,86918,10917,76001,9842,593,34763,3476,44605,27327,9656,1327,1919,6019
TACGCGAGCATAGGCG,sample,150263,144577,40249,104328,12804,91524,12828,663,39798,4173,52626,34062,10378,1354,3247,6553
GGCAGGTTCATAGGCG,sample,133735,132811,8311,124500,51996,72504,42995,3012,16395,1593,59390,8509,3927,1594,16096,29197
ATGGCGTTCATAGGCG,sample,98978,96890,16263,80627,21235,59392,20298,1433,20613,1962,40911,15086,6644,1711,5041,12175
CGGTTGGTCATAGGCG,sample,66101,65266,5169,60097,22941,37156,21603,1099,9842,1436,31445,3176,1981,767,12215,13034
GCTCTTCTCATAGGCG,sample,219558,213998,43278,170720,23806,146914,24343,1204,63504,6902,87847,50961,11769,1994,6844,13281
CTAACCGGCATAGGCG,sample,40295,39563,6207,33356,7641,25715,10203,675,8042,853,18245,5942,4742,1544,2486,4461
GCTGCTTCCATAGGCG,sample,27188,26142,8719,17423,1844,15579,2265,142,6764,662,9029,5746,3829,596,403,912
GCCTATTCCATAGGCG,sample,94841,93028,13447,79581,20165,59416,20526,1260,22388,2712,42914,12530,6433,1468,6778,11835
AGCAGAGCCATAGGCG,sample,39906,39092,5447,33645,10264,23381,9929,401,7024,715,16953,5312,3467,903,4177,6093
GTCGCGAACATAGGCG,sample,80709,79043,11332,67711,10606,57105,19347,1370,21542,2004,40889,12842,5510,1232,3670,7183
ATATGCAACATAGGCG,sample,39864,39556,4475,35081,8888,26193,6923,595,10228,1245,17151,7202,5950,1269,1291,5613
CTGGTCTTTTGGAGAG,Pos_Ctrl,221323,210128,35048,175080,10348,164732,137066,11463,11585,1495,148651,3123,8067,11028,9530,6342
CTAGCGACTTGGAGAG,sample,37233,35777,12073,23704,1701,22003,1827,117,10036,971,11863,9052,5080,315,79,655
TGATTCCGTTGGAGAG,Pos_Ctrl,106007,101531,17114,84417,5186,79231,66293,5342,5368,631,71661,1597,6969,8246,4681,3391
ATACGTTCTTGGAGAG,sample,122869,118997,27614,91383,15698,75685,14731,824,30433,3234,45164,26463,9096,1528,4038,8393
CCGCAGTCTTGGAGAG,sample,93547,90785,17941,72844,14632,58212,15002,833,22464,2496,37466,17417,6654,1205,4774,8551
CCGTACGCTTGGAGAG,sample,64309,63055,7884,55171,14222,40949,14393,699,14675,1421,29068,9761,4943,1066,5642,9033
TCTCAGGATTGGAGAG,sample,64705,63340,10306,53034,12384,40650,10607,551,16574,1603,27181,11315,5411,909,3829,7617
GATGCGTTTTGGAGAG,sample,89758,87093,18479,68614,10523,58091,10865,585,24625,2688,35490,19328,8069,1309,2848,6151
AGCGTCTTTTGGAGAG,sample,49172,48069,10058,38011,4581,33430,6942,568,14549,1544,21491,9827,4822,1144,384,2447
TAGCGAGTTTGGAGAG,sample,148498,146820,16811,130009,24976,105033,34723,2877,37207,4090,71930,26136,8396,2191,8360,16175
TAACGAAGTTGGAGAG,sample,114410,111039,27292,83747,8648,75099,11490,779,32425,3087,43915,27318,9698,1755,1739,4445
ATACCGCCTTGGAGAG,sample,85597,84123,8747,75376,21680,53696,22880,1276,18058,1602,40938,9880,4521,1019,9817,13751
GGCGTACCTTGGAGAG,sample,130514,128086,17356,110730,23500,87230,30494,1451,31928,3649,62422,19708,5245,1203,11327,15902
AAGTAGAGTTGGAGAG,sample,63572,62281,8527,53754,15520,38234,15344,1191,12285,1230,27629,8184,4778,1481,3422,8862
TAACGCCATTGGAGAG,sample,91850,90110,11385,78725,16905,61820,28028,1752,17471,1897,45499,12672,5335,1562,9065,10997
CGCGAGACTTGGAGAG,sample,73365,71312,11937,59375,11025,48350,13493,971,17489,1847,30982,14550,6839,1405,3546,6681
GGAGAAGCTTCAAGCC,sample,117254,113594,26168,87426,11108,76318,11531,538,32456,3278,43987,28515,9242,1276,3384,6120
CATACTCCTTCAAGCC,sample,20363,19823,4576,15247,2681,12566,3159,193,5057,520,8216,3637,3049,672,815,1443
GGTAGAGATTCAAGCC,sample,140149,136060,28732,107328,15880,91448,15726,1084,40044,4451,55770,30143,10653,1704,4051,9053
TACGCGAGTTCAAGCC,sample,34304,33128,8011,25117,4224,20893,4952,332,8469,939,13421,6201,4103,785,1220,2490
ACGCTTAATTCAAGCC,sample,98002,96267,11289,84978,21862,63116,22935,1216,21733,2554,44668,14678,4090,1113,9029,14049
CTAAGCATTTCAAGCC,sample,89978,87286,17989,69297,11833,57464,16766,1191,21239,2357,38005,15911,6882,1504,4370,7361
CCTAGCGGTTCAAGCC,sample,70786,69416,12110,57306,10711,46595,9218,631,19235,2213,28453,15298,7452,1128,2353,6276
GGCGACGATTCAAGCC,sample,39130,38040,8881,29159,4942,24217,5050,265,9997,1154,15047,7751,4847,916,1257,2801
GTCGCGAATTCAAGCC,sample,83209,81419,12008,69411,14918,54493,15153,692,20698,2023,35851,15927,4964,1067,4411,10304
CGTCGAGGTTCAAGCC,Pos_Ctrl,103675,99395,14869,84526,4768,79758,67090,5685,4850,656,71940,1477,6614,8235,3518,2576
CGCGGTCGTTCAAGCC,sample,91481,87917,21200,66717,8452,58265,8809,714,24930,2631,33739,21181,8923,1221,1327,4649
ATGAATAGTTCAAGCC,sample,134218,130600,29426,101174,12870,88304,14336,933,37442,3718,51778,31875,9469,1298,4535,7320
CGCGAGACTTCAAGCC,sample,90259,88256,14138,74118,15286,58832,18894,1187,21878,2264,40772,14609,5703,1234,5949,9724
TTAACTGATTCAAGCC,sample,13667,13315,1915,11400,2774,8626,3640,132,2662,268,6302,1924,1536,456,1473,1682
ATATGCAATTCAAGCC,sample,121730,119044,22865,96179,11048,85131,12837,790,36374,4019,49211,31111,9496,1250,3231,6027
CTGGTCTTAACTTAAC,sample,114383,112570,15609,96961,24759,72202,21881,1272,26364,3002,48245,19683,7816,1424,8020,15667
GTCGTTCTAACTTAAC,Neg_Ctrl,2689,1307,782,525,125,400,110,7,152,17,262,114,193,43,42,28
GACGTATGAACTTAAC,sample,14354,14104,2572,11532,2167,9365,1879,143,3987,453,5866,2903,2482,437,608,1168
GAGCCTCCAACTTAAC,sample,116793,115700,13425,102275,24203,78072,18169,1078,31636,3870,49805,23319,7929,1651,6666,14982
GGTAGAGAAACTTAAC,sample,26387,26090,1304,24786,13428,11358,7407,583,2350,438,9757,580,1576,1076,2093,5841
CGTCGCCAAACTTAAC,sample,183743,180099,28324,151775,27596,124179,26018,1358,51314,5763,77332,39726,10479,2056,8260,16851
TGATTCCGAACTTAAC,sample,120942,118129,23750,94379,14499,79880,15326,1186,33858,3677,49184,25833,9282,1611,4156,8235
GCAACTAGAACTTAAC,Neg_Ctrl,3287,1143,874,269,45,224,44,1,98,7,142,74,86,18,21,8
TACGCGAGAACTTAAC,sample,111802,108549,25162,83387,11894,71493,11068,548,31119,3161,42187,25597,9270,1266,2757,6713
GACTCAAGAACTTAAC,sample,59378,58160,9686,48474,9271,39203,9435,764,15678,1727,25113,11599,5481,1041,2314,5437
CCGTACGCAACTTAAC,sample,85935,83992,15921,68071,13283,54788,11538,712,22203,2580,33741,17755,7038,1208,2842,7599
CATTCGGTAACTTAAC,sample,73800,72387,10470,61917,16637,45280,20284,1483,12859,1313,33143,9341,5355,1550,5256,10188
TAGCGAGTAACTTAAC,sample,201636,197257,33255,164002,22813,141189,26978,1391,59197,5099,86175,48524,10116,1951,6704,14048
GCTCTTCTAACTTAAC,sample,116355,113233,23772,89461,12824,76637,11751,1035,32573,3504,44324,27774,8987,1218,2858,7663
GAGATTCTAACTTAAC,sample,23636,23212,2428,20784,8103,12681,5295,320,4082,516,9377,2468,2094,585,2135,4244
ATACCGCCAACTTAAC,sample,150923,146955,29348,117607,13299,104308,16535,1020,44538,4589,61073,37626,10790,1471,4862,8428
GGCGTACCAACTTAAC,sample,72209,70676,8581,62095,13144,48951,18910,1450,15719,1630,34629,11242,3834,931,7363,8953
TCTCCTAGAACTTAAC,sample,57726,56259,9585,46674,8507,38167,10705,915,14540,1456,25245,10551,5173,1035,2967,4816
TCAATCAGAACTTAAC,sample,18091,17473,4675,12798,1814,10984,1756,117,4529,439,6285,4143,2482,372,628,878
CGCGAGACAACTTAAC,sample,70916,69338,10898,58440,12916,45524,13696,1014,16884,1504,30580,12426,5419,1060,4248,8007
AGATACTAAACTTAAC,sample,81384,79480,12804,66676,14557,52119,19792,1085,17760,1955,37552,11527,5652,1215,5054,9063
AACCGGTTATACTTGA,sample,189319,186827,18966,167861,55467,112394,47828,2026,37827,3882,85655,20831,5056,1291,23946,32650
GTCGTTCTATACTTGA,sample,186307,182125,42274,139851,16351,123500,15055,843,54899,6039,69954,46664,12221,1886,3715,8336
CATACTCCATACTTGA,sample,27282,26855,3191,23664,9005,14659,5203,348,4884,473,10087,3751,2818,776,1656,4742
ATTCAAGGATACTTGA,sample,128726,127026,14819,112207,36627,75580,29177,1625,26018,2738,55195,16022,6147,1481,6985,20429
GCAACTAGATACTTGA,sample,29251,28794,5298,23496,4686,18810,4156,407,7305,740,11461,6202,4548,1018,1049,2723
TACGCGAGATACTTGA,sample,51241,50888,4935,45953,12578,33375,9455,597,12831,1348,22286,9144,5513,1015,3537,7956
CCGTACGCATACTTGA,sample,137692,135162,21798,113364,23008,90356,22016,1723,36566,4086,58582,25965,8585,1605,7153,14502
CCATTCTTATACTTGA,sample,133748,131116,23128,107988,15994,91994,21785,1438,36273,3808,58058,28690,8178,1682,4465,9181
CCTAGCGGATACTTGA,sample,140853,138049,24354,113695,13321,100374,32047,2013,34254,3939,66301,28121,9615,2331,4060,8180
GGCGACGAATACTTGA,sample,54355,52858,12563,40295,7786,32509,7703,603,13208,1542,20911,9453,4774,1000,2139,4105
GCTGCTTCATACTTGA,sample,174028,169760,30876,138884,18003,120881,18875,2520,51568,4867,70443,43051,10575,1562,5158,11278
ATACCGCCATACTTGA,sample,39877,38909,7821,31088,7149,23939,5669,502,9464,909,15133,7395,4345,910,1290,4088
CAGCTTCGATACTTGA,Neg_Ctrl,4751,2233,1388,845,69,776,335,1,329,11,664,100,76,14,15,42
TTATGACGATACTTGA,sample,151900,150220,17955,132265,31495,100770,33689,2237,36130,3775,69819,24939,7450,1613,9155,18914
TCTCCTAGATACTTGA,sample,22392,21920,2313,19607,7052,12555,6055,349,3502,371,9557,2278,1832,515,2724,4081
TCAATCAGATACTTGA,sample,31730,31142,5518,25624,5724,19900,8251,614,6199,649,14450,4187,4018,1496,1470,3498
ATTCTACCATACTTGA,sample,47917,46929,6879,40050,11517,28533,10384,682,9257,932,19641,7278,3787,885,3926,6825
GACTAACCATACTTGA,sample,173471,169459,28548,140911,19144,121767,30713,1225,51030,5871,81743,32928,9308,1845,6690,12237
CTGGTCTTATCCGCGA,sample,178616,173771,49353,124418,13940,110478,18236,1214,49813,5077,68049,36138,10234,1803,3339,7059
GTCGTTCTATCCGCGA,sample,54403,52733,14898,37835,6264,31571,4022,256,14162,1417,18184,11714,5924,777,906,3011
GGAGAAGCATCCGCGA,sample,75928,73832,20728,53104,5518,47586,7297,454,20635,2086,27932,17114,6556,1119,1106,2579
TACGCGAGATCCGCGA,sample,166666,163364,20247,143117,43454,99663,37134,2015,35022,3835,72156,21657,5626,1438,14595,26111
GACTCAAGATCCGCGA,sample,137808,134902,26420,108482,20669,87813,21861,1488,34492,3716,56353,26256,8578,1645,6092,13022
CCGCAGTCATCCGCGA,sample,76358,74421,16752,57669,12800,44869,10594,696,17977,1892,28571,13710,6308,1017,2911,7102
TGGATCAAATCCGCGA,sample,165168,160878,39401,121477,16825,104652,16925,1041,45764,4885,62689,36037,10166,1577,4581,9261
ATGGCGTTATCCGCGA,sample,136331,133005,33628,99377,15359,84018,13115,733,36062,3635,49177,30473,9161,1415,2556,8670
TGCGCGTTATCCGCGA,sample,168243,164688,33118,131570,16081,115489,15821,737,50301,5286,66122,43344,11175,1642,4670,9701
ACGCTTAAATCCGCGA,sample,214482,208350,48760,159590,16069,143521,20465,940,61445,6321,81910,54350,11909,1757,4975,9429
CATTCGGTATCCGCGA,sample,113858,111588,19250,92338,19868,72470,23932,1438,26284,2703,50216,18113,7152,1661,6784,12660
GCTCTTCTATCCGCGA,sample,111853,109495,19919,89576,19911,69665,18151,1196,27475,2821,45626,20022,7924,1450,3838,12107
CTAAGCATATCCGCGA,sample,114166,111746,22339,89407,15897,73510,19055,1722,28627,3238,47682,20868,7194,1456,3336,9497
CCTAGCGGATCCGCGA,sample,71300,69661,14180,55481,8783,46698,9337,869,19447,1995,28784,15050,6484,1268,1231,4786
ATGAATAGATCCGCGA,sample,114369,113240,7552,105688,42515,63173,35255,3771,16119,3700,51374,4328,1994,781,14214,25067
TCAATCAGATCCGCGA,sample,129919,128171,15091,113080,23331,89749,36384,1989,28370,2794,64754,20212,7381,1834,6118,16648
CGCGAGACATCCGCGA,sample,175598,170496,31832,138664,22211,116453,25345,1303,45415,4196,70760,40194,9147,1568,7217,12576
AGATACTAATCCGCGA,sample,187961,183138,33366,149772,29186,120586,31557,2021,45865,4692,77422,36451,6775,1790,7536,18895
CATAATGGAGGACTCA,sample,126592,124875,14122,110753,34341,76412,28541,2129,25297,2590,53838,17855,7588,1633,11043,19974
GGAGAAGCAGGACTCA,sample,104362,101803,23673,78130,8450,69680,9050,656,30824,3117,39874,26033,8232,1384,1430,3874
GAGCCTCCAGGACTCA,sample,108457,107452,10941,96511,21831,74680,23683,1606,27922,2608,51605,18861,7648,1481,8865,14368
CTAGCGACAGGACTCA,sample,162621,159992,20634,139358,34050,105308,35999,2846,37284,4591,73283,24588,8343,1728,10902,20998
TCGAACGAAGGACTCA,sample,165873,163206,21221,141985,33691,108294,34487,1682,41186,3156,75673,27783,7302,1426,12018,21496
TCTCAGGAAGGACTCA,sample,142245,139295,25903,113392,16072,97320,20724,1117,41906,4415,62630,29158,8830,1656,4846,8885
GGCAGGTTAGGACTCA,sample,99832,98138,11736,86402,25339,61063,27086,1788,21025,2393,48111,8771,4111,1105,11471,15693
TGCGCGTTAGGACTCA,sample,155788,152772,19601,133171,28318,104853,26328,1100,41177,4307,67505,31941,7132,1279,10523,17856
CCATTCTTAGGACTCA,sample,179751,174333,37421,136912,18527,118385,21372,1255,50548,5326,71920,39884,10280,1601,6015,10583
ACGCTTAAAGGACTCA,sample,70560,68120,20220,47900,4857,43043,4936,338,18942,1972,23878,16855,7081,879,1039,2113
GAGATTCTAGGACTCA,sample,94286,92692,11955,80737,16284,64453,25873,2012,20717,2511,46590,13340,5891,1690,3669,10293
CTAAGCATAGGACTCA,sample,159580,156257,23869,132388,24225,108163,28346,1626,42185,4717,70531,31289,8289,1842,7729,15759
CTAACCGGAGGACTCA,sample,111891,110007,14461,95546,28214,67332,23396,1188,22492,2142,45888,18114,4686,1138,8752,16792
TGCGCTCCAGGACTCA,sample,38233,37053,9386,27667,3558,24109,3497,245,10374,1148,13871,8845,4628,687,788,1711
GTCGCGAAAGGACTCA,sample,156911,152870,30753,122117,21110,101007,18189,1899,41745,3894,59934,35280,8441,1349,4892,11666
CGCGAGACAGGACTCA,sample,87086,85909,5674,80235,30376,49859,31770,1860,11527,1801,43297,2901,1749,819,12421,18068
CCTAACTAAGGACTCA,Pos_Ctrl,164696,155798,21234,134564,6673,127891,106710,9360,8290,1105,115000,2426,7071,9613,5270,3568
ATATGCAAAGGACTCA,sample,224925,221548,32482,189066,33951,155115,32906,2352,63745,6547,96651,49565,11279,2120,6547,20211
TCTAGGTTTATTGAAC,sample,27753,27443,3108,24335,6585,17750,6759,457,6514,798,13273,3222,2814,817,2419,4100
AGCTGAATTATTGAAC,sample,235125,230677,43610,187067,33670,153397,31515,1439,64046,6458,95561,49939,11223,1877,11995,19711
TATACGGATATTGAAC,sample,63616,62684,9781,52903,10723,42180,15669,1045,14439,1640,30108,9387,5479,1607,3369,6601
CTAGCGACTATTGAAC,sample,117211,114587,26193,88394,11656,76738,12017,914,33929,3372,45946,26506,9021,1487,2568,6054
TCGAACGATATTGAAC,sample,203700,200736,28609,172127,34986,137141,29324,1586,58039,6226,87363,41966,9746,1998,8136,21544
TACGCGAGTATTGAAC,sample,132622,129772,17326,112446,26973,85473,29713,1901,31501,3339,61214,19019,7289,1692,9531,17222
GACTCAAGTATTGAAC,sample,91509,88753,23528,65225,8558,56667,8271,498,24531,2385,32802,20982,7678,1073,2206,4289
ATACGTTCTATTGAAC,sample,200351,196308,30569,165739,39037,126702,31105,2015,49388,6129,80493,38065,10764,1810,9528,23959
TCTCAGGATATTGAAC,sample,60439,58982,10818,48164,11960,36204,8797,475,14188,1369,22985,11375,5832,779,3079,6726
CGGTTGGTTATTGAAC,sample,23593,22911,5490,17421,3007,14414,2991,159,5901,600,8892,4763,3320,537,971,1526
CTAACCGGTATTGAAC,sample,21166,20551,3603,16948,4696,12252,3767,238,4632,456,8399,3159,2850,626,1382,2628
AGCAGAGCTATTGAAC,sample,30623,29472,7340,22132,2456,19676,2316,152,8799,988,11115,7421,4480,458,643,1284
GTCGCGAATATTGAAC,sample,202461,197785,32520,165265,21204,144061,45578,2297,52750,6031,98328,37405,9676,2268,10623,12446
TTATGACGTATTGAAC,sample,63594,61543,13029,48514,7412,41102,9486,616,16000,1751,25486,13249,6119,935,3452,4459
TCTCCTAGTATTGAAC,sample,13854,13397,2886,10511,1604,8907,1778,163,3793,432,5571,2741,2505,448,475,853
AAGTAGAGTATTGAAC,sample,292553,285411,46435,238976,18123,220853,28737,1702,97667,9374,126404,83373,15201,2711,6982,11086
ATTCTACCTATTGAAC,sample,49557,48028,9438,38590,7089,31501,8308,590,12126,1164,20434,9313,4866,971,2494,4136
AGATACTATATTGAAC,sample,37350,36240,7177,29063,5630,23433,6888,473,8766,864,15654,6442,4214,907,2064,3461
GCGCAATATATTGAAC,sample,55534,53611,12225,41386,5342,36044,6768,285,14846,1553,21614,12592,6157,773,2598,2915
TCTAGGTTGTTCAACT,sample,266665,259682,52721,206961,24241,182720,23394,1244,81608,8465,105002,68009,13570,2271,4658,13302
AGCTGAATGTTCAACT,sample,63671,63231,5300,57931,18807,39124,15971,1615,11886,1365,27857,8287,4513,1214,4570,11134
GACGTATGGTTCAACT,sample,133672,131550,19653,111897,19010,92887,19247,998,37524,3504,56771,31614,9758,1530,6669,12251
TGATTCCGGTTCAACT,sample,90813,89713,5183,84530,11147,73383,42374,4848,18192,2009,60566,5960,5046,2831,2171,8233
GATGCGTTGTTCAACT,sample,67581,66784,5665,61119,14266,46853,22631,2568,15329,1319,37960,5006,3003,1314,5867,10359
ATGGCGTTGTTCAACT,sample,353244,345452,62417,283035,26653,256382,43806,2296,111309,11384,155115,87587,16797,3419,7206,14306
TGCGCGTTGTTCAACT,sample,121491,119676,17001,102675,23698,78977,32466,2717,23922,2388,56388,17484,6640,1740,5427,15661
AGCGTCTTGTTCAACT,sample,58693,57233,10795,46438,8193,38245,6613,413,16420,1640,23033,13159,5984,762,2250,4639
ACGCTTAAGTTCAACT,sample,66790,65183,9338,55845,11396,44449,11991,632,16987,1594,28978,13245,6291,1233,4259,7014
CTAACCGGGTTCAACT,sample,50385,49121,8517,40604,8403,32201,8534,391,12396,1252,20930,9628,5230,893,3279,5251
GGCGACGAGTTCAACT,sample,25550,24807,4092,20715,5115,15600,5860,508,5184,459,11044,3589,3058,998,1962,3279
TAACGAAGGTTCAACT,sample,39735,38648,5362,33286,6826,26460,8795,656,9251,864,18046,6894,4104,1027,2695,4450
GCCTATTCGTTCAACT,sample,18089,17745,2533,15212,3635,11577,3818,189,4138,402,7956,3030,2504,598,1530,2389
AGCAGAGCGTTCAACT,sample,28049,27117,5368,21749,4239,17510,3781,212,6766,739,10547,6012,3500,525,1376,2624
CGCGGTCGGTTCAACT,sample,14082,13699,2387,11312,2749,8563,3339,207,2818,376,6157,1823,1688,449,1631,1835
GACTAACCGTTCAACT,sample,25013,24709,2569,22140,6349,15791,6489,434,4830,624,11319,3414,2923,782,2670,3849
CGTAGAACGTTCAACT,sample,38535,37476,6918,30558,6457,24101,7661,441,8814,845,16475,6340,4293,948,2485,3921
CCTAACTAGTTCAACT,sample,27007,26539,5101,21438,5898,15540,6153,302,5045,440,11198,3600,2653,721,2417,3395
GCGCAATAGTTCAACT,Neg_Ctrl,909,523,346,177,30,147,38,3,40,6,78,60,58,19,12,16
TTAACTGAGTTCAACT,sample,38292,37446,6509,30937,3768,27169,4771,305,11382,1138,16153,9573,4913,723,1559,2159
AACCGGTTCTGAGGTT,sample,689547,679352,84470,594882,97162,497720,96235,5174,201847,24750,298082,169714,18572,5004,32304,61070
GTCGTTCTCTGAGGTT,sample,1137123,1115827,175181,940646,66573,874073,230862,17351,395650,47630,626512,182580,21932,6096,23318,41431
TGATTCCGCTGAGGTT,sample,103309,102186,9298,92888,30308,62580,32372,2337,17831,2311,50203,7729,4359,1684,9650,18993
TACGCGAGCTGAGGTT,sample,195107,193490,12563,180927,70311,110616,71974,5551,20679,2489,92653,9923,4996,2239,21756,40031
TGGATCAACTGAGGTT,sample,445423,440473,46455,394018,41426,352592,93033,7074,149995,16527,243028,85963,15256,4188,16635,27008
TGCGCGTTCTGAGGTT,sample,479174,472963,57141,415822,59267,356555,105109,5442,146055,15698,251164,84251,10333,3525,28347,41503
TAGCGAGTCTGAGGTT,sample,101403,98467,19446,79021,9125,69896,12221,609,29390,3230,41611,24446,8774,1254,4293,5207
CTAAGCATCTGAGGTT,sample,151436,147990,20957,127033,27582,99451,28683,2313,37998,3630,66681,26827,7778,1837,10334,18169
CTAACCGGCTGAGGTT,sample,122663,120540,13488,107052,30653,76399,28121,1247,25395,2290,53516,19346,4786,1160,13760,19076
GGCGACGACTGAGGTT,sample,165113,161186,28129,133057,21742,111315,22234,1231,45743,4521,67977,37586,10394,1581,9360,12979
GCGTTACCCTGAGGTT,sample,32821,31672,9110,22562,2642,19920,2605,181,8764,929,11369,7441,4978,631,382,1370
AAGTAGAGCTGAGGTT,sample,56656,55331,9084,46247,10192,36055,11985,793,12993,1537,24978,8747,5383,1441,3177,6309
TCAATCAGCTGAGGTT,sample,38975,38163,6259,31904,5164,26740,12101,1138,7497,790,19598,5214,4353,1865,1443,3224
GACTAACCCTGAGGTT,sample,64161,62958,8172,54786,13232,41554,15342,774,14466,1898,29808,9074,4609,1130,6537,8348
GCGCAATACTGAGGTT,sample,28633,28032,4078,23954,4904,19050,7180,503,6539,793,13719,4035,2944,959,2054,3088
ATATGCAACTGAGGTT,sample,182817,178564,33979,144585,15264,129321,19264,983,56105,6285,75369,46684,12953,1958,5779,8302
GACGTATGAGACCGTT,sample,347952,344257,32265,311992,85193,226799,81936,5899,79197,7414,161133,52353,10835,2482,29714,53320
CATAATGGAGACCGTT,sample,393247,389342,29189,360153,89519,270634,132118,12108,75131,8287,207249,42990,9239,2754,25981,60838
GAGCCTCCAGACCGTT,sample,505350,499762,47256,452506,76348,376158,173189,10335,105978,14219,279167,72437,12514,3335,29355,55107
TCGAACGAAGACCGTT,sample,113854,112038,14270,97768,19196,78572,27796,1668,28259,3272,56055,17577,6529,1722,6279,11887
TCATCGAAAGACCGTT,sample,213943,211376,20706,190670,42741,147929,75335,8033,38134,4919,113469,21508,7976,2716,16047,29304
TCATACCAAGACCGTT,sample,337692,330990,54896,276094,45798,230296,57949,4571,87237,9404,145186,71135,14541,3360,12201,30422
GGCAGGTTAGACCGTT,sample,197047,193387,28473,164914,35969,128945,39025,3444,51062,6207,90087,29207,8251,1989,10049,23584
CATTCGGTAGACCGTT,sample,135389,132623,17238,115385,29729,85656,31743,1722,28878,3236,60621,20077,7014,1398,12680,19306
CTAACCGGAGACCGTT,sample,77667,76002,15801,60201,7044,53157,8880,452,22598,2329,31478,18898,8439,1232,2709,4066
TAACGAAGAGACCGTT,sample,83664,81654,14667,66987,9254,57733,12532,771,23932,2505,36464,17993,6234,1316,3750,5322
AGCAGAGCAGACCGTT,sample,70638,69282,9256,60026,16252,43774,18875,1486,12451,1332,31326,9630,4663,1667,5601,10518
ATACCGCCAGACCGTT,sample,210899,205804,33130,172674,24851,147823,28932,1644,64989,6346,93921,45912,10805,2021,9229,17132
GGCGTACCAGACCGTT,sample,141196,138499,18330,120169,33428,86741,36625,2257,27963,3109,64588,16787,6357,1696,12190,21771
CGCGGTCGAGACCGTT,sample,264468,259038,34758,224280,36662,187618,54320,3052,69723,7534,124043,52989,13253,2645,12511,22814
TCTCCTAGAGACCGTT,sample,73784,72371,7851,64520,20522,43998,22635,1591,12182,1318,34817,6272,3363,1193,8848,12728
TAACGCCAAGACCGTT,sample,41598,40433,9947,30486,7065,23421,3870,243,10006,1035,13876,8267,5050,702,1153,3803
GCGCAATAAGACCGTT,sample,50992,50202,5193,45009,15850,29159,18511,881,6552,1013,25063,2202,1555,721,8995,10342
TTAACTGAAGACCGTT,sample,40454,39485,7367,32118,7048,25070,7151,478,8912,1107,16063,7422,4040,783,2992,4108
AGAGTTCTCTTGAGTT,sample,285583,283946,11057,272889,102673,170216,137753,13527,13713,1731,151466,3492,3127,2834,30472,61158
GGTAGAGACTTGAGTT,sample,571939,562605,80536,482069,84204,397865,86540,5965,160397,15761,246937,129202,15009,3581,19394,54427
CGTCGCCACTTGAGTT,sample,217079,214807,18736,196071,57937,138134,73652,5359,35383,3962,109035,19778,6708,2349,12731,36688
TACGCGAGCTTGAGTT,sample,878133,864687,112138,752549,103694,648855,139580,11829,258876,29804,398456,208766,20857,6551,38961,66572
ATGGCGTTCTTGAGTT,sample,99626,97393,17052,80341,17712,62629,16948,1147,23894,2597,40842,18043,6077,1255,6597,10371
TGCGCGTTCTTGAGTT,sample,50560,49427,11122,38305,9238,29067,3431,191,12619,1372,16050,11454,4855,627,815,4455
AGCGTCTTCTTGAGTT,sample,216963,213302,30300,183002,31506,151496,37546,2440,60203,6221,97749,45086,10205,1884,12809,19997
CATTCGGTCTTGAGTT,sample,236237,231172,36839,194333,27469,166864,37628,3034,68779,7060,106407,50363,12543,2640,10197,17587
CTAAGCATCTTGAGTT,sample,243922,238812,31811,207001,44124,162877,37840,2091,66350,6905,104190,49691,10665,2206,13271,28861
AGCAGAGCCTTGAGTT,sample,375094,363950,78440,285510,24858,260652,36356,2383,116964,12081,153320,92868,17365,3296,6251,11703
GGCGTACCCTTGAGTT,sample,76820,75082,12526,62556,12716,49840,16000,924,18128,1903,34128,12885,6255,1265,5053,8034
AAGTAGAGCTTGAGTT,sample,28984,28291,4220,24071,5274,18797,7033,375,6828,889,13861,3672,3027,982,1854,3407
GACTAACCCTTGAGTT,sample,93559,91510,11317,80193,25357,54836,22286,1530,18078,1942,40364,11000,3411,1108,9827,15929
AACCGGTTTCGGAGTT,sample,128766,125908,24492,101416,14762,86654,24424,1868,33704,4059,58128,22599,8680,1691,7183,8847
AGCTGAATTCGGAGTT,sample,552622,541499,87482,454017,53610,400407,92605,6824,156733,17822,249338,126423,16430,3879,19634,32873
GACGTATGTCGGAGTT,sample,121765,119002,20455,98547,16527,82020,16358,1038,33069,3538,49427,28017,8849,1517,3420,9670
TATACGGATCGGAGTT,sample,190656,187504,20281,167223,27339,139884,44565,3508,49193,4641,93758,37977,9722,2236,8879,19331
CTAGCGACTCGGAGTT,sample,111802,109638,10643,98995,26870,72125,29621,2931,23149,3058,52770,13366,6159,1487,9538,17014
ATACGTTCTCGGAGTT,sample,110749,108444,17933,90511,20937,69574,20790,1382,25910,2700,46700,18792,7223,1454,7322,12453
TCTCAGGATCGGAGTT,sample,74418,73273,6482,66791,20433,46358,22363,1216,13115,1379,35478,8285,3107,892,10796,12970
GGCAGGTTTCGGAGTT,sample,111624,109191,16925,92266,13564,78702,15736,1030,32926,3500,48662,25510,8752,1305,5630,8846
CCATTCTTTCGGAGTT,sample,50020,48994,5206,43788,9353,34435,15279,803,11558,1337,26837,5458,3872,1129,4373,6580
CATTCGGTTCGGAGTT,sample,48146,47367,7522,39845,7377,32468,7288,295,12825,1237,20113,10823,5627,897,2872,4701
TAGCGAGTTCGGAGTT,sample,37040,36393,4745,31648,6678,24970,8611,581,9115,916,17726,5747,3548,840,3504,4601
TGCGCTCCTCGGAGTT,sample,156415,153288,22941,130347,20007,110340,23444,1794,45020,4535,68464,35547,9792,1666,5324,12479
ATACCGCCTCGGAGTT,sample,176757,173503,23781,149722,19263,130459,29740,2152,51784,6027,81524,40756,11153,1723,10951,13345
GTCGCGAATCGGAGTT,sample,123021,119658,21129,98529,7201,91328,12271,746,39752,4168,52023,34391,11263,1582,2767,3424
CGTCGAGGTCGGAGTT,Pos_Ctrl,93575,89799,9588,80211,2967,77244,64696,5771,4764,561,69460,1452,6618,8433,3011,1313
TCTCCTAGTCGGAGTT,sample,44473,42991,8551,34440,4615,29825,6931,526,11490,1224,18421,9654,5682,1072,1361,2967
ATGAATAGTCGGAGTT,sample,44141,42838,9669,33169,5079,28090,5515,427,11487,1116,17002,9545,5338,706,2053,3011
AAGTAGAGTCGGAGTT,sample,43843,42240,10427,31813,2828,28985,3552,205,12939,1326,16491,10963,6309,602,984,1492
TCAATCAGTCGGAGTT,sample,44961,43580,8588,34992,3872,31120,4488,235,13875,1399,18363,11123,6008,720,1480,2290
TAACGCCATCGGAGTT,sample,46672,45267,9320,35947,4360,31587,6474,356,12962,1381,19436,10414,5908,854,1953,2583
CCTAACTATCGGAGTT,sample,49773,48263,10087,38176,5418,32758,8824,448,12480,1547,21304,9459,5316,803,3597,3469
CTGGTCTTTGAACCTT,Pos_Ctrl,259937,248963,32622,216341,10247,206094,172951,15562,12212,1442,185163,3927,8228,12057,10968,5379
GTCGTTCTTGAACCTT,sample,295372,287945,63885,224060,25707,198353,38002,3201,83553,8604,121555,64993,13686,3165,4789,13567
AGAGTTCTTGAACCTT,sample,246894,242709,27552,215157,45544,169613,48814,3018,64456,6603,113270,46722,9747,2352,15907,30682
CTAGCGACTGAACCTT,sample,136868,133772,23773,109999,24177,85822,18701,1091,35111,4420,53812,26499,8667,1575,5728,14426
GGTAGAGATGAACCTT,Pos_Ctrl,250128,238907,32030,206877,10478,196399,165171,13920,11841,1524,177012,3943,8139,12025,9943,5577
TACGCGAGTGAACCTT,sample,180916,176067,33370,142697,20028,122669,27790,2038,52101,5299,79891,35441,9153,1791,6000,11604
ATGGCGTTTGAACCTT,Pos_Ctrl,189626,186477,18059,168418,8155,160263,135991,12748,7880,1037,143871,2607,7684,11264,9514,4054
TGCGCGTTTGAACCTT,sample,197542,195587,18968,176619,50266,126353,52001,2879,42785,4922,94786,23766,5732,1497,21361,31878
AGCGTCTTTGAACCTT,sample,51019,50243,7830,42413,6570,35843,10188,796,14353,1450,24541,9056,5055,1256,2897,4222
TAGCGAGTTGAACCTT,sample,405693,401207,46159,355048,50417,304631,61805,5198,124022,13293,185827,100313,12588,2823,15678,31681
GAGATTCTTGAACCTT,sample,627410,619458,71087,548371,62017,486354,100874,8506,201764,21342,302638,153868,17855,5437,21318,38227
CCTAGCGGTGAACCTT,Pos_Ctrl,108779,105970,12169,93801,4798,89003,75454,6378,4936,714,80390,1521,6956,8968,5214,2429
TAACGAAGTGAACCTT,sample,46426,45481,6722,38759,9324,29435,8790,598,10304,1196,19094,8547,4271,745,3934,5586
CGCGGTCGTGAACCTT,sample,273173,265844,46149,219695,18251,201444,28338,1443,84870,8726,113208,78067,14053,2377,7510,10092
TTATGACGTGAACCTT,sample,396702,387546,58548,328998,28499,300499,51011,2720,125486,12368,176497,108914,16389,3592,7609,16587
ATTCTACCTGAACCTT,Pos_Ctrl,85609,82728,10268,72460,3540,68920,57913,4938,4259,598,62172,1212,6518,7853,4244,1950
AGATACTATGAACCTT,sample,83786,81489,15155,66334,11391,54943,12268,739,21743,2491,34011,17702,5900,1089,4056,6851
CCTAACTATGAACCTT,sample,124213,118699,30687,88012,8354,79658,9655,491,34853,3602,44508,31057,10921,1297,2237,4174
AACCGGTTACCGAATT,sample,226704,223455,28122,195333,50978,144355,53765,4177,48559,5961,102324,31893,9839,2686,16747,32248
CTGGTCTTACCGAATT,sample,335412,329189,50518,278671,61871,216800,62169,4480,82844,8500,145013,58807,11151,2625,16287,38590
GTCGTTCTACCGAATT,sample,265557,262244,23560,238684,74922,163762,76010,3767,50807,4941,126817,28237,7030,1858,31138,45689
CATAATGGACCGAATT,sample,327259,320232,46954,273278,39353,233925,49291,2467,94875,9466,144166,77826,13580,2643,12491,25404
TATACGGAACCGAATT,sample,1064102,1045808,176011,869797,54757,815040,180067,10442,386240,45868,566307,192423,22509,6019,13757,31134
TCGAACGAACCGAATT,sample,78956,77185,14797,62388,15063,47325,12507,1132,17418,1829,29925,14439,6086,1252,3008,8674
TCATACCAACCGAATT,sample,167751,164482,22336,142146,35820,106326,34204,2963,39193,4072,73397,25894,7918,1707,11299,22041
GACTCAAGACCGAATT,sample,255727,252648,23399,229249,54112,175137,67017,3773,61224,7685,128241,35438,8872,1946,23954,35185
TCTCAGGAACCGAATT,sample,223277,220741,17711,203030,54120,148910,56773,3887,54025,4916,110798,29309,7027,1922,19642,36244
ATGGCGTTACCGAATT,sample,290050,285409,41333,244076,54430,189646,56252,3726,67985,6845,124237,54838,10829,2249,18446,33244
AAGGTCTGACCGAATT,sample,624430,615597,87194,528403,56199,472204,88106,4307,199231,20501,287337,160059,16751,4132,26314,34659
GGCGACGAACCGAATT,sample,190490,187638,19946,167692,32774,134918,52602,5587,50884,4939,103486,20906,6562,1639,12314,22450
TAACGAAGACCGAATT,sample,494674,486705,79106,407599,43837,363762,59913,4763,152992,14229,212905,131865,15590,3508,13406,24954
GCTGCTTCACCGAATT,sample,248413,244204,29145,215059,44912,170147,62461,6011,57855,6106,120316,37714,9216,1930,12554,26985
AGCAGAGCACCGAATT,sample,230020,224182,43944,180238,21939,158299,28347,1565,64861,6803,93208,56723,12423,2220,10203,12347
GGCGTACCACCGAATT,sample,89664,87491,15023,72468,13636,58832,16733,1096,22239,2585,38972,16179,6476,1252,5741,8589
CAGCTTCGACCGAATT,Neg_Ctrl,7327,3962,3630,332,100,232,71,1,88,7,159,65,118,27,20,17
AGATACTAACCGAATT,sample,96394,94537,13335,81202,23335,57867,22233,1639,19718,1907,41951,12370,4127,1119,9027,15265
ATATGCAAACCGAATT,sample,130408,128431,20684,107747,14618,93129,16831,1223,39462,3776,56293,31837,9730,1563,5515,8931
GAGCCTCCGGTCTGGT,sample,154942,152692,18658,134034,30191,103843,31742,1932,37985,4205,69727,27979,8379,1437,13258,19750
CGTCGCCAGGTCTGGT,Neg_Ctrl,5675,2618,2083,535,145,390,109,5,131,15,240,130,163,35,45,30
TACGCGAGGGTCTGGT,sample,291057,288072,19375,268697,104399,164298,87523,5543,43274,4656,130797,23302,5209,1920,35434,57816
TGCGCGTTGGTCTGGT,Neg_Ctrl,3655,1792,1436,356,114,242,76,11,91,11,167,53,113,33,21,23
CGGTTGGTGGTCTGGT,sample,122598,120236,14369,105867,25033,80834,26609,1630,29050,2938,55659,20607,8092,1442,10804,15794
GAGATTCTGGTCTGGT,sample,187692,184811,17433,167378,48378,119000,50698,3029,36508,5766,87206,22999,5913,1521,15260,30475
CTAACCGGGGTCTGGT,Neg_Ctrl,4981,2303,1996,307,81,226,74,2,93,10,167,47,98,17,29,17
TAACGAAGGGTCTGGT,sample,721393,709594,97394,612200,45236,566964,89051,5972,252512,27904,341563,191525,22350,6192,19156,25286
ATGAATAGGGTCTGGT,sample,78290,76525,9215,67310,20066,47244,18603,1044,15958,1813,34561,9826,4176,907,9511,12864
TAACGCCAGGTCTGGT,sample,24188,23539,3461,20078,7057,13021,4688,347,4868,561,9556,2557,2572,693,1778,3742
GACTAACCGGTCTGGT,Neg_Ctrl,3748,2485,1881,604,72,532,272,5,146,13,418,96,122,30,20,83
CGTAGAACGGTCTGGT,sample,89203,86229,13664,72565,12202,60363,14761,917,23543,2437,38304,18705,7291,1228,5274,7466
ATATGCAAGGTCTGGT,sample,60644,59928,6880,53048,17051,35997,15513,1293,10341,1076,25854,7774,4818,1486,5673,9974
AACCGGTTCGACGTTA,sample,247240,243059,32493,210566,60220,150346,59642,4333,45821,4698,105463,35852,9230,2381,16817,34188
AGCTGAATCGACGTTA,sample,1181159,1151988,182166,969822,130633,839189,151040,7824,346371,37317,497411,296637,22485,6931,38061,80058
CATAATGGCGACGTTA,sample,347321,340006,48387,291619,44340,247279,55924,4347,96147,10267,152071,80594,12603,2790,17366,29055
GGAGAAGCCGACGTTA,sample,101848,100309,7376,92933,39302,53631,38094,2333,10283,975,48377,1946,2141,1361,16621,21935
CATACTCCCGACGTTA,sample,120477,118255,12147,106108,46133,59975,27712,2652,17209,1891,44921,10511,5426,1760,8551,23024
GGTAGAGACGACGTTA,sample,625428,612636,72557,540079,100895,439184,108874,8209,167626,17002,276500,137473,16936,4220,34548,70049
ATTCAAGGCGACGTTA,sample,196617,193337,25162,168175,45907,122268,32018,2701,47880,4872,79898,34797,10099,2296,9622,28635
GCAACTAGCGACGTTA,sample,193142,190689,30987,159702,40841,118861,50448,2193,41626,4449,92074,20145,6937,1652,18377,33958
TACGCGAGCGACGTTA,sample,481906,475306,58907,416399,94713,321686,109248,5539,119011,12629,228259,75259,9747,2871,42805,60219
TGGATCAACGACGTTA,sample,270065,266151,25009,241142,66799,174343,80384,4497,53741,6700,134125,29021,5422,1666,38149,43149
TGCGCGTTCGACGTTA,sample,104237,102745,13476,89269,34415,54854,21262,1514,17882,1929,39144,12267,5859,1428,6215,18398
TAGCGAGTCGACGTTA,sample,422334,416750,45732,371018,78500,292518,87004,6529,106622,11476,193626,80887,12456,3238,16544,49464
GAGATTCTCGACGTTA,sample,347866,342994,38681,304313,46468,257845,93627,7273,90776,12452,184403,53717,9454,2280,22577,30786
CCTAGCGGCGACGTTA,sample,208548,206421,14773,191648,67349,124299,76378,6430,27518,3032,103896,10941,4700,1472,24840,41130
GGCGACGACGACGTTA,sample,378001,373044,30976,342068,92881,249187,109129,6120,77253,7223,186382,49462,7294,2247,34064,61324
GGCGTACCCGACGTTA,sample,344739,340242,46955,293287,60475,232812,80237,6458,79794,8685,160031,57638,9771,2683,23812,39415
CGTCGAGGCGACGTTA,sample,325575,321836,40697,281139,40622,240517,59979,3142,95628,9984,155607,71784,12611,2654,19772,25302
CGCGGTCGCGACGTTA,sample,53645,52720,9734,42986,5570,37416,9299,757,15450,1550,24749,10360,5761,1193,1952,3344
TTATGACGCGACGTTA,sample,41283,40838,4815,36023,8675,27348,10479,868,9328,1065,19807,5608,3807,1181,3520,5477
TAACGCCACGACGTTA,sample,111375,110361,10631,99730,30423,69307,31914,2520,22333,2472,54247,10068,4039,1172,15196,18366
ATTCTACCCGACGTTA,sample,190801,189070,18674,170396,50432,119964,52215,3785,39304,4583,91519,20077,6000,1487,13896,30962
GACTAACCCGACGTTA,sample,141411,139779,14956,124823,30533,94290,35928,2927,33727,4099,69655,17609,7434,1770,11533,20347
GTCGTTCTTACTAAGT,sample,75554,73655,16767,56888,8026,48862,6391,407,21976,2160,28367,17928,6587,946,768,4099
CTAGCGACTACTAAGT,sample,105733,103818,14504,89314,19646,69668,22036,1819,23375,2537,45411,19901,8104,2188,4621,12017
TCATCGAATACTAAGT,sample,118262,116017,13542,102475,24166,78309,28757,2334,26431,3076,55188,17711,7097,1695,5454,15990
TACGCGAGTACTAAGT,sample,59102,57014,13817,43197,5534,37663,7426,494,16388,1683,23814,11672,6135,1234,1090,2956
ATACGTTCTACTAAGT,sample,271062,262719,82567,180152,15395,164757,19744,1438,75183,8068,94927,60324,15439,2299,1967,7199
CCGCAGTCTACTAAGT,sample,127330,124949,15527,109422,20835,88587,30133,1583,31336,3343,61469,22192,6221,1368,8185,13589
TCTCAGGATACTAAGT,sample,149444,147042,21256,125786,25391,100395,35570,3059,33757,3890,69327,24119,8334,1571,9097,15651
AGCGTCTTTACTAAGT,sample,38959,37761,8858,28903,3585,25318,3525,211,11124,1123,14649,9335,5254,513,1225,2007
CGGTTGGTTACTAAGT,sample,8494,8244,1201,7043,1934,5109,2198,149,1546,192,3744,1024,1282,489,818,1207
ACGCTTAATACTAAGT,sample,15741,15224,3676,11548,1490,10058,1943,116,4212,475,6155,3312,2578,396,607,793
CATTCGGTTACTAAGT,sample,6741,6531,684,5847,3160,2687,1518,110,631,53,2149,375,774,393,664,1340
TAGCGAGTTACTAAGT,sample,23372,22792,2886,19906,5807,14099,6666,358,4120,391,10786,2564,1876,547,3470,3699
GCTCTTCTTACTAAGT,sample,43723,42455,8253,34202,5226,28976,6018,322,11691,1092,17709,9853,4963,681,2655,3056
GAGATTCTTACTAAGT,sample,34709,33674,6207,27467,5509,21958,6445,309,7932,788,14377,6484,3039,685,2740,3697
CTAAGCATTACTAAGT,sample,34771,33781,6715,27066,4948,22118,6100,222,8627,882,14727,6287,3978,655,2803,3291
AGCAGAGCTACTAAGT,sample,13614,13144,2887,10257,2277,7980,2130,93,3033,273,5163,2451,1963,298,1126,1315
TGCGCTCCTACTAAGT,sample,11468,11185,1505,9680,2962,6718,3087,173,2207,235,5294,1016,1455,529,1054,1876
TTATGACGTACTAAGT,sample,39540,38569,7961,30608,3170,27438,6548,338,11832,1328,18380,7392,4223,854,1933,1898
TAACGCCATACTAAGT,sample,40520,39528,6944,32584,5529,27055,6962,407,10514,1225,17476,7947,4398,719,2656,3676
GACTAACCTACTAAGT,sample,32723,31877,5976,25901,6200,19701,6599,464,6950,688,13549,5000,3432,799,2618,3672
CGCGAGACTACTAAGT,sample,15184,14720,2529,12191,2826,9365,2840,216,3691,439,6531,2179,2244,513,855,1724
GCGCAATATACTAAGT,sample,42338,41161,8489,32672,3137,29535,4568,250,12637,1285,17205,10795,5947,714,1001,1710
ATATGCAATACTAAGT,sample,64368,63463,9324,54139,11299,42840,14379,858,15056,1626,29435,10921,5310,1236,4859,7599
AACCGGTTTTGCCGCT,sample,738216,731983,69478,662505,116711,545794,130812,9264,216875,21789,347687,167054,17304,5172,30578,78867
CTGGTCTTTTGCCGCT,sample,402523,398556,30413,368143,101014,267129,111574,7971,86830,9082,198404,51672,10746,3096,33703,65500
GTCGTTCTTTGCCGCT,sample,708320,700748,72001,628747,119734,509013,140361,8012,187185,21165,327546,152290,15633,5301,50779,81289
AGAGTTCTTTGCCGCT,sample,239779,236561,22450,214111,73130,140981,59080,4075,44565,5000,103645,28261,7530,2385,13298,42068
GAGCCTCCTTGCCGCT,sample,75915,73671,14616,59055,9704,49351,4184,248,23041,2562,27225,19316,7063,773,526,5621
CTAGCGACTTGCCGCT,sample,582857,572596,72629,499967,83986,415981,153007,10257,129931,12318,282938,110468,13902,3646,29804,56032
GGTAGAGATTGCCGCT,sample,944589,927934,122873,805061,118190,686871,153737,7736,269453,27058,423190,228887,18573,6063,51048,82012
TCATACCATTGCCGCT,sample,651667,640618,89621,550997,77290,473707,99978,6718,191613,20540,291591,154858,16364,4181,27895,49597
GCAACTAGTTGCCGCT,sample,328353,324815,35179,289636,50113,239523,69704,3990,88867,8802,158571,68160,13482,3444,19268,33533
CCGTACGCTTGCCGCT,sample,257015,252281,32451,219830,52562,167268,53523,1846,59040,6556,112563,46303,10221,1841,17772,33620
GATGCGTTTTGCCGCT,sample,319257,316039,22459,293580,103287,190293,116543,10553,46457,3912,163000,12828,5062,1773,34988,63044
TGCGCGTTTTGCCGCT,sample,284419,280759,28466,252293,66923,185370,86417,6274,51340,6089,137757,35250,10317,3133,15006,41411
CGGTTGGTTTGCCGCT,sample,36561,35894,6530,29364,6170,23194,5994,346,8630,830,14624,7394,4349,856,2307,3655
CTAAGCATTTGCCGCT,sample,59821,58272,7283,50989,15780,35209,16201,713,11300,1191,27501,5804,4045,1051,7465,9647
CCTAGCGGTTGCCGCT,sample,43411,42156,9708,32448,3511,28937,5070,334,12596,1324,17666,9613,5824,987,1277,2083
TAACGAAGTTGCCGCT,sample,36643,35789,5197,30592,8651,21941,8954,590,6886,784,15840,4727,3835,1022,3770,5426
TAACGCCATTGCCGCT,sample,268463,259862,67990,191872,19269,172603,21135,1096,77728,8154,98863,64490,15757,2139,4497,10252
ATTCTACCTTGCCGCT,sample,63858,61459,13095,48364,6910,41454,9012,550,17086,1781,26098,13025,5852,1085,2972,3494
GCGCAATATTGCCGCT,sample,56370,54145,12385,41760,6121,35639,7088,403,14939,1611,22027,11598,5614,949,1708,3399
AACCGGTTTTCGACCT,sample,684558,673899,100779,573120,85000,488120,122973,7000,188059,21409,311032,148679,16380,4283,27073,52375
CTGGTCTTTTCGACCT,sample,576367,562699,105711,456988,53273,403715,76813,5558,171805,17267,248618,132272,16730,4078,15011,32135
GTCGTTCTTTCGACCT,sample,728125,716346,102111,614235,83150,531085,125022,9642,210078,22149,335100,164194,19705,5797,21108,54595
GGAGAAGCTTCGACCT,sample,494195,481980,109605,372375,32425,339950,44138,2843,149736,15329,193874,127904,18629,4437,5293,17065
CTAGCGACTTCGACCT,sample,769852,761665,85542,676123,117772,558351,123051,8030,211961,22269,335012,193040,16862,4932,39651,71636
TGATTCCGTTCGACCT,sample,743970,724013,148878,575135,48393,526742,66167,3419,232510,24386,298677,200260,21328,5672,12106,24440
ATACGTTCTTCGACCT,sample,606924,594730,102687,492043,73674,418369,85624,6251,173473,18739,259097,134282,17241,4113,22408,43468
ATGGCGTTTTCGACCT,sample,229003,224367,35637,188730,39365,149365,45535,3011,53786,6225,99321,40808,10313,2319,12018,24914
GAGATTCTTTCGACCT,sample,100999,98244,17248,80996,20780,60216,23029,1521,19591,2178,42620,13897,5279,1299,9092,12735
AAGGTCTGTTCGACCT,sample,8341,8048,1393,6655,1273,5382,1637,85,2086,204,3723,1370,1561,423,463,816
TAACGAAGTTCGACCT,sample,21008,20509,3778,16731,3281,13450,3864,229,4993,627,8857,3737,2758,737,1080,1737
TGCGCTCCTTCGACCT,sample,296782,288706,69412,219294,21085,198209,39480,2069,88202,10532,127682,57926,15075,2669,5781,12189
CGCGGTCGTTCGACCT,sample,153047,149139,26829,122310,16001,106309,21487,1306,43332,4464,64819,35720,10326,1675,6021,9535
TCAATCAGTTCGACCT,sample,36414,35617,6426,29191,5701,23490,5387,372,9246,965,14633,7520,4535,752,1996,3445
TTAACTGATTCGACCT,sample,90058,87896,14894,73002,10637,62365,14230,795,23891,2398,38121,21051,6930,1139,5757,6710
GTCGTTCTTCCAGACT,sample,253649,249688,34496,215192,33108,182084,34478,1299,73142,8391,107620,64774,11520,2114,12298,21230
GACGTATGTCCAGACT,sample,138208,135128,18258,116870,22090,94780,28811,1398,34603,3869,63414,26099,8892,1679,10295,14946
TATACGGATCCAGACT,sample,317592,307705,78081,229624,15102,214522,25020,1312,97839,10335,122859,80016,16401,2886,2636,6714
CATACTCCTCCAGACT,sample,57500,56519,5599,50920,10505,40415,18594,1810,12479,1520,31073,6012,4643,1718,3196,7509
GGTAGAGATCCAGACT,sample,217920,214517,26990,187527,47866,139661,53976,3258,46869,5813,100845,29745,7694,2032,17670,33155
CCGCAGTCTCCAGACT,sample,64126,62945,6323,56622,20766,35856,18670,633,10502,855,29172,5196,2340,804,8223,12015
CCGTACGCTCCAGACT,sample,86147,84373,10332,74041,17593,56448,22025,993,19352,1911,41377,12167,6508,1109,8247,11910
TCTCAGGATCCAGACT,sample,163021,159570,29115,130455,15638,114817,20757,1113,49177,5016,69934,38754,10539,1808,5913,9598
GGCAGGTTTCCAGACT,sample,85935,84045,13551,70494,15079,55415,16850,1008,21320,1934,38170,14303,6022,1175,6616,9354
ACGCTTAATCCAGACT,sample,70991,69000,13390,55610,7193,48417,7977,445,20338,2107,28315,17550,6718,893,2783,4502
TAACGAAGTCCAGACT,sample,55090,53664,10628,43036,5609,37427,6320,297,15903,1416,22223,13491,6282,947,1922,3308
TGCGCTCCTCCAGACT,Pos_Ctrl,37621,36163,5233,30930,1584,29346,24597,1989,1882,251,26479,627,5131,5006,1719,824
ATACCGCCTCCAGACT,sample,52169,50481,10791,39690,5257,34433,7318,291,14228,1454,21546,11142,5311,800,2481,3432
CGTCGAGGTCCAGACT,Pos_Ctrl,68782,65712,8387,57325,2368,54957,46575,3877,3096,381,49671,1028,6080,7258,2355,1088
TTATGACGTCCAGACT,sample,25873,24983,7248,17735,1313,16422,1711,91,7460,740,9171,6420,4235,381,344,576
TCTCCTAGTCCAGACT,sample,27694,26703,5620,21083,3173,17910,3491,206,7666,813,11157,5734,4051,642,862,2065
AGATACTATCCAGACT,sample,9666,9356,2113,7243,1130,6113,1431,145,2415,254,3846,1868,1670,389,313,638
GCGCAATATCCAGACT,sample,38180,36711,9230,27481,2495,24986,3334,166,10780,1105,14114,9601,5173,490,1046,1344
ATATGCAATCCAGACT,sample,11288,10933,2634,8299,954,7345,987,79,3274,403,4261,2602,2160,293,130,433
CTGGTCTTACCATTAT,sample,541362,532102,74615,457487,68444,389043,75931,4127,164163,17461,240094,127361,16233,3904,25582,43884
GACGTATGACCATTAT,sample,402702,397505,34208,363297,117423,245874,109005,7075,76377,7510,185382,45907,6188,1974,39571,71573
TATACGGAACCATTAT,sample,329050,324166,36054,288112,41569,246543,81055,6256,94248,13590,175303,51394,9406,2286,18088,28845
CATACTCCACCATTAT,sample,372525,366327,46233,320094,67599,252495,80319,4991,96196,9665,176515,61324,12644,2645,22591,46307
CTAGCGACACCATTAT,sample,392605,386814,38415,348399,73788,274611,116751,8923,88143,11177,204894,49617,10155,2634,21482,49594
TCATCGAAACCATTAT,sample,599137,587999,92055,495944,73721,422223,96353,6268,176048,16323,272401,127231,15005,3454,26927,46613
CGGTTGGTACCATTAT,sample,192520,190091,24840,165251,30384,134867,38953,2411,51921,6069,90874,35513,9177,2043,15787,20216
GCTGCTTCACCATTAT,sample,197667,195613,14521,181092,50731,130361,89261,9283,20872,1988,110133,8957,4957,2401,16813,33828
GCCTATTCACCATTAT,sample,1769895,1740035,241655,1498380,87606,1410774,299089,14588,674312,68526,973401,354259,27118,10172,27174,48530
AGCAGAGCACCATTAT,sample,203618,199207,32544,166663,24122,142541,37016,3416,54172,5655,91188,42282,9363,1635,9357,14938
TCTCCTAGACCATTAT,sample,131482,127929,21558,106371,21794,84577,21290,1204,33088,3196,54378,25799,7569,1512,6278,14005
TCAATCAGACCATTAT,sample,74837,73688,5863,67825,28609,39216,26590,1231,8359,728,34949,2308,1688,871,13267,15258
AGATACTAACCATTAT,sample,28783,27792,6075,21717,4543,17174,4435,310,6587,737,11022,5105,2899,595,1693,2273
TATACGGACAATGGAT,sample,347986,343332,53935,289397,34244,255153,54629,3370,111514,11198,166143,74442,14956,3277,14112,22096
GGAGAAGCCAATGGAT,sample,344749,339871,43863,296008,43852,252156,60933,3426,100064,10086,160997,77647,13708,2735,20220,29804
GAGCCTCCCAATGGAT,sample,277179,272453,37840,234613,35155,199458,51020,2651,84428,7799,135448,53560,10918,2270,16780,22638
TCGAACGACAATGGAT,sample,104713,102969,14005,88964,20260,68704,23826,2076,25915,2970,49741,13917,6331,1540,5591,12737
GCAACTAGCAATGGAT,sample,110000,108760,13643,95117,19121,75996,28568,2348,27388,3015,55956,14677,7846,2389,4731,12782
CCGCAGTCCAATGGAT,sample,212798,206687,44410,162277,19452,142825,22291,1169,63759,7399,86050,48207,12218,2042,5788,11326
TCTCAGGACAATGGAT,sample,191208,187929,23090,164839,45647,119192,50480,3409,36669,4009,87149,24625,6964,1921,20557,28355
CTAACCGGCAATGGAT,sample,106812,104654,15358,89296,19303,69993,22065,1328,25762,3065,47827,17773,7143,1308,7544,11772
GGCGACGACAATGGAT,sample,205104,200627,32611,168016,31614,136402,36328,1860,48752,5059,85080,44403,9878,1978,11302,19410
TAACGAAGCAATGGAT,sample,35292,34765,4753,30012,8617,21395,8604,547,6618,703,15222,4923,3787,1119,2858,5273
GCCTATTCCAATGGAT,sample,129705,126743,23164,103579,11506,92073,16304,1087,38476,4324,54780,31882,10273,2109,3390,6086
ATACCGCCCAATGGAT,Neg_Ctrl,5871,2761,2215,546,125,421,116,8,177,13,293,107,235,50,38,32
CAGCTTCGCAATGGAT,Neg_Ctrl,4691,2261,2079,182,55,127,39,2,50,5,89,31,72,20,12,18
TTATGACGCAATGGAT,sample,166297,163615,20260,143355,29864,113491,43106,2796,38321,4197,81427,25071,7750,1422,15798,19849
AAGTAGAGCAATGGAT,sample,76644,74458,14683,59775,8960,50815,13728,889,18962,1955,32690,15281,7301,1685,2642,5142
CCTAACTACAATGGAT,Pos_Ctrl,135526,129128,16098,113030,5431,107599,90829,7924,6329,739,97158,1778,7165,9508,6707,2765
AACCGGTTAGATTCAT,sample,207136,205491,21553,183938,35982,147956,51215,3669,54997,5166,106212,32909,8191,1932,17263,22282
TATACGGAAGATTCAT,sample,662615,655808,66942,588866,98397,490469,141343,8452,179924,17946,321267,142804,14784,5289,54375,69793
ATTCAAGGAGATTCAT,sample,253664,249525,35197,214328,43189,171139,49614,3074,63140,6969,112754,48342,10834,2285,14430,27758
TACGCGAGAGATTCAT,sample,109664,106958,18631,88327,18991,69336,15451,1154,27207,2793,42658,22731,6805,1081,5153,10497
CCGTACGCAGATTCAT,sample,62648,61168,14524,46644,5812,40832,5721,487,18346,1933,24067,14345,6916,1301,455,2911
TCTCAGGAAGATTCAT,sample,89740,87604,17451,70153,10321,59832,12696,737,24000,2458,36696,19941,7568,1218,4525,6096
GATGCGTTAGATTCAT,sample,184878,181458,33388,148070,19977,128093,29731,1224,51017,5172,80748,40949,9968,1599,11037,14436
CATTCGGTAGATTCAT,sample,175090,172969,15331,157638,51198,106440,70002,5674,21499,4303,91501,4962,1914,849,25554,33965
GCTCTTCTAGATTCAT,sample,269340,265681,36072,229609,30687,198922,68659,4843,73355,7408,142014,44657,8252,1878,15235,18638
TAACGAAGAGATTCAT,sample,673479,663736,100286,563450,50987,512463,74139,3116,223010,25575,297149,186623,21814,6005,13225,30081
TGCGCTCCAGATTCAT,sample,32211,31484,4531,26953,5961,20992,7928,558,7574,844,15502,4088,3590,1129,1791,3952
GGCGTACCAGATTCAT,sample,58142,56955,10007,46948,10171,36777,10563,554,14056,1471,24619,10133,5368,933,3937,6244
AAGTAGAGAGATTCAT,sample,27997,27473,4128,23345,6692,16653,6087,322,5383,492,11470,4369,2588,580,2842,3836
GACTAACCAGATTCAT,sample,36735,36029,5684,30345,8730,21615,7937,473,7373,835,15310,4997,3927,1086,2640,5068
CGCGAGACAGATTCAT,sample,84104,82675,11235,71440,15828,55612,23137,1687,16628,1762,39765,12398,5608,1434,5256,9898
AGATACTAAGATTCAT,sample,44381,43136,7840,35296,5157,30139,9413,633,11997,1277,21410,6819,4475,1192,2062,3453
GCGCAATAAGATTCAT,sample,60930,59223,13740,45483,7177,38306,6921,367,16121,1677,23042,13220,6535,980,2150,4060
GTCGTTCTCAATCTTG,sample,71220,70373,4936,65437,26952,38485,19696,1770,10476,1511,30172,5032,3868,1630,4912,14478
AGAGTTCTCAATCTTG,sample,442856,437726,47122,390604,85744,304860,104400,8188,109524,11490,213924,71258,12182,2676,37706,56673
TCATCGAACAATCTTG,sample,354817,350376,35274,315102,82363,232739,102631,7084,74226,7278,176857,41520,8453,2259,39754,52878
TCATACCACAATCTTG,sample,134245,129939,36552,93387,9741,83646,10836,606,36243,3678,47079,32283,8213,1308,2331,4508
TGATTCCGCAATCTTG,sample,329157,323656,45362,278294,67710,210584,67809,4017,79497,8211,147306,51050,10761,2142,20226,44138
TCTCAGGACAATCTTG,sample,216692,211795,40863,170932,22861,148071,31064,2371,61184,6698,92248,46754,12828,2663,5756,13770
GATGCGTTCAATCTTG,sample,521440,512429,79740,432689,54602,378087,85270,4404,154692,16037,239962,117684,16710,3879,25517,34292
AGCGTCTTCAATCTTG,sample,72410,71104,11247,59857,14861,44996,13163,956,16432,1630,29595,12815,5519,1268,4480,9030
GAGATTCTCAATCTTG,sample,132127,129917,15272,114645,20585,94060,35070,3116,33872,3474,68942,18528,6621,1592,10342,13563
CCTAGCGGCAATCTTG,sample,203143,200426,20162,180264,46821,133443,50501,2912,44891,4790,95392,30349,8428,1829,15011,31105
CTAACCGGCAATCTTG,sample,314336,310600,31299,279301,74783,204518,86793,6571,61139,8261,147932,41754,7409,1981,26917,50270
GCCTATTCCAATCTTG,sample,405197,398924,51997,346927,62084,284843,97938,9634,105598,11049,203536,60624,13228,3334,21632,43694
TCTCCTAGCAATCTTG,sample,94683,92065,14714,77351,19343,58008,15616,902,21311,2107,36927,18072,5461,1160,5789,11827
ATGAATAGCAATCTTG,sample,132793,129193,26115,103078,14040,89038,14956,920,37274,3941,52230,31947,8526,1345,4381,8031
GACTAACCCAATCTTG,sample,417190,406510,85087,321423,20573,300850,68895,4706,147043,15983,215938,64223,15452,3106,5293,11793
CGTAGAACCAATCTTG,sample,104023,100379,24496,75883,9509,66374,9175,478,28709,2840,37884,25172,8699,1055,2627,4486
CCTAACTACAATCTTG,sample,16558,16050,3661,12389,2298,10091,2338,171,4021,342,6359,3219,2724,588,748,1234
GCGCAATACAATCTTG,Neg_Ctrl,2850,1547,1165,382,96,286,74,4,127,15,201,66,133,34,22,38
GTCGTTCTCGTTCCGA,sample,305646,301912,30836,271076,98991,172085,92027,6468,46253,7009,138280,20328,5428,1893,27345,56839
AGAGTTCTCGTTCCGA,sample,435103,426046,85273,340773,52434,288339,55137,4035,122198,12394,177335,94575,14358,2783,17223,29554
GACGTATGCGTTCCGA,sample,343742,335997,61169,274828,51128,223700,51509,1934,90105,10089,141614,70063,12638,2424,19074,30803
TATACGGACGTTCCGA,sample,435299,427081,72253,354828,64208,290620,90050,6018,103065,10536,193115,80951,13725,3398,16162,41268
GGAGAAGCCGTTCCGA,sample,120833,118764,15601,103163,16904,86259,31467,2106,32862,4530,64329,15294,5668,1667,5825,11860
GAGCCTCCCGTTCCGA,sample,282950,276846,58311,218535,23716,194819,37693,2347,81869,8650,119562,64260,11779,2575,6424,12526
TCGAACGACGTTCCGA,sample,470611,461076,86708,374368,49162,325206,61146,4347,133602,15199,194748,110912,15224,3382,11121,29333
GGTAGAGACGTTCCGA,sample,50718,49232,13441,35791,4266,31525,4807,284,14098,1346,18905,10990,5173,736,1256,2058
ATACGTTCCGTTCCGA,sample,274087,268800,48173,220627,36198,184429,45906,3673,74321,7987,120227,52542,10142,2109,13270,21393
CCGCAGTCCGTTCCGA,sample,662976,647199,142829,504370,45380,458990,71477,3712,208149,22592,279626,153060,20760,4948,13077,22720
GGCAGGTTCGTTCCGA,sample,280444,274905,56388,218517,26374,192143,38022,2517,85201,9149,123223,57254,11067,2278,7623,15794
ATGGCGTTCGTTCCGA,sample,327914,321362,59669,261693,43167,218526,44345,2741,87938,9321,132283,74181,12409,2604,12241,26616
CCATTCTTCGTTCCGA,sample,175428,172042,27706,144336,25703,118633,31996,2431,45752,4924,77748,33530,10673,2458,7539,16395
AGCGTCTTCGTTCCGA,sample,148956,147016,18476,128540,36218,92322,32576,2243,31304,3163,63880,23036,8202,1816,12362,21714
CATTCGGTCGTTCCGA,sample,228107,225621,17364,208257,68602,139655,74958,5343,37384,4055,112342,17915,6336,1682,17852,42971
GCTGCTTCCGTTCCGA,sample,268744,265035,34280,230755,37750,193005,48582,2578,77173,8708,125755,55964,12775,2581,10832,24492
TGCGCTCCCGTTCCGA,sample,563750,556399,72502,483897,81564,402333,156995,10627,124127,12511,281122,98073,11720,3595,28254,57131
ATACCGCCCGTTCCGA,sample,131011,129426,13364,116062,32267,83795,37145,2645,27550,2840,64695,13615,5452,1523,11868,20001
ATGAATAGCGTTCCGA,sample,30658,30382,3185,27197,8573,18624,7247,515,6272,708,13519,3882,3335,736,3084,5095
AACCGGTTCAATTCGG,sample,44732,44097,6497,37600,8421,29179,7192,517,12621,1243,19813,7606,4252,827,2602,5237
CTGGTCTTCAATTCGG,Pos_Ctrl,319809,310690,32005,278685,11767,266918,226165,20572,13908,1833,240073,4440,8388,13469,13962,4991
GAGCCTCCCAATTCGG,sample,415295,410881,42771,368110,54315,313795,72967,5305,125919,13479,198886,96125,14293,3229,27227,35615
CATACTCCCAATTCGG,Pos_Ctrl,355928,342585,35761,306824,12588,294236,248793,21533,16690,2211,265483,5009,8274,13607,13583,5943
ATTCAAGGCAATTCGG,sample,410515,407518,25128,382390,138483,243907,174319,6086,45327,5801,219646,12374,3163,1208,84620,81708
GCAACTAGCAATTCGG,sample,357277,353655,37093,316562,46198,270364,75626,4764,102844,10453,178470,76677,15448,4343,19233,31064
GACTCAAGCAATTCGG,Pos_Ctrl,382818,373899,32406,341493,14078,327415,278138,24973,16594,2234,294732,5476,8470,14472,16288,6744
GGCAGGTTCAATTCGG,sample,348517,341963,60039,281924,33761,248163,35229,2958,107801,11364,143030,90811,14355,2836,8788,19927
GATGCGTTCAATTCGG,sample,853457,844436,96647,747789,96640,651149,170750,12231,257407,28358,428157,182403,16531,5761,51121,66807
ATGGCGTTCAATTCGG,Pos_Ctrl,767852,747418,70214,677204,26748,650456,547350,49564,37025,5334,584375,11183,8795,16216,24563,10017
AGCGTCTTCAATTCGG,sample,21214,20753,5114,15639,4359,11280,3317,159,3763,429,7080,3612,2598,541,1844,1908
GAGATTCTCAATTCGG,Pos_Ctrl,172551,166331,20020,146311,7387,138924,116865,10170,8458,1017,125323,2414,7835,10658,9333,3889
GGCGACGACAATTCGG,sample,43506,42405,6862,35543,8833,26710,10405,840,8360,933,18765,6172,4700,1289,3703,5144
GCCTATTCCAATTCGG,sample,42779,41295,12185,29110,4771,24339,4142,316,10279,1180,14421,8422,5372,921,961,2307
AGCAGAGCCAATTCGG,Pos_Ctrl,196265,189321,21949,167372,7708,159664,135120,11360,9122,1227,144242,2835,7943,11335,10101,4310
CGTCGAGGCAATTCGG,Pos_Ctrl,148209,142892,17410,125482,6099,119383,100904,8289,7133,935,108037,2122,7477,9960,7504,3127
CAGCTTCGCAATTCGG,sample,68780,66829,13102,53727,7848,45879,10379,851,18696,1964,29075,13989,6222,1353,1777,4583
TCTCCTAGCAATTCGG,sample,21032,20656,2678,17978,8208,9770,4910,500,2740,285,7650,1335,1766,812,1797,4137
AAGTAGAGCAATTCGG,sample,177564,173164,31795,141369,16639,124730,28460,1932,51756,5058,80216,37524,10640,2369,4923,9467
TAACGCCACAATTCGG,sample,73081,70222,15643,54579,9076,45503,9332,458,18515,1848,27847,15350,6124,904,3228,4768
CCTAACTACAATTCGG,sample,56181,53351,10157,43194,9918,33276,7751,500,13527,1600,21278,9898,4806,792,2855,6002
GCGCAATACAATTCGG,sample,302485,293744,66846,226898,21112,205786,27700,1015,90783,9463,118483,76825,16914,2764,7285,10824
TTAACTGACAATTCGG,sample,48469,47382,9769,37613,6565,31048,7128,343,12349,1296,19477,9932,5404,821,2881,3691
TCTAGGTTAACTCCGG,sample,124173,122186,16021,106165,48298,57867,12705,1152,23930,2520,36635,17560,7249,1415,3498,21821
TCGAACGAAACTCCGG,sample,201828,195490,38831,156659,24958,131701,31503,1831,54420,5933,85923,38014,10470,1955,6775,15106
ATTCAAGGAACTCCGG,sample,265322,261785,27558,234227,65632,168595,67445,4504,56627,6355,124072,33664,9218,2356,17043,42536
TGATTCCGAACTCCGG,sample,193154,189281,33770,155511,19782,135729,27602,1866,55050,6033,82652,45178,12448,3197,3602,10709
TACGCGAGAACTCCGG,sample,227891,223370,31601,191769,36401,155368,46785,3207,58647,7021,105432,39708,8974,2020,12480,21829
GATGCGTTAACTCCGG,sample,340165,335985,33198,302787,45049,257738,132302,12843,62334,5865,194636,44394,9875,3059,9627,27835
AGCGTCTTAACTCCGG,sample,32842,32232,2575,29657,12544,17113,10868,762,4204,304,15072,975,1276,663,5836,6913
CTAAGCATAACTCCGG,sample,52643,51492,8115,43377,8278,35099,12453,921,12912,1349,25365,7464,5511,1626,2770,5591
CTAACCGGAACTCCGG,sample,3521,3476,585,2891,624,2267,488,20,928,100,1416,731,857,132,139,361
CGTCGAGGAACTCCGG,sample,53130,51639,10462,41177,5881,35296,8869,781,13653,1435,22522,10558,6009,1310,2010,3508
TCTCCTAGAACTCCGG,sample,49997,48979,6582,42397,13591,28806,12384,574,9598,842,21982,5408,3272,915,4616,7921
AAGTAGAGAACTCCGG,sample,210976,204596,52896,151700,15498,136202,17906,889,59581,6472,77487,51354,14639,2103,3363,8240
CGTAGAACAACTCCGG,sample,86298,84040,13857,70183,15707,54476,13643,896,21328,2412,34971,16197,7715,1161,5808,9511
GTCGTTCTCCTGAAGG,Neg_Ctrl,8280,4191,3195,996,191,805,224,14,335,29,559,203,410,73,69,41
AGAGTTCTCCTGAAGG,sample,140777,138492,15057,123435,24311,99124,40084,2378,34473,3507,74557,18682,5571,2001,10331,16355
AGCTGAATCCTGAAGG,sample,323253,316348,51129,265219,49163,216056,54911,3493,81167,8196,136078,68289,13488,3062,13668,29945
GACGTATGCCTGAAGG,sample,703640,691067,103530,587537,81887,505650,82595,4479,216999,19335,299594,182242,17738,5196,29861,53194
CATAATGGCCTGAAGG,sample,287065,282352,36138,246214,68242,177972,66390,3406,56844,5950,123234,45382,7177,1988,21811,42161
GGAGAAGCCCTGAAGG,sample,266093,259781,48024,211757,24438,187319,46953,3170,75322,7970,122275,53904,12899,3066,5646,16109
CTAGCGACCCTGAAGG,Neg_Ctrl,7703,3929,3199,730,166,564,148,6,247,17,395,146,249,38,57,30
ATACGTTCCCTGAAGG,Neg_Ctrl,8007,4425,3698,727,181,546,124,12,228,24,352,158,270,47,45,49
CCGCAGTCCCTGAAGG,sample,190570,186867,24082,162785,27586,135199,44869,2975,52133,5851,97002,29371,7546,1760,7723,18022
GATGCGTTCCTGAAGG,sample,313119,309462,38705,270757,73166,197591,82166,6082,58965,6927,141131,43451,8984,2383,24082,48251
TGCGCGTTCCTGAAGG,Neg_Ctrl,6933,3661,2878,783,134,649,202,3,286,14,488,144,221,43,111,31
ACGCTTAACCTGAAGG,sample,172972,168651,31685,136966,27729,109237,28793,2483,41938,4461,70731,31562,9428,1893,8660,16844
CATTCGGTCCTGAAGG,sample,128410,126515,14837,111678,31424,80254,30952,1443,28518,3808,59470,15533,6409,1280,13515,20215
GAGATTCTCCTGAAGG,sample,110674,107873,16800,91073,26847,64226,22889,1348,21231,2657,44120,16101,4292,1285,10014,16807
CTAAGCATCCTGAAGG,Neg_Ctrl,4914,3204,2500,704,160,544,149,7,171,15,320,202,243,62,46,113
AAGGTCTGCCTGAAGG,sample,75752,73454,17636,55818,5901,49917,9509,571,21388,2074,30897,16375,7308,1406,1539,3194
CTAACCGGCCTGAAGG,sample,42441,41256,7207,34049,5216,28833,8479,575,11448,1271,19927,7060,4392,965,2291,3367
GGCGACGACCTGAAGG,sample,115567,113256,17433,95823,27107,68716,24499,1028,24581,2340,49080,16268,5893,1229,10759,16175
GCCTATTCCCTGAAGG,sample,153798,149790,28064,121726,26076,95650,26952,1594,36296,3518,63248,27290,5974,1544,9502,16250
AGCAGAGCCCTGAAGG,sample,128408,125303,24310,100993,17467,83526,17753,974,33563,3313,51316,27923,9638,1764,5441,10758
TGCGCTCCCCTGAAGG,Neg_Ctrl,4381,2246,1825,421,84,337,82,4,134,15,216,102,154,31,17,32
GCGTTACCCCTGAAGG,sample,116221,111971,22846,89125,14237,74888,11633,605,32213,3506,43846,26931,9102,1153,3874,8484
CAGCTTCGCCTGAAGG,Neg_Ctrl,4307,2086,1823,263,65,198,65,4,79,16,144,34,102,23,28,7
TCAATCAGCCTGAAGG,sample,73457,71357,13881,57476,9683,47793,10243,699,19548,2025,29791,15278,6754,1033,3539,5806
CCTAACTACCTGAAGG,sample,64211,61833,14145,47688,8191,39497,8792,623,15943,1468,24735,12671,5894,875,3529,4948
TTAACTGACCTGAAGG,sample,96760,94547,15592,78955,10841,68114,13576,633,29383,3095,42959,21427,8081,1282,4754,7969
TCTAGGTTAATATTCG,sample,120362,119041,8756,110285,46855,63430,41646,2593,12691,1769,54337,4731,2748,1248,23060,25314
AGCTGAATAATATTCG,sample,129141,126483,20505,105978,28586,77392,22389,1482,28942,3099,51331,21480,6701,1171,8923,15927
GACGTATGAATATTCG,sample,369198,363163,41997,321166,75015,246151,64748,4836,94179,9337,158927,73051,14315,2896,22697,48491
GAGCCTCCAATATTCG,sample,86034,84170,12600,71570,11685,59885,16435,989,24337,3062,40772,15062,6046,1460,4250,7551
CATACTCCAATATTCG,sample,924453,908517,111514,797003,89478,707525,84750,4540,313264,31585,398014,273386,22695,7187,17235,55682
TCGAACGAAATATTCG,sample,197926,194333,26974,167359,38696,128663,39465,2868,44184,4689,83649,37457,9614,2241,11387,23648
TCATCGAAAATATTCG,sample,330082,323195,46578,276617,54681,221936,66393,4687,79329,8676,145722,62851,12291,3315,14230,35909
TGATTCCGAATATTCG,sample,517695,510449,54326,456123,70590,385533,187541,14956,108326,10088,295867,64622,12485,3592,24151,52432
GCAACTAGAATATTCG,sample,82421,80960,11285,69675,14262,55413,16018,1080,21043,2467,37061,14805,6984,1261,5027,9187
ATGGCGTTAATATTCG,sample,172075,168097,43922,124175,18790,105385,15365,745,44525,4736,59890,40014,11016,1557,4456,8388
AGCGTCTTAATATTCG,sample,151249,147578,26770,120808,15668,105140,14800,1392,46078,4611,60878,38259,9388,1415,3679,9210
ACGCTTAAAATATTCG,sample,127538,126109,9937,116172,47425,68747,30016,2058,21938,2057,51954,12678,5387,1539,11888,25938
GCTGCTTCAATATTCG,sample,48370,47219,8784,38435,8266,30169,8130,296,10996,1159,19126,9588,4681,760,3633,4802
GCCTATTCAATATTCG,sample,62463,60149,14570,45579,4897,40682,4861,241,17850,1755,22711,15975,6617,722,1243,2314
GCGTTACCAATATTCG,sample,20518,20004,2809,17195,6393,10802,4578,414,3046,390,7624,2374,2018,630,2021,3588
CGTCGAGGAATATTCG,sample,292903,287179,41310,245869,22113,223756,35316,1743,98265,10328,133581,78104,15075,2973,6654,14051
ATTCTACCAATATTCG,Pos_Ctrl,147212,142002,16290,125712,5620,120092,100961,8568,7322,947,108283,2294,7426,9954,7346,2786
AGAGTTCTAGTCTCCG,sample,339364,335938,26526,309412,56641,252771,111099,8941,80605,7688,191704,44438,8926,2718,16657,39558
CTAGCGACAGTCTCCG,sample,540187,534401,52555,481846,60887,420959,73703,4311,169256,16882,242959,156807,17539,4638,21102,39612
GGTAGAGAAGTCTCCG,sample,147478,145927,15644,130283,24942,105341,42671,4110,31548,3160,74219,23852,7995,2163,5977,16738
TCATACCAAGTCTCCG,sample,459079,454500,38285,416215,96602,319613,126700,8400,107876,11345,234576,65292,11868,2696,38551,64306
TCTCAGGAAGTCTCCG,sample,123925,122055,14676,107379,33347,74032,20255,1292,27969,2986,48224,21530,7521,1302,8966,19233
TGCGCGTTAGTCTCCG,sample,93606,91663,11410,80253,18713,61540,16884,801,23095,2527,39979,18233,7147,1179,7304,11594
CATTCGGTAGTCTCCG,sample,127432,125617,12405,113212,27492,85720,32549,1653,31049,3257,63598,17212,5405,1388,15382,18344
GCTCTTCTAGTCTCCG,sample,126516,124430,16369,108061,24050,84011,26870,1742,30706,3096,57576,21597,7562,1577,8493,15533
GAGATTCTAGTCTCCG,sample,50409,49901,3340,46561,16403,30158,18245,1388,7467,889,25712,2169,2648,1517,5073,9813
AAGGTCTGAGTCTCCG,sample,230694,224520,39332,185188,21584,163604,24945,1198,71388,7607,96333,58466,13332,2184,7221,12810
GGCGTACCAGTCTCCG,sample,193795,189833,26602,163231,24464,138767,30862,1714,55456,5816,86318,44919,11230,1922,8237,15111
GTCGCGAAAGTCTCCG,sample,65862,64784,7193,57591,14620,42971,22049,1194,12117,1194,34166,6417,4183,1062,10425,9470
CGTCGAGGAGTCTCCG,sample,178291,175714,19818,155896,24758,131138,35797,2208,51296,5473,87093,36364,8771,1787,7386,16169
TCTCCTAGAGTCTCCG,sample,67425,66679,6548,60131,28218,31913,19686,540,8367,1340,28053,1980,1449,760,8204,14338
AAGTAGAGAGTCTCCG,sample,83337,81349,11640,69709,17991,51718,16141,874,18547,2087,34688,14069,6208,1291,6219,11672
TAACGCCAAGTCTCCG,sample,145913,142583,22401,120182,23003,97179,21287,1119,39283,3817,60570,31673,9232,1308,9711,14985
CGCGAGACAGTCTCCG,sample,57980,56000,10935,45065,5601,39464,6889,460,17666,1880,24555,12569,6202,933,1680,2916
GCGCAATAAGTCTCCG,sample,65341,63634,8360,55274,13191,42083,14925,991,14689,1523,29614,9955,5664,1482,4750,8357
ATATGCAAAGTCTCCG,sample,32854,32128,4830,27298,7440,19858,3819,273,8372,895,12191,6499,3905,527,1285,4396
GTCGTTCTTGCCTACG,sample,82717,80260,18845,61415,7631,53784,10571,668,22563,2435,33134,17547,7931,1578,1671,3931
AGAGTTCTTGCCTACG,sample,239598,235223,35956,199267,36466,162801,31738,1825,66821,7304,98559,55113,11812,2065,12579,22547
AGCTGAATTGCCTACG,sample,346423,340282,49802,290480,50139,240341,49579,2750,98850,9833,148429,79329,13544,2636,13079,31148
CATAATGGTGCCTACG,sample,343142,334864,58717,276147,38458,237689,48736,2795,97346,9874,146082,78938,15903,3453,12795,25099
GAGCCTCCTGCCTACG,sample,77558,75898,13709,62189,7652,54537,8719,518,23649,2433,32368,19218,8611,1322,2555,4390
TCGAACGATGCCTACG,sample,102115,100431,13368,87063,21609,65454,22932,1794,22037,2399,44969,16292,7011,1841,4323,13378
CGTCGCCATGCCTACG,sample,280979,274544,45680,228864,30639,198225,30113,1497,84905,9159,115018,72551,15239,2952,8182,19505
TGATTCCGTGCCTACG,sample,303406,299903,39206,260697,50198,210499,52620,3543,82958,8286,135578,63092,13424,3102,17018,31448
CCGTACGCTGCCTACG,sample,148747,145334,29351,115983,12164,103819,14957,670,45092,4801,60049,38299,12264,1909,3190,6478
TCTCAGGATGCCTACG,sample,37518,36503,6616,29887,5379,24508,6930,483,9703,986,16633,6406,3913,943,1973,3215
GGCAGGTTTGCCTACG,sample,59501,57692,12238,45454,6580,38874,5938,302,16277,1640,22215,14717,6394,798,1825,3848
AGCGTCTTTGCCTACG,sample,57755,56878,6242,50636,14892,35744,18150,1364,10172,1194,28322,4864,3790,1510,4911,9032
CGGTTGGTTGCCTACG,sample,100820,98048,21334,76714,6963,69751,5120,215,32990,3304,38110,28122,9927,924,266,3236
TGCGCTCCTGCCTACG,sample,85851,83944,11328,72616,12389,60227,15255,721,22710,2724,37965,18817,7222,1014,5940,8359
CGTCGAGGTGCCTACG,sample,16038,15380,3554,11826,2117,9709,2019,139,3912,379,5931,3260,2813,507,474,1068
TTATGACGTGCCTACG,sample,190321,186480,30476,156004,14260,141744,20668,1690,61508,6206,82176,51672,12174,1980,3989,8348
TCAATCAGTGCCTACG,sample,20209,19646,3980,15666,2468,13198,1952,169,5857,532,7809,4688,3461,464,412,1352
GACTAACCTGCCTACG,Neg_Ctrl,1817,1027,751,276,56,220,40,8,82,15,122,75,104,26,5,14
AGATACTATGCCTACG,sample,54041,52891,9973,42918,7984,34934,6614,389,14535,1570,21149,11826,6167,816,2366,4733
CATACTCCCTTAGTTC,sample,45398,44128,10247,33881,9149,24732,2225,156,11512,1165,13737,9674,5321,494,348,4454
TCATCGAACTTAGTTC,sample,167395,164831,24420,140411,34164,106247,37940,2768,36896,3888,74836,24755,9064,2814,5973,21036
GACTCAAGCTTAGTTC,sample,108707,106340,16417,89923,15071,74852,25412,1764,27126,2884,52538,17666,7581,1879,4792,9483
ATTCTACCCTTAGTTC,sample,68125,66601,10695,55906,16979,38927,12590,667,14193,1554,26783,9923,5612,1154,4334,9280
TTAACTGACTTAGTTC,sample,84441,82793,10638,72155,15178,56977,16197,628,20022,2205,36219,17925,5182,977,6939,9811
ATATGCAACTTAGTTC,sample,66777,65898,9127,56771,9786,46985,14199,1015,18867,2182,33066,10722,5266,1252,4644,6014
AACCGGTTCGAGCTTC,sample,346761,343792,19124,324668,155397,169271,118434,5976,35565,2074,153999,7222,2729,1319,50784,75274
TCTAGGTTCGAGCTTC,sample,194099,191986,13785,178201,60047,118154,60384,4909,30576,3377,90960,18908,7541,2751,14431,35446
CTGGTCTTCGAGCTTC,sample,305720,300212,35683,264529,61699,202830,62904,3911,76502,7331,139406,52182,9884,2134,24860,39186
GTCGTTCTCGAGCTTC,sample,246668,243450,21249,222201,49825,172376,87505,8175,50478,6573,137983,19645,7708,3158,13699,35854
CATACTCCCGAGCTTC,sample,185036,182226,16653,165573,53678,111895,56187,4133,30075,4247,86262,17253,6728,2122,14931,32897
CGTCGCCACGAGCTTC,sample,978143,959479,132528,826951,105811,721140,122522,6739,300383,30345,422905,261151,22337,7049,30329,64686
TCATACCACGAGCTTC,sample,379393,373667,30381,343286,120895,222391,102698,10032,64199,7124,166897,38338,8078,2011,39600,72788
GCAACTAGCGAGCTTC,sample,227186,224191,16249,207942,64659,143283,64470,3262,43617,5893,108087,26041,5385,1679,27088,41867
TACGCGAGCGAGCTTC,sample,146061,142914,20052,122862,38738,84124,21953,1661,32061,3656,54014,24793,7545,1458,8188,21224
GACTCAAGCGAGCTTC,sample,221404,218776,17668,201108,81906,119202,75575,2672,26346,4182,101921,10427,3354,1304,35479,46965
CCGCAGTCCGAGCTTC,sample,230721,227054,14465,212589,86712,125877,83211,3565,27264,6121,110475,5716,2213,1055,26106,49066
GGCAGGTTCGAGCTTC,sample,336845,329698,47406,282292,57897,224395,55636,4441,85149,8640,140785,70529,12577,2357,18638,36800
ACGCTTAACGAGCTTC,sample,553657,544709,64892,479817,72399,407418,91022,4455,165660,18021,256682,128260,16325,4084,23431,46078
CTAAGCATCGAGCTTC,sample,669115,661106,66744,594362,117554,476808,154696,11285,165897,19664,320593,125266,14933,4219,26991,76766
AAGGTCTGCGAGCTTC,sample,376820,372311,36716,335595,62237,273358,100018,6781,100121,10721,200139,55717,10785,2481,28994,43463
GGCGACGACGAGCTTC,sample,430110,423587,47636,375951,64258,311693,87798,7493,116576,13329,204374,86497,13918,2937,29530,43107
TAACGAAGCGAGCTTC,sample,578812,570651,68030,502621,72614,430007,83159,5394,179237,18060,262396,144157,16887,4785,23086,48418
ATACCGCCCGAGCTTC,sample,236229,231951,23742,208209,44968,163241,66190,5268,51903,5661,118093,34219,9094,1889,6950,29056
CAGCTTCGCGAGCTTC,sample,82865,81857,5851,76006,21382,54624,36028,3650,9949,1010,45977,3987,4504,2924,4134,14000
ATATGCAACGAGCTTC,sample,123607,121910,14115,107795,27552,80243,30531,2264,25430,2938,55961,19080,7398,1926,6374,16722
AACCGGTTGTAGAATG,sample,52075,51430,2877,48553,23945,24608,13811,1231,6708,632,20519,2226,2800,1373,3520,11140
CTGGTCTTGTAGAATG,Pos_Ctrl,502972,482336,54008,428328,17819,410509,344641,30779,24678,2934,369319,7477,8857,14999,20320,7881
AGAGTTCTGTAGAATG,sample,56629,55853,3598,52255,23674,28581,17537,1466,6236,821,23773,2521,3060,1765,5337,11766
CATAATGGGTAGAATG,sample,292025,287475,32505,254970,67336,187634,57168,4175,65402,6574,122570,54315,11800,2735,15721,40866
CGTCGCCAGTAGAATG,sample,196290,192978,18085,174893,44371,130522,68094,6403,30900,3153,98994,21972,8103,3017,11621,29824
GCAACTAGGTAGAATG,Pos_Ctrl,88391,86828,5860,80968,4459,76509,63367,6148,4828,623,68195,1543,7101,9691,4705,2471
TACGCGAGGTAGAATG,sample,248810,246451,14761,231690,88778,142912,95487,4144,33106,1655,128593,8520,2465,1066,40715,51434
CCGTACGCGTAGAATG,sample,160666,156803,25878,130925,20752,110173,28457,2135,43231,4839,71688,31511,8907,2052,6641,13077
GATGCGTTGTAGAATG,sample,64020,63012,4966,58046,24315,33731,23244,1096,6892,970,30136,1529,1508,792,10756,13573
CGGTTGGTGTAGAATG,sample,347128,340401,48231,292170,34077,258093,41777,2030,111169,11474,152946,91643,14561,2929,10676,20260
GCTCTTCTGTAGAATG,Pos_Ctrl,454748,438475,43167,395308,15909,379399,318042,29170,22609,2852,340651,6726,8413,14394,15254,5918
GAGATTCTGTAGAATG,sample,148854,146120,22282,123838,20652,103186,24596,2137,41817,4992,66413,29644,7868,1559,8940,12506
TAACGAAGGTAGAATG,sample,148865,147131,10081,137050,52906,84144,55473,4371,16260,2928,71733,5112,2944,1253,17034,30754
AGCAGAGCGTAGAATG,sample,300967,297051,33473,263578,60009,203569,72109,4253,71126,6917,143235,49164,10165,2462,25691,37762
GTCGCGAAGTAGAATG,sample,174517,171818,20218,151600,28234,123366,50890,4642,39471,3806,90361,24557,7996,2181,7471,18862
CGCGGTCGGTAGAATG,Pos_Ctrl,74175,71043,8509,62534,2786,59748,50088,4444,3642,373,53730,1201,6493,7566,3684,1242
AAGTAGAGGTAGAATG,sample,97480,96002,10750,85252,28836,56416,29568,1715,15991,1620,45559,7522,3048,1004,13122,17003
TCAATCAGGTAGAATG,sample,58864,57593,8768,48825,10508,38317,11607,719,14004,1576,25611,10411,5338,990,4796,6364
CGCGAGACGTAGAATG,sample,62730,61499,7986,53513,16859,36654,14140,800,11901,1454,26041,8359,4717,890,6465,9687
GTCGTTCTCAATAGTC,sample,193799,190193,26044,164149,46793,117356,35721,2433,43721,4723,79442,30758,10156,2156,10825,28423
AGCTGAATCAATAGTC,sample,430441,423108,51437,371671,56337,315334,137883,13305,90936,9394,228819,63816,11582,3008,22949,39038
TATACGGACAATAGTC,sample,217133,213380,26854,186526,43220,143306,51380,3203,49255,5874,100635,33594,9265,1806,17246,27271
CGTCGCCACAATAGTC,sample,310121,303567,43652,259915,41576,218339,55158,3011,86957,8954,142115,64259,11143,2053,15287,27205
TGATTCCGCAATAGTC,sample,207295,203990,24925,179065,38113,140952,53646,4532,47345,4870,100991,30559,8650,2132,10122,25766
CCGCAGTCCAATAGTC,sample,251091,246898,28213,218685,48858,169827,55903,3432,60187,8136,116090,42169,8754,2106,19996,33999
TCTCAGGACAATAGTC,sample,105115,103517,13577,89940,20820,69120,21778,1378,25021,2491,46799,18452,7194,1793,5353,13471
ATGGCGTTCAATAGTC,sample,162790,160024,20108,139916,29785,110131,35143,2492,39237,4334,74380,28925,8994,1945,8461,18424
CCTAGCGGCAATAGTC,sample,112219,110703,9673,101030,29542,71488,28005,2520,25178,2714,53183,13071,6236,1342,9103,18472
GGCGTACCCAATAGTC,sample,173830,171611,16827,154784,37358,117426,49382,4315,37470,4290,86852,21969,5061,1471,13840,25317
CGCGGTCGCAATAGTC,sample,25681,25332,1960,23372,9286,14086,9249,567,2762,328,12011,1180,1384,724,3723,5169
TCTCCTAGCAATAGTC,sample,93532,91239,15887,75352,14787,60565,16115,1018,23064,2429,39179,17939,7314,1488,4383,8527
TCAATCAGCAATAGTC,sample,38302,37637,6472,31165,8051,23114,6017,367,9203,1059,15220,6468,4570,991,1583,4694
TAACGCCACAATAGTC,sample,66011,65167,5243,59924,22516,37408,20862,1133,9835,770,30697,4808,2267,839,10820,13021
GACTAACCCAATAGTC,sample,98762,97036,14821,82215,19760,62455,20800,1146,22230,2423,43030,15856,6793,1261,7896,11166
CGTAGAACCAATAGTC,sample,424236,418742,63359,355383,26028,329355,101172,6966,146880,18715,248052,55622,14277,3100,9683,15216
CCTAACTACAATAGTC,sample,84095,82916,13249,69667,13979,55688,15276,894,21578,2165,36854,15775,6990,1273,4847,8258
GCGCAATACAATAGTC,sample,62645,61790,8648,53142,9163,43979,7964,468,18488,1985,26452,15074,7220,994,2523,5580
ATATGCAACAATAGTC,sample,33693,33281,3990,29291,6988,22303,5928,397,8720,887,14648,6371,4272,728,2526,4351
GTCGTTCTCGTTACTC,Neg_Ctrl,8843,4025,2896,1129,242,887,271,7,347,25,618,237,372,65,87,53
GACGTATGCGTTACTC,sample,418912,411269,53359,357910,79432,278478,80561,4536,109671,13385,190232,70325,11666,2737,25201,49234
TATACGGACGTTACTC,sample,231399,226944,32749,194195,40458,153737,43521,3004,59793,6587,103314,40832,9125,2024,10597,25228
GCAACTAGCGTTACTC,sample,281306,277559,21653,255906,82721,173185,88033,5034,51421,6223,139454,22474,6415,2203,30013,53444
TACGCGAGCGTTACTC,Neg_Ctrl,9801,5253,4251,1002,268,734,199,12,186,16,385,321,260,53,84,70
TGCGCGTTCGTTACTC,sample,199186,197786,10329,187457,64466,122991,70772,6065,31016,3030,101788,12108,4648,1605,19863,38139
GAGATTCTCGTTACTC,Neg_Ctrl,5406,3551,2792,759,163,596,148,12,188,15,336,233,218,61,53,102
CTAACCGGCGTTACTC,sample,129088,126957,17661,109296,23940,85356,23985,1990,33170,3836,57155,22375,7755,1699,6805,14723
GGCGACGACGTTACTC,sample,28125,27432,4770,22662,4096,18566,5289,379,7688,759,12977,4451,3360,953,978,2385
TGCGCTCCCGTTACTC,sample,177582,172919,38307,134612,22775,111837,24720,1960,44933,4706,69653,35518,11586,2471,4916,13017
GTCGCGAACGTTACTC,sample,251612,247292,30328,216964,54972,161992,49498,3531,60883,6354,110381,41726,9758,2042,20382,36205
TTATGACGCGTTACTC,Neg_Ctrl,5392,3526,3036,490,112,378,116,5,122,9,238,126,148,27,45,34
TCTCCTAGCGTTACTC,sample,158922,157300,12679,144621,61026,83595,47641,2905,21323,2190,68964,9536,3581,1287,22482,33237
GACTAACCCGTTACTC,sample,228416,222641,44318,178323,28584,149739,27905,1737,63247,6878,91152,49972,11344,1860,10249,16576
TTAACTGACGTTACTC,sample,41659,40570,9334,31236,4106,27130,4643,405,11903,1295,16546,8884,4929,979,679,2145
ATATGCAACGTTACTC,sample,99883,99048,10117,88931,29926,59005,20797,1409,20030,1851,40827,14918,5890,1576,7211,16663
AGAGTTCTTGGACTGC,sample,519880,511723,66628,445095,77064,368031,85951,6980,143985,15876,229936,115239,15704,3641,22242,49426
AGCTGAATTGGACTGC,sample,328498,323545,42021,281524,71003,210521,66203,4802,76976,9175,143179,53365,10905,2266,22365,41914
TATACGGATGGACTGC,sample,731239,720289,86953,633336,74386,558950,87416,5820,241218,24869,328634,199627,21452,6447,12699,49075
CGTCGCCATGGACTGC,sample,409247,400916,51359,349557,76483,273074,71778,4740,106804,11978,178582,77774,12947,2786,20244,47897
TCATACCATGGACTGC,sample,219780,214418,33349,181069,26069,155000,46504,2889,59611,7430,106115,38566,10094,2378,8052,16507
TGATTCCGTGGACTGC,sample,430952,423290,47570,375720,81768,293952,96594,7671,105851,11866,202445,71970,13350,3031,30888,54057
GACTCAAGTGGACTGC,sample,308364,301999,40288,261711,43075,218636,59420,3200,85583,8785,145003,61648,12481,2505,18588,28772
CCGCAGTCTGGACTGC,sample,210437,207346,16847,190499,65829,124670,60470,4032,34397,3490,94867,22281,6358,1934,21040,40068
CCGTACGCTGGACTGC,sample,378561,371638,46007,325631,53962,271669,63524,5954,111638,10810,175162,79743,12940,3001,20370,36620
ACGCTTAATGGACTGC,sample,83892,82524,7165,75359,22412,52947,24538,1454,16344,2280,40882,8331,4856,1273,9796,13930
CATTCGGTTGGACTGC,sample,85076,84025,7683,76342,30615,45727,30919,1327,9787,1393,40706,2301,1695,901,16292,17435
GAGATTCTTGGACTGC,sample,78929,76839,14036,62803,13342,49461,10984,525,19797,2125,30781,16030,7029,1120,3754,8012
CTAAGCATTGGACTGC,sample,71164,68856,12739,56117,10887,45230,9601,349,17886,1755,27487,15639,6478,1013,3796,6585
GCGTTACCTGGACTGC,sample,41302,39734,8611,31123,4960,26163,5270,361,11346,1107,16616,8079,5133,849,1672,2660
GTCGCGAATGGACTGC,sample,277186,271133,42301,228832,36332,192500,48368,3481,74409,7488,122777,58754,10740,2442,14631,24043
ATTCTACCTGGACTGC,sample,112535,109711,16339,93372,19582,73790,18949,896,28298,2645,47247,23002,6349,1265,7959,13082
CCTAACTATGGACTGC,sample,56317,54729,8737,45992,9987,36005,10935,758,12766,1187,23701,10359,5677,1332,2587,6354
CTGGTCTTCCTTGAGC,sample,878883,853427,204692,648735,71955,576780,79025,4885,258410,26984,337435,207476,22712,5820,12645,38182
AGAGTTCTCCTTGAGC,sample,500403,492203,70201,422002,82874,339128,87205,5053,136790,13743,223995,96337,14566,3201,28840,51377
AGCTGAATCCTTGAGC,sample,670203,657628,92506,565122,93014,472108,90920,5473,199706,19826,290626,156183,14784,4095,26553,59060
GAGCCTCCCCTTGAGC,Pos_Ctrl,397142,382224,45315,336909,14403,322506,272544,24095,17747,2297,290291,5823,8414,14050,14296,6901
ATTCAAGGCCTTGAGC,sample,471652,460743,82103,378640,50162,328478,68839,4888,134856,14092,203695,105803,17519,4423,13045,30942
CCGCAGTCCCTTGAGC,sample,53872,52149,13813,38336,5770,32566,5783,472,14377,1453,20160,10481,6121,1145,907,3217
CCGTACGCCCTTGAGC,sample,173126,170894,10238,160656,66578,94078,66495,2680,19024,1939,85519,3940,1898,941,32705,37922
GGCAGGTTCCTTGAGC,Pos_Ctrl,303494,292451,39735,252716,12317,240399,202048,17766,13639,1971,215687,4975,8364,12809,12570,7067
AGCGTCTTCCTTGAGC,sample,84300,82710,14193,68517,13921,54596,15286,1309,21240,2123,36526,14638,5674,1291,3018,7763
TAACGAAGCCTTGAGC,sample,152829,148839,28214,120625,23959,96666,20962,1250,38166,4049,59128,32239,8936,1453,9015,14006
GCTGCTTCCCTTGAGC,Pos_Ctrl,147397,142116,19712,122404,6091,116313,97966,8487,6954,876,104920,2030,7488,9809,7487,3384
GGCGTACCCCTTGAGC,sample,109590,106343,19916,86427,18755,67672,17872,1450,25662,2703,43534,19985,7194,1276,6888,11517
CAGCTTCGCCTTGAGC,sample,223850,221329,18105,203224,78910,124314,73362,3748,31491,2656,104853,13057,3600,1148,23054,45822
TCAATCAGCCTTGAGC,sample,144300,141018,23131,117887,24019,93868,29364,2133,34817,4051,64181,23503,5734,1658,6501,15206
CCTAACTACCTTGAGC,Pos_Ctrl,181367,174311,21942,152369,7733,144636,122575,10872,7737,945,130312,2507,7649,10797,9110,3717
AGCTGAATCGATATCC,sample,233166,229258,31529,197729,47836,149893,52378,2970,55252,6235,107630,33058,8236,1628,22919,31687
GGAGAAGCCGATATCC,sample,326115,321477,39664,281813,76170,205643,75401,6146,71098,8921,146499,44077,7618,2360,22085,46701
CATACTCCCGATATCC,sample,325606,321135,43779,277356,52141,225215,45990,2968,95539,9620,141529,71098,16207,3794,7998,33714
GCAACTAGCGATATCC,sample,242647,239663,25224,214439,45062,169377,57833,4119,62058,6627,119891,38740,11775,2927,15690,30640
ATACGTTCCGATATCC,sample,264988,259572,36964,222608,57343,165265,56097,4868,57750,6122,113847,40428,10043,2413,11093,34689
GGCAGGTTCGATATCC,sample,304424,299766,36755,263011,89352,173659,73113,4419,53208,5686,126321,37233,8965,2223,27515,50795
CCATTCTTCGATATCC,sample,274143,269001,42951,226050,59346,166704,47561,2227,59733,5971,107294,51212,10938,1892,18543,34040
TAGCGAGTCGATATCC,sample,181797,178988,24522,154466,40105,114361,43943,4147,35679,3782,79622,26810,8515,2465,10267,23489
GAGATTCTCGATATCC,sample,121152,118607,19626,98981,17352,81629,14598,725,34189,3336,48787,28781,8851,1377,4670,10366
AAGGTCTGCGATATCC,sample,205821,202111,31177,170934,39950,130984,45906,3294,43549,4210,89455,34025,9763,2824,10352,22961
CCTAGCGGCGATATCC,sample,92247,90611,13543,77068,10150,66918,14411,1055,29896,3295,44307,18261,7803,1533,3076,5795
GCTGCTTCCGATATCC,sample,410184,406105,37226,368879,67434,301445,74971,5146,117686,11991,192657,91651,14981,3654,22805,45518
GGCGTACCCGATATCC,sample,307484,303880,30686,273194,59236,213958,87338,4129,69535,6700,156873,46256,9056,2239,22155,39453
TTATGACGCGATATCC,sample,127150,126071,6193,119878,53864,66014,45689,1898,14087,1674,59776,2666,1758,942,24834,29171
ATGAATAGCGATATCC,sample,195275,193501,15099,178402,63956,114446,54554,3979,34333,4626,88887,16954,6013,1649,24623,37492
AAGTAGAGCGATATCC,sample,148017,146591,19588,127003,22596,104407,22729,1358,41686,4447,64415,34187,10479,1868,8357,14397
ATTCTACCCGATATCC,sample,95404,93918,16595,77323,13531,63792,14471,1224,26966,2927,41437,18204,7667,1614,3030,8171
CGCGAGACCGATATCC,sample,157407,154733,19721,135012,34736,100276,31100,1416,37335,3811,68435,26614,6763,1434,11961,21990
AACCGGTTATCTGACC,sample,702,689,166,523,134,389,106,9,158,15,264,101,190,51,45,75
GACGTATGATCTGACC,sample,253093,248062,39624,208438,36595,171843,30764,1948,73361,7802,104125,57968,12199,2324,5715,21394
CATAATGGATCTGACC,sample,175744,174383,12181,162202,78533,83669,58556,3753,16415,1579,74971,3366,1742,831,29190,38797
CATACTCCATCTGACC,Neg_Ctrl,5207,2192,1630,562,112,450,129,10,208,12,337,91,194,55,51,29
CGTCGCCAATCTGACC,sample,180808,177496,23434,154062,39020,115042,43629,3404,38761,4288,82390,24960,7930,1583,16325,24826
TCATACCAATCTGACC,sample,111944,109351,19177,90174,24387,65787,14586,924,27329,2669,41915,20279,7725,1423,4378,13696
ATTCAAGGATCTGACC,sample,257935,251870,44163,207707,24757,182950,31303,1834,77602,8384,108905,63827,12867,2523,6296,13940
TGATTCCGATCTGACC,sample,383632,372959,70870,302089,31894,270195,40389,3299,117547,13036,157936,95924,16153,3460,7958,17454
ATACGTTCATCTGACC,sample,185079,182348,17468,164880,57511,107369,48814,4518,31648,3278,80462,19111,4991,1382,20977,34819
TCTCAGGAATCTGACC,sample,170814,167060,29387,137673,25163,112510,24911,1620,45111,4253,70022,36615,9675,1597,8232,15053
GATGCGTTATCTGACC,Neg_Ctrl,4623,2426,1685,741,158,583,128,10,222,22,350,201,191,51,42,61
AGCGTCTTATCTGACC,sample,134804,132026,23959,108067,17443,90624,21342,1259,36272,3539,57614,28212,8520,1575,6641,10666
CATTCGGTATCTGACC,sample,244485,241095,25026,216069,48396,167673,60330,4998,56924,6986,117254,38435,9924,1768,19694,31438
GAGATTCTATCTGACC,sample,302612,298017,42373,255644,39531,216113,43978,2742,87369,8853,131347,73171,12796,2357,11837,24118
CTAACCGGATCTGACC,sample,124883,122165,20401,101764,18445,83319,22793,1471,32235,3108,55028,23712,8478,1373,8148,11223
GGCGACGAATCTGACC,sample,73305,72361,6413,65948,27224,38724,19569,1502,10544,870,30113,6239,3452,1239,7976,14676
GCTGCTTCATCTGACC,sample,56985,56113,5462,50651,17804,32847,14677,747,10112,950,24789,6361,3230,777,5897,10287
GCCTATTCATCTGACC,Neg_Ctrl,3868,2047,1562,485,95,390,97,10,175,14,272,94,173,35,35,49
AGCAGAGCATCTGACC,sample,64038,62760,8645,54115,17777,36338,15206,1107,10716,1071,25922,8238,4671,1229,5097,10316
CGCGGTCGATCTGACC,sample,49728,48991,5324,43667,14605,29062,17800,1347,6188,1072,23988,2655,1657,613,8905,9439
TTATGACGATCTGACC,sample,73647,72507,7719,64788,19216,45572,19190,1488,15640,1225,34830,8029,4551,793,8584,12514
ATGAATAGATCTGACC,sample,61932,60459,8921,51538,14459,37079,12856,723,13881,1254,26737,8365,4241,969,5471,8910
CGCGAGACATCTGACC,sample,33829,32639,7389,25250,4145,21105,4434,303,8903,1011,13337,6454,4258,754,1309,2374
CGTAGAACATCTGACC,sample,38949,37932,7292,30640,6654,23986,6807,549,9071,941,15878,6618,4282,853,2667,3962
AGATACTAATCTGACC,sample,36440,35663,5378,30285,10341,19944,9021,486,6215,722,15236,3500,3084,997,3340,5911
GCGCAATAATCTGACC,Neg_Ctrl,2314,1251,915,336,68,268,61,2,122,7,183,76,114,23,30,27
AACCGGTTCTTCTTAC,sample,1093,1039,245,794,178,616,180,16,237,26,417,157,307,75,48,114
TCTAGGTTCTTCTTAC,sample,387903,377750,95090,282660,28242,254418,30250,1693,109343,11437,139593,101695,15284,2838,5978,12848
CTGGTCTTCTTCTTAC,sample,327926,324762,26824,297938,127567,170371,83759,5615,49082,5099,132841,26816,6576,1941,26407,68250
GTCGTTCTCTTCTTAC,sample,708335,696694,95121,601573,89456,512117,103254,5599,216639,23405,319893,163220,19166,5087,31952,60071
CATAATGGCTTCTTAC,sample,624832,613362,98236,515126,46826,468300,83942,5483,211100,22533,295042,145242,20546,6151,11259,25616
TATACGGACTTCTTAC,sample,518438,512089,51724,460365,93609,366756,128970,8389,130650,13391,259620,85356,12680,4085,27490,65612
GAGCCTCCCTTCTTAC,sample,195043,192965,9365,183600,81418,102182,67174,5721,22167,2574,89341,4546,1921,861,34435,43079
TCGAACGACTTCTTAC,sample,254981,250590,32624,217966,51185,166781,36337,2803,65612,7256,101949,54773,12010,2198,9257,33973
CGTCGCCACTTCTTAC,sample,164612,161188,21776,139412,40895,98517,34150,1911,36612,3737,70762,22107,7652,1539,9681,23604
TGATTCCGCTTCTTAC,sample,447059,434470,92104,342366,35438,306928,33322,1573,139181,13740,172503,119112,18729,3645,3845,20533
GACTCAAGCTTCTTAC,sample,203732,198876,29643,169233,36009,133224,38903,2102,50237,6284,89140,35698,9445,1770,11591,22381
ATGGCGTTCTTCTTAC,sample,182403,177411,38054,139357,17980,121377,20844,1315,53724,5556,74568,39938,10735,1955,4728,10232
AGCGTCTTCTTCTTAC,sample,41525,40508,10111,30397,5305,25092,3880,264,10826,1175,14706,8947,5115,759,803,2782
CGGTTGGTCTTCTTAC,sample,151946,149013,18131,130882,35204,95678,27588,1939,33535,3497,61123,29119,5154,1160,11825,21584
GCTGCTTCCTTCTTAC,sample,309390,305571,31897,273674,67372,206302,90517,4093,57241,6831,147758,47620,8466,1935,35084,46005
ATACCGCCCTTCTTAC,sample,38241,37298,5373,31925,7081,24844,9491,531,9276,949,18767,4597,3555,1014,3248,4529
CGTCGAGGCTTCTTAC,sample,234862,227997,39147,188850,18056,170794,27904,1287,73512,7905,101416,60186,13128,2277,7911,10367
TCTCCTAGCTTCTTAC,sample,63311,61100,13950,47150,9002,38148,7289,381,15850,1630,23139,12998,6012,866,2665,4886
ATGAATAGCTTCTTAC,sample,295095,286321,75946,210375,25446,184929,27366,1317,80693,8762,108059,66791,16407,2472,7418,14535
AAGTAGAGCTTCTTAC,sample,57599,56791,5120,51671,23530,28141,19391,1122,5549,739,24940,1340,1565,885,8378,11827
TCAATCAGCTTCTTAC,sample,64100,62449,11609,50840,9652,41188,10852,777,15821,1756,26673,11982,5822,1198,3410,5815
TAACGCCACTTCTTAC,sample,50824,50206,3959,46247,19999,26248,16532,863,5480,619,22012,2754,1998,924,8591,10693
ATTCTACCCTTCTTAC,sample,80989,80092,5071,75021,33632,41389,27042,2014,8835,1435,35877,2063,1615,842,12858,18107
GACTAACCCTTCTTAC,sample,64789,62646,12585,50061,10894,39167,10948,714,14711,1555,25659,11239,5733,1270,2815,6572
CGTAGAACCTTCTTAC,sample,79985,78357,12304,66053,14063,51990,12328,861,20810,2148,33138,15843,6926,1340,4214,8484
AGATACTACTTCTTAC,sample,103529,101010,19116,81894,19156,62738,16008,653,24480,2493,40488,19104,7225,1143,6289,11349
CCTAACTACTTCTTAC,sample,96050,94264,12181,82083,22031,60052,25953,1753,18924,2098,44877,11324,4612,1234,11730,13727
TCGAACGAACTTCTAC,sample,60793,60250,4069,56181,23755,32426,19902,1702,6460,754,26362,3608,3167,1301,6723,12954
GGTAGAGAACTTCTAC,sample,304512,299938,34079,265859,59375,206484,88827,6333,62838,6880,151665,41606,9859,2216,26259,37497
TCATCGAAACTTCTAC,sample,224822,221578,25063,196515,52858,143657,46065,2923,51392,5455,97457,37822,8491,1768,18256,33414
TCATACCAACTTCTAC,sample,109945,105832,31364,74468,6780,67688,12047,963,27760,2876,39807,24042,9040,2121,1152,2741
TGATTCCGACTTCTAC,sample,148653,146089,21549,124540,28136,96404,25381,1767,37258,3685,62639,28313,9638,2189,8323,17188
ATACGTTCACTTCTAC,sample,141736,139367,17091,122276,37018,85258,38895,2847,25264,3138,64159,15114,6203,1534,14041,22891
TGGATCAAACTTCTAC,sample,98365,96328,17489,78839,15339,63500,17512,1172,26236,2731,43748,15849,6104,1416,5412,8509
ACGCTTAAACTTCTAC,sample,195036,192884,15023,177861,55125,122736,85305,4823,25563,2651,110868,4394,2030,811,38818,36219
CTAAGCATACTTCTAC,sample,190732,188220,15993,172227,55339,116888,70868,5467,24181,3088,95049,13284,4228,1526,16253,34107
CCTAGCGGACTTCTAC,sample,188840,185626,25537,160089,33383,126706,45226,2788,40738,4427,85964,33527,9111,1818,11043,21844
TAACGAAGACTTCTAC,sample,234141,231026,28843,202183,37813,164370,49574,1775,63614,6456,113188,42951,9638,2070,14440,25247
GCTGCTTCACTTCTAC,sample,270439,265650,40268,225382,43408,181974,46960,3398,70684,7236,117644,53696,11974,2748,8286,26477
GGCGTACCACTTCTAC,sample,33964,33440,3195,30245,13061,17184,10998,847,3877,574,14875,888,1149,620,4938,7186
GTCGCGAAACTTCTAC,sample,34798,34111,4860,29251,8130,21121,9336,780,6582,765,15918,3658,3482,1121,2565,4978
CGTCGAGGACTTCTAC,sample,27085,26422,4582,21840,4837,17003,5605,311,6250,690,11855,4147,3192,637,2350,2778
CAGCTTCGACTTCTAC,sample,39181,38645,3125,35520,16623,18897,11527,858,4774,482,16301,1256,1217,632,5492,8456
AAGTAGAGACTTCTAC,sample,124015,121289,21772,99517,14231,85286,13905,789,36040,3844,49945,30708,10314,1487,4005,8733
AGCTGAATAGAAGTAA,sample,191286,189528,17248,172280,50459,121821,42269,3178,47121,5293,89390,23960,7893,1871,13501,29931
TATACGGAAGAAGTAA,sample,1563,1495,403,1092,232,860,281,11,296,37,577,235,426,117,70,132
TCGAACGAAGAAGTAA,sample,12195,11896,975,10921,3916,7005,2758,171,2367,270,5125,1439,1763,537,806,2090
ATTCAAGGAGAAGTAA,sample,148988,147901,7687,140214,32828,107386,82942,9270,9206,1349,92148,4619,5073,4158,5623,22980
TACGCGAGAGAAGTAA,sample,321112,315027,41757,273270,61761,211509,74942,5155,70933,7663,145875,52816,11301,2478,18107,40482
ATACGTTCAGAAGTAA,sample,261394,256467,50601,205866,25751,180115,24080,1751,79312,8143,103392,66829,13688,2355,6053,15075
GGCAGGTTAGAAGTAA,sample,188878,186484,18627,167857,46813,121044,57080,4148,37684,4946,94764,17186,6491,1980,14661,28796
CCATTCTTAGAAGTAA,sample,230583,228343,16463,211880,100117,111763,74568,4702,24361,3382,98929,4750,2042,1037,33318,51712
ACGCTTAAAGAAGTAA,sample,668331,659459,75673,583786,95095,488691,101038,6085,200253,21882,301291,159433,14800,4499,32991,59815
CATTCGGTAGAAGTAA,sample,444771,437295,58423,378872,60128,318744,79019,5359,131423,13230,210442,89713,12942,3134,23486,38918
TAGCGAGTAGAAGTAA,sample,668792,660188,76481,583707,88525,495182,79147,5793,215798,24020,294945,170424,17520,5220,13952,55163
GCTGCTTCAGAAGTAA,sample,269922,266815,28632,238183,65403,172780,69330,5783,59388,6043,128718,32236,9976,2568,19081,40620
TGCGCTCCAGAAGTAA,sample,279600,276061,37574,238487,37537,200950,56731,5484,82328,10611,139059,45796,10183,2221,10403,22948
ATACCGCCAGAAGTAA,sample,624510,614672,77901,536771,48525,488246,146487,12389,196110,25327,342597,107933,14802,4459,13751,28611
GTCGCGAAAGAAGTAA,sample,112047,110236,12675,97561,25175,72386,28825,1843,23130,2340,51955,16248,5895,1228,9018,16105
GACTAACCAGAAGTAA,sample,127950,125828,18245,107583,23487,84096,24548,1309,31625,3279,56173,23335,8337,1595,7813,13993
CCTAACTAAGAAGTAA,sample,53053,52352,6827,45525,12525,33000,11991,775,10989,1162,22980,8083,4967,1174,4449,7246
GCGCAATAAGAAGTAA,sample,61136,60184,8733,51451,10919,40532,14872,1418,13751,1460,28623,9031,5173,1529,2518,6448
TTAACTGAAGAAGTAA,sample,109556,107644,18627,89017,14375,74642,14199,888,30197,3065,44396,26293,8930,1241,5850,8651
ATATGCAAAGAAGTAA,sample,50596,50127,6506,43621,11138,32483,10484,654,11396,1113,21880,8836,5373,1253,3797,6665
Short,Non_sample,0,NA,NA,NA,NA,NA,NA,NA,NA,NA,NA,NA,NA,NA,NA,NA
Unselected,Non_sample,1889329,NA,NA,NA,NA,NA,NA,NA,NA,NA,NA,NA,NA,NA,NA,NA
Undetermined,Non_sample,287525826,NA,NA,NA,NA,NA,NA,NA,NA,NA,NA,NA,NA,NA,NA,NA
