Barcode,Sample,Barcoded_Reads,Trimmed_Reads,Unmapped_Reads,Mapped_Reads,Multimapped_Reads,Uniquely_Mapped_Reads,Exon_Reads,Ambiguous_Exon_Reads,Intron_Reads,Ambiguous_Intron_Reads,Gene_Reads,Intergenic_Reads,No_of_Genes,No_of_Transcripts,Mitochondrial_Reads,Ribosomal_Reads
ATTCTCTTCGTTGGTT,sample,171464,170026,10032,159994,30192,129802,77456,5163,30941,3772,108397,12470,7287,3450,9936,21014
AAGTTCGTCGTTGGTT,sample,151255,150115,9306,140809,43035,97774,60199,3810,20047,2275,80246,11443,5682,2481,18528,27865
TCCTCCGTCGTTGGTT,sample,117932,116473,9321,107152,22045,85107,41469,3253,24572,2661,66041,13152,6810,2429,6136,15497
TAGTACGGCGTTGGTT,sample,123959,123086,8856,114230,29708,84522,42955,3243,22476,2659,65431,13189,5598,2046,12984,19000
TGAGCGCGCGTTGGTT,sample,32264,32013,2666,29347,8379,20968,9452,1008,6472,745,15924,3291,3720,1580,2905,5078
TTAGAAGTCGTTGGTT,sample,793,771,92,679,149,530,275,14,141,22,416,78,287,146,74,96
TCGCATCTCGTTGGTT,sample,449,437,61,376,94,282,154,16,64,9,218,39,155,97,41,58
ACTATACTCGTTGGTT,sample,727,709,92,617,128,489,260,25,115,16,375,73,262,146,65,92
GTTAGCCGCGTTGGTT,sample,13808,13654,613,13041,3931,9110,4792,493,2731,349,7523,745,2015,1225,1423,2477
CCGCAACGCGTTGGTT,sample,1526,1487,153,1334,366,968,497,38,252,30,749,151,515,291,111,218
TGGACGAGCGTTGGTT,sample,126411,125387,9004,116383,25646,90737,46532,2987,25280,2847,71812,13091,6760,2375,13855,17076
GGCCAGAGCGTTGGTT,sample,68223,67599,4289,63310,13041,50269,29132,2420,12007,1115,41139,5595,4576,2507,3629,8781
CATGATTCCGTTGGTT,sample,134990,133963,6809,127154,31264,95890,57043,4086,21113,2316,78156,11332,5559,2395,17947,21584
AATCCGTCCGTTGGTT,sample,166847,165118,21161,143957,36985,106972,39520,2579,34442,3569,73962,26862,11217,2504,12619,21790
AGTCCGCACGTTGGTT,sample,265189,262916,15246,247670,62880,184790,104833,6844,47649,5267,152482,20197,6531,2456,28581,43388
GTCCTGCCCGTTGGTT,sample,233539,231826,7417,224409,81437,142972,110691,6955,17267,1960,127958,6099,2159,1588,34992,49196
CGGATTACCGTTGGTT,sample,241792,239802,12937,226865,47313,179552,114731,8987,31861,3739,146592,20234,8552,3667,15265,32552
AACTCGTACGTTGGTT,sample,118619,117580,9747,107833,18636,89197,40386,2713,26932,2958,67318,16208,7664,2392,10852,11952
TTGGCCTCCGTTGGTT,sample,117567,116625,6617,110008,20937,89071,47328,4111,25104,3258,72432,9270,5203,2202,11346,14393
ACCAATGCCGTTGGTT,sample,163381,162255,4924,157331,36730,120601,88667,5771,17826,2013,106493,6324,3869,2224,21683,25941
AAGAGCGCCGTTGGTT,sample,161653,160220,14868,145352,24818,120534,50238,3660,36909,3674,87147,26053,9192,2665,13134,16404
CCAATTCCCGTTGGTT,sample,107328,106345,5566,100779,20407,80372,44155,3770,20900,2899,65055,8648,5036,1747,13878,14209
CTTCATGACGTTGGTT,sample,139211,138268,4812,133456,40226,93230,72782,5100,12333,910,85115,2105,1735,1359,26445,26402
AGGTCGGACGTTGGTT,sample,131392,130509,5289,125220,45292,79928,64970,4266,7881,647,72851,2164,2356,1945,17141,27111
GACCGGAACGTTGGTT,sample,51693,51260,2093,49167,13437,35730,18920,1973,10183,1317,29103,3337,2877,1421,3990,8664
AAGTTCGTCTATCGTT,sample,13598,13281,2424,10857,2016,8841,3269,209,2867,303,6136,2193,2475,802,1078,1155
AGTACCATCTATCGTT,sample,41394,40660,3585,37075,8821,28254,14870,961,7678,711,22548,4034,3455,1354,3892,5543
TTCGTAATCTATCGTT,sample,55997,54940,7550,47390,10271,37119,18277,1259,9881,914,28158,6788,5193,2067,3716,6506
ACGTTATGCTATCGTT,sample,62655,62089,3541,58548,21022,37526,28870,1650,4649,379,33519,1978,1713,1424,10957,12736
TCGCATCTCTATCGTT,sample,31664,31439,2269,29170,6364,22806,12404,1018,5917,673,18321,2794,3391,1881,3503,4251
GCCTTGCTCTATCGTT,sample,27538,27251,1961,25290,3590,21700,10205,778,7175,808,17380,2734,3422,1673,1675,2400
GGCCAGAGCTATCGTT,sample,47794,47147,5281,41866,6378,35488,14788,832,10940,1088,25728,7840,4778,1540,2623,4141
CCATGAAGCTATCGTT,sample,34849,34377,4437,29940,3916,26024,8932,520,8848,1006,17780,6718,4655,1117,3263,2555
ACGACTTCCTATCGTT,sample,21666,21487,1050,20437,6724,13713,10523,593,1636,219,12159,742,1254,1050,3783,4264
AATCCGTCCTATCGTT,sample,26834,26506,3401,23105,4130,18975,7346,518,6248,762,13594,4101,3710,1167,2451,2656
AGTCCGCACTATCGTT,sample,73825,73122,5709,67413,17672,49741,29450,2277,10719,925,40169,6370,3915,1424,9747,10957
CTAGGACCCTATCGTT,sample,108467,107561,5529,102032,21847,80185,54449,4381,12934,1445,67383,6976,5377,2927,9825,15491
CGGATTACCTATCGTT,sample,121551,120802,4785,116017,31205,84812,58227,3484,15933,1684,74160,5484,3282,1621,18696,21499
GAAGGCGCCTATCGTT,sample,48412,48056,1945,46111,8594,37517,24464,1797,7394,951,31858,2911,3214,1817,4041,6032
GTCTTAGCCTATCGTT,sample,8641,8529,564,7965,1872,6093,2249,191,2284,233,4533,1136,1716,645,289,1193
GTACCGTACTATCGTT,sample,40040,39508,4191,35317,6498,28819,13340,864,8441,846,21781,5328,4365,1377,3096,4141
TCGCCTGACTATCGTT,sample,41296,40923,3954,36969,7332,29637,12629,886,8891,869,21520,6362,4736,1197,3736,4632
ATTCTCTTGTCTTCTT,Pos_Ctrl,48203,46602,6052,40550,2671,37879,31120,2591,2938,403,34058,827,6069,6232,2507,1625
TCCTCCGTGTCTTCTT,sample,31209,30759,2152,28607,5176,23431,10833,887,8301,904,19134,2506,2637,1313,1874,3479
CCTCTAGAGTCTTCTT,Pos_Ctrl,41132,39159,5083,34076,2123,31953,26460,2233,2263,284,28723,713,5643,5755,2105,1236
ACGTTATGGTCTTCTT,sample,27520,26973,3734,23239,4339,18900,7083,426,6564,782,13647,4045,3770,1124,2537,2680
TTCTAATGGTCTTCTT,sample,35848,35328,2604,32724,5493,27231,17874,1149,4977,634,22851,2597,3724,2228,5465,3812
TTCCGTCTGTCTTCTT,sample,58765,57802,5260,52542,14333,38209,21330,1391,8727,947,30057,5814,4250,1531,7086,9284
GCCTTGCTGTCTTCTT,sample,31765,31321,2298,29023,4598,24425,11833,839,7656,1019,19489,3078,3269,1590,2105,2940
CTTGATAGGTCTTCTT,sample,51395,50897,2693,48204,15664,32540,26165,2135,2955,269,29120,1016,1583,1465,9147,9934
GACGATAAGTCTTCTT,sample,25120,24836,2521,22315,4485,17830,8446,416,4727,573,13173,3668,3314,1041,3136,2949
GCCTGAACGTCTTCTT,sample,56395,56058,2261,53797,20017,33780,23058,2332,5101,640,28159,2649,2337,1281,7165,11674
TTGGCCTCGTCTTCTT,sample,70537,70191,1953,68238,17380,50858,38573,4147,5646,553,44219,1939,2893,2380,6248,11773
TGCTTCGCGTCTTCTT,sample,48972,48687,2205,46482,12270,34212,21610,1583,6674,828,28284,3517,3367,1671,5650,8111
GTCTTAGCGTCTTCTT,sample,48879,48587,1880,46707,9373,37334,23693,1911,7332,843,31025,3555,3892,2068,4408,6473
GTACCGTAGTCTTCTT,sample,90931,90404,3602,86802,22375,64427,48361,3762,7519,859,55880,3926,3187,1960,10134,15037
TCGCCTGAGTCTTCTT,sample,40296,39985,2259,37726,9603,28123,17200,1439,5547,615,22747,3322,3074,1384,4631,6454
AGGTCGGAGTCTTCTT,Pos_Ctrl,18151,17941,1312,16629,1008,15621,13040,1395,759,117,13799,310,3965,4098,804,560
TTATTCGAGTCTTCTT,sample,55615,55185,3514,51671,15304,36367,21274,1883,7352,800,28626,5058,4415,1636,5581,9677
GACCGGAAGTCTTCTT,sample,25342,25115,1640,23475,5929,17546,8959,617,4736,511,13695,2723,2732,1060,2548,3660
ATTCTCTTTAGGCTCT,sample,159370,156995,12837,144158,38568,105590,64840,3563,22590,2529,87430,12068,5658,1823,26843,25236
AAGTTCGTTAGGCTCT,sample,39813,38892,4752,34140,6627,27513,9775,797,10503,1109,20278,5329,4268,1390,2253,4327
GGTTGCGTTAGGCTCT,sample,170771,168483,14083,154400,54883,99517,57931,4271,20985,2428,78916,13902,5600,2035,19856,33348
TTCTAATGTAGGCTCT,sample,50078,49527,4721,44806,5675,39131,15706,1447,12939,1366,28645,7673,6303,2656,1861,3404
TTAGAAGTTAGGCTCT,sample,268768,267042,11111,255931,93184,162747,122012,8739,22157,2817,144169,7022,2138,1594,56985,56212
GGACCTCTTAGGCTCT,sample,199376,197846,8679,189167,57110,132057,90401,6159,21625,3040,112026,10832,5608,2522,30232,36606
TCGCATCTTAGGCTCT,sample,78329,77566,5054,72512,10945,61567,30763,2662,18725,2098,49488,7319,5947,3216,4131,7221
GCCTTGCTTAGGCTCT,sample,147019,145376,11664,133712,29755,103957,53514,4629,26274,3339,79788,16201,7424,2847,14433,19346
ACTATACTTAGGCTCT,sample,130188,128863,8067,120796,35870,84926,51667,4000,16497,2128,68164,10634,5362,1997,16359,22581
CCGCAACGTAGGCTCT,sample,177722,176030,9658,166372,46555,119817,78018,5415,22336,2135,100354,11913,4483,1945,29860,31116
GGACGTAGTAGGCTCT,sample,179656,178152,9268,168884,49776,119108,73865,4520,25987,3261,99852,11475,4901,2079,31206,31944
CTTGATAGTAGGCTCT,sample,205918,203482,18270,185212,43583,141629,76152,4896,34299,4525,110451,21757,6134,2146,31637,29274
TGGACGAGTAGGCTCT,sample,199587,197561,14682,182879,43004,139875,72229,4755,37569,4824,109798,20498,8371,2667,23046,28912
GGCCAGAGTAGGCTCT,sample,113802,112472,8060,104412,28438,75974,45992,3173,16398,2350,62390,8061,5040,2095,15289,18286
CATTGCAGTAGGCTCT,sample,143235,141458,10720,130738,29589,101149,56372,4448,23469,2499,79841,14361,6663,2423,16123,20158
ACGACTTCTAGGCTCT,sample,149273,148034,7336,140698,42809,97889,65511,4740,16886,1450,82397,9302,4811,2524,18084,26997
GTCCTGCCTAGGCTCT,sample,202241,198998,32856,166142,28847,137295,33179,1939,53588,5669,86767,42920,12368,2545,9066,16859
GTCTTAGCTAGGCTCT,sample,53350,52263,6957,45306,7803,37503,10867,666,13772,1428,24639,10770,5629,1450,1699,4425
ATGACCGATAGGCTCT,sample,119169,117589,11980,105609,16615,88994,29863,2500,31481,3086,61344,22064,8269,1726,5592,10341
GACCGGAATAGGCTCT,sample,168845,167617,9209,158408,38168,120240,75860,5595,22081,2532,97941,14172,5231,1862,19607,25442
GGAGAGTTTTGACTAT,sample,17911,17457,2970,14487,1840,12647,4243,195,4722,515,8965,2972,3059,837,1257,1107
TCCAACTTTTGACTAT,Neg_Ctrl,2306,1513,1133,380,70,310,143,13,94,4,237,56,150,72,36,21
AAGTTCGTTTGACTAT,sample,46816,46021,4493,41528,9212,32316,16261,906,8167,838,24428,6144,4100,1313,5974,6059
TCCTCCGTTTGACTAT,sample,26625,26064,3541,22523,3884,18639,8161,540,5895,630,14056,3413,3835,1652,1518,2460
ACGTAAGTTTGACTAT,sample,53125,52156,10618,41538,8333,33205,13850,981,10262,1103,24112,7009,4215,1213,5656,4954
AGTACCATTTGACTAT,Neg_Ctrl,3198,2283,1753,530,92,438,218,25,110,6,328,79,206,105,53,32
TGAGCGCGTTGACTAT,sample,13722,13402,1789,11613,2149,9464,5190,338,2219,251,7409,1466,2469,1209,1075,1403
CAACCGCGTTGACTAT,sample,23293,22521,4777,17744,2659,15085,4188,255,5687,628,9875,4327,3955,1032,815,1425
TTCCGTCTTTGACTAT,Pos_Ctrl,31033,29883,4554,25329,1568,23761,19472,1702,1852,214,21324,521,5017,4766,1350,924
GACGGAGATTGACTAT,sample,50613,49863,3842,46021,11473,34548,21545,1289,7478,637,29023,3599,2851,1217,9425,7680
CCGCAACGTTGACTAT,Pos_Ctrl,18126,17574,2444,15130,999,14131,11769,1009,933,114,12702,306,3941,3465,980,672
ACCTCGAGTTGACTAT,sample,34879,34265,3909,30356,6964,23392,9488,614,7499,796,16987,4995,3928,1092,3582,4346
GGCCAGAGTTGACTAT,sample,39823,39167,5316,33851,6176,27675,10887,718,8564,948,19451,6558,4423,996,4517,3929
CATTGCAGTTGACTAT,sample,38563,37994,4187,33807,5581,28226,11981,696,9123,1023,21104,5403,4161,1519,3058,3796
ACGACTTCTTGACTAT,sample,68086,67330,4833,62497,15198,47299,27167,1951,10220,1111,37387,6850,3916,1473,8632,10060
AATCCGTCTTGACTAT,Pos_Ctrl,19331,18810,2401,16409,1039,15370,12638,1056,1189,131,13827,356,4166,3672,930,659
CGTACGTCTTGACTAT,sample,10551,10294,1317,8977,2195,6782,3379,194,1723,215,5102,1271,1883,857,883,1363
AGTCCGCATTGACTAT,sample,22189,21828,2736,19092,3636,15456,6062,533,5220,573,11282,3068,3142,1045,1706,2437
GTCCTGCCTTGACTAT,sample,33405,32914,2420,30494,8726,21768,12377,1010,5083,474,17460,2824,2760,1234,4295,5733
TTGGTACCTTGACTAT,sample,48828,48376,2724,45652,13019,32633,23164,1665,5401,507,28565,1896,2370,1605,6411,8337
CTAGGACCTTGACTAT,sample,20164,19818,2530,17288,2883,14405,5692,430,4800,535,10492,2948,3151,1193,1416,1807
TTGGCCTCTTGACTAT,Pos_Ctrl,28448,27933,3237,24696,1446,23250,19384,1748,1483,182,20867,453,4960,5035,1240,781
AATATATCTTGACTAT,sample,69053,68612,3036,65576,17672,47904,34221,2700,6740,698,40961,3545,3453,2044,9587,11750
ACCAATGCTTGACTAT,sample,57088,56585,2464,54121,19257,34864,27397,1554,4374,425,31771,1114,1380,1145,10152,11864
TGCTTCGCTTGACTAT,sample,25074,24902,1122,23780,3317,20463,17376,1446,891,108,18267,642,2968,2964,1013,2559
CCAATTCCTTGACTAT,sample,57258,56839,4013,52826,12625,40201,20013,1573,11402,1310,31415,5903,4419,1433,6786,7963
TTATTCGATTGACTAT,Neg_Ctrl,1371,911,531,380,57,323,214,14,58,2,272,35,200,105,29,21
TATCAGTTTGCAGTTG,sample,19089,18344,3573,14771,1389,13382,2450,140,5836,564,8286,4392,3467,598,491,745
ATTCTCTTTGCAGTTG,sample,21750,21451,1127,20324,5889,14435,11099,862,1685,227,12784,562,1210,1011,4444,3917
AAGTTCGTTGCAGTTG,sample,11314,11056,1295,9761,2180,7581,2902,227,2705,349,5607,1398,2208,932,453,1322
TTCTAATGTGCAGTTG,sample,37114,36383,4147,32236,4298,27938,9505,571,11249,1124,20754,5489,4245,1393,1229,2830
TTAGAAGTTGCAGTTG,sample,41968,41503,4154,37349,8309,29040,11296,678,9267,1149,20563,6650,4733,1112,4115,5262
CAAGGCCTTGCAGTTG,sample,61803,61181,2799,58382,18767,39615,30231,1963,4916,467,35147,2038,1801,1504,10841,11904
CCAGAGCGTGCAGTTG,sample,31354,31065,1837,29228,9815,19413,11667,945,4238,529,15905,2034,3074,1947,3133,5821
GGAGGACGTGCAGTTG,sample,52136,51625,2953,48672,9001,39671,22914,1485,10331,1159,33245,3782,3688,1842,6502,6319
CCATGAAGTGCAGTTG,sample,80768,79841,5750,74091,9759,64332,27520,1133,23766,2651,51286,9262,5294,1625,7521,6909
CGTACGTCTGCAGTTG,sample,41796,41335,2544,38791,6740,32051,18057,1392,7600,814,25657,4188,3782,2004,3400,4935
TTGGTACCTGCAGTTG,sample,49243,48841,1893,46948,8869,38079,28531,2452,5005,476,33536,1615,2919,2472,6153,6423
CTAGGACCTGCAGTTG,sample,49498,49016,1966,47050,14541,32509,22970,1669,5479,537,28449,1854,1940,1354,8306,9209
AATATATCTGCAGTTG,sample,61381,60663,6132,54531,9944,44587,13732,995,16204,1806,29936,11850,6473,1278,3786,6500
AAGAGCGCTGCAGTTG,sample,54760,54108,5212,48896,7343,41553,17483,1364,13330,1376,30813,8000,5609,1583,3113,4944
CCAATTCCTGCAGTTG,sample,52861,52232,4732,47500,8258,39242,17561,1018,11768,1369,29329,7526,5325,1347,4865,5391
TTGGTTAATGCAGTTG,sample,24188,23944,2364,21580,3348,18232,5756,422,7041,753,12797,4260,3703,1102,1170,2207
GGCATATATGCAGTTG,sample,52206,51589,4292,47297,8884,38413,19323,1356,9978,1263,29301,6493,4838,1454,5386,6153
TCGCCTGATGCAGTTG,sample,38622,38184,3497,34687,7008,27679,13808,1275,6944,682,20752,4970,3991,1290,4167,4567
CTTCATGATGCAGTTG,sample,30217,29799,2473,27326,4848,22478,9448,790,7341,778,16789,4121,3945,1251,1615,3128
TTATTCGATGCAGTTG,sample,31267,30962,1857,29105,7998,21107,12993,987,4584,589,17577,1954,2337,1065,4133,5179
AAGTTCGTTCATGCTG,sample,17445,17250,821,16429,5230,11199,8391,461,1535,191,9926,621,943,768,3957,3228
GGTTGCGTTCATGCTG,sample,23413,23086,1955,21131,4369,16762,9422,578,4210,387,13632,2165,2656,1205,3094,2981
ACGTAAGTTCATGCTG,sample,23363,23081,1803,21278,5008,16270,9124,767,3998,403,13122,1978,2613,1439,2735,3465
TAGTACGGTCATGCTG,sample,31963,31299,3876,27423,5029,22394,10080,527,6796,779,16876,4212,3901,1178,3881,3435
TTAGAAGTTCATGCTG,sample,19082,18812,1437,17375,2835,14540,7935,581,4212,377,12147,1435,2395,1246,1589,1974
GGACCTCTTCATGCTG,Neg_Ctrl,748,445,265,180,40,140,55,4,49,5,104,27,77,35,15,12
CCAGAGCGTCATGCTG,sample,13803,13496,2041,11455,2322,9133,2590,159,3466,348,6056,2570,2806,733,776,1416
CCGCAACGTCATGCTG,sample,14710,14508,1199,13309,3080,10229,6397,351,2108,232,8505,1141,2216,1246,1506,2086
GGACGTAGTCATGCTG,Neg_Ctrl,837,509,327,182,45,137,69,3,41,3,110,21,79,38,17,8
GGCCAGAGTCATGCTG,sample,18485,18096,2328,15768,2715,13053,5104,365,4177,404,9281,3003,2972,848,1265,1691
CGAGGCAGTCATGCTG,sample,28509,27923,4179,23744,4641,19103,7456,359,6037,642,13493,4609,3874,1141,2400,2888
ACGACTTCTCATGCTG,sample,19664,19371,1672,17699,4257,13442,8377,435,2546,246,10923,1838,1957,1034,2929,2923
AATCCGTCTCATGCTG,sample,15458,15152,2455,12697,1303,11394,4472,277,3503,388,7975,2754,3098,1115,348,782
CGTACGTCTCATGCTG,Neg_Ctrl,755,540,217,323,56,267,132,18,74,6,206,37,138,69,50,24
CGGATTACTCATGCTG,sample,19183,18819,2060,16759,2733,14026,7713,486,3138,395,10851,2294,2662,1237,2007,1771
AACTCGTATCATGCTG,sample,18719,18482,1161,17321,4124,13197,9516,767,1817,171,11333,926,1719,1208,2172,2836
AATATATCTCATGCTG,Neg_Ctrl,525,314,164,150,35,115,62,2,26,3,88,22,66,36,11,8
ACCAATGCTCATGCTG,sample,6782,6622,530,6092,1397,4695,2763,214,1041,148,3804,529,1256,740,285,866
TGCTTCGCTCATGCTG,sample,11399,11217,1086,10131,1312,8819,3253,175,3433,354,6686,1604,1980,684,365,866
GTACCGTATCATGCTG,sample,17865,17596,1829,15767,2510,13257,6705,528,3445,336,10150,2243,2530,1004,2240,1731
TTATTCGATCATGCTG,sample,17005,16735,1635,15100,2797,12303,5845,367,3445,399,9290,2247,2426,742,1592,1806
GACCGGAATCATGCTG,sample,17148,16846,1972,14874,2434,12440,4378,308,4311,417,8689,3026,2867,785,1033,1558
ATTCTCTTTTAGGCGG,Pos_Ctrl,20900,20179,2660,17519,998,16521,13584,1141,1229,146,14813,421,4292,3784,1038,581
TCCAACTTTTAGGCGG,sample,50847,50008,3988,46020,10213,35807,21379,1250,7910,787,29289,4481,3182,1601,6436,7197
CCTCTAGATTAGGCGG,Pos_Ctrl,46671,44766,5782,38984,2301,36683,30333,2694,2582,307,32915,767,5944,6339,2230,1463
TTCGTAATTTAGGCGG,sample,63828,63022,4420,58602,14447,44155,26551,2025,10157,931,36708,4491,4328,2249,6233,9188
ACGTTATGTTAGGCGG,sample,95332,94525,5101,89424,28918,60506,46727,2774,8353,544,55080,2108,1684,1394,20952,18345
TTCTAATGTTAGGCGG,sample,129724,128768,9521,119247,29014,90233,43892,2287,26226,2720,70118,15108,7089,1968,15495,19102
AATGGTAATTAGGCGG,sample,67154,66139,5013,61126,14676,46450,32018,1983,7019,775,39037,4655,3423,1835,10367,9819
TTCCGTCTTTAGGCGG,sample,43354,42586,4153,38433,10438,27995,15596,1125,6480,737,22076,4057,4016,1717,4054,6228
CATAACCTTTAGGCGG,sample,57100,55974,5409,50565,10691,39874,21731,1414,10063,1243,31794,5423,4164,1741,6343,7229
GTTAGCCGTTAGGCGG,sample,81371,79905,8915,70990,16759,54231,27945,1934,13594,1331,41539,9427,5983,1864,10036,10911
GGAGGACGTTAGGCGG,sample,53532,52748,4493,48255,11457,36798,22556,1530,7801,825,30357,4086,4267,2075,6214,7444
GACGATAATTAGGCGG,sample,144976,143586,6523,137063,31018,106045,82493,5368,13095,1673,95588,3416,2971,1996,20719,21898
AATCCGTCTTAGGCGG,sample,83651,82649,9788,72861,17843,55018,25741,1520,14483,1693,40224,11581,5454,1730,11446,11289
CGTACGTCTTAGGCGG,sample,22219,21573,3634,17939,2824,15115,4135,298,5921,570,10056,4191,3690,845,907,1537
GTCCTGCCTTAGGCGG,sample,26103,25561,2949,22612,5236,17376,6922,614,5951,580,12873,3309,3223,1030,2109,3092
TTGGTACCTTAGGCGG,sample,84559,83291,8937,74354,12008,62346,30946,1666,17064,1789,48010,10881,6129,1738,7478,8422
CGGATTACTTAGGCGG,sample,50771,50145,3132,47013,10018,36995,23258,1542,7753,921,31011,3521,3559,2113,3967,7047
GTTAGGACTTAGGCGG,sample,55166,54373,4577,49796,11299,38497,19075,1177,11822,1130,30897,5293,4074,1316,5125,7730
CGTATGAATTAGGCGG,sample,108003,106868,6432,100436,22492,77944,50370,3578,14395,2004,64765,7597,4491,2020,13492,15674
CCAATTCCTTAGGCGG,sample,72229,71221,7823,63398,14960,48438,25847,2584,11341,1444,37188,7222,4607,1692,5525,9634
GTACCGTATTAGGCGG,sample,57062,56459,4204,52255,8838,43417,26520,2053,9136,995,35656,4713,4689,2393,4478,6156
CTTCATGATTAGGCGG,sample,57744,57126,3000,54126,16186,37940,23924,2088,7472,887,31396,3569,3364,1847,4333,10205
ATGACCGATTAGGCGG,sample,122493,121653,3942,117711,33640,84071,68496,6125,6144,478,74640,2828,1934,1697,17173,22152
TATCAGTTTCAGATAC,sample,13321,13145,737,12408,3357,9051,5626,335,1982,180,7608,928,1383,791,875,2104
TCCTCCGTTCAGATAC,sample,8479,8283,1404,6879,1219,5660,2556,181,1569,205,4125,1149,1683,714,628,728
CCTCTAGATCAGATAC,sample,22396,22044,1866,20178,3396,16782,9643,645,4099,391,13742,2004,2735,1354,2388,2208
TTCTAATGTCAGATAC,sample,5177,5019,838,4181,710,3471,1379,83,1085,108,2464,816,1111,378,533,429
AATGGTAATCAGATAC,sample,911,853,257,596,81,515,110,8,204,29,314,164,228,51,31,40
GACGGAGATCAGATAC,sample,4965,4891,956,3935,366,3569,724,40,1477,164,2201,1164,1311,238,213,214
GTTAGCCGTCAGATAC,sample,15949,15729,1167,14562,4369,10193,6757,525,1982,156,8739,773,1445,913,2485,2808
GGACGTAGTCAGATAC,sample,14372,14119,1520,12599,2950,9649,5379,362,2156,243,7535,1509,1930,810,2076,1934
TGGACGAGTCAGATAC,sample,96560,95508,5642,89866,20399,69467,45702,3032,12645,1923,58347,6165,3718,1571,13810,13893
CATTGCAGTCAGATAC,sample,25707,25211,3999,21212,3004,18208,6535,345,6008,718,12543,4602,4063,921,1981,1820
CGAGGCAGTCAGATAC,sample,37166,36570,3297,33273,6132,27141,13580,1062,7543,685,21123,4271,3659,1139,4283,4152
ACGACTTCTCAGATAC,sample,25579,25184,3038,22146,4338,17808,8929,694,4325,526,13254,3334,2715,860,3374,2662
CATGATTCTCAGATAC,sample,35162,34853,1316,33537,9998,23539,18969,1427,2324,210,21293,609,1210,1149,5340,6623
GTCCTGCCTCAGATAC,sample,132176,130788,8332,122456,28360,94096,62484,4176,16300,1573,78784,9563,5720,2171,17096,19214
CTAGGACCTCAGATAC,sample,123779,122588,5965,116623,28489,88134,63234,4914,11975,1589,75209,6422,3951,1851,17688,18860
TCAATATATCAGATAC,sample,76722,76104,2890,73214,20764,52450,40027,4029,6446,790,46473,1158,1170,1082,11678,13914
AGGTCGGATCAGATAC,sample,30562,30166,3331,26835,4608,22227,11581,971,5331,558,16912,3786,3319,1077,2144,2889
TTATTCGATCAGATAC,sample,21254,20933,3323,17610,2407,15203,4960,472,5356,586,10316,3829,3545,840,1484,1339
GGAGAGTTTCGCTAGG,sample,354618,349069,48910,300159,52679,247480,93173,5993,79028,8376,172201,60910,15752,3632,30395,34077
TCCAACTTTCGCTAGG,Neg_Ctrl,3200,1494,1061,433,80,353,158,18,102,2,260,73,161,69,26,19
ACGTAAGTTCGCTAGG,sample,94000,92467,9512,82955,12188,70767,29696,1671,23549,3331,53245,12520,6021,1854,6963,7763
AGTACCATTCGCTAGG,Neg_Ctrl,2826,1742,1349,393,58,335,180,11,80,12,260,52,182,72,49,12
CAACCGCGTCGCTAGG,sample,83618,82163,9487,72676,12897,59779,30420,1731,16059,1403,46479,10166,5652,1485,11070,8960
TCGCATCTTCGCTAGG,sample,22099,21727,1849,19878,4704,15174,9390,469,3205,439,12595,1671,2127,1058,3430,3218
CTAGGACCTCGCTAGG,sample,131271,129546,14432,115114,13094,102020,34040,2390,38901,4766,72941,21923,9057,2395,3587,7896
ACGTATTATCGCTAGG,sample,121990,120028,16418,103610,10468,93142,25002,1900,35826,4759,60828,25655,9776,1942,2848,6268
CGTATGAATCGCTAGG,sample,55833,55334,2134,53200,8077,45123,31423,1872,8377,944,39800,2507,2736,1803,7657,5825
AATATATCTCGCTAGG,sample,75325,74346,7564,66782,10667,56115,20913,1321,18223,2098,39136,13560,7037,1543,6223,6745
AAGAGCGCTCGCTAGG,sample,62924,62276,4125,58151,10625,47526,29014,2484,9034,1310,38048,5684,4492,1562,7074,7618
TTGGTTAATCGCTAGG,sample,65500,64847,4256,60591,8396,52195,33463,2308,10379,1192,43842,4853,4253,1991,5807,5824
GTACCGTATCGCTAGG,Pos_Ctrl,31949,31169,3542,27627,1369,26258,21793,1978,1791,206,23584,490,5138,5283,1141,758
TCGCCTGATCGCTAGG,sample,79351,78557,7221,71336,8734,62602,30487,1986,16712,2051,47199,11366,6913,1876,5031,5828
ATGACCGATCGCTAGG,sample,40292,39773,3259,36514,6501,30013,14172,1344,8401,1042,22573,5054,4080,1194,2806,4360
GACCGGAATCGCTAGG,sample,23783,23549,1512,22037,2581,19456,8653,774,6780,742,15433,2507,2987,1401,692,1859
ATTCTCTTCCGTTGCG,sample,235227,231192,25155,206037,31456,174581,83724,5313,47638,5278,131362,32628,10329,3063,24888,20373
AAGTTCGTCCGTTGCG,sample,113082,111135,8236,102899,25569,77330,42488,2825,19729,1854,62217,10434,5488,2036,8073,16316
GGTTGCGTCCGTTGCG,sample,135861,132807,16879,115928,20702,95226,38956,4084,29862,3248,68818,19076,7900,2043,7253,12960
TCCTCCGTCCGTTGCG,sample,96335,94981,7837,87144,24564,62580,34021,2413,16213,1864,50234,8069,5260,1725,10104,15526
TTCGTAATCCGTTGCG,sample,255799,254189,7540,246649,56592,190057,146966,13577,20576,2003,167542,6935,4180,2801,31786,36966
TTCTAATGCCGTTGCG,sample,197339,195089,17799,177290,30144,147146,70369,5457,42457,4925,112826,23938,8622,2281,20328,20571
TGAGCGCGCCGTTGCG,sample,253512,250379,22877,227502,33101,194401,76639,5026,60627,6755,137266,45354,10233,2830,25610,24183
TTCCGTCTCCGTTGCG,sample,154687,153065,8330,144735,33396,111339,79355,5190,17839,1768,97194,7187,4003,2448,22770,22379
GGACCTCTCCGTTGCG,sample,99696,98647,5140,93507,20089,73418,50050,3254,13618,1585,63668,4911,3802,2418,14199,14243
CAAGGCCTCCGTTGCG,sample,229937,226510,24097,202413,33081,169332,73748,5491,49606,5454,123354,35033,10766,3201,20155,20980
ACGACTTCCCGTTGCG,sample,80869,79868,7184,72684,13284,59400,30030,2458,15879,1803,45909,9230,5208,1867,8653,9349
AGTCCGCACCGTTGCG,sample,238501,235811,18049,217762,41108,176654,89340,7364,47226,4815,136566,27909,8495,2537,25563,29077
CTAGGACCCCGTTGCG,sample,168559,167176,6923,160253,36069,124184,95690,8268,11709,1531,107399,6986,5872,4306,16086,24898
GCCTGAACCCGTTGCG,sample,145746,143889,13786,130103,22359,107744,53048,4411,29556,3256,82604,17473,7671,2024,16090,14513
CGTATGAACCGTTGCG,sample,138157,136884,6664,130220,20735,109485,69118,4633,23595,3150,92713,8989,4928,2286,13676,14649
AATATATCCCGTTGCG,sample,175850,173639,20396,153243,21493,131750,51669,3055,42148,4411,93817,30467,10614,2480,14569,13333
GAAGGCGCCCGTTGCG,sample,95493,94492,8557,85935,12363,73572,34139,3097,21958,2353,56097,12025,6695,2208,5117,7651
AAGAGCGCCCGTTGCG,sample,146895,145510,10930,134580,19305,115275,56455,4645,32332,4687,88787,17156,7131,2398,9738,13129
CCAATTCCCCGTTGCG,sample,173669,171934,12418,159516,28708,130808,66668,5414,36066,4603,102734,18057,7454,2158,17893,18797
CTTCATGACCGTTGCG,sample,133181,131685,11367,120318,22163,98155,44673,3230,28011,3228,72684,19013,7692,2145,8631,14036
TTCGTAATAGGCCAAG,sample,142918,140984,11611,129373,21933,107440,55930,3936,32103,3586,88033,11885,6208,2607,10328,13709
ATGCCTGGAGGCCAAG,sample,158146,155905,15010,140895,25386,115509,62313,4834,28877,3200,91190,16285,9050,3468,12585,17037
TAGTACGGAGGCCAAG,sample,57547,56780,5498,51282,12322,38960,21313,1694,9506,1044,30819,5403,5668,3068,3612,7928
TTCCGTCTAGGCCAAG,sample,122894,120073,19341,100732,15191,85541,25745,1786,31682,3360,57427,22968,10131,2780,5240,8870
ACTATACTAGGCCAAG,sample,139481,136208,21783,114425,15482,98943,32821,2120,33856,3816,66677,26330,9962,2747,5262,8459
GTTAGCCGAGGCCAAG,sample,150451,148015,17993,130022,22965,107057,49236,2788,31612,2989,80848,20432,8114,2045,15090,14698
CTTGATAGAGGCCAAG,sample,217340,214685,16258,198427,35839,162588,85019,6047,44867,5422,129886,21233,7637,2298,24985,24404
CGAGGCAGAGGCCAAG,sample,151067,149526,7317,142209,19564,122645,78946,6312,25570,3089,104516,8728,5005,2946,14331,13343
ACGACTTCAGGCCAAG,sample,169331,167556,11034,156522,35928,120594,63969,5147,31967,3847,95936,15664,6862,1955,19577,23805
CATGATTCAGGCCAAG,sample,270324,267405,18763,248642,41379,207263,121107,7793,45463,5219,166570,27681,8829,2867,23252,28146
AATCCGTCAGGCCAAG,sample,146521,143776,20892,122884,17472,105412,41506,3074,33620,3746,75126,23466,10533,3299,8311,11005
AGTCCGCAAGGCCAAG,sample,235506,233178,17595,215583,36899,178684,92710,6081,46273,5336,138983,28284,8767,2502,29179,25962
TTGGTACCAGGCCAAG,sample,127987,126787,8152,118635,24653,93982,60505,4452,18497,2180,79002,8348,5337,2545,15981,16625
GTTAGGACAGGCCAAG,sample,83609,82798,6349,76449,12786,63663,36193,2869,15013,1980,51206,7608,5991,2775,7550,8645
ACCAATGCAGGCCAAG,sample,70836,70175,3403,66772,6787,59985,33762,2755,16629,2070,50391,4769,4708,2402,2901,4504
GAAGGCGCAGGCCAAG,sample,152990,151742,9669,142073,27615,114458,59955,4215,31359,3595,91314,15334,6953,1942,15262,19297
AAGAGCGCAGGCCAAG,sample,173453,172473,5055,167418,37832,129586,86768,7437,25288,3130,112056,6963,4245,2205,19715,26137
GGCATATAAGGCCAAG,Neg_Ctrl,2757,1217,742,475,78,397,238,20,94,1,332,44,244,120,53,18
TTATTCGAAGGCCAAG,sample,24904,24698,1085,23613,5852,17761,10141,1213,4029,460,14170,1918,2369,1054,2186,3783
CCTCTAGAAGAACCGC,sample,78904,76325,13683,62642,10457,52185,18029,1194,17786,2035,35815,13141,6544,1425,6236,6157
TAGTACGGAGAACCGC,sample,310303,308331,11873,296458,65988,230470,153615,10926,43807,6490,197422,15632,7215,3052,42904,45932
AATGGTAAAGAACCGC,sample,267849,265720,10926,254794,77240,177554,132408,6690,24355,4557,156763,9544,2008,1508,59297,51650
CATAACCTAGAACCGC,sample,153035,151449,9086,142363,32232,110131,63820,4929,28587,2809,92407,9986,5616,2240,17461,22797
GGAGGACGAGAACCGC,sample,109438,108351,7744,100607,12239,88368,41973,3186,28665,3669,70638,10875,5889,2663,6619,8607
CCGCAACGAGAACCGC,sample,129049,127580,9145,118435,28889,89546,56524,3402,18727,2349,75251,8544,4897,1729,22376,19359
CTTGATAGAGAACCGC,sample,212665,211243,8218,203025,57605,145420,112542,6367,16900,2427,129442,7184,2884,1963,43856,38216
ACCTCGAGAGAACCGC,sample,90219,88764,9798,78966,16421,62545,29711,2024,16910,2153,46621,11747,6498,2035,10082,9882
ACGACTTCAGAACCGC,sample,277817,275215,17008,258207,55818,202389,123020,11154,41742,4488,164762,21985,8041,2670,38887,38211
CGTACGTCAGAACCGC,sample,237046,234651,16338,218313,42876,175437,106736,6511,37946,4363,144682,19881,7956,2634,29636,29771
AGTCCGCAAGAACCGC,sample,174435,172756,11407,161349,34400,126949,89489,6345,18694,1945,108183,10476,6273,2844,19823,22787
CTAGGACCAGAACCGC,sample,136718,135248,11652,123596,20906,102690,48365,3353,32178,3025,80543,15769,7175,2190,16976,13780
CGGATTACAGAACCGC,sample,161452,159166,15349,143817,21247,122570,53042,3247,41513,4686,94555,20082,7563,2234,7617,13874
GCCTGAACAGAACCGC,sample,159648,157412,15427,141985,31734,110251,52955,3551,29987,3538,82942,20220,8403,2284,14272,20572
AACTCGTAAGAACCGC,sample,91906,90714,9057,81657,14803,66854,30754,2510,19621,2284,50375,11685,6051,1442,10943,9794
AAGAGCGCAGAACCGC,sample,206789,203837,25895,177942,27787,150155,48635,4034,52919,5721,101554,38846,11590,2419,9952,17823
GTCTTAGCAGAACCGC,sample,168916,166900,12576,154324,27739,126585,71129,4621,29065,3298,100194,18472,8326,2464,21085,18506
CTTCATGAAGAACCGC,sample,239025,236498,16512,219986,40033,179953,117211,7637,30839,3413,148050,20853,8344,2936,18962,26381
TTATTCGAAGAACCGC,sample,177888,176319,15595,160724,29293,131431,65261,5829,32655,2971,97916,24715,7934,1952,19722,19136
GGAGAGTTCATCAAGC,sample,20311,20098,1372,18726,4686,14040,8815,579,2907,324,11722,1415,2155,1192,3117,3066
TCCTCCGTCATCAAGC,sample,163201,161222,9237,151985,21984,130001,75906,5475,33969,4415,109875,10236,5181,2476,14539,14482
ATGCCTGGCATCAAGC,sample,94178,92854,8068,84786,10889,73897,33390,2669,25830,2489,59220,9519,4994,1917,9070,7478
TGAGCGCGCATCAAGC,sample,247830,244179,25199,218980,34804,184176,92400,5449,44441,4987,136841,36899,10296,2856,26414,23335
TTCCGTCTCATCAAGC,sample,148847,146666,15028,131638,23834,107804,41564,2625,38301,4526,79865,20788,8070,1846,8712,16504
CCAGAGCGCATCAAGC,sample,72641,71549,6733,64816,15047,49769,27559,1750,11701,1385,39260,7374,5351,2028,8553,9973
TGGACGAGCATCAAGC,sample,141089,139701,8424,131277,28894,102383,66075,4334,20824,2227,86899,8923,4983,2627,16712,19524
CGAGGCAGCATCAAGC,sample,136363,134634,9781,124853,19238,105615,46528,4081,36614,4515,83142,13877,6254,1917,9003,13170
CGTACGTCCATCAAGC,sample,232149,227820,36113,191707,26137,165570,47226,3320,60092,6774,107318,48158,14290,3186,13366,15265
AACTCGTACATCAAGC,sample,231053,229269,17218,212051,36230,175821,108311,9532,32636,3459,140947,21883,8849,3302,15164,25300
CGTATGAACATCAAGC,sample,195133,192543,20277,172266,26830,145436,62367,3742,41980,4388,104347,32959,8930,2003,20269,16841
TTGGCCTCCATCAAGC,Pos_Ctrl,66693,65468,7390,58078,2973,55105,46303,4064,3290,403,49593,1045,6575,7835,3008,1471
GAAGGCGCCATCAAGC,sample,107367,106574,3574,103000,29715,73285,53790,4628,9788,1211,63578,3868,2987,1812,13004,19017
GACCGGAACATCAAGC,sample,87611,86806,7138,79668,14329,65339,32314,2655,18180,2084,50494,10106,6531,2241,3965,9088
GGAGAGTTAGAGAGCC,sample,56790,56176,3716,52460,11983,40477,26174,1658,7731,779,33905,4135,2975,1353,9681,8261
TATCAGTTAGAGAGCC,sample,46039,45160,4930,40230,6636,33594,16844,994,8575,941,25419,6240,4854,1680,5296,4605
GGTTGCGTAGAGAGCC,sample,129742,127501,12118,115383,20957,94426,47717,3002,25412,2536,73129,15759,6688,1951,15479,13880
TTCGTAATAGAGAGCC,sample,158962,157139,12686,144453,36117,108336,66071,5281,23366,3180,89437,10438,4329,1672,26505,24873
TTCTAATGAGAGAGCC,sample,38086,37413,5134,32279,6320,25959,10530,762,8109,998,18639,5560,4076,1098,3410,3971
ATGCCTGGAGAGAGCC,sample,75905,74831,5645,69186,13274,55912,26154,2110,17336,2620,43490,7692,4917,1532,4947,8660
TAGTACGGAGAGAGCC,sample,140711,139198,10892,128306,19997,108309,58050,3806,29688,3698,87738,13067,6661,2458,14834,13722
AATGGTAAAGAGAGCC,sample,127048,125664,8790,116874,23943,92931,52320,4266,23005,2772,75325,10568,6188,3037,8110,16058
GCCTTGCTAGAGAGCC,sample,72279,70868,6791,64077,12540,51537,26834,1795,13105,1332,39939,8471,5680,1879,8792,8519
GGACGTAGAGAGAGCC,sample,69274,68821,2415,66406,16588,49818,36886,2946,7046,974,43932,1966,3805,3378,6202,11273
GTCCTGCCAGAGAGCC,sample,68482,67029,10252,56777,9782,46995,13058,1167,17823,1891,30881,13056,7102,1683,2554,5747
TTGGTACCAGAGAGCC,sample,148078,146592,12604,133988,23633,110355,48007,3702,32459,3370,80466,22817,8279,2144,13909,14864
GTTAGGACAGAGAGCC,sample,114726,112785,15724,97061,16343,80718,21968,1337,32621,3128,54589,21664,8619,1707,4061,10259
GCCTGAACAGAGAGCC,sample,114608,112934,9974,102960,18371,84589,45845,3275,21011,2087,66856,12371,6587,2046,12220,11859
AACTCGTAAGAGAGCC,sample,111507,110623,4487,106136,23602,82534,60572,4013,12709,1611,73281,3629,2884,1557,16426,15326
TTGGCCTCAGAGAGCC,sample,84795,83712,9242,74470,10359,64111,22747,2003,22990,2362,45737,14009,7494,2072,4451,6366
TGCTTCGCAGAGAGCC,sample,43882,43239,5135,38104,6025,32079,12512,851,10489,990,23001,7237,4728,1158,3638,3560
AAGAGCGCAGAGAGCC,sample,89428,88430,6962,81468,14688,66780,39457,3059,14527,1504,53984,8233,5200,1859,10738,9830
GTCTTAGCAGAGAGCC,sample,62498,61930,3608,58322,10423,47899,29696,2265,10476,1319,40172,4143,4042,1988,5648,7275
ATTCTCTTAGCATTGA,sample,6885,6683,1201,5482,1527,3955,958,86,1573,222,2531,1116,1463,360,237,808
GGTTGCGTAGCATTGA,sample,320672,316848,31457,285391,52180,233211,71739,5245,82721,9377,154460,64129,14169,3335,18335,33955
AGTACCATAGCATTGA,sample,247533,244678,15892,228786,53106,175680,91567,5935,46425,5484,137992,26269,8648,2381,31666,35821
ACGTTATGAGCATTGA,sample,222334,220559,8628,211931,49924,162007,119957,8202,24028,2857,143985,6963,5351,3503,30139,33891
TTCTAATGAGCATTGA,sample,254898,253156,10313,242843,60001,182842,144824,11283,17344,2057,162168,7334,4741,3488,29431,41048
ATGCCTGGAGCATTGA,sample,89418,88502,4889,83613,16794,66819,37736,2509,17573,1814,55309,7187,4527,1954,13179,11385
CAACCGCGAGCATTGA,sample,135061,133606,6542,127064,20045,107019,65951,4395,25687,2681,91638,8305,4575,2215,16956,14447
TTCCGTCTAGCATTGA,sample,197229,195054,12578,182476,34578,147898,82323,5008,36298,3771,118621,20498,8255,2793,14433,23367
CTTGATAGAGCATTGA,sample,208439,206293,12541,193752,41050,152702,92781,6670,34960,3479,127741,14812,5484,2018,28272,28478
ACCTCGAGAGCATTGA,sample,119560,118318,5187,113131,18535,94596,59257,4632,21420,2672,80677,6615,4698,2601,14345,12827
TGGACGAGAGCATTGA,sample,152145,150483,10087,140396,28221,112175,63824,5231,27561,2665,91385,12894,6051,2233,20986,19664
GACGATAAAGCATTGA,sample,150587,148984,8186,140798,26799,113999,74270,6320,22460,2586,96730,8363,5697,3053,16301,18103
CGAGGCAGAGCATTGA,sample,109106,107770,7877,99893,19524,80369,38193,2626,24554,2919,62747,12077,5412,1847,11781,13526
CCATGAAGAGCATTGA,sample,210130,208000,11011,196989,38677,158312,78534,6319,49133,6001,127667,18325,6890,2393,15037,28496
ACGACTTCAGCATTGA,sample,189255,187688,7810,179878,52627,127251,94961,6434,16449,1826,111410,7581,5339,3054,16919,33861
AATCCGTCAGCATTGA,sample,212703,210766,8804,201962,34462,167500,124018,6986,24408,2434,148426,9654,5900,3018,22826,24823
CGGATTACAGCATTGA,sample,131053,129556,10111,119445,16680,102765,47361,3879,34260,3868,81621,13397,6282,2426,11386,10944
AATATATCAGCATTGA,Neg_Ctrl,2989,1706,1093,613,97,516,226,18,136,8,362,128,203,103,60,39
GAAGGCGCAGCATTGA,sample,25224,24834,3009,21825,2739,19086,4653,416,8447,1001,13100,4569,4013,1065,388,1507
GACCGGAAAGCATTGA,sample,241667,239997,9979,230018,47422,182596,119932,11264,30972,3203,150904,17225,7538,2588,26676,30566
AAGTTCGTAATTACCA,sample,49047,48332,4618,43714,7279,36435,16224,1109,11478,1216,27702,6408,3741,1412,4993,4947
AGTACCATAATTACCA,sample,180681,178829,15723,163106,28317,134789,71720,4198,32474,4584,104194,21813,7794,2077,26085,18870
ATGCCTGGAATTACCA,sample,101654,100815,4539,96276,16358,79918,48956,3784,19427,2492,68383,5259,3891,2061,13486,11827
AATGGTAAAATTACCA,sample,103804,102563,7701,94862,16078,78784,45026,3235,19581,2352,64607,8590,5066,1881,12209,11163
GGACCTCTAATTACCA,sample,154423,152807,12231,140576,21995,118581,77363,5154,20245,2402,97608,13417,6806,2836,19434,14372
TCGCATCTAATTACCA,sample,107424,105885,16764,89121,16596,72525,25699,2050,23733,2594,49432,18449,9537,1937,8685,10080
GCCTTGCTAATTACCA,sample,117750,116819,4377,112442,29954,82488,63231,4092,10516,1328,73747,3321,2271,1687,25234,20061
CAAGGCCTAATTACCA,sample,101042,99839,8084,91755,25954,65801,39702,3062,13525,1252,53227,8260,5774,2587,10668,16588
GGACGTAGAATTACCA,sample,175342,172787,17443,155344,17591,137753,55810,3702,42709,4261,98519,31271,9353,1965,7478,11171
TGGACGAGAATTACCA,sample,169735,168154,7935,160219,26805,133414,104516,6574,14020,1361,118536,6943,4824,2742,17276,18864
CGAGGCAGAATTACCA,sample,133385,131893,10994,120899,20914,99985,57466,3214,22462,2783,79928,14060,7318,2033,18984,13927
CCATGAAGAATTACCA,sample,30522,30100,2567,27533,2680,24853,15995,1306,4880,611,20875,2061,4495,3438,582,1714
AATCCGTCAATTACCA,sample,138721,137032,12448,124584,17561,107023,59253,4306,24777,2359,84030,16328,7572,2515,12839,11547
AGTCCGCAAATTACCA,sample,103319,102033,9130,92903,16967,75936,43162,3388,17991,1970,61153,9425,5857,1809,11785,11094
CTAGGACCAATTACCA,sample,159245,157377,11302,146075,23291,122784,77939,5232,22095,2629,100034,14889,7530,2374,27285,16428
AATATATCAATTACCA,sample,98250,97269,6637,90632,15193,75439,46554,3867,15125,1564,61679,8329,4831,2276,8690,10636
GAAGGCGCAATTACCA,sample,84282,83460,4933,78527,15722,62805,40277,2937,11670,1652,51947,6269,3533,1620,10772,10620
AAGAGCGCAATTACCA,sample,202171,200546,7831,192715,31803,160912,136041,10180,8835,1094,144876,4762,2167,1990,22956,23283
TTGGTTAAAATTACCA,sample,63345,62373,9836,52537,5946,46591,12492,728,18245,2032,30737,13094,6635,1422,1395,3559
GTACCGTAAATTACCA,sample,94932,93654,10777,82877,18117,64760,26582,1400,21716,2057,48298,13005,6640,1460,8418,11300
TCAATATAAATTACCA,sample,97704,96720,7703,89017,14627,74390,46961,2482,15029,1646,61990,8272,4891,1675,10515,9975
TCGCCTGAAATTACCA,sample,40495,40051,2055,37996,10515,27481,18759,1601,4880,493,23639,1748,2136,1183,6506,6897
TTATTCGAAATTACCA,sample,94130,93033,8344,84689,12122,72567,35122,2506,19556,2063,54678,13320,6579,1672,7178,8054
ATTCTCTTTAGATGAC,Pos_Ctrl,53933,52978,5018,47960,2381,45579,38140,3679,2603,310,40743,847,6053,7059,2339,1157
TCCTCCGTTAGATGAC,sample,27931,27688,1914,25774,6287,19487,12871,813,3445,409,16316,1949,2724,1658,4120,4024
CCTCTAGATAGATGAC,sample,93028,91636,9417,82219,15794,66425,26739,2051,21890,2334,48629,13411,6636,1607,6920,9711
AGTACCATTAGATGAC,sample,182369,180568,10728,169840,31745,138095,89327,5875,26694,3381,116021,12818,6312,2594,21867,20962
ACGTTATGTAGATGAC,Pos_Ctrl,55204,53328,6963,46365,2838,43527,35933,3119,3058,366,38991,1051,6367,6919,2774,1545
TAGTACGGTAGATGAC,sample,124051,122952,6691,116261,21045,95216,75566,6458,8288,858,83854,4046,4221,3359,15631,14672
TTCCGTCTTAGATGAC,Pos_Ctrl,53531,52261,6184,46077,2524,43553,36323,3028,2901,384,39224,917,6239,6721,2883,1341
GCCTTGCTTAGATGAC,sample,114109,112430,13362,99068,15384,83684,28896,1953,29377,3341,58273,20117,8390,1986,7233,9899
CATAACCTTAGATGAC,sample,38462,37581,6564,31017,5682,25335,8946,724,8300,990,17246,6375,4865,1464,2484,3316
GACGGAGATAGATGAC,sample,87890,86509,8773,77736,13829,63907,33706,1826,16961,1697,50667,9717,5815,1551,14998,9125
GTTAGCCGTAGATGAC,sample,99965,98782,7496,91286,16114,75172,46630,2590,16745,1597,63375,7610,4988,1835,15288,11471
GGAGGACGTAGATGAC,sample,55441,54448,6750,47698,9585,38113,18891,1428,9847,1166,28738,6781,5251,1967,5003,6178
GACGATAATAGATGAC,sample,45424,44516,8024,36492,5040,31452,11196,782,10666,1126,21862,7682,5913,1736,1823,2761
CATTGCAGTAGATGAC,sample,72895,71761,6716,65045,12736,52309,24856,1529,14868,1755,39724,9301,5210,1355,6786,7930
ACGACTTCTAGATGAC,sample,147497,145750,12255,133495,25921,107574,58907,4668,25196,2508,84103,16295,7911,2769,13894,17480
CGTACGTCTAGATGAC,sample,109057,107724,6433,101291,19091,82200,50613,3335,18227,2176,68840,7849,4651,1638,10319,12782
AGTCCGCATAGATGAC,sample,171374,169674,9784,159890,28483,131407,86092,6634,24532,2619,110624,11530,5156,2151,17265,20420
GTCCTGCCTAGATGAC,sample,148808,147148,9521,137627,22853,114774,68057,5533,25919,2603,93976,12662,7096,2812,12248,15804
CTAGGACCTAGATGAC,sample,181702,178601,30984,147617,30176,117441,41412,3241,42407,4935,83819,25446,11463,3650,6788,17498
GCCTGAACTAGATGAC,sample,137543,135712,10780,124932,15547,109385,48454,3948,36804,3915,85258,16264,6964,2152,10437,10446
AATATATCTAGATGAC,sample,113186,112218,7978,104240,19410,84830,48336,4357,19040,1802,67376,11295,5320,1826,10308,12809
TGCTTCGCTAGATGAC,sample,109331,108319,3498,104821,13894,90927,70137,4739,11201,1246,81338,3604,4027,3259,4686,9701
GTCTTAGCTAGATGAC,sample,174760,172911,11529,161382,26789,134593,87835,5598,23693,3108,111528,14359,7634,2326,19756,19489
GGCATATATAGATGAC,sample,279894,277328,13494,263834,32141,231693,172179,9742,29192,3445,201371,17135,7673,2902,16897,22798
TCGCCTGATAGATGAC,sample,149551,148389,6496,141893,24302,117591,79539,6304,20854,3515,100393,7379,4778,2178,11545,16686
CTTCATGATAGATGAC,sample,142503,140190,18270,121920,16691,105229,33745,2237,38538,3805,72283,26904,9945,2021,4535,10038
AGGTCGGATAGATGAC,sample,256676,254479,16224,238255,47091,191164,112870,9604,38083,4521,150953,26086,8654,2185,27195,33702
TTATTCGATAGATGAC,sample,231877,229853,17847,212006,32978,179028,89353,8333,44988,4338,134341,32016,10292,2457,25238,21465
TATCAGTTGTTCAGAA,sample,175537,173626,8496,165130,32660,132470,87185,5333,27104,2982,114289,9866,4936,1938,29726,23288
ATTCTCTTGTTCAGAA,sample,225581,222889,13083,209806,35760,174046,97567,6965,47679,4464,145246,17371,5701,2321,27716,25898
AAGTTCGTGTTCAGAA,sample,212022,209335,13272,196063,33808,162255,105886,6353,30088,3329,135974,16599,7797,2690,32965,23137
TTAGAAGTGTTCAGAA,sample,213217,210736,13135,197601,33018,164583,105695,6822,30807,3393,136502,17866,7722,2824,21413,23716
GGACCTCTGTTCAGAA,sample,143225,140971,13046,127925,21870,106055,60509,3119,25055,3439,85564,13933,6475,1804,22060,14391
GCCTTGCTGTTCAGAA,sample,85721,84553,7298,77255,13915,63340,31188,1838,18261,2183,49449,9870,5960,2014,10331,9481
GTTAGCCGGTTCAGAA,sample,76756,75396,8537,66859,12283,54576,25661,1545,15402,1586,41063,10382,6043,1579,9938,7848
CCGCAACGGTTCAGAA,sample,46462,45702,3201,42501,8586,33915,20519,1082,8107,937,28626,3270,3244,1676,7064,5921
GACGATAAGTTCAGAA,sample,69162,68591,2126,66465,18226,48239,31424,2748,10010,1214,41434,2843,2956,1358,8750,11297
GGCCAGAGGTTCAGAA,sample,52398,51894,3244,48650,8519,40131,19343,1280,12200,1521,31543,5787,4340,1525,3475,5718
CGAGGCAGGTTCAGAA,sample,234778,233036,8533,224503,42719,181784,117052,7062,38957,5058,156009,13655,4941,2012,27872,31212
ACGACTTCGTTCAGAA,sample,249292,247148,13252,233896,43577,190319,106551,8977,44633,5015,151184,25143,9254,2684,25482,31269
CTAGGACCGTTCAGAA,sample,260246,258305,14026,244279,56795,187484,92769,9330,48864,5915,141633,30606,10449,3149,20654,37403
GTTAGGACGTTCAGAA,sample,265104,263029,16307,246722,45972,200750,120814,7552,43688,5002,164502,23694,8046,2309,33381,31477
TTGGCCTCGTTCAGAA,sample,224123,222856,8379,214477,46903,167574,129109,9011,21114,1990,150223,6350,3450,2058,32156,31135
TTGGTTAAGTTCAGAA,sample,146990,145629,11639,133990,19207,114783,52901,4453,32993,3743,85894,20693,8908,2630,1627,12052
AGGTCGGAGTTCAGAA,Pos_Ctrl,85584,84833,4883,79950,3974,75976,63933,6764,3520,502,67453,1257,6866,9667,4303,1770
TTATTCGAGTTCAGAA,sample,143151,142143,6057,136086,20224,115862,64990,6093,31058,3377,96048,10344,5650,2197,8822,14181
GACCGGAAGTTCAGAA,sample,143559,142676,3818,138858,32099,106759,79351,8550,12553,2056,91904,4249,3141,1778,15733,22643
GGAGAGTTTTCTGGTT,sample,168392,167420,7315,160105,43195,116910,80946,6947,16426,1920,97372,10671,6277,3261,15932,27847
TCCAACTTTTCTGGTT,Neg_Ctrl,4051,2014,1233,781,112,669,321,21,127,19,448,181,291,148,82,49
ACGTAAGTTTCTGGTT,sample,108016,106264,9980,96284,22721,73563,38946,2429,19036,2275,57982,10877,6340,2463,10658,14594
TTCGTAATTTCTGGTT,sample,218058,215590,15071,200519,31824,168695,96906,6335,40341,3934,137247,21179,6852,2162,28969,22402
ACGTTATGTTCTGGTT,sample,121770,119833,13421,106412,13877,92535,36884,3321,32950,3800,69834,15580,7250,1880,11536,8753
TTCTAATGTTCTGGTT,Neg_Ctrl,3335,1624,1038,586,85,501,217,16,176,12,393,80,242,93,58,27
GGACCTCTTTCTGGTT,Neg_Ctrl,2492,1363,824,539,86,453,175,8,195,11,370,64,190,87,43,44
GCCTTGCTTTCTGGTT,sample,200103,197581,14979,182602,31873,150729,88746,4945,33696,3545,122442,19797,7956,2809,22058,21358
CAAGGCCTTTCTGGTT,sample,160697,158587,11191,147396,24447,122949,75733,4326,26961,2646,102694,13283,6417,2454,12658,16376
TGGACGAGTTCTGGTT,sample,194827,191260,23283,167977,19051,148926,45814,2472,53563,5391,99377,41686,11759,2301,16544,11899
GACGATAATTCTGGTT,sample,247397,244504,20434,224070,23991,200079,78379,5076,71169,8177,149548,37278,10103,2924,11493,16246
CATTGCAGTTCTGGTT,sample,65620,64337,6413,57924,10486,47438,21527,1183,14781,1565,36308,8382,5650,1456,6714,6508
CGAGGCAGTTCTGGTT,sample,110728,108850,16069,92781,11718,81063,30364,2178,26494,2741,56858,19286,9549,2456,5375,7093
CCATGAAGTTCTGGTT,sample,123763,122526,6982,115544,18610,96934,64702,4817,16999,1773,81701,8643,4462,1920,20062,12930
CGTACGTCTTCTGGTT,sample,316643,312369,31359,281010,33371,247639,113725,7384,68820,7513,182545,50197,13750,3631,21911,21296
AGTCCGCATTCTGGTT,sample,257208,254939,15304,239635,50323,189312,126511,8245,31004,3353,157515,20199,8258,3083,29421,34946
TTGGTACCTTCTGGTT,sample,217894,215645,14458,201187,30595,170592,80547,5879,56826,6362,137373,20978,7398,2300,13009,18765
CGTATGAATTCTGGTT,sample,138241,136810,15541,121269,17949,103320,38467,2689,37976,3650,76443,20538,8907,1979,9798,11943
TTGGCCTCTTCTGGTT,sample,192110,190888,5733,185155,33995,151160,118715,8734,15104,1919,133819,6688,4070,2454,26947,23550
GTCTTAGCTTCTGGTT,sample,149810,148491,9657,138834,22345,116489,58873,6599,30382,3757,89255,16878,7535,2259,5032,14700
CCAATTCCTTCTGGTT,sample,115706,114718,3454,111264,21745,89519,59877,5226,15940,1452,75817,7024,3915,1779,17036,15988
TTGGTTAATTCTGGTT,sample,240879,239438,10447,228991,41709,187282,129513,10071,26817,2954,156330,17927,7309,2532,26516,28448
TTATTCGATTCTGGTT,sample,471,463,37,426,73,353,207,18,87,8,294,33,204,118,49,59
GGAGAGTTGTTCGGTT,sample,198518,195585,17779,177806,24786,153020,75558,3929,43756,5011,119314,24766,8472,2565,11443,16051
TATCAGTTGTTCGGTT,sample,234104,230663,18041,212622,38498,174124,96005,6764,42046,5157,138051,24152,9008,3082,22930,25335
TCCAACTTGTTCGGTT,sample,218749,216256,11072,205184,43979,161205,115194,9238,23775,2538,138969,10460,5753,2446,34451,30628
AGTACCATGTTCGGTT,sample,171602,168870,14999,153871,25363,128508,61561,4397,37128,4628,98689,20794,7921,2594,10557,17656
TTCTAATGGTTCGGTT,sample,222082,219240,18742,200498,33952,166546,83762,5513,44780,5151,128542,27340,9232,2531,25092,21784
AATGGTAAGTTCGGTT,sample,202127,200625,12239,188386,50804,137582,73555,6111,35262,3509,108817,19145,9034,3775,11969,32868
TTAGAAGTGTTCGGTT,sample,255905,253717,14145,239572,44297,195275,111913,6992,50871,6378,162784,19121,7413,2260,41554,30794
TTCCGTCTGTTCGGTT,sample,247632,245715,8539,237176,61877,175299,139186,8611,19240,3385,158426,4877,2476,1706,63122,43368
GCCTTGCTGTTCGGTT,sample,151126,149620,9686,139934,20386,119548,63055,4193,35240,4131,98295,12929,5798,2205,16829,13652
CCATGAAGGTTCGGTT,sample,424961,420998,23014,397984,62194,335790,202371,14904,69518,7910,271889,41087,9672,3254,48893,42981
CGTACGTCGTTCGGTT,sample,282854,280426,11930,268496,44161,224335,158549,16980,32484,3672,191033,12650,5639,2669,36478,31317
TTGGTACCGTTCGGTT,sample,232867,230459,21482,208977,38241,170736,69072,4370,53178,5622,122250,38494,11354,2946,17881,24517
CTAGGACCGTTCGGTT,sample,214076,211593,17115,194478,44233,150245,80041,6268,37664,3983,117705,22289,8118,2436,17926,28681
ACGTATTAGTTCGGTT,sample,414036,407124,52744,354380,40764,313616,107269,6964,104821,11147,212090,83415,17842,4848,22213,24117
CGTATGAAGTTCGGTT,sample,246650,244716,9140,235576,36199,199377,153314,10907,25379,2190,178693,7587,4716,2865,24657,27773
TGCTTCGCGTTCGGTT,sample,207070,204888,14137,190751,28373,162378,88661,5570,38953,4279,127614,24915,8828,2385,19453,18998
GTCTTAGCGTTCGGTT,sample,235976,233848,9139,224709,42748,181961,127325,13165,26705,2961,154030,11805,5811,2209,24745,29186
CCAATTCCGTTCGGTT,sample,229069,226582,12484,214098,26891,187207,112977,9387,40049,5560,153026,19234,7694,2560,17959,18477
TTGGTTAAGTTCGGTT,sample,386424,382837,28063,354774,45267,309507,164927,10279,71914,8190,236841,54197,11819,3276,44890,31476
GTACCGTAGTTCGGTT,sample,231498,229134,12047,217087,31434,185653,97420,8034,48989,4619,146409,26591,6680,1853,17078,21517
TCGCCTGAGTTCGGTT,sample,216241,214524,10495,204029,32260,171769,106440,9140,34973,4092,141413,17124,7659,2413,18615,22862
TTATTCGAGTTCGGTT,Neg_Ctrl,2263,1273,599,674,121,553,273,14,159,25,432,82,299,123,80,34
ACGTAAGTTGGCGGTT,sample,302447,298341,18392,279949,47011,232938,142765,8365,49865,6295,192630,25648,7322,2541,40167,33496
ACGTTATGTGGCGGTT,sample,256465,253986,12892,241094,46424,194670,146596,10439,24273,2549,170869,10813,5821,3195,34330,33424
TAGTACGGTGGCGGTT,sample,412315,408487,13462,395025,65982,329043,255009,17819,39892,3194,294901,13129,5751,3224,40674,50639
TCGCATCTTGGCGGTT,sample,300199,297813,10907,286906,77351,209555,165332,9698,24984,2329,190316,7212,2809,1794,61335,53038
CAAGGCCTTGGCGGTT,sample,390926,387686,14391,373295,74658,298637,259365,16158,14308,2213,273673,6593,4152,4319,42811,54680
GACGATAATGGCGGTT,sample,247265,243407,23401,220006,37909,182097,77560,4909,57418,5033,134978,37177,10813,2346,29666,23326
ACGACTTCTGGCGGTT,sample,486531,482304,18018,464286,90242,374044,282092,20319,47579,3601,329671,20453,5617,2891,69619,63699
CGGATTACTGGCGGTT,sample,333521,331119,13700,317419,59429,257990,155870,11327,60706,6868,216576,23219,6247,2510,52298,42852
GTTAGGACTGGCGGTT,sample,255941,252584,20010,232574,35767,196807,92941,5372,59706,6967,152647,31821,9080,2265,11249,24659
TGCTTCGCTGGCGGTT,sample,259826,258150,7455,250695,36578,214117,145814,13757,40022,4437,185836,10087,4968,2961,31202,27299
GTCTTAGCTGGCGGTT,sample,349635,346483,19839,326644,57327,269317,148090,14105,61661,6930,209751,38531,9898,2933,40080,39831
CCAATTCCTGGCGGTT,sample,261202,259296,10629,248667,36470,212197,127911,8912,50621,5497,178532,19256,8546,3827,20680,25781
TTGGTTAATGGCGGTT,sample,370456,367533,18441,349092,69343,279749,177819,16512,48391,5101,226210,31926,9271,3061,25051,47193
GGCATATATGGCGGTT,sample,439329,436383,14930,421453,86873,334580,261184,20821,33657,2994,294841,15924,6071,2327,42387,62466
TCAATATATGGCGGTT,sample,227267,225684,7852,217832,49534,168298,126367,11259,19404,3069,145771,8199,4724,2049,31503,35679
TCGCCTGATGGCGGTT,sample,383272,379997,20819,359178,37320,321858,179633,13618,67991,8326,247624,52290,11508,3479,19387,25394
CTTCATGATGGCGGTT,sample,58356,57740,2102,55638,16839,38799,26533,2104,6655,774,33188,2733,3121,1346,6293,10277
GGAGAGTTTCCTTATT,sample,17285,17166,593,16573,3863,12710,9727,821,1553,159,11280,450,1705,1453,2407,2722
ATTCTCTTTCCTTATT,sample,161600,160403,8398,152005,34076,117929,71696,5573,25288,2475,96984,12897,6253,2278,22163,23361
TCCAACTTTCCTTATT,sample,179363,177901,7344,170557,43334,127223,102628,6963,13184,1879,115812,2569,1950,1449,39611,30991
ACGTAAGTTCCTTATT,sample,188670,186912,11348,175564,29778,145786,101119,7265,22136,2805,123255,12461,7369,2742,23452,21547
AGTACCATTCCTTATT,sample,139061,138032,4679,133353,34759,98594,76987,6406,10504,1062,87491,3635,2958,2499,21179,23051
ACGTTATGTCCTTATT,sample,124759,123088,12011,111077,15492,95585,39766,2370,29674,4007,69440,19768,7862,2043,9246,10026
AATGGTAATCCTTATT,sample,109964,109287,3404,105883,37784,68099,53293,3432,7487,1039,60780,2848,2651,2190,15669,22785
ACTATACTTCCTTATT,sample,55214,54587,5371,49216,8101,41115,20144,1235,12076,1515,32220,6145,4635,1683,7004,5423
GTTAGCCGTCCTTATT,sample,62659,61936,5839,56097,13005,43092,21794,1594,10708,983,32502,8013,5274,1802,7559,7989
CATTGCAGTCCTTATT,sample,78575,77664,5342,72322,13278,59044,34226,2921,12963,1648,47189,7286,5206,1781,9940,8956
AATCCGTCTCCTTATT,sample,155012,153551,10856,142695,21997,120698,72977,4433,25696,2592,98673,15000,6977,2352,15580,14194
TTGGTACCTCCTTATT,sample,125332,124004,9583,114421,22934,91487,42369,3345,26665,2845,69034,16263,7210,1637,14212,15113
CGGATTACTCCTTATT,sample,123379,122309,6052,116257,28206,88051,64217,5451,11877,1090,76094,5416,3873,1718,21959,19520
GTTAGGACTCCTTATT,sample,139657,138017,14730,123287,19410,103877,41823,2589,33421,3766,75244,22278,8444,1754,11910,12839
TTGGCCTCTCCTTATT,Pos_Ctrl,58276,57092,5827,51265,2279,48986,41171,3791,2709,355,43880,960,6159,7376,2502,1077
ACCAATGCTCCTTATT,sample,129438,128213,7480,120733,19449,101284,66014,6149,17176,1870,83190,10075,5611,1971,14234,12832
TGCTTCGCTCCTTATT,sample,30352,30086,1200,28886,5727,23159,17068,1004,3445,451,20513,1191,2236,1527,4213,3895
GAAGGCGCTCCTTATT,sample,100575,99050,15064,83986,13008,70978,17383,1155,27326,2785,44709,22329,8460,1336,4143,6870
GGAGAGTTAATAAGGT,sample,23569,23183,2358,20825,4674,16151,6650,430,5552,763,12202,2756,3261,1250,1738,2924
TATCAGTTAATAAGGT,sample,206087,202881,18196,184685,25915,158770,71690,4285,47463,4903,119153,30429,8523,2422,22788,18131
ATTCTCTTAATAAGGT,sample,90422,89365,6146,83219,12058,71161,41055,2977,19336,1488,60391,6305,4282,2190,11542,8211
ACGTAAGTAATAAGGT,sample,66583,65569,5817,59752,10952,48800,26703,2331,12001,1214,38704,6551,4686,1596,8736,7105
ACGTTATGAATAAGGT,sample,225663,222865,16880,205985,34043,171942,83538,6665,50855,4916,134393,25968,8045,2661,22860,21853
TAGTACGGAATAAGGT,sample,199075,196609,15287,181322,24918,156404,91185,6289,36241,4628,127426,18061,8218,3794,16932,16672
TTCCGTCTAATAAGGT,sample,373822,370520,15355,355165,51570,303595,226194,16242,40019,5631,266213,15509,7827,4538,27133,39315
GGACCTCTAATAAGGT,sample,313226,311441,7157,304284,72820,231464,189178,11952,20794,3017,209972,6523,2957,1949,59353,52102
CCGCAACGAATAAGGT,Pos_Ctrl,75335,74080,6320,67760,3593,64167,54027,5089,3470,524,57497,1057,6802,8595,4780,1642
ACGACTTCAATAAGGT,sample,146965,145532,7151,138381,29629,108752,70250,5593,22341,2433,92591,8135,5229,2387,22333,20086
AATCCGTCAATAAGGT,Pos_Ctrl,107499,105491,9840,95651,4482,91169,76591,6742,5385,712,81976,1739,7506,10004,5690,2151
AGTCCGCAAATAAGGT,sample,218257,215683,16091,199592,26518,173074,78534,7235,55860,6260,134394,25185,8383,2369,23832,17497
GTCCTGCCAATAAGGT,sample,234661,232724,14612,218112,51973,166139,98334,6519,37116,4455,135450,19715,8225,2336,25824,34706
ACGTATTAAATAAGGT,sample,476528,473226,20473,452753,75956,376797,272227,16515,49884,7284,322111,30887,8048,2815,52364,53090
CGTATGAAAATAAGGT,sample,355305,352586,19744,332842,69536,263306,166936,11141,57204,5453,224140,22572,7002,2355,44771,46894
AAGAGCGCAATAAGGT,sample,346198,344255,16299,327956,71517,256439,151193,10919,53975,6087,205168,34265,11672,3530,43669,48518
CTTCATGAAATAAGGT,sample,7295,7225,388,6837,1519,5318,3352,338,910,120,4262,598,1403,943,566,992
GGTTGCGTCAGGACCA,sample,278731,275956,10854,265102,60396,204706,170108,11661,15909,2391,186017,4637,2330,1933,53276,43991
CCTCTAGACAGGACCA,sample,240666,237084,17694,219390,41039,178351,105191,7932,36702,7384,141893,21142,8269,2794,29441,27804
ATGCCTGGCAGGACCA,sample,254326,251014,16791,234223,38634,195589,118331,5665,43575,4279,161906,23739,7544,2164,43595,27675
CAACCGCGCAGGACCA,sample,189832,187405,13235,174170,39505,134665,71133,4519,32710,3794,103843,22509,7428,2405,22643,25936
AATGGTAACAGGACCA,sample,166146,163776,12115,151661,29806,121855,52610,4513,41438,5701,94048,17593,6767,1805,11823,19253
GCCTTGCTCAGGACCA,sample,154471,152983,5412,147571,20036,127535,91488,6754,20253,2804,111741,6236,5196,3971,8230,14424
GTTAGCCGCAGGACCA,sample,151499,150182,8094,142088,40818,101270,64551,4189,19351,2201,83902,10978,6516,3175,18515,25104
GGAGGACGCAGGACCA,sample,279323,275440,24055,251385,42768,208617,101413,5918,57168,5368,158581,38750,10632,2573,44671,28497
CCGCAACGCAGGACCA,sample,102311,100532,12073,88459,11390,77069,25539,1691,30197,3522,55736,16120,7566,2075,5431,6782
GACGATAACAGGACCA,sample,452235,445285,51662,393623,57003,336620,105903,8236,123290,12957,229193,86234,16024,4149,22776,35782
CGAGGCAGCAGGACCA,sample,222947,220359,15739,204620,33462,171158,77344,6594,55625,4564,132969,27031,9625,2521,7667,20470
CGTACGTCCAGGACCA,sample,169441,167257,14157,153100,18284,134816,62648,5536,42313,4787,104961,19532,8378,2860,8100,11648
TTGGTACCCAGGACCA,sample,410418,407012,31299,375713,60641,315072,162918,13721,80222,7413,243140,50798,10922,2965,43962,42534
CGGATTACCAGGACCA,sample,304544,302464,11498,290966,70527,220439,164357,10083,28464,4076,192821,13459,4978,2077,50546,46997
ACGTATTACAGGACCA,sample,361194,358190,20045,338145,68084,270061,153980,14419,59386,6056,213366,36220,10304,3337,31904,45910
AATATATCCAGGACCA,Neg_Ctrl,3431,2072,1317,755,98,657,226,20,102,34,328,275,225,119,62,42
ACCAATGCCAGGACCA,sample,275399,272826,19742,253084,42809,210275,100612,6859,59297,7410,159909,36097,10390,2610,24810,28071
CTTCATGACAGGACCA,sample,257760,256435,5483,250952,39638,211314,171542,18664,14120,1585,185662,5403,4089,3100,16786,28125
AAGTTCGTCCTCGTTG,sample,118731,116874,9158,107716,17421,90295,56352,3698,17076,1792,73428,11377,5614,2162,15126,11955
TCCTCCGTCCTCGTTG,sample,111614,109223,14316,94907,11282,83625,32457,1859,27272,3002,59729,19035,8127,2061,5979,6999
CCTCTAGACCTCGTTG,sample,205559,203140,11790,191350,38719,152631,104916,5742,25414,3387,130330,13172,5069,2242,31143,26924
ATGCCTGGCCTCGTTG,sample,81940,80343,13052,67291,9496,57795,22849,1447,18185,1878,41034,13436,7115,1781,7533,5635
TAGTACGGCCTCGTTG,sample,66951,65720,9116,56604,7637,48967,20862,1531,15603,1617,36465,9354,5764,1567,5930,4539
TGAGCGCGCCTCGTTG,sample,58342,56879,11335,45544,5037,40507,10198,781,15971,1787,26169,11770,6552,1270,2287,2596
AATGGTAACCTCGTTG,sample,147067,144863,16849,128014,15093,112921,41965,3428,38997,4196,80962,24335,8876,2509,10582,9011
TTCCGTCTCCTCGTTG,sample,128439,126339,15259,111080,14518,96562,34798,2345,35671,4140,70469,19608,7813,2156,10216,9424
GGACGTAGCCTCGTTG,Neg_Ctrl,4094,1619,1134,485,82,403,208,12,100,11,308,72,215,81,55,12
GACGATAACCTCGTTG,sample,55675,54774,7151,47623,6216,41407,16382,1198,14125,1531,30507,8171,5082,1323,4417,3585
CGAGGCAGCCTCGTTG,sample,264273,260989,21699,239290,39303,199987,106380,7319,46750,5338,153130,34200,11202,3077,28620,25998
CATGATTCCCTCGTTG,sample,126918,125169,12126,113043,26501,86542,35919,2673,26164,2880,62083,18906,7082,1799,7964,16096
CGTACGTCCCTCGTTG,Neg_Ctrl,4246,2085,1191,894,138,756,375,23,201,25,576,132,396,169,96,41
TTGGTACCCCTCGTTG,sample,290370,287867,14713,273154,46476,226678,128503,9578,57625,5568,186128,25404,5872,2363,32705,33298
GTTAGGACCCTCGTTG,sample,307238,304705,18488,286217,64114,222103,144701,8142,39805,6669,184506,22786,5686,2012,57511,43687
TTGGCCTCCCTCGTTG,sample,133519,132000,18484,113516,10097,103419,29254,1982,40845,3997,70099,27341,10367,2215,3751,5315
AAGAGCGCCCTCGTTG,sample,126225,125026,5909,119117,16754,102363,62409,5806,21501,3346,83910,9301,4496,1953,11832,10778
GTACCGTACCTCGTTG,Pos_Ctrl,131223,128982,11930,117052,5354,111698,94219,8499,6009,847,100228,2124,7535,10604,5637,2446
GGCATATACCTCGTTG,sample,318206,315195,21833,293362,41498,251864,145035,10535,55624,6532,200659,34138,9763,3235,25291,28208
ATGACCGACCTCGTTG,sample,201247,199561,15790,183771,63142,120629,43962,4633,43190,4727,87152,24117,8695,1886,10249,36273
GACCGGAACCTCGTTG,sample,143212,141921,6881,135040,39570,95470,51542,4952,23378,2133,74920,13465,6379,1612,14187,24936
TATCAGTTTTGCGGAC,sample,337760,335633,13845,321788,39430,282358,177367,16063,59231,7436,236598,22261,5104,2079,34660,26146
AAGTTCGTTTGCGGAC,sample,121683,120791,5068,115723,19373,96350,65443,4853,17528,2197,82971,6329,4249,2500,14194,14683
GGTTGCGTTTGCGGAC,sample,156685,155083,9716,145367,27461,117906,81007,4523,19649,2226,100656,10501,5085,2279,19947,20645
CCTCTAGATTGCGGAC,sample,191627,190080,7748,182332,31018,151314,100188,7415,28781,4115,128969,10815,5268,2063,35806,23317
AGTACCATTTGCGGAC,sample,218441,216466,10433,206033,27377,178656,92563,7204,54661,7489,147224,16739,5804,2184,16368,20616
TTCGTAATTTGCGGAC,sample,155323,153336,13568,139768,24658,115110,45820,2681,40820,5038,86640,20751,7856,1793,11681,16909
TTCTAATGTTGCGGAC,sample,423068,418662,33323,385339,43001,342338,159134,9438,114839,18192,273973,40735,10254,3383,38484,31597
ATGCCTGGTTGCGGAC,sample,218739,216277,25961,190316,39607,150709,63342,4294,44295,4672,107637,34106,11251,2959,18665,22063
CAACCGCGTTGCGGAC,sample,144458,142749,9589,133160,17426,115734,51996,3259,39473,4445,91469,16561,6894,2033,8492,11307
TCGCATCTTTGCGGAC,sample,188581,187009,10606,176403,33908,142495,89418,6460,27612,3071,117030,15934,7528,2931,19466,22856
CAAGGCCTTTGCGGAC,sample,248851,246269,15590,230679,42646,188033,121314,8864,34328,3668,155642,19859,7614,2177,42815,28392
CTTGATAGTTGCGGAC,sample,302940,299735,18582,281153,51179,229974,123484,8736,57838,6620,181322,33296,9613,2476,15514,33070
CGAGGCAGTTGCGGAC,sample,186192,184201,10001,174200,19358,154842,77528,5278,49072,5795,126600,17169,5966,1705,8918,13331
CGGATTACTTGCGGAC,sample,167810,165986,9641,156345,24415,131930,81768,5940,27173,2777,108941,14272,5755,1913,12927,17058
CGTATGAATTGCGGAC,sample,217641,215415,12510,202905,34840,168065,99512,8566,35805,4228,135317,19954,8105,2927,16609,24167
GAAGGCGCTTGCGGAC,sample,208035,205570,16224,189346,26785,162561,75747,6539,45926,5070,121673,29279,9183,2336,23746,17329
GTCTTAGCTTGCGGAC,sample,133448,132277,7619,124658,23070,101588,64300,5792,20224,1893,84524,9379,5302,2389,10451,15695
CCAATTCCTTGCGGAC,sample,185973,184225,9532,174693,34363,140330,97823,8702,20716,3259,118539,9830,4471,1714,31532,24698
ATGACCGATTGCGGAC,sample,148203,147082,9072,138010,22636,115374,60479,4405,32749,3117,93228,14624,6430,1945,11957,15298
GGAGAGTTTCCATTGG,sample,268541,266097,16367,249730,49858,199872,132452,10533,35494,3570,167946,17823,7763,2967,37685,34258
ACGTAAGTTCCATTGG,sample,118307,116426,10647,105779,16745,89034,55529,3277,17355,1939,72884,10934,6697,2884,14234,11164
AGTACCATTCCATTGG,sample,99265,97698,9156,88542,14018,74524,41974,2879,17363,1793,59337,10515,5547,1564,14863,9539
TAGTACGGTCCATTGG,sample,65763,65023,3713,61310,12985,48325,34306,1944,7292,995,41598,3788,3608,2117,7586,8998
CAAGGCCTTCCATTGG,sample,61725,61099,3031,58068,16920,41148,31605,1952,5289,525,36894,1777,2235,1719,11364,11163
CATAACCTTCCATTGG,sample,42479,41828,4545,37283,7514,29769,15386,1118,7193,902,22579,5170,3941,1475,5008,4905
ACTATACTTCCATTGG,sample,35452,34763,4280,30483,5042,25441,10387,612,8655,856,19042,4931,4063,1348,3568,3233
GACGGAGATCCATTGG,sample,24899,24478,2662,21816,3636,18180,9714,632,4744,508,14458,2582,3019,1180,3732,2323
GTTAGCCGTCCATTGG,sample,41773,41159,4100,37059,6542,30517,16684,937,7752,771,24436,4373,3655,1491,5540,4193
GGAGGACGTCCATTGG,sample,17521,17122,2243,14879,2831,12048,5661,392,3396,328,9057,2271,2879,1106,1654,1703
CCGCAACGTCCATTGG,sample,33326,32632,3861,28771,4032,24739,12469,824,6756,916,19225,3774,4182,1634,2757,2629
GGACGTAGTCCATTGG,sample,19557,19135,2334,16801,3424,13377,6709,415,3360,395,10069,2498,2810,1109,2238,2295
GACGATAATCCATTGG,sample,85406,84556,4698,79858,20687,59171,40886,2836,10171,1106,51057,4172,3884,1838,10394,13325
CATTGCAGTCCATTGG,sample,132091,130691,8000,122691,24373,98318,63576,4951,16490,1987,80066,11314,5280,2104,16843,17235
CCATGAAGTCCATTGG,sample,59031,57769,9266,48503,6005,42498,16402,1660,13730,1405,30132,9301,6202,1846,3978,3438
ACGACTTCTCCATTGG,sample,147860,146069,13477,132592,22942,109650,53940,3395,30124,3440,84064,18751,8281,2372,12980,14221
AATCCGTCTCCATTGG,sample,110497,109281,8009,101272,17557,83715,46248,3440,20683,2248,66931,11096,6028,2154,13688,11694
CGTACGTCTCCATTGG,sample,73341,72182,8077,64105,9010,55095,24262,1846,16435,2103,40697,10449,5887,1543,8200,5603
GTCCTGCCTCCATTGG,sample,65820,65006,5781,59225,10535,48690,25178,1825,13500,1291,38678,6896,4700,1527,7101,6943
AAGAGCGCTCCATTGG,sample,40591,40223,3614,36609,6213,30396,17203,1514,6443,692,23646,4544,3782,1242,4668,4076
GTCTTAGCTCCATTGG,sample,51879,51518,1753,49765,8537,41228,28448,1897,7256,919,35704,2708,3562,2370,4509,5837
CCAATTCCTCCATTGG,sample,81517,80867,3753,77114,12577,64537,38132,2881,14521,1368,52653,7635,4597,1611,8476,8557
GGCATATATCCATTGG,Neg_Ctrl,1448,782,313,469,72,397,252,16,71,13,323,45,212,130,69,23
TCAATATATCCATTGG,sample,98887,98253,4149,94104,17602,76502,49070,4197,14338,1304,63408,7593,3861,1504,10995,12064
CTTCATGATCCATTGG,sample,76246,75758,1825,73933,18700,55233,43789,4431,5057,751,48846,1205,1314,1212,12856,12206
GACCGGAATCCATTGG,sample,8051,7864,293,7571,2618,4953,3291,312,941,141,4232,268,945,680,653,1502
TATCAGTTCATAGGCG,sample,419876,415726,20006,395720,75372,320348,248943,14377,35946,3725,284889,17357,5395,2987,54502,51704
ACGTTATGCATAGGCG,sample,154072,151810,23417,128393,23453,104940,64079,4388,22177,2650,86256,11646,5588,1966,21649,19445
TGAGCGCGCATAGGCG,sample,126690,124974,12064,112910,22184,90726,50988,3667,21124,1978,72112,12969,6976,1942,15563,14398
GCCTTGCTCATAGGCG,sample,273885,271962,9735,262227,64735,197492,157942,11979,21348,2776,179290,3447,2091,1794,59048,44277
CATAACCTCATAGGCG,sample,228444,226484,9284,217200,52360,164840,128808,9106,20834,1738,149642,4354,2241,1926,45554,35984
ACTATACTCATAGGCG,sample,201512,199338,13319,186019,41996,144023,93782,6197,27099,2807,120881,14138,6513,2606,26414,28300
GACGGAGACATAGGCG,sample,162472,160717,11167,149550,33450,116100,83774,6207,14899,1954,98673,9266,5874,3075,23799,22929
CCAGAGCGCATAGGCG,sample,215934,213715,11010,202705,33574,169131,123593,9780,22298,3093,145891,10367,6404,3102,30350,25065
CCGCAACGCATAGGCG,sample,167452,164915,14410,150505,29318,121187,65222,4476,29715,3173,94937,18601,7693,2085,16934,19123
CCATGAAGCATAGGCG,sample,65824,64514,7288,57226,13483,43743,24034,1724,9416,1095,33450,7474,5367,2181,6583,8564
GTCCTGCCCATAGGCG,sample,221212,218829,18324,200505,36572,163933,80970,7138,45068,4969,126038,25788,9103,2426,29466,23917
TTGGTACCCATAGGCG,sample,10364,10275,437,9838,2060,7778,5877,587,833,102,6710,379,1934,1722,614,1397
CTAGGACCCATAGGCG,sample,269281,266476,20719,245757,35593,210164,95901,6575,65383,7473,161284,34832,9831,2780,27447,22928
GTTAGGACCATAGGCG,sample,234519,232641,10074,222567,36008,186559,108030,7815,48744,5054,156774,16916,6210,2421,12288,25763
AACTCGTACATAGGCG,sample,40531,39585,7933,31652,3299,28353,5664,444,12371,1389,18035,8485,5314,1191,777,1488
TTGGCCTCCATAGGCG,sample,203341,201976,9814,192162,40544,151618,104267,9905,24875,2827,129142,9744,5017,2093,31785,28473
CCAATTCCCATAGGCG,sample,161749,159677,16139,143538,22171,121367,49640,3530,38423,4461,88063,25313,10176,2309,12287,14928
TTGGTTAACATAGGCG,sample,201274,199461,15773,183688,25891,157797,80573,7243,41107,3982,121680,24892,8169,2115,21678,16852
TCGCCTGACATAGGCG,sample,123988,123058,5882,117176,21996,95180,66452,4972,14851,1775,81303,7130,4634,1690,18847,15171
AGGTCGGACATAGGCG,sample,243550,241147,14128,227019,38901,188118,128886,9104,30148,3400,159034,16580,7004,2686,22216,27465
ATGACCGACATAGGCG,sample,87681,86772,9637,77135,12533,64602,30965,3121,17191,1826,48156,11499,6054,1656,9912,7991
GACCGGAACATAGGCG,sample,265014,263036,10090,252946,41496,211450,148944,15305,31075,3214,180019,12912,5029,2005,40245,30491
ATTCTCTTTTGGAGAG,Pos_Ctrl,119077,115256,15155,100101,5534,94567,78711,6587,6463,792,85174,2014,7567,9542,6461,3054
ACGTAAGTTTGGAGAG,sample,181418,179247,9029,170218,34495,135723,93807,5939,24301,3141,118108,8535,5082,2146,29690,23751
CCTCTAGATTGGAGAG,sample,212468,209635,14314,195321,31231,164090,106428,6697,29895,3735,136323,17335,7029,2482,32951,21988
ACGTTATGTTGGAGAG,sample,249775,246666,16840,229826,39806,190020,114027,7241,41781,5123,155808,21848,8206,2657,26066,26260
TAGTACGGTTGGAGAG,sample,230179,228069,9661,218408,43496,174912,127644,7567,26819,2770,154463,10112,5321,2475,34187,30539
TTCCGTCTTTGGAGAG,Pos_Ctrl,77722,75404,9885,65519,3747,61772,51307,4204,4416,507,55723,1338,6838,7855,4691,1964
TCGCATCTTTGGAGAG,sample,85874,84762,6884,77878,9930,67948,28489,1832,24608,3040,53097,9979,5580,1939,4327,6801
ACCTCGAGTTGGAGAG,sample,131478,128789,15643,113146,15162,97984,46533,3310,26508,3173,73041,18460,7784,1991,12894,9386
GACGATAATTGGAGAG,sample,189358,187547,7321,180226,29003,151223,105306,8869,26700,3277,132006,7071,4460,2541,23276,20505
TTGGTACCTTGGAGAG,sample,162250,160435,11534,148901,22565,126336,71801,5419,30469,3566,102270,15081,7055,2760,13843,13960
CTAGGACCTTGGAGAG,sample,167934,166209,8660,157549,20648,136901,94351,7018,21271,2794,115622,11467,6319,2918,5729,13950
GCCTGAACTTGGAGAG,sample,232106,230078,14176,215902,45796,170106,101736,6577,35014,3660,136750,23119,9115,2702,28141,30925
AATATATCTTGGAGAG,sample,260484,258566,12673,245893,50316,195577,130412,10631,32637,4797,163049,17100,7183,2076,41362,34636
ACCAATGCTTGGAGAG,sample,155241,154149,7733,146416,36910,109506,71385,5284,20082,1978,91467,10777,6424,2602,20958,24441
TGCTTCGCTTGGAGAG,sample,188489,186746,11770,174976,25193,149783,87456,5199,34157,3901,121613,19070,8576,2616,21437,17419
AAGAGCGCTTGGAGAG,sample,196542,195391,6852,188539,54015,134524,92082,8292,22199,2505,114281,9446,5633,2333,16979,34545
GGCATATATTGGAGAG,sample,249927,248049,9225,238824,56029,182795,148352,11047,17708,1784,166060,3904,2226,1435,44097,38661
AGGTCGGATTGGAGAG,sample,212317,210302,10875,199427,31234,168193,105800,10116,33829,3015,139629,15433,5811,1771,23695,20687
GGAGAGTTTTCAAGCC,sample,48328,47509,5638,41871,8157,33714,17137,1172,8249,979,25386,6177,4804,1838,4504,5073
ATTCTCTTTTCAAGCC,sample,291258,289113,9564,279549,57348,222201,185801,13793,16601,1746,202402,4260,2891,2701,50040,40551
AAGTTCGTTTCAAGCC,sample,162874,160471,14762,145709,21825,123884,57049,4128,41313,4544,98362,16850,7274,2298,14177,14494
TGAGCGCGTTCAAGCC,sample,74459,73419,4841,68578,10849,57729,35481,2213,12199,1377,47680,6459,4514,2158,2975,7066
TTAGAAGTTTCAAGCC,sample,130731,128516,15454,113062,16443,96619,45849,2424,26356,3047,72205,18943,7513,2068,15475,11671
TCGCATCTTTCAAGCC,sample,166754,165691,7304,158387,39251,119136,89404,5249,16315,1826,105719,6342,2361,1564,39558,28080
CAAGGCCTTTCAAGCC,sample,129495,127740,9770,117970,21287,96683,66538,5556,14288,1353,80826,8948,5057,2852,13163,15198
GACGGAGATTCAAGCC,sample,66266,65083,8522,56561,9489,47072,19873,1226,15261,1761,35134,8951,5772,1698,6007,5978
GGAGGACGTTCAAGCC,sample,69338,68102,8418,59684,11869,47815,22407,1627,13010,1387,35417,9384,5893,1744,7134,7526
CCGCAACGTTCAAGCC,sample,52014,51137,5949,45188,7786,37402,13901,1315,12944,1438,26845,7804,5363,1514,3680,4993
GACGATAATTCAAGCC,sample,102893,101851,4395,97456,23762,73694,53944,4030,10393,1312,64337,4015,3608,2214,14441,16094
CCATGAAGTTCAAGCC,sample,193015,191358,5647,185711,40640,145071,119892,7868,13684,1537,133576,2090,1801,1597,42660,29638
ACGACTTCTTCAAGCC,sample,119069,117479,9519,107960,16883,91077,47471,3801,25347,2550,72818,11908,6473,2287,12032,11193
AATCCGTCTTCAAGCC,sample,136369,134981,7672,127309,25889,101420,67944,5208,17394,2572,85338,8302,5197,2101,17541,17931
AGTCCGCATTCAAGCC,sample,175096,172865,15520,157345,22006,135339,77932,6236,28735,3366,106667,19070,7900,2624,16720,13858
GTTAGGACTTCAAGCC,sample,124444,123165,6405,116760,13031,103729,76249,5760,14481,1854,90730,5385,4779,3455,8286,10227
TTGGCCTCTTCAAGCC,Pos_Ctrl,54783,53422,6351,47071,2329,44742,37592,3271,2681,352,40273,846,6114,7037,2418,1091
GTACCGTATTCAAGCC,sample,227302,225577,10043,215534,39690,175844,119590,9810,28390,3075,147980,14979,5372,1928,30215,28803
TCAATATATTCAAGCC,sample,70216,68833,10884,57949,5769,52180,12275,700,21575,2035,33850,15595,6733,1357,1985,2833
CTTCATGATTCAAGCC,sample,103523,102234,6676,95558,13389,82169,46937,3650,20359,1786,67296,9437,5417,1796,6084,8981
GACCGGAATTCAAGCC,sample,158942,158019,6509,151510,27181,124329,84611,6136,22523,2274,107134,8785,5052,2382,12014,20141
TCCAACTTAACTTAAC,Neg_Ctrl,3560,1630,1070,560,100,460,234,18,112,8,346,88,223,95,69,20
AAGTTCGTAACTTAAC,sample,125173,124422,4893,119529,25597,93932,65295,5164,16109,1935,81404,5429,4244,2872,17577,17950
ACGTAAGTAACTTAAC,sample,233377,232070,6553,225517,42361,183156,141747,10727,20499,3007,162246,7176,4921,3205,31734,31081
TGAGCGCGAACTTAAC,sample,193115,191738,8396,183342,34130,149212,98142,7417,27175,3499,125317,12979,4754,2098,33219,23306
GGACCTCTAACTTAAC,Neg_Ctrl,2381,1087,734,353,66,287,170,11,66,9,236,31,168,87,44,15
ACTATACTAACTTAAC,sample,210272,208282,20449,187833,26631,161202,75200,4624,44230,4637,119430,32511,10343,2646,30150,16942
GACGGAGAAACTTAAC,sample,117108,116127,5021,111106,23890,87216,57558,4336,17009,1844,74567,6469,4415,2104,15958,16466
CTTGATAGAACTTAAC,sample,162638,160841,13200,147641,26646,120995,61104,3914,32869,3320,93973,19788,7541,2146,15354,17096
TGGACGAGAACTTAAC,sample,170952,169034,13139,155895,32621,123274,75018,6140,24764,2669,99782,14683,7145,2452,22619,21585
GGCCAGAGAACTTAAC,sample,202911,201408,9565,191843,46540,145303,110419,9030,17847,1987,128266,6020,3795,2229,28677,32751
CATTGCAGAACTTAAC,sample,192317,190632,10277,180355,35452,144903,106117,7968,18932,2134,125049,9752,4241,2135,31220,25618
CGAGGCAGAACTTAAC,sample,245854,243829,10191,233638,35984,197654,146237,9717,25270,3956,171507,12474,6043,3031,24248,26426
AATCCGTCAACTTAAC,sample,137719,136255,9456,126799,22646,104153,62325,4774,21831,2296,84156,12927,6574,2458,15430,15123
ACGTATTAAACTTAAC,sample,199744,197367,15529,181838,31387,150451,87230,6016,34961,3828,122191,18416,6443,1930,28003,20611
AACTCGTAAACTTAAC,sample,143055,141515,11644,129871,25720,104151,42317,3755,33002,4015,75319,21062,8962,2329,6861,16716
GAAGGCGCAACTTAAC,sample,223112,220905,14758,206147,33149,172998,107947,7049,34761,4316,142708,18925,6658,2172,30139,22991
GGAGAGTTATACTTGA,sample,65492,64854,5924,58930,9548,49382,19344,1748,16565,1829,35909,9896,5725,1503,3255,6044
TATCAGTTATACTTGA,sample,2019,1987,224,1763,322,1441,806,53,335,39,1141,208,641,342,225,215
ATTCTCTTATACTTGA,sample,54473,53764,6897,46867,5493,41374,13481,834,15812,1652,29293,9595,5865,1639,2047,3210
AAGTTCGTATACTTGA,sample,193581,192068,9977,182091,41822,140269,102390,6706,19866,2331,122256,8976,6171,3364,24797,27450
TGAGCGCGATACTTGA,sample,185556,183562,12086,171476,27713,143763,87590,7229,30049,3129,117639,15766,5977,2301,21879,18502
CAACCGCGATACTTGA,sample,76761,75885,5016,70869,15481,55388,35195,2905,10715,1162,45910,5411,4481,1914,11091,10634
GCCTTGCTATACTTGA,sample,137574,136693,7198,129495,26309,103186,68561,4715,17063,1961,85624,10886,6330,2716,20258,17840
ACTATACTATACTTGA,sample,198498,196538,11077,185461,30568,154893,108372,8102,24311,3082,132683,11026,5329,3067,24371,23776
GACGGAGAATACTTGA,sample,52817,52067,4532,47535,12452,35083,20104,1449,8424,1025,28528,4081,3712,1470,7862,7602
GTTAGCCGATACTTGA,sample,31011,30575,4801,25774,4648,21126,6420,473,7527,860,13947,5846,4941,1569,1663,2733
GGACGTAGATACTTGA,sample,215162,212346,17804,194542,36748,157794,87226,5635,37551,4514,124777,22868,8055,2479,30288,25436
CTTGATAGATACTTGA,sample,114382,112693,11770,100923,11757,89166,30062,2423,36978,3655,67040,16048,6429,1848,3800,7873
TGGACGAGATACTTGA,sample,33430,32976,2706,30270,6412,23858,15810,1289,4067,410,19877,2282,3333,1938,3646,4332
CATTGCAGATACTTGA,sample,47930,47149,4395,42754,5132,37622,19526,1293,10296,1124,29822,5383,4175,1519,5985,3164
AATCCGTCATACTTGA,sample,206612,205079,8199,196880,40180,156700,113320,8201,22352,2830,135672,9997,5383,2196,32934,28315
CGTACGTCATACTTGA,sample,134090,132747,10475,122272,24438,97834,49156,2615,27233,3541,76389,15289,7353,2012,19302,16925
CTAGGACCATACTTGA,sample,211112,209518,6269,203249,32693,170556,115641,9689,32522,4447,148163,8257,4051,2288,26541,24491
ACGTATTAATACTTGA,sample,180402,178987,7379,171608,39558,132050,89316,6557,22711,2729,112027,10737,6427,2743,16915,26159
AACTCGTAATACTTGA,sample,77896,77015,6738,70277,15050,55227,25965,2443,15108,1869,41073,9842,4990,1255,8358,9046
TTGGCCTCATACTTGA,sample,217728,215483,16709,198774,19034,179740,78219,7548,64800,6957,143019,22216,8512,2672,9844,11772
AATATATCATACTTGA,Neg_Ctrl,2816,1362,836,526,103,423,220,22,91,22,311,68,240,123,38,25
TGCTTCGCATACTTGA,sample,149962,148363,11916,136447,22688,113759,56834,4736,29842,3017,86676,19330,8311,2088,15635,14902
AAGAGCGCATACTTGA,sample,148611,147137,8411,138726,35734,102992,56633,4761,23749,2945,80382,14904,6214,2412,9484,22864
CCAATTCCATACTTGA,sample,232716,230148,16010,214138,24303,189835,115596,9171,35608,3846,151204,25614,9435,3461,17892,15775
TTGGTTAAATACTTGA,sample,159821,158008,13567,144441,26462,117979,59644,5300,30258,3423,89902,19354,7453,1628,14720,17213
GTACCGTAATACTTGA,sample,119635,118569,9153,109416,22796,86620,45489,3208,23075,2402,68564,12446,6435,1969,10292,14846
GGCATATAATACTTGA,sample,176442,175089,5050,170039,40591,129448,99642,7284,15062,2175,114704,5285,2379,1407,27261,28737
TCAATATAATACTTGA,sample,122126,120735,9768,110967,15835,95132,45983,4296,27910,2717,73893,14226,6322,2012,12110,10759
ATGACCGAATACTTGA,sample,183950,182534,11757,170777,33278,137499,69599,4567,36673,4309,106272,22351,9222,2567,16919,22481
TATCAGTTATCCGCGA,sample,32625,32091,5465,26626,4105,22521,9431,714,6400,682,15831,5294,4497,1778,2559,2031
ATTCTCTTATCCGCGA,sample,170102,166519,35765,130754,16496,114258,32532,1754,41695,4630,74227,33647,13036,2341,11772,8843
TCCTCCGTATCCGCGA,sample,194648,193048,9126,183922,41268,142654,102869,7427,21769,2090,124638,8499,5618,2943,24200,30256
AGTACCATATCCGCGA,sample,308727,306221,16078,290143,62444,227699,165943,11783,30708,3906,196651,15359,3993,2361,50571,44833
TTCGTAATATCCGCGA,sample,204924,202972,12850,190122,37729,152393,92594,6398,31411,3217,124005,18773,7096,2550,23189,26668
TTCTAATGATCCGCGA,sample,285569,283489,9281,274208,57115,217093,168512,11760,25760,2535,194272,8526,3585,2269,42668,42333
CAAGGCCTATCCGCGA,sample,161720,159994,9250,150744,34849,115895,77820,5470,20588,3049,98408,8968,4647,1723,32395,23804
CATTGCAGATCCGCGA,sample,239430,236411,20309,216102,35102,181000,96627,8035,43005,4573,139632,28760,8709,2862,29008,23964
ACGACTTCATCCGCGA,sample,177176,175005,15496,159509,31239,128270,69382,3718,31023,3557,100405,20590,8034,2304,29805,20074
CATGATTCATCCGCGA,sample,140843,139023,12552,126471,29642,96829,49175,4118,25621,2384,74796,15531,7245,2175,12651,18097
AATCCGTCATCCGCGA,sample,58912,58091,5212,52879,8257,44622,26209,1844,10691,1004,36900,4874,4115,1743,7838,5390
TTGGTACCATCCGCGA,sample,289535,287064,17673,269391,52200,217191,141143,9348,40132,3816,181275,22752,6338,2361,37023,34685
CTAGGACCATCCGCGA,sample,70117,68992,9827,59165,7860,51305,17362,1573,18038,1865,35400,12467,7248,2228,2025,4335
CGGATTACATCCGCGA,sample,127088,125429,10664,114765,16005,98760,45089,3432,31766,3841,76855,14632,5946,2013,9126,10122
GTTAGGACATCCGCGA,sample,196586,194650,11538,183112,31699,151413,95457,7443,32820,3377,128277,12316,6007,2546,19672,23135
AACTCGTAATCCGCGA,sample,273435,271132,16990,254142,50325,203817,127458,11816,38801,4094,166259,21648,8782,2870,31834,33731
CGTATGAAATCCGCGA,sample,250106,247984,9010,238974,53236,185738,150543,8844,18483,2734,169026,5134,2659,1674,46725,39209
TTGGCCTCATCCGCGA,sample,184154,182484,12127,170357,26344,144013,92214,7107,25509,3820,117723,15363,6574,2347,17409,17800
GTCTTAGCATCCGCGA,sample,151093,149192,13361,135831,19622,116209,62895,3842,27125,2804,90020,19543,7886,1835,22373,13271
TTGGTTAAATCCGCGA,sample,278865,277090,9727,267363,60997,206366,166059,13960,18843,2614,184902,4890,2247,1618,48143,44224
GTACCGTAATCCGCGA,sample,248263,246077,16669,229408,32526,196882,114929,10296,44026,4904,158955,22727,7867,2834,16124,22779
TTATTCGAATCCGCGA,sample,172457,170547,20400,150147,18739,131408,51954,4202,43370,5032,95324,26850,10045,2438,13011,10933
AAGTTCGTAGGACTCA,sample,44417,43785,2368,41417,7061,34356,20677,1745,8138,1008,28815,2788,3570,2266,2926,4847
ACGTTATGAGGACTCA,sample,240523,237861,18477,219384,36367,183017,93674,7120,48216,5097,141890,28910,9431,2371,32620,24688
ATGCCTGGAGGACTCA,sample,348674,343958,37770,306188,37117,269071,101469,6415,93919,11413,195388,55855,13567,3332,29058,22252
TAGTACGGAGGACTCA,sample,299471,295789,28697,267092,38994,228098,105927,8439,62082,6438,168009,45212,11464,2993,32450,27143
TTCCGTCTAGGACTCA,sample,122618,120644,20470,100174,18213,81961,26570,1241,29131,3187,55701,21832,10108,2024,8571,10761
ACTATACTAGGACTCA,sample,69173,68351,4810,63541,22814,40727,20166,1711,11774,1477,31940,5599,5000,2019,6749,12755
CCAGAGCGAGGACTCA,sample,250740,247746,23601,224145,34650,189495,88515,7025,53469,5682,141984,34804,9731,2695,29252,22208
GGAGGACGAGGACTCA,sample,119949,118877,5653,113224,21859,91365,62636,3571,17697,1914,80333,5547,4048,2485,15141,15066
GGACGTAGAGGACTCA,sample,364122,360781,22397,338384,43307,295077,185220,12435,62289,7680,247509,27453,6191,2115,34317,28976
TGGACGAGAGGACTCA,sample,146619,145264,9345,135919,26344,109575,71456,4240,19525,3077,90981,11277,5654,1789,25243,17312
GACGATAAAGGACTCA,sample,207073,204835,15737,189098,30261,158837,84809,6125,38739,3598,123548,25566,7819,1966,24323,20299
CATTGCAGAGGACTCA,sample,267585,265956,12771,253185,45057,208128,137384,12027,35883,4153,173267,18681,8604,3092,32646,31864
CCATGAAGAGGACTCA,sample,332833,330032,16907,313125,48777,264348,185285,12614,37876,3802,223161,24771,8575,3490,24119,34259
TTGGTACCAGGACTCA,sample,332341,328192,31586,296606,48514,248092,110969,7596,69540,7661,180509,52326,12829,3218,34141,31755
ACGTATTAAGGACTCA,sample,266536,264478,9864,254614,54955,199659,154233,10196,23987,2506,178220,8737,3893,2061,47458,38973
TGCTTCGCAGGACTCA,sample,134912,133304,9547,123757,17255,106502,57400,4677,29394,3552,86794,11479,6042,2318,8904,11001
GAAGGCGCAGGACTCA,sample,212623,209577,20205,189372,32770,156602,85836,5958,35489,3476,121325,25843,9686,2446,30101,21767
TTGGTTAAAGGACTCA,sample,234743,231052,29112,201940,22015,179925,50224,2591,69749,6876,119973,50485,12048,2390,9391,14016
AGGTCGGAAGGACTCA,Pos_Ctrl,85575,84529,6222,78307,3685,74622,63026,6022,3885,469,66911,1220,6810,9213,3994,1395
ATGACCGAAGGACTCA,sample,209769,207980,16067,191913,33453,158460,78483,5972,40076,4324,118559,29605,10880,2788,18621,22010
GACCGGAAAGGACTCA,sample,69821,69322,5473,63849,15398,48451,27251,2184,10314,1417,37565,7285,4371,1704,11613,9835
GGAGAGTTTATTGAAC,sample,104385,103899,5013,98886,31238,67648,44633,3580,11030,1341,55663,7064,4827,2511,12828,19705
TATCAGTTTATTGAAC,sample,137356,136060,11203,124857,23232,101625,44360,2663,30781,3497,75141,20324,7956,1953,15250,14583
TTCTAATGTATTGAAC,sample,49369,48768,4722,44046,8118,35928,13107,858,13003,1602,26110,7358,5025,1381,2216,5062
TAGTACGGTATTGAAC,sample,72016,71058,7718,63340,10200,53140,24765,1431,14898,1384,39663,10662,5937,1694,8402,6716
CAACCGCGTATTGAAC,sample,76991,76301,9426,66875,10037,56838,21899,1311,18000,1766,39899,13862,6201,1536,8066,6030
AATGGTAATATTGAAC,sample,25817,25439,2243,23196,4333,18863,9250,756,5529,636,14779,2692,3745,1886,1200,2633
TTAGAAGTTATTGAAC,sample,36993,36521,2684,33837,6636,27201,12385,1068,9259,1125,21644,3364,3288,1390,3195,4626
GGACCTCTTATTGAAC,sample,82219,80810,8877,71933,12021,59912,31361,1787,14859,1587,46220,10318,5846,1916,9662,7554
TCGCATCTTATTGAAC,sample,32262,31454,5361,26093,3088,23005,5048,423,9188,880,14236,7466,4641,820,1048,1826
CAAGGCCTTATTGAAC,sample,72228,71030,5835,65195,10209,54986,29499,1970,14781,1695,44280,7041,4879,1734,7452,7307
GGAGGACGTATTGAAC,sample,9512,9289,1428,7861,1551,6310,2399,141,2135,222,4534,1413,2014,637,886,956
ACCTCGAGTATTGAAC,sample,64362,63500,3680,59820,7376,52444,31956,2735,11253,1692,43209,4808,3734,1952,4881,5060
TGGACGAGTATTGAAC,sample,51988,51251,4111,47140,9461,37679,17745,1549,10743,1182,28488,6460,4867,2031,1651,6055
GACGATAATATTGAAC,sample,119869,118242,9641,108601,15991,92610,49666,3640,23241,2378,72907,13685,6812,1787,11575,10872
GGCCAGAGTATTGAAC,sample,63411,62142,7503,54639,6927,47712,19367,1421,15602,1553,34969,9769,5933,1562,5355,4456
AATCCGTCTATTGAAC,sample,99265,97899,7377,90522,16895,73627,40781,2605,17732,1628,58513,10881,5255,1754,13639,11493
CGTACGTCTATTGAAC,sample,67384,66122,7800,58322,9254,49068,19276,1757,15531,1658,34807,10846,6041,1759,3871,5554
AGTCCGCATATTGAAC,sample,13129,12928,803,12125,3329,8796,4440,354,2730,270,7170,1002,2220,1222,693,2103
CTAGGACCTATTGAAC,sample,24651,24132,2800,21332,5983,15349,5683,567,5030,490,10713,3579,3728,1345,747,3439
CGTATGAATATTGAAC,sample,99536,97688,10683,87005,9954,77051,28983,1635,25927,2820,54910,17686,8350,2092,5086,5956
CCAATTCCTATTGAAC,sample,40314,39772,1945,37827,7722,30105,19671,1498,5868,883,25539,2185,2487,1537,5599,5373
TCAATATATATTGAAC,sample,49921,49184,4541,44643,4568,40075,17730,1205,13304,1469,31034,6367,5009,2103,2135,2893
TCGCCTGATATTGAAC,sample,71860,70523,9565,60958,7191,53767,20538,1578,16968,1723,37506,12960,7048,1872,5472,4328
CTTCATGATATTGAAC,sample,62633,61335,7304,54031,6323,47708,16526,1091,17593,2335,34119,10163,6099,1705,3858,3716
TATCAGTTGTTCAACT,sample,109183,107242,14598,92644,13633,79011,29057,1473,24964,2842,54021,20675,9213,2011,9428,8074
AAGTTCGTGTTCAACT,sample,32537,31898,3272,28626,4907,23719,10041,559,7859,776,17900,4484,3556,1022,3206,3389
TCCTCCGTGTTCAACT,sample,41219,40585,3777,36808,5905,30903,14966,871,8365,1035,23331,5666,3121,1150,5394,4079
ACGTAAGTGTTCAACT,sample,42685,42094,4417,37677,6006,31671,13693,1076,9462,1123,23155,6317,4067,1121,5081,4034
ACGTTATGGTTCAACT,sample,33546,33302,3854,29448,4310,25138,7711,415,8532,752,16243,7728,3513,1184,2116,2634
TCGCATCTGTTCAACT,sample,29376,28575,5127,23448,3008,20440,5753,446,7722,896,13475,5623,4682,1072,1622,1735
GGACGTAGGTTCAACT,sample,29187,28683,2461,26222,6424,19798,10240,573,4848,645,15088,3492,2986,1127,4282,4044
TGGACGAGGTTCAACT,sample,42183,41647,2893,38754,6516,32238,18627,982,7769,857,26396,4003,3006,1113,5985,4626
GACGATAAGTTCAACT,sample,60054,58901,7478,51423,6946,44477,14927,1052,15273,1514,30200,11711,6398,1358,3480,4323
TTGGTACCGTTCAACT,sample,24838,24308,3552,20756,3010,17746,5686,423,6190,625,11876,4822,3808,946,1901,1787
TTGGCCTCGTTCAACT,sample,20077,19805,1824,17981,2703,15278,7099,584,4935,527,12034,2133,2494,986,2215,1775
AATATATCGTTCAACT,sample,50070,49488,4243,45245,8380,36865,19670,1189,8855,899,28525,6252,3405,1249,7194,5714
CCAATTCCGTTCAACT,sample,39230,38788,3542,35246,6483,28763,13621,929,8039,814,21660,5360,4136,1696,3811,4239
TCGCCTGAGTTCAACT,sample,41294,40715,5305,35410,4111,31299,8773,391,12262,1298,21035,8575,5599,1265,2730,2228
TTATTCGAGTTCAACT,Neg_Ctrl,510,306,171,135,27,108,55,2,28,6,83,17,67,32,14,9
TCCAACTTCTGAGGTT,sample,259803,257678,14925,242753,43035,199718,113736,7526,45745,4380,159481,28331,8526,3049,23462,30417
CCTCTAGACTGAGGTT,sample,173605,172055,13060,158995,29643,129352,72960,5044,30833,3249,103793,17266,6140,2038,26609,21123
ACGTTATGCTGAGGTT,sample,194777,192848,11948,180900,31494,149406,85305,5682,34889,3816,120194,19714,6369,2675,22277,21977
TAGTACGGCTGAGGTT,sample,192551,191246,14078,177168,40980,136188,102988,5816,16345,1860,119333,9179,2250,1692,44179,27060
TGAGCGCGCTGAGGTT,sample,171855,169362,23370,145992,25257,120735,40727,2646,40636,4137,81363,32589,11753,2295,12882,16238
CAACCGCGCTGAGGTT,sample,115120,114039,7058,106981,23537,83444,51697,3842,16414,1624,68111,9867,3324,1705,18987,16313
GCCTTGCTCTGAGGTT,sample,108606,106973,10730,96243,16714,79529,39260,2388,22117,2065,61377,13699,6723,2124,13749,11285
CATAACCTCTGAGGTT,sample,136004,134707,6710,127997,29374,98623,72177,5389,13213,1808,85390,6036,2701,1718,26961,21144
ACTATACTCTGAGGTT,sample,82601,81554,6266,75288,17117,58171,37149,2198,10492,1173,47641,7159,5034,2557,9958,11750
GACGGAGACTGAGGTT,sample,84570,83430,5797,77633,13595,64038,35419,1887,17801,1612,53220,7319,3986,1684,12373,9701
CTTGATAGCTGAGGTT,sample,66578,65726,5136,60590,10262,50328,33849,2502,8483,945,42332,4549,4370,2934,6161,7005
GGCCAGAGCTGAGGTT,sample,82046,81354,2882,78472,17870,60602,47460,3985,5804,1007,53264,2346,2926,2736,7087,12041
CATGATTCCTGAGGTT,sample,44216,43456,4404,39052,8655,30397,13999,924,8996,1026,22995,5452,4495,1535,4163,5583
CTAGGACCCTGAGGTT,sample,71305,70137,5755,64382,11016,53366,23100,1967,16989,1668,40089,9642,5171,1592,5386,7407
GCCTGAACCTGAGGTT,sample,45976,45155,4730,40425,7838,32587,16171,1101,9152,1047,25323,5116,4347,1540,5701,4884
TGCTTCGCCTGAGGTT,sample,122060,120951,6581,114370,20337,94033,65828,4814,13641,1645,79469,8105,4112,1435,20909,14396
GGCATATACTGAGGTT,sample,124539,123526,6189,117337,26650,90687,67670,4632,11888,2127,79558,4370,3377,2101,18183,19316
AGGTCGGACTGAGGTT,sample,97261,96032,6966,89066,16057,73009,39859,2878,18622,1795,58481,9855,5940,1776,14640,10703
ATGACCGACTGAGGTT,sample,77746,76978,5145,71833,11700,60133,36568,2818,13102,1373,49670,6272,5102,2403,9775,7913
TATCAGTTAGACCGTT,sample,175391,173600,12970,160630,27660,132970,68937,4715,36482,4359,105419,18477,7156,2283,14390,19094
ATTCTCTTAGACCGTT,sample,146898,145645,6756,138889,34906,103983,67806,5618,20188,2354,87994,8017,4413,2293,12983,21971
AAGTTCGTAGACCGTT,sample,215149,213359,16455,196904,38841,158063,76541,6439,41178,4399,117719,29506,9781,2309,29594,25969
TTAGAAGTAGACCGTT,sample,113116,111660,9004,102656,18797,83859,43186,2573,22665,2981,65851,12454,6122,2490,9186,12394
TCGCATCTAGACCGTT,sample,37647,36843,3277,33566,5304,28262,14597,1488,7447,972,22044,3758,3537,1482,2754,3665
CATAACCTAGACCGTT,sample,37284,36723,3650,33073,9027,24046,9909,628,7401,853,17310,5255,4171,1480,3853,5494
CCAGAGCGAGACCGTT,sample,137833,136086,17093,118993,23823,95170,45163,2999,25653,3510,70816,17845,5010,1823,17348,15741
GGACGTAGAGACCGTT,sample,75087,73734,9007,64727,9697,55030,17982,1205,20586,2196,38568,13061,6797,1702,3456,6091
CTTGATAGAGACCGTT,sample,61583,60813,3818,56995,10277,46718,23627,1528,14511,1862,38138,5190,4105,1934,5947,7119
ACCTCGAGAGACCGTT,sample,100564,99544,5295,94249,14287,79962,52506,4603,15407,1629,67913,5817,3827,1674,14963,10179
AGTCCGCAAGACCGTT,sample,129376,127847,10817,117030,18364,98666,42979,3058,33663,2973,76642,15993,7428,2357,10758,12560
TTGGTACCAGACCGTT,sample,86653,85736,6631,79105,10062,69043,31576,2609,21469,2820,53045,10569,6219,2563,4697,7021
CTAGGACCAGACCGTT,sample,78921,78071,4452,73619,15894,57725,34753,2721,12796,1683,47549,5772,3611,1478,9664,10477
GCCTGAACAGACCGTT,sample,175709,174150,8211,165939,46062,119877,93543,7500,13254,1301,106797,4279,1884,1489,28200,29765
CGTATGAAAGACCGTT,sample,71634,70619,5556,65063,6780,58283,25095,2103,20284,2220,45379,8581,4646,1492,4457,4353
CCAATTCCAGACCGTT,sample,151774,150030,9915,140115,27587,112528,67563,4146,23497,2130,91060,15192,4715,1905,25607,19546
GGCATATAAGACCGTT,sample,149221,147414,12104,135310,28209,107101,59644,3100,26087,2801,85731,15469,6249,1955,19010,19513
TCCAACTTCTTGAGTT,sample,222551,221058,11859,209199,53339,155860,106049,7956,24316,2422,130365,15117,5676,2876,30605,36081
AAGTTCGTCTTGAGTT,sample,122924,121560,6568,114992,21629,93363,56690,4206,21081,2195,77771,9191,5308,2435,15099,15124
CCTCTAGACTTGAGTT,sample,167758,165960,13654,152306,27160,125146,71060,5050,29518,2926,100578,16592,6896,2591,22558,18634
CATAACCTCTTGAGTT,sample,47901,46535,7931,38604,3794,34810,7044,482,15017,1901,22061,10366,5910,1217,1028,2039
CATTGCAGCTTGAGTT,sample,140713,139419,7281,132138,27125,105013,83568,5024,10726,1414,94294,4281,2203,1656,27264,20130
AATCCGTCCTTGAGTT,sample,103963,103002,5420,97582,24434,73148,57000,4048,7600,1138,64600,3362,3418,2927,14810,16984
GTCCTGCCCTTGAGTT,sample,101074,99694,6239,93455,9377,84078,38000,2525,29713,3728,67713,10112,4699,1891,2746,6238
CTAGGACCCTTGAGTT,sample,185610,183859,12367,171492,28554,142938,81659,5457,32435,2989,114094,20398,7777,2427,21614,19196
CGGATTACCTTGAGTT,sample,145465,144010,8301,135709,33830,101879,73009,6077,14132,1613,87141,7048,3299,1689,26955,22892
AACTCGTACTTGAGTT,sample,159448,157693,12771,144922,20331,124591,65838,4471,32149,3737,97987,18396,7374,2194,15877,13393
AATATATCCTTGAGTT,sample,67426,66498,10495,56003,5051,50952,10002,727,22053,2356,32055,15814,7606,1605,874,2119
TTGGTTAACTTGAGTT,sample,77688,76401,8510,67891,10027,57864,24421,1795,18762,1991,43183,10895,6018,1863,6607,6330
TCGCCTGACTTGAGTT,sample,182918,180762,14942,165820,33489,132331,68774,3917,30174,2760,98948,26706,6521,2118,22928,22205
TTATTCGACTTGAGTT,sample,98173,97190,5507,91683,22552,69131,44879,3370,12668,1536,57547,6678,4047,1715,13545,15347
ATGACCGACTTGAGTT,sample,195379,194046,9993,184053,43808,140245,94196,6769,22700,2381,116896,14199,7028,2361,28885,30671
ATTCTCTTTCGGAGTT,sample,41868,41192,2904,38288,7422,30866,18929,1031,6245,686,25174,3975,2697,1257,7661,5370
ACGTAAGTTCGGAGTT,sample,13235,13007,1448,11559,2011,9548,3771,239,3004,332,6775,2202,2464,886,1328,1251
AGTACCATTCGGAGTT,sample,26466,25967,2050,23917,4086,19831,11341,577,5348,495,16689,2070,2661,1396,2702,2986
ACGTTATGTCGGAGTT,sample,26248,25839,2302,23537,5209,18328,12447,843,2866,268,15313,1904,1567,1035,4723,3537
TGAGCGCGTCGGAGTT,sample,9491,9251,1250,8001,1225,6776,3077,170,1923,235,5000,1371,1788,554,1315,837
TTCCGTCTTCGGAGTT,sample,6648,6448,636,5812,1000,4812,2042,171,1536,187,3578,876,1269,561,510,658
GCCTTGCTTCGGAGTT,sample,60586,59443,6342,53101,5666,47435,18847,1388,14785,1596,33632,10819,5379,1455,1582,3282
CCGCAACGTCGGAGTT,sample,8500,8321,827,7494,1105,6389,3139,203,1875,210,5014,962,1511,660,1208,730
GGCCAGAGTCGGAGTT,sample,16334,16000,1187,14813,2212,12601,7212,469,3036,260,10248,1624,1988,895,1015,1562
CGTACGTCTCGGAGTT,sample,50092,49451,3128,46323,8487,37836,25192,1802,6309,1007,31501,3526,3782,2233,4586,6080
GTCCTGCCTCGGAGTT,sample,36863,36078,5974,30104,2486,27618,4496,310,12278,1305,16774,9229,5692,931,522,1278
GTTAGGACTCGGAGTT,sample,31168,30841,2133,28708,4816,23892,14442,933,4681,539,19123,3297,3387,1590,3925,3514
TTGGCCTCTCGGAGTT,Pos_Ctrl,18370,18038,1545,16493,687,15806,13200,1142,995,114,14195,355,4073,3897,729,237
GGCATATATCGGAGTT,sample,30630,30268,2580,27688,4372,23316,11609,789,6396,846,18005,3676,3895,1546,2832,3110
TTATTCGATCGGAGTT,sample,13978,13778,869,12909,2101,10808,5020,402,3502,468,8522,1416,1970,861,700,1453
ATGACCGATCGGAGTT,sample,41355,40885,2855,38030,7255,30775,18321,1568,5684,598,24005,4604,4060,1699,3104,5142
ATTCTCTTTGAACCTT,Pos_Ctrl,42596,41321,4697,36624,2003,34621,28723,2372,2447,323,31170,756,5707,5823,2501,1083
TCCAACTTTGAACCTT,sample,77537,76632,4254,72378,18738,53640,42451,2133,6714,461,49165,1881,1477,1180,20313,12948
AAGTTCGTTGAACCTT,sample,14921,14496,2859,11637,1376,10261,3178,201,3790,384,6968,2708,2765,705,1011,690
TCCTCCGTTGAACCTT,sample,61111,60488,3221,57267,13683,43584,31924,2593,5491,527,37415,3049,3616,2809,6579,9292
ACGTAAGTTGAACCTT,sample,81483,80392,5203,75189,10765,64424,34209,2316,19709,2110,53918,6080,4189,1856,7684,7009
TTCGTAATTGAACCTT,sample,61763,61041,2781,58260,12932,45328,35103,2560,4543,690,39646,2432,2721,2359,10041,9255
TAGTACGGTGAACCTT,Pos_Ctrl,64631,62801,6841,55960,3156,52804,43842,3720,3815,412,47657,1015,6671,7606,3676,1626
AATGGTAATGAACCTT,sample,29831,29384,3301,26083,4581,21502,12034,630,4998,575,17032,3265,2620,1323,4120,3156
CCAGAGCGTGAACCTT,sample,28859,28398,3999,24399,2912,21487,5814,452,8794,957,14608,5470,4673,1263,1637,1766
GGAGGACGTGAACCTT,sample,88055,87244,4426,82818,15906,66912,42394,3164,15375,1437,57769,4542,2903,1580,14131,11435
CCGCAACGTGAACCTT,Pos_Ctrl,38324,37446,3630,33816,1830,31986,27008,2379,1738,266,28746,595,5539,5877,2339,866
CTTGATAGTGAACCTT,sample,90079,89292,3611,85681,18912,66769,46519,3938,10272,1001,56791,5039,3405,1442,12529,13166
CGAGGCAGTGAACCTT,sample,46834,46369,2534,43835,7229,36606,19103,1340,11086,1185,30189,3892,3338,1493,5150,4835
AATCCGTCTGAACCTT,Pos_Ctrl,49132,47902,4923,42979,2226,40753,34172,2958,2490,314,36662,819,6187,6787,2744,1238
ACGTATTATGAACCTT,sample,125328,124141,8237,115904,16709,99195,57980,4085,21756,2459,79736,12915,6057,1932,15139,11457
TTGGCCTCTGAACCTT,sample,27405,26977,2831,24146,2450,21696,7331,648,8243,829,15574,4645,4127,1355,622,1436
GTACCGTATGAACCTT,Pos_Ctrl,52098,51122,4733,46389,2294,44095,37038,3331,2544,337,39582,845,6174,6992,2981,1181
TTATTCGATGAACCTT,sample,78846,78211,3683,74528,12075,62453,38969,2642,13087,1541,52056,6214,4025,2142,9366,9111
TATCAGTTACCGAATT,sample,182379,179005,21169,157836,21775,136061,45008,2910,47552,5229,92560,35362,10208,2265,15201,14068
TCCAACTTACCGAATT,sample,162003,159357,14186,145171,21419,123752,68773,5438,29578,3694,98351,16269,7634,3672,10887,14144
CAACCGCGACCGAATT,sample,136953,135419,15027,120392,16678,103714,32056,2060,38758,4150,70814,26690,10088,2499,8254,11149
TTAGAAGTACCGAATT,sample,46818,46291,4154,42137,6787,35350,19543,1362,8016,908,27559,5521,4553,2022,5160,4457
GGACCTCTACCGAATT,sample,43278,42692,4904,37788,6123,31665,9753,553,11747,1181,21500,8431,5258,1199,2057,3980
ACTATACTACCGAATT,sample,87258,86223,8330,77893,16071,61822,31001,2455,16622,1795,47623,9949,5910,1994,9857,10757
GTTAGCCGACCGAATT,sample,122017,120343,13463,106880,14248,92632,23913,1626,40149,4207,64062,22737,8912,1671,4627,8401
GGAGGACGACCGAATT,sample,117939,116454,11723,104731,17713,87018,38584,2723,24917,2510,63501,18284,7509,1891,13620,11782
ACCTCGAGACCGAATT,sample,176401,174484,12955,161529,24769,136760,73852,6375,32834,3834,106686,19865,8619,2675,17034,17382
ACGACTTCACCGAATT,sample,107547,106324,5698,100626,16966,83660,45766,4059,20922,2321,66688,10592,6002,2611,5560,10900
CGTACGTCACCGAATT,sample,169907,168015,11067,156948,26645,130303,78137,6071,27344,3317,105481,15434,6285,2375,23204,18946
AGTCCGCAACCGAATT,sample,164232,162468,22507,139961,21569,118392,42068,2937,39142,4078,81210,30167,9547,2349,13613,14207
TTGGTACCACCGAATT,sample,117630,116578,4929,111649,21538,90111,62420,6010,14974,1499,77394,5208,4135,2498,11731,15643
GCCTGAACACCGAATT,sample,139324,137458,12905,124553,15031,109522,47808,3278,33763,3842,81571,20831,8405,2152,11324,9648
TTGGCCTCACCGAATT,sample,212486,210211,21146,189065,27063,162002,70398,4818,48177,5129,118575,33480,8821,2343,20872,17593
AATATATCACCGAATT,Neg_Ctrl,2577,1416,1043,373,73,300,102,15,113,10,215,60,140,67,24,22
TTGGTTAAACCGAATT,sample,143842,142416,10555,131861,21736,110125,49848,3245,34870,3220,84718,18942,7978,2326,14921,14723
TCAATATAACCGAATT,sample,232397,230244,14482,215762,30885,184877,99581,10089,40488,3758,140069,30961,7809,2330,21978,21112
TATCAGTTGGTCTGGT,sample,199238,197585,8605,188980,36176,152804,119515,9124,14972,1940,134487,7253,5189,4109,15113,27107
TCCAACTTGGTCTGGT,Neg_Ctrl,2934,1833,1163,670,119,551,260,24,115,9,375,143,271,153,59,46
TTCGTAATGGTCTGGT,sample,93352,92146,6985,85161,16142,69019,32728,2124,19573,2245,52301,12349,5045,1497,9861,10608
TGAGCGCGGGTCTGGT,Neg_Ctrl,2139,1497,933,564,72,492,157,8,235,7,392,85,178,68,51,36
CCAGAGCGGGTCTGGT,sample,53181,52410,5889,46521,6788,39733,12945,923,13633,1508,26578,10724,4935,1232,5302,4557
GGACGTAGGGTCTGGT,Neg_Ctrl,1625,987,698,289,66,223,102,8,71,6,173,36,122,53,22,38
GACGATAAGGTCTGGT,sample,74908,73807,5486,68321,14920,53401,25429,1819,16516,1721,41945,7916,4802,1640,6440,9660
ACGACTTCGGTCTGGT,sample,70578,69794,3092,66702,10304,56398,35587,2894,13553,1507,49140,2857,3217,2284,5055,7275
CGTACGTCGGTCTGGT,Neg_Ctrl,2208,1641,786,855,136,719,370,36,206,13,576,94,388,196,78,84
AGTCCGCAGGTCTGGT,sample,99184,98211,5714,92497,25636,66861,50318,3817,8741,966,59059,3019,1904,1579,19915,17316
CTAGGACCGGTCTGGT,sample,113652,112594,6436,106158,11904,94254,43845,4337,29880,4875,73725,11317,5268,1776,6307,8134
CGTATGAAGGTCTGGT,sample,145356,144130,6755,137375,23496,113879,78337,6715,18636,1817,96973,8374,4516,1958,19693,17252
TTGGCCTCGGTCTGGT,sample,114728,113642,7953,105689,13906,91783,52809,3263,20312,2122,73121,13277,5784,1695,15126,8792
TGCTTCGCGGTCTGGT,sample,82966,82341,4696,77645,10744,66901,35170,2863,18821,2539,53991,7508,5320,2199,6079,7278
AAGAGCGCGGTCTGGT,sample,154302,153022,7802,145220,15591,129629,76301,4854,33166,5041,109467,10267,5371,2137,13190,11614
GTCTTAGCGGTCTGGT,sample,116160,115363,7684,107679,22262,85417,55747,4245,14589,1583,70336,9253,3881,1447,21634,15221
GGCATATAGGTCTGGT,Neg_Ctrl,1836,1202,689,513,132,381,211,20,106,7,317,37,197,108,40,47
TTATTCGAGGTCTGGT,sample,88750,87864,5455,82409,15143,67266,45711,2873,11025,1047,56736,6610,4595,2252,10713,10406
TCCAACTTCGACGTTA,sample,267196,263636,23106,240530,38308,202222,91256,5937,60689,6349,151945,37991,9182,2088,25891,25237
AAGTTCGTCGACGTTA,sample,176714,173768,16288,157480,25850,131630,47007,2001,44648,5164,91655,32810,9205,1882,14471,16888
ACGTAAGTCGACGTTA,sample,133031,131415,6855,124560,25051,99509,68721,4632,16585,1982,85306,7589,4455,2678,20057,16886
ATGCCTGGCGACGTTA,sample,228994,225523,23863,201660,27670,173990,74531,5296,51658,5899,126189,36606,10904,3114,21667,19278
TGAGCGCGCGACGTTA,sample,76371,75470,4456,71014,12565,58449,31232,2330,15977,1764,47209,7146,4509,2096,8353,8597
AATGGTAACGACGTTA,sample,184538,182311,12289,170022,28036,141986,77329,4969,38646,4644,115975,16398,6901,2185,31355,19182
TTCCGTCTCGACGTTA,sample,243729,240939,22575,218364,38579,179785,70803,4798,58330,6397,129133,39457,9141,2537,23994,25835
CCAGAGCGCGACGTTA,sample,299414,296725,14708,282017,66393,215624,170966,16538,20344,2567,191310,5209,2187,1515,51389,45733
CTTGATAGCGACGTTA,sample,265088,262909,17473,245436,43904,201532,128730,10312,36622,3797,165352,22071,6551,2001,39582,31438
CGAGGCAGCGACGTTA,sample,162524,160966,11005,149961,21453,128508,59638,3813,38657,5238,98295,21162,7834,2147,9372,14290
CGTACGTCCGACGTTA,sample,164359,163224,9586,153638,28589,125049,79028,5667,23904,2609,102932,13841,5550,2038,21393,18807
TTGGCCTCCGACGTTA,sample,130315,129269,5835,123434,18871,104563,58024,5593,29027,3094,87051,8825,3798,1745,7772,12913
TGCTTCGCCGACGTTA,sample,89411,88776,4180,84596,16664,67932,39413,3212,17019,1913,56432,6375,3987,1642,7543,11032
AAGAGCGCCGACGTTA,sample,212343,211257,9684,201573,44142,157431,101386,9311,27362,3542,128748,15830,6334,2339,25562,30746
CCAATTCCCGACGTTA,sample,84248,83587,3077,80510,17284,63226,42709,3042,12018,1212,54727,4245,3110,1662,8186,11949
TTATTCGACGACGTTA,sample,117479,116924,3886,113038,33193,79845,63269,5187,8027,496,71296,2866,1513,1432,21654,21829
TATCAGTTTACTAAGT,sample,90199,89087,5123,83964,13448,70516,46262,3201,13204,1460,59466,6389,4457,1659,12212,9174
ACGTTATGTACTAAGT,sample,24764,24326,1847,22479,5019,17460,12457,750,2873,258,15330,1122,1936,1294,4205,3535
ATGCCTGGTACTAAGT,sample,74266,73390,4223,69167,11517,57650,40148,2286,10139,1292,50287,3785,3635,1937,13097,8192
TAGTACGGTACTAAGT,sample,69762,69017,5124,63893,11576,52317,29593,2095,13560,1483,43153,5586,4209,1604,9723,7847
TTAGAAGTTACTAAGT,sample,59795,59026,4261,54765,12400,42365,28486,1873,7047,703,35533,4256,3086,1425,10539,8748
TTCCGTCTTACTAAGT,sample,29704,29173,2956,26217,4053,22164,9827,626,7665,761,17492,3285,3317,1055,3110,2768
GCCTTGCTTACTAAGT,sample,90847,89977,3908,86069,14915,71154,52155,3984,10867,1348,63022,2800,3674,2795,10289,11441
ACTATACTTACTAAGT,sample,194726,192161,19584,172577,21801,150776,64507,4961,43908,4790,108415,32610,10652,2892,17402,13946
GGAGGACGTACTAAGT,sample,9155,8894,1136,7758,1078,6680,2748,201,2179,245,4927,1307,1861,715,684,691
CATGATTCTACTAAGT,sample,124342,122828,9301,113527,14059,99468,51942,3814,25829,2678,77771,15205,5728,1935,13745,9429
AATCCGTCTACTAAGT,sample,122114,120741,9030,111711,14218,97493,44588,2427,28607,2849,73195,19022,6825,1867,14641,9456
GTCCTGCCTACTAAGT,sample,94315,92831,9438,83393,8785,74608,32667,1972,22603,2166,55270,15200,7341,2190,5916,5327
GCCTGAACTACTAAGT,sample,74310,73649,3457,70192,16591,53601,38490,2914,7342,932,45832,3923,3313,1458,14137,11411
ACGTATTATACTAAGT,sample,104496,103650,6226,97424,20379,77045,55102,4314,11130,850,66232,5649,3685,1708,17486,14261
CGTATGAATACTAAGT,sample,99784,98938,3877,95061,12535,82526,54279,4989,16266,1826,70545,5166,3529,2147,13061,9003
CCAATTCCTACTAAGT,sample,44449,43973,3361,40612,5250,35362,15298,1172,11364,1590,26662,5938,4424,1561,3701,3514
TTGGTTAATACTAAGT,sample,123468,122620,4181,118439,24927,93512,77188,6038,7023,667,84211,2596,1935,1706,25345,17664
GTACCGTATACTAAGT,sample,105093,103949,8584,95365,15343,80022,40288,3101,21295,2458,61583,12880,6767,1714,11950,9818
GGCATATATACTAAGT,sample,90929,90278,3522,86756,21954,64802,49062,2791,8863,968,57925,3118,2796,1724,17035,15008
GGAGAGTTTTGCCGCT,sample,407057,403915,24376,379539,65286,314253,143518,10772,98074,10687,241592,51202,12244,4027,28423,46352
ACGTAAGTTTGCCGCT,sample,481592,478063,20603,457460,85269,372191,264372,19633,55290,7530,319662,25366,6765,2991,93880,61448
CAACCGCGTTGCCGCT,sample,255147,253334,11366,241968,61332,180636,144949,9050,18882,2956,163831,4799,1928,1547,63836,40950
GCCTTGCTTTGCCGCT,sample,115447,114273,6256,108017,19968,88049,51587,3511,21931,2620,73518,8400,5296,2563,12929,13744
CAAGGCCTTTGCCGCT,sample,96586,95404,5919,89485,10777,78708,37928,3055,25456,2944,63384,9325,5446,2348,4499,7351
ACTATACTTTGCCGCT,sample,506011,502132,28607,473525,86488,387037,262800,19861,62438,5917,325238,36021,7813,3093,83840,62816
GACGGAGATTGCCGCT,sample,383431,380530,18151,362379,84317,278062,195180,12914,41351,3385,236531,25232,7229,2443,67291,57753
CCAGAGCGTTGCCGCT,sample,381497,377866,25512,352354,65401,286953,164190,12653,62067,6997,226257,41046,9156,2727,65315,43989
CTTGATAGTTGCCGCT,sample,161128,159467,9941,149526,34819,114707,80690,4869,17710,1429,98400,10009,3838,1917,31829,25166
TGGACGAGTTGCCGCT,sample,252722,249059,22484,226575,26759,199816,87902,6180,63220,7205,151122,35309,9931,2684,24250,18642
CATTGCAGTTGCCGCT,sample,244242,242004,14892,227112,38583,188529,111903,9215,41771,4144,153674,21496,8177,2248,39205,26997
AATCCGTCTTGCCGCT,sample,184326,182752,10160,172592,24973,147619,81120,5988,39317,5122,120437,16072,6932,2569,18814,16990
CGTACGTCTTGCCGCT,sample,329990,327236,13691,313545,27078,286467,221460,18869,31443,2615,252903,12080,6693,4219,26018,19995
CGGATTACTTGCCGCT,sample,240329,237117,20842,216275,27523,188752,86917,5984,54254,5882,141171,35715,11068,3688,18127,17214
GTTAGGACTTGCCGCT,sample,221224,218584,16978,201606,30409,171197,100629,5949,39489,4275,140118,20855,8423,2530,35052,20714
TTGGCCTCTTGCCGCT,sample,223849,221512,12818,208694,27312,181382,111330,8859,43138,4326,154468,13729,5975,2296,26350,20151
ACCAATGCTTGCCGCT,sample,270973,268607,11550,257057,35938,221119,143506,14377,43126,4054,186632,16056,6246,2696,32400,24809
GTCTTAGCTTGCCGCT,sample,182748,180800,11680,169120,28853,140267,88515,5535,28325,2710,116840,15182,7144,2448,27437,20128
TCAATATATTGCCGCT,sample,230184,227942,13504,214438,40401,174037,99017,8080,42419,4947,141436,19574,7253,1964,32647,27323
TTATTCGATTGCCGCT,sample,142911,141393,9978,131415,21503,109912,62063,5132,26542,2951,88605,13224,6950,2534,14269,14794
TATCAGTTTTCGACCT,sample,414114,410389,25803,384586,71076,313510,179007,13862,66503,7700,245510,46438,10461,3095,64382,50349
GGTTGCGTTTCGACCT,sample,309786,306601,20805,285796,59181,226615,107616,6739,68506,7702,176122,36052,9459,2459,30587,37844
TCCTCCGTTTCGACCT,sample,129661,128505,5829,122676,19156,103520,57322,4446,31422,3255,88744,7075,4449,2081,18439,13022
ACGTTATGTTCGACCT,sample,173081,171444,9309,162135,38679,123456,87174,6034,20509,2553,107683,7186,4080,2177,36124,25975
TTAGAAGTTTCGACCT,sample,190072,188480,7478,181002,31130,149872,98519,6799,32001,3637,130520,8916,4173,2923,24056,23904
TTCCGTCTTTCGACCT,sample,215156,212751,15945,196806,38004,158802,87623,6599,39410,4711,127033,20459,7235,2195,32525,25233
ACTATACTTTCGACCT,sample,128753,127422,9429,117993,19609,98384,52179,4006,26561,2379,78740,13259,5875,2547,14868,13567
GACGGAGATTCGACCT,sample,52130,50977,6791,44186,6705,37481,15880,1009,11293,1376,27173,7923,5454,1764,4121,4062
ACCTCGAGTTCGACCT,sample,98465,97529,7454,90075,15602,74473,42754,3228,17610,2098,60364,8783,6160,2348,6651,10374
TTGGTACCTTCGACCT,sample,168982,167212,11139,156073,23689,132384,77640,6700,29294,3473,106934,15277,6644,2116,21373,15886
CTAGGACCTTCGACCT,sample,196646,194981,8150,186831,27144,159687,118606,8413,22606,1928,141212,8134,4821,2730,23233,19449
ACGTATTATTCGACCT,sample,686613,677250,70959,606291,40879,565412,223855,19573,225368,26347,449223,70269,16104,5182,25926,24538
AACTCGTATTCGACCT,sample,193551,191800,9578,182222,21347,160875,98276,7360,37076,4657,135352,13506,6116,2034,28809,13577
TCAATATATTCGACCT,sample,192018,190532,12317,178215,30360,147855,77354,6096,35209,3735,112563,25461,8980,2397,25403,20803
CTTCATGATTCGACCT,sample,158645,157355,6303,151052,25178,125874,86949,7002,19593,1934,106542,10396,5524,3025,12657,17748
GGAGAGTTTCCAGACT,sample,130499,129568,7168,122400,22016,100384,59841,3790,23461,2675,83302,10617,6398,2384,17955,14876
ATTCTCTTTCCAGACT,sample,190035,187658,16995,170663,23468,147195,68285,5096,44055,5404,112340,24355,8939,2233,23734,15161
TCCAACTTTCCAGACT,sample,198080,195976,12473,183503,29586,153917,95564,7533,29414,3639,124978,17767,7408,2718,26129,19609
GGTTGCGTTCCAGACT,sample,83977,82727,6223,76504,13523,62981,36869,2574,14095,1515,50964,7928,5623,2134,10660,9321
AATGGTAATCCAGACT,sample,59121,58377,3758,54619,10805,43814,26912,1909,10065,1003,36977,3925,3398,1559,7598,7794
TTCCGTCTTCCAGACT,sample,55548,54846,2640,52206,8852,43354,30003,2035,7913,963,37916,2440,2836,1786,6540,6199
GCCTTGCTTCCAGACT,sample,77888,76497,8094,68403,10873,57530,26919,1841,16233,1784,43152,10753,6213,1657,8797,6800
CAAGGCCTTCCAGACT,sample,131953,130488,7768,122720,21792,100928,69674,4858,16406,2235,86080,7755,3453,1785,19731,16239
GACGGAGATCCAGACT,sample,21735,21310,1852,19458,2050,17408,8427,546,5667,612,14094,2156,2596,1137,1369,1262
GTTAGCCGTCCAGACT,sample,69931,68695,8232,60463,8433,52030,24520,1281,14816,1500,39336,9913,5687,1119,9956,6108
GGCCAGAGTCCAGACT,sample,36581,36197,1874,34323,7222,27101,20028,1629,3105,500,23133,1839,2277,1658,5478,4937
GTCCTGCCTCCAGACT,sample,55820,55025,4435,50590,5202,45388,21570,1442,14560,1849,36130,5967,4111,1609,3045,3848
GTTAGGACTCCAGACT,Pos_Ctrl,50236,48944,5013,43931,1810,42121,35484,3103,2474,334,37958,726,5923,6853,2530,749
ACGTATTATCCAGACT,sample,5636,5493,763,4730,1184,3546,1356,118,1210,134,2566,728,1248,482,333,683
AACTCGTATCCAGACT,sample,87717,87036,3523,83513,17523,65990,52244,3946,6234,551,58478,3015,2288,1708,15471,13646
CGTATGAATCCAGACT,sample,60075,59143,7227,51916,5512,46404,18895,1000,15286,1583,34181,9640,5890,1706,4474,3619
TTGGCCTCTCCAGACT,Pos_Ctrl,49083,48082,4560,43522,1741,41781,35295,2997,2377,321,37672,791,5999,6839,2519,564
GTCTTAGCTCCAGACT,sample,51707,51114,4141,46973,6386,40587,18641,1422,11560,1326,30201,7638,5881,2238,2858,4200
TTGGTTAATCCAGACT,sample,94762,93875,6923,86952,14388,72564,41346,2391,16900,1945,58246,9982,5577,1636,12116,9244
GTACCGTATCCAGACT,sample,38780,38167,4201,33966,4694,29272,14841,1120,7489,824,22330,4998,4038,1331,4567,3190
TCAATATATCCAGACT,sample,81734,80971,3734,77237,13016,64221,49994,3241,6801,790,56795,3395,2912,1834,15763,9864
CTTCATGATCCAGACT,sample,82641,81250,8772,72478,9426,63052,23871,1364,20109,2032,43980,15676,6850,1754,5305,5775
AGTACCATACCATTAT,sample,99905,98459,8535,89924,14583,75341,43603,3406,17312,1928,60915,9092,6365,3290,8735,10073
ATGCCTGGACCATTAT,sample,292144,288703,22095,266608,44558,222050,112348,8035,57103,7956,169451,36608,9481,2651,37231,29310
TAGTACGGACCATTAT,sample,216449,213948,15118,198830,32200,166630,96093,6327,37951,4431,134044,21828,7684,2845,15568,22211
TTAGAAGTACCATTAT,sample,194312,192767,8234,184533,39273,145260,119098,8523,11767,2118,130865,3754,3392,2883,23507,28151
TGGACGAGACCATTAT,sample,119275,117683,7852,109831,16970,92861,49996,3645,25005,2771,75001,11444,6427,2683,6328,11979
GGCCAGAGACCATTAT,sample,229368,227122,14737,212385,51664,160721,97016,8318,31171,4783,128187,19433,6872,2220,25965,34651
AATCCGTCACCATTAT,sample,252979,250727,18566,232161,38950,193211,114375,8334,45204,4571,159579,20727,6818,2371,37039,26682
CGTACGTCACCATTAT,sample,208135,206243,8530,197713,24962,172751,92483,7134,53089,6268,145572,13777,4886,2067,20612,16981
ACCAATGCACCATTAT,sample,265771,263686,15419,248267,47997,200270,113653,8565,45492,4419,159145,28141,9644,2692,34765,32463
TCGCCTGAACCATTAT,sample,357460,354479,27673,326806,45029,281777,124572,9576,81085,8652,205657,57892,14554,3826,34941,27501
GGTTGCGTCAATGGAT,sample,722625,712842,78090,634752,61788,572964,250357,14961,201156,23591,451513,82899,16641,5305,51111,39649
ACGTAAGTCAATGGAT,sample,374290,370913,20854,350059,63969,286090,200129,13965,48063,5995,248192,17938,6273,3080,51178,46604
TGAGCGCGCAATGGAT,sample,239189,237106,20313,216793,32619,184174,75080,4903,61066,7515,136146,35610,10712,2623,25060,21640
CAACCGCGCAATGGAT,sample,189510,188038,9880,178158,32834,145324,107840,6341,20964,2361,128804,7818,4345,1802,41301,23208
CAAGGCCTCAATGGAT,sample,237600,235571,14312,221259,45102,176157,118442,7604,29264,3259,147706,17588,7071,2730,45330,31778
GACGGAGACAATGGAT,sample,275061,272303,15466,256837,40861,215976,121637,10116,53688,6027,175325,24508,6847,2450,31360,28336
CCATGAAGCAATGGAT,sample,209225,207534,9084,198450,24685,173765,112600,9245,34318,4651,146918,12951,5737,2618,22281,17202
ACGACTTCCAATGGAT,sample,244361,242096,10680,231416,35684,195732,135329,9203,36987,4981,172316,9232,4511,2215,34376,25993
AATCCGTCCAATGGAT,sample,150349,148492,12476,136016,21760,114256,47584,4497,38547,4092,86131,19536,7827,1981,10251,14590
CGTACGTCCAATGGAT,sample,215578,213413,13154,200259,24957,175302,116966,8547,31982,4858,148948,12949,6707,3304,22212,17284
GTTAGGACCAATGGAT,sample,249264,246855,17769,229086,27862,201224,92772,9423,62748,6716,155520,29565,8991,2563,16731,18472
GCCTGAACCAATGGAT,Neg_Ctrl,3435,1744,1148,596,111,485,264,22,118,15,382,66,266,146,79,36
AATATATCCAATGGAT,Neg_Ctrl,2738,1349,896,453,85,368,187,12,108,8,295,53,195,90,58,23
AAGAGCGCCAATGGAT,sample,318563,315472,21739,293733,36931,256802,143439,10820,57632,6161,201071,38750,9827,3136,33988,26399
CTTCATGACAATGGAT,sample,254024,252019,12237,239782,49163,190619,144797,8803,23961,2836,168758,10222,4613,2005,48376,34616
AGGTCGGACAATGGAT,Pos_Ctrl,92753,91239,8057,83182,3783,79399,66914,6308,4259,505,71173,1413,7159,9348,5381,1572
GACCGGAACAATGGAT,sample,173117,171690,5722,165968,31511,134457,112674,7694,9556,877,122230,3656,3981,3565,18352,22884
ATTCTCTTAGATTCAT,sample,186946,185073,12152,172921,33646,139275,81284,6213,31289,3031,112573,17458,7715,2877,22825,21991
TCCAACTTAGATTCAT,sample,151892,150608,6738,143870,29692,114178,72882,5971,25181,2333,98063,7811,5012,2348,18650,20814
AATGGTAAAGATTCAT,sample,146681,145391,6665,138726,25363,113363,78024,6255,19085,2132,97109,7867,4676,2689,18951,17979
TCGCATCTAGATTCAT,sample,44616,44058,2688,41370,6626,34744,21901,1520,7158,871,29059,3294,3843,2005,3917,4461
CATAACCTAGATTCAT,sample,272789,269814,21608,248206,36538,211668,112041,6633,50791,5665,162832,36538,9993,2810,45483,26098
CCGCAACGAGATTCAT,sample,229985,227790,14348,213442,36077,177365,115299,7391,31622,3474,146921,19579,7365,2464,31387,24157
ACCTCGAGAGATTCAT,sample,220045,217601,15310,202291,30939,171352,96355,8886,39493,4267,135848,22351,6860,2131,26334,21042
TGGACGAGAGATTCAT,sample,111562,109936,7676,102260,16345,85915,52593,4843,18793,2706,71386,6980,4908,2096,7332,11108
GGCCAGAGAGATTCAT,sample,107109,106161,4266,101895,14151,87744,59742,5072,16283,1679,76025,4968,3517,2169,11760,9923
CGAGGCAGAGATTCAT,sample,58061,57138,2921,54217,12558,41659,25037,2483,9622,1270,34659,3247,3167,1730,2886,7636
ACGACTTCAGATTCAT,sample,107732,106495,5328,101167,17117,84050,49482,3819,20049,2413,69531,8287,4884,1878,7725,11456
GTCCTGCCAGATTCAT,sample,179557,178017,8781,169236,28263,140973,95849,8059,26096,2850,121945,8119,4299,2246,29793,20116
AACTCGTAAGATTCAT,sample,103165,101911,8425,93486,14775,78711,45239,3530,16525,2058,61764,11359,6452,2175,11523,10082
CCAATTCCAGATTCAT,sample,185088,183198,16418,166780,25986,140794,72644,6530,35821,4440,108465,21359,8903,2651,15709,16444
TTGGTTAAAGATTCAT,sample,248837,247124,10235,236889,30992,205897,152575,11576,28711,2743,181286,10292,5581,3624,18781,23142
TCCAACTTCAATCTTG,sample,199188,197288,10939,186349,33075,153274,87033,5924,39741,4413,126774,16163,5946,2075,19322,22454
ATGCCTGGCAATCTTG,sample,151325,149635,7208,142427,20662,121765,87799,6065,18368,1889,106167,7644,4523,2569,21786,14441
AATGGTAACAATCTTG,sample,145316,143355,14778,128577,19930,108647,54034,2884,29551,3229,83585,18949,7673,2270,18695,12320
TTCCGTCTCAATCTTG,sample,189580,187623,11474,176149,17172,158977,76139,5953,49845,5491,125984,21549,6509,1765,15128,11621
GCCTTGCTCAATCTTG,sample,219077,216977,11675,205302,24318,180984,112382,8282,36801,4068,149183,19451,7258,2586,20935,16867
ACTATACTCAATCTTG,sample,294787,292672,11021,281651,66232,215419,173181,13872,20631,2773,193812,4962,2531,2032,56124,46681
GACGGAGACAATCTTG,sample,330575,327343,23473,303870,57069,246801,165829,14477,38766,4319,204595,23410,5337,2377,60048,40796
CCAGAGCGCAATCTTG,sample,323997,320858,22269,298589,38625,259964,163582,10882,47915,5909,211497,31676,10471,4032,32343,25866
GGAGGACGCAATCTTG,sample,91796,90476,8520,81956,18193,63763,30244,2865,17298,2100,47542,11256,6267,2177,7127,11585
CGAGGCAGCAATCTTG,sample,292120,289769,17086,272683,44679,228004,127461,10315,52918,4839,180379,32471,9601,3011,33960,30985
CATGATTCCAATCTTG,sample,190798,189104,11076,178028,26930,151098,85866,6605,35664,3852,121530,19111,8153,2867,18260,17844
CGGATTACCAATCTTG,sample,285353,282740,20648,262092,36917,225175,116963,9735,56081,6808,173044,35588,8388,2597,32780,24859
CGTATGAACAATCTTG,sample,201910,199969,9439,190530,28000,162530,105213,8816,30640,3892,135853,13969,5444,2026,33716,19048
GAAGGCGCCAATCTTG,sample,185688,183959,10967,172992,31124,141868,82963,7433,30458,4216,113421,16798,8149,2500,24343,20570
GTCTTAGCCAATCTTG,sample,157823,156054,14122,141932,19663,122269,52075,3217,38287,3836,90362,24854,8814,1862,13520,12104
CCAATTCCCAATCTTG,sample,216997,214832,13031,201801,30736,171065,106903,8826,31650,3673,138553,20013,6502,2121,33599,20493
TCAATATACAATCTTG,sample,234662,232327,15733,216594,34754,181840,92802,7379,50599,4763,143401,26297,9098,2421,26000,24202
TCGCCTGACAATCTTG,sample,216069,214568,9283,205285,42583,162702,120975,9577,19520,2078,140495,10552,5737,2972,29768,29725
CTTCATGACAATCTTG,sample,134149,132811,6844,125967,20142,105825,77358,6302,13506,1526,90864,7133,4794,2188,14952,14339
TTATTCGACAATCTTG,Neg_Ctrl,2593,1387,802,585,85,500,236,19,117,14,353,114,241,128,67,29
GACCGGAACAATCTTG,sample,438155,434744,19651,415093,43139,371954,284469,22089,39229,3903,323698,22264,7473,3189,40339,28342
ACGTAAGTCGTTCCGA,sample,253385,250663,13026,237637,50818,186819,131740,9645,28343,3815,160083,13276,6196,2820,39644,34524
TTCCGTCTCGTTCCGA,sample,238504,236281,11539,224742,35601,189141,128047,8217,37805,4242,165852,10830,5008,2913,31729,24909
GGACCTCTCGTTCCGA,sample,335991,333488,13469,320019,87818,232201,186735,13805,21852,2457,208587,7352,2272,2024,61741,59443
TCGCATCTCGTTCCGA,sample,242728,240795,10172,230623,41448,189175,132544,10413,32119,3539,164663,10560,5144,3167,28292,29227
GCCTTGCTCGTTCCGA,sample,218292,216078,13475,202603,39861,162742,114451,8702,23899,2737,138350,12953,6874,3604,21898,27568
CAAGGCCTCGTTCCGA,sample,312784,309091,25226,283865,56273,227592,116499,7124,60224,6691,176723,37054,10281,2945,42431,38258
CATAACCTCGTTCCGA,sample,299693,296947,17356,279591,54557,225034,154111,10853,36348,4784,190459,18938,7494,3156,39488,37468
ACCTCGAGCGTTCCGA,sample,215084,211886,22050,189836,25203,164633,81280,3708,42343,4662,123623,32640,9574,2265,20350,15952
TGGACGAGCGTTCCGA,sample,311267,308987,12897,296090,53294,242796,198253,17689,19063,1817,217316,5974,2283,1756,43497,40449
CATTGCAGCGTTCCGA,sample,267393,263833,21195,242638,30252,212386,115757,9753,53119,5240,168876,28517,8860,2438,28944,18435
CGAGGCAGCGTTCCGA,sample,302038,299130,21810,277320,33986,243334,117065,6905,68419,6503,185484,44442,10607,2798,32375,21656
CATGATTCCGTTCCGA,sample,361006,357955,12430,345525,42977,302548,241076,19667,26849,4205,267925,10751,5965,3355,28452,31525
AATCCGTCCGTTCCGA,sample,197439,195616,9148,186468,30698,155770,101862,9205,28348,3379,130210,12976,7125,3208,14889,20639
CGTACGTCCGTTCCGA,sample,100728,99811,6590,93221,15325,77896,39064,3408,21492,2512,60556,11420,6259,1932,13502,10383
TTGGTACCCGTTCCGA,sample,238407,234883,33835,201048,13857,187191,46409,4271,82925,8219,129334,45367,12018,3017,2064,7150
GTTAGGACCGTTCCGA,sample,200679,198628,15137,183491,32143,151348,77196,4854,39972,3948,117168,25378,8525,2116,14555,19902
ACGTATTACGTTCCGA,sample,428156,425165,16238,408927,70536,338391,264653,16615,40097,2924,304750,14102,4394,2386,66598,52044
TTGGCCTCCGTTCCGA,sample,293013,290622,13864,276758,50208,226550,150740,12087,42641,4796,193381,16286,4717,1766,45089,36587
ACCAATGCCGTTCCGA,sample,190231,188628,15676,172952,16734,156218,65982,5287,50999,5676,116981,28274,10728,3413,10571,10013
TGCTTCGCCGTTCCGA,sample,94441,93540,3493,90047,13303,76744,48247,4582,16836,2140,65083,4939,4269,2483,2710,9109
GAAGGCGCCGTTCCGA,sample,263908,262238,8370,253868,30973,222895,162027,11631,32974,4149,195001,12114,5765,3303,13839,21821
GTCTTAGCCGTTCCGA,sample,144431,143026,8056,134970,22442,112528,66357,5480,25496,3147,91853,12048,6430,2526,8076,14358
GTACCGTACGTTCCGA,sample,3805,3690,370,3320,747,2573,1414,124,631,62,2045,342,949,505,304,440
TATCAGTTCAATTCGG,sample,449341,446232,27133,419099,63333,355766,177166,13486,98444,12769,275610,53901,13562,4297,32813,41340
ATTCTCTTCAATTCGG,Pos_Ctrl,222244,218467,16905,201562,8645,192917,162841,15097,10260,1184,173101,3535,8164,12779,10602,4089
TCCAACTTCAATTCGG,sample,270462,266470,35923,230547,40265,190282,41567,3481,78284,8677,119851,58273,13490,2957,7605,24375
CCTCTAGACAATTCGG,sample,217290,215111,11610,203501,34984,168517,107791,7620,37460,3315,145251,12331,6025,2188,44243,24064
AGTACCATCAATTCGG,sample,148341,146837,8686,138151,32295,105856,65181,5063,22744,2536,87925,10332,5930,2942,22970,22949
ACGTTATGCAATTCGG,Pos_Ctrl,113325,109579,11608,97971,4707,93264,78108,6633,5884,661,83992,1978,7679,9979,6518,2182
TGAGCGCGCAATTCGG,sample,192010,190481,10008,180473,34259,146214,95913,6375,28045,3046,123958,12835,5490,1935,41035,24227
TTAGAAGTCAATTCGG,sample,201434,199808,13599,186209,35583,150626,91609,7227,28802,3121,120411,19867,7588,2765,34007,23181
GGACCTCTCAATTCGG,sample,239606,237077,19294,217783,32397,185386,74856,5042,62870,7842,137726,34776,10175,2499,22702,21337
GCCTTGCTCAATTCGG,Pos_Ctrl,84925,82983,7943,75040,3697,71343,59948,5229,4130,604,64078,1432,7215,8820,5155,1640
CAAGGCCTCAATTCGG,sample,284501,282126,14052,268074,55195,212879,161802,11507,26207,3124,188009,10239,5943,3470,39191,38701
CATAACCTCAATTCGG,sample,253420,250417,19623,230794,43129,187665,97258,7133,48825,6381,146083,28068,9848,2951,29279,29932
GTTAGCCGCAATTCGG,sample,342168,339789,18592,321197,54135,267062,154310,14418,58783,6324,213093,33227,10069,3211,39796,37014
CCGCAACGCAATTCGG,Pos_Ctrl,87912,85198,7338,77860,2978,74882,62606,5944,4268,561,66874,1503,6881,9217,3712,936
TGGACGAGCAATTCGG,sample,360765,356896,36621,320275,43934,276341,138756,11171,64000,8212,202756,54202,10662,3097,45267,26418
CCATGAAGCAATTCGG,Pos_Ctrl,106735,103154,9606,93548,3613,89935,75339,6765,5413,678,80752,1740,7231,9765,4539,1232
GTCCTGCCCAATTCGG,sample,258208,256078,8488,247590,35794,211796,173987,14636,17522,1954,191509,3697,2209,1531,62036,28825
CGGATTACCAATTCGG,Pos_Ctrl,101680,99170,8545,90625,3822,86803,73104,6683,4845,606,77949,1565,7133,9696,4864,1484
TTGGCCTCCAATTCGG,Pos_Ctrl,88622,86777,7601,79176,3299,75877,63714,5874,4323,559,68037,1407,7130,9236,4219,1214
TGCTTCGCCAATTCGG,sample,209612,208111,5383,202728,51707,151021,120714,10632,14534,1166,135248,3975,3391,2379,35413,35656
GAAGGCGCCAATTCGG,sample,353113,349688,27285,322403,56404,265999,126897,10206,71628,7682,198525,49586,12361,3721,31967,39208
AAGAGCGCCAATTCGG,sample,282660,280230,15201,265029,66298,198731,123065,9668,39980,4117,163045,21901,7722,2419,45351,43979
GTCTTAGCCAATTCGG,sample,301468,299022,15494,283528,63601,219927,134368,11025,42599,4784,176967,27151,9950,3092,41411,42225
TTGGTTAACAATTCGG,sample,320634,318024,12509,305515,26456,279059,215800,16939,31813,3749,247613,10758,6882,4718,22322,17134
GTACCGTACAATTCGG,sample,257696,255130,13287,241843,42174,199669,127947,9638,37313,4391,165260,20380,8195,2597,28063,28313
AGGTCGGACAATTCGG,sample,184863,182727,11501,171226,14798,156428,75274,4758,52512,6040,127786,17844,7113,2683,4374,9323
GACCGGAACAATTCGG,sample,310340,308037,12082,295955,66095,229860,189954,11153,21703,3894,211657,3156,2037,1544,67394,46845
GGAGAGTTAACTCCGG,sample,227410,225968,8664,217304,37902,179402,102701,10052,42170,5473,144871,19006,8342,3468,19552,25636
CAACCGCGAACTCCGG,sample,135587,133118,16618,116500,16675,99825,28559,1710,39546,4187,68105,25823,9152,1928,6828,9633
GGACCTCTAACTCCGG,sample,52899,52025,5096,46929,8141,38788,20989,1357,9474,1079,30463,5889,4979,2240,5917,5228
GCCTTGCTAACTCCGG,sample,66375,65288,7553,57735,7376,50359,21481,1520,16216,1934,37697,9208,6121,2283,3144,4270
CAAGGCCTAACTCCGG,sample,171356,169723,10244,159479,21977,137502,71092,4912,40954,5702,112046,14842,6172,2286,12881,14643
ACTATACTAACTCCGG,sample,416107,412239,16962,395277,47443,347834,270578,17625,34784,4071,305362,20776,7738,4002,34698,33426
TGGACGAGAACTCCGG,sample,142526,140842,9765,131077,17542,113535,63662,6291,28560,2630,92222,12392,6378,2646,7342,11535
CCATGAAGAACTCCGG,sample,204929,203041,7217,195824,27704,168120,124243,9268,24926,2133,149169,7550,4243,2135,33481,21300
AATCCGTCAACTCCGG,sample,170785,168668,17075,151593,15735,135858,40785,3207,52348,6872,93133,32646,10640,2788,5650,9184
CGGATTACAACTCCGG,sample,238292,236015,13286,222729,40565,182164,114619,9403,36146,4277,150765,17719,6283,1944,40863,28399
CGTATGAAAACTCCGG,sample,222042,219948,15915,204033,27249,176784,80955,6668,50654,5435,131609,33072,9318,2470,22235,18191
ACCAATGCAACTCCGG,sample,196228,194296,15473,178823,23456,155367,80846,7792,37874,3910,118720,24945,8587,2034,27510,14573
AAGAGCGCAACTCCGG,sample,315524,313433,14182,299251,52027,247224,176112,15371,32605,3497,208717,19639,6366,2775,51971,39382
CCAATTCCAACTCCGG,sample,293144,290789,14111,276678,53840,222838,146724,13493,36107,4195,182831,22319,6568,2718,37464,37882
CTTCATGAAACTCCGG,sample,143542,141949,8995,132954,22148,110806,61014,4926,27242,3251,88256,14373,6425,1835,9160,13762
ATGACCGAAACTCCGG,sample,14683,14428,701,13727,2981,10746,6936,1012,1823,234,8759,741,1553,1024,1403,1852
GGAGAGTTCCTGAAGG,sample,345744,342884,17257,325627,60178,265449,181224,14192,41927,5057,223151,23049,7957,3481,55587,41861
TATCAGTTCCTGAAGG,sample,274637,272113,15002,257111,43282,213829,135690,10535,41546,5041,177236,21017,8700,4281,22592,30278
TCCAACTTCCTGAAGG,Neg_Ctrl,5057,2768,1791,977,183,794,426,35,206,19,632,108,414,200,120,40
GGTTGCGTCCTGAAGG,sample,339806,336535,17772,318763,58192,260571,189588,11625,34689,4857,224277,19812,6253,3212,61959,40596
ACGTAAGTCCTGAAGG,sample,298671,296092,9594,286498,41466,245032,180420,11650,38475,4586,218895,9901,5095,3488,22229,29991
ACGTTATGCCTGAAGG,sample,239058,237214,10617,226597,49253,177344,139202,9234,21163,1918,160365,5827,2457,1575,64713,34369
TTCTAATGCCTGAAGG,Neg_Ctrl,3043,1778,1263,515,86,429,232,10,106,18,338,63,235,101,72,29
TAGTACGGCCTGAAGG,sample,233136,230425,22242,208183,32065,176118,66459,5632,58460,7435,124919,38132,10976,2617,16875,20905
CAAGGCCTCCTGAAGG,Neg_Ctrl,3464,2203,1283,920,176,744,434,39,161,13,595,97,357,204,128,65
CATAACCTCCTGAAGG,sample,159520,157710,8506,149204,28201,121003,87020,5602,19259,1880,106279,7242,4806,2285,30543,19408
GGACGTAGCCTGAAGG,Neg_Ctrl,2656,1631,924,707,101,606,291,10,186,11,477,108,290,140,84,45
ACCTCGAGCCTGAAGG,sample,98240,96818,8111,88707,18786,69921,31061,2909,21477,2090,52538,12384,6786,2011,4436,11585
CATTGCAGCCTGAAGG,sample,313841,310356,25302,285054,37581,247473,124502,8406,62221,6061,186723,46283,11838,3636,26957,25217
ACGACTTCCCTGAAGG,Neg_Ctrl,3899,2421,1097,1324,204,1120,627,70,252,30,879,141,547,311,149,71
CGTACGTCCCTGAAGG,sample,224196,222097,11729,210368,32365,178003,115763,7363,34537,4564,150300,15776,6317,2494,32472,21698
TTGGTACCCCTGAAGG,sample,223480,221453,10770,210683,31094,179589,113414,9165,37612,4341,151026,15057,5872,2358,29331,21748
GTTAGGACCCTGAAGG,Neg_Ctrl,3401,2034,1170,864,124,740,413,28,171,31,584,97,402,198,110,36
ACGTATTACCTGAAGG,sample,226621,224016,17184,206832,21689,185143,88177,6488,57792,7107,145969,25579,8358,2500,19108,13552
AATATATCCCTGAAGG,Neg_Ctrl,2655,1577,1015,562,92,470,247,12,99,16,346,96,242,125,64,37
TGCTTCGCCCTGAAGG,sample,147051,145201,14981,130220,19560,110660,40472,2851,36856,4193,77328,26288,9414,2179,6988,11973
GTACCGTACCTGAAGG,sample,236198,233398,17621,215777,30050,185727,97630,7376,45770,4708,143400,30243,9670,2583,28779,20188
GGCATATACCTGAAGG,sample,225581,223480,13424,210056,35651,174405,123785,5834,29089,2833,152874,12864,5633,2112,39857,26335
TCGCCTGACCTGAAGG,sample,230479,228744,17660,211084,35314,175770,138542,11196,17380,2242,155922,6410,3258,1970,38525,32535
CTTCATGACCTGAAGG,sample,208429,205607,17333,188274,25645,162629,82007,6736,42917,5226,124924,25743,8890,2268,24188,16002
ATGACCGACCTGAAGG,sample,320791,317483,31348,286135,26673,259462,115637,7411,77280,8672,192917,50462,13398,3979,25668,15671
TATCAGTTAATATTCG,sample,316156,313048,22220,290828,44540,246288,120756,8972,70016,8069,190772,38475,10495,3307,22360,30318
AAGTTCGTAATATTCG,sample,260961,257130,19561,237569,42057,195512,96273,5933,50220,4632,146493,38454,11111,2934,28043,27977
GGTTGCGTAATATTCG,sample,311944,308352,20178,288174,40620,247554,151609,12342,49945,5493,201554,28165,8904,2772,53041,28097
ACGTAAGTAATATTCG,sample,210128,207913,9294,198619,26609,172010,108528,6071,40354,5329,148882,11728,5338,2356,29136,18611
TTCGTAATAATATTCG,sample,237222,235190,10420,224770,40472,184298,122350,8400,35525,4148,157875,13875,6786,3147,29373,28234
ATGCCTGGAATATTCG,sample,169014,167393,14189,153204,24015,129189,62614,4236,35106,3744,97720,23489,9011,2764,16115,15606
TGAGCGCGAATATTCG,sample,198551,196971,5908,191063,41138,149925,123393,10806,10126,1487,133519,4113,3653,3169,25507,29025
TCGCATCTAATATTCG,sample,327062,324646,15803,308843,56790,252053,173484,12256,43848,5382,217332,17083,5615,2174,63691,39320
CGAGGCAGAATATTCG,sample,341840,339152,18127,321025,34422,286603,174189,13252,57149,6586,231338,35427,9337,2780,32895,22154
CCATGAAGAATATTCG,sample,312940,310254,15058,295196,45133,250063,157722,14561,46278,5342,204000,26160,8893,2826,42408,31883
ACGACTTCAATATTCG,sample,389492,386446,10724,375722,57295,318427,266623,21720,18945,3004,285568,8135,3832,2967,40385,42669
CATGATTCAATATTCG,sample,257792,255421,11260,244161,45425,198736,133842,8283,36693,4142,170535,15776,5555,2241,41947,31579
GTCCTGCCAATATTCG,sample,297722,295530,10669,284861,56267,228594,175753,12725,25446,3944,201199,10726,5648,3063,45541,40689
ACGTATTAAATATTCG,sample,281048,278480,15195,263285,32699,230586,140445,10671,49885,5905,190330,23680,8335,3381,20985,22828
GAAGGCGCAATATTCG,sample,284570,282408,13681,268727,53407,215320,158908,10887,30341,3854,189249,11330,4555,1885,54064,38693
GTACCGTAAATATTCG,Pos_Ctrl,151487,150051,8899,141152,6414,134738,114287,11131,6259,791,120546,2270,7884,11622,9816,2263
TCAATATAAATATTCG,sample,394124,389794,32333,357461,38816,318645,136534,9259,102413,13420,238947,57019,13490,3858,25917,25300
AGGTCGGAAATATTCG,sample,226321,224384,13549,210835,45418,165417,94935,8105,36904,4127,131839,21346,8728,2036,20688,30056
GGAGAGTTAGTCTCCG,sample,210761,209604,10670,198934,35073,163861,85421,6511,43582,4460,129003,23887,10389,4185,19108,23219
TATCAGTTAGTCTCCG,sample,108836,108159,5853,102306,17537,84769,41492,3590,26175,3045,67667,10467,6045,2020,9532,11172
ATTCTCTTAGTCTCCG,sample,339926,336672,19360,317312,39550,277762,149372,9352,81574,8081,230946,29383,8486,2717,44890,27081
TTCGTAATAGTCTCCG,sample,340825,337770,20298,317472,58846,258626,136572,11311,60755,7053,197327,42935,10387,2869,52494,39466
TTCCGTCTAGTCTCCG,sample,23135,22836,2257,20579,3446,17133,9612,590,4226,487,13838,2218,2642,1064,4228,2266
CATAACCTAGTCTCCG,sample,205324,203722,7184,196538,33244,163294,101769,7049,37324,6483,139093,10669,4764,2100,23696,23220
GACGGAGAAGTCTCCG,sample,276351,274803,11013,263790,49965,213825,145782,11749,35776,4607,181558,15911,6372,2592,53817,33912
CCAGAGCGAGTCTCCG,sample,53158,51393,2479,48914,9076,39838,30617,3244,3872,875,34489,1230,1187,697,10015,5896
CGAGGCAGAGTCTCCG,sample,299010,295026,24112,270914,30138,240776,109167,6307,70752,6787,179919,47763,11291,2865,32640,19575
AATCCGTCAGTCTCCG,sample,287738,285253,12908,272345,30149,242196,161096,9758,47429,5854,208525,18059,6503,2458,51543,21410
CGTACGTCAGTCTCCG,sample,101994,100727,8807,91920,14726,77194,39674,2063,20329,2333,60003,12795,6816,1995,13530,9664
AGTCCGCAAGTCTCCG,sample,212102,210057,11285,198772,34409,164363,115604,7848,26111,2905,141715,11895,6633,2845,31363,24884
CGGATTACAGTCTCCG,sample,245742,242844,17290,225554,33261,192293,102628,6814,49708,5647,152336,27496,9787,2409,30874,22594
GCCTGAACAGTCTCCG,sample,280673,278156,15567,262589,35733,226856,151780,11107,37563,6164,189343,20242,5792,2256,42798,24954
AACTCGTAAGTCTCCG,sample,275598,272904,19445,253459,33985,219474,100476,5775,62810,7487,163286,42926,10413,2710,28898,21837
TTGGCCTCAGTCTCCG,sample,330437,327810,23001,304809,36995,267814,139589,13396,61326,8099,200915,45404,11875,3273,43743,25040
AAGAGCGCAGTCTCCG,sample,275586,273875,8905,264970,49478,215492,173563,12256,21703,2346,195266,5624,2756,1877,52281,34758
GTCTTAGCAGTCTCCG,sample,241420,239608,11508,228100,42713,185387,115818,9853,36516,3954,152334,19246,7369,2269,31003,29736
TCAATATAAGTCTCCG,sample,279349,277663,12902,264761,43766,220995,124194,10823,57000,7269,181194,21709,7238,2327,32885,29878
AGGTCGGAAGTCTCCG,sample,337160,335019,21006,314013,52985,261028,160519,13174,48602,6116,209121,32617,10747,3229,53035,35290
TTATTCGAAGTCTCCG,sample,103368,102466,4825,97641,16802,80839,51230,4428,15359,2084,66589,7738,4716,1601,4305,10589
GGTTGCGTTGCCTACG,sample,320192,316971,26671,290300,41325,248975,126023,9565,61690,6399,187713,45298,10636,3149,42483,27636
ACGTAAGTTGCCTACG,sample,174623,171805,20315,151490,17504,133986,43977,3001,48038,4988,92015,33982,10700,2278,12662,10692
TTCGTAATTGCCTACG,sample,79843,78884,8095,70789,9118,61671,21025,1522,24186,2516,45211,12422,6213,1684,4580,5741
TGAGCGCGTGCCTACG,sample,98799,97268,14136,83132,7908,75224,21594,1269,29235,3384,50829,19742,8674,1764,3801,4362
CCAGAGCGTGCCTACG,sample,7745,7668,405,7263,2296,4967,2761,245,1193,148,3954,620,1513,916,626,1380
GGCCAGAGTGCCTACG,sample,96670,95620,3587,92033,15608,76425,53014,5060,11961,1293,64975,5097,3754,1590,11652,10646
CCATGAAGTGCCTACG,sample,137628,136336,6735,129601,17864,111737,70924,5173,22085,2234,93009,11321,5762,1976,18449,12961
ACGACTTCTGCCTACG,sample,204960,203123,11430,191693,37681,154012,98398,6633,27101,2825,125499,19055,8546,2412,31166,25365
CGTACGTCTGCCTACG,sample,123911,122749,9505,113244,21609,91635,55820,4527,18940,2184,74760,10164,5132,2031,10718,13809
TTGGTACCTGCCTACG,sample,170455,168538,13640,154898,20503,134395,66908,4588,36347,5072,103255,21480,8385,2076,8631,13694
ACGTATTATGCCTACG,sample,144486,143288,8797,134491,18330,116161,69202,4247,23895,2299,93097,16518,6559,2098,16760,12301
CGTATGAATGCCTACG,sample,125095,123808,7553,116255,17916,98339,64330,5202,17438,1793,81768,9576,5024,1481,21052,12685
AATATATCTGCCTACG,sample,78083,77060,6083,70977,9865,61112,30528,2698,14966,1585,45494,11335,6147,2095,5884,6416
AAGAGCGCTGCCTACG,sample,112257,111100,9340,101760,11115,90645,44458,3956,25291,2971,69749,13969,7327,2591,8510,6671
GGCATATATGCCTACG,Neg_Ctrl,1850,982,545,437,76,361,220,15,75,12,295,39,193,117,69,21
ATGACCGATGCCTACG,sample,160576,158937,16381,142556,26290,116266,50326,3521,34440,3829,84766,24150,9164,2180,7918,16312
GACCGGAATGCCTACG,sample,201311,199807,12651,187156,27161,159995,94892,8115,33444,3526,128336,20018,7659,2350,29274,18959
ATTCTCTTCTTAGTTC,sample,440331,434973,38573,396400,51180,345220,156361,10028,98465,11697,254826,68669,13472,3500,54021,34522
AAGTTCGTCTTAGTTC,sample,287165,284758,12155,272603,37769,234834,159174,15185,42415,4741,201589,13319,6793,3450,29186,27076
AGTACCATCTTAGTTC,sample,208154,204272,27924,176348,24140,152208,65352,4434,46067,5158,111419,31197,11515,3530,14737,15342
TTCGTAATCTTAGTTC,sample,96068,93482,10302,83180,15225,67955,21370,1366,25339,2783,46709,17097,7544,1853,4365,9071
ACGTTATGCTTAGTTC,sample,235933,232694,21796,210898,31297,179601,78650,4421,51844,5463,130494,39223,11361,2881,28078,21336
TTCTAATGCTTAGTTC,sample,44170,43454,5133,38321,6823,31498,14569,1223,8801,1040,23370,5865,5387,2560,2481,4072
CAACCGCGCTTAGTTC,sample,198995,196837,14252,182585,36471,146114,83201,5948,32350,3848,115551,20767,9020,2788,24203,23275
TCGCATCTCTTAGTTC,sample,126952,125805,6449,119356,23029,96327,76233,3461,10536,1371,86769,4726,2377,1474,38117,16693
CGAGGCAGCTTAGTTC,sample,243551,240572,18580,221992,34822,187170,101146,7550,44705,5140,145851,28629,9655,2273,27325,21430
ACGACTTCCTTAGTTC,sample,300180,297414,13092,284322,44020,240302,162535,9718,40615,4767,203150,22667,6617,2384,55645,32416
CGTACGTCCTTAGTTC,sample,418706,414767,27922,386845,51880,334965,182775,11404,81515,8692,264290,50579,12259,3711,43689,34769
CGGATTACCTTAGTTC,sample,359686,356672,16121,340551,43008,297543,184828,14850,64031,7836,248859,25998,7999,2767,33121,29010
AACTCGTACTTAGTTC,sample,292321,290028,13174,276854,36881,239973,153022,11537,46645,4156,199667,24613,8299,2580,29149,26157
AAGAGCGCCTTAGTTC,sample,374468,372259,15625,356634,31922,324712,222614,19363,49214,6401,271828,27120,10393,4810,24932,22015
TCGCCTGACTTAGTTC,sample,307202,305295,7997,297298,41567,255731,182889,22346,34180,4718,217069,11598,4638,2360,28014,30738
ATGACCGACTTAGTTC,sample,261866,260198,11414,248784,48796,199988,127029,10085,39521,4414,166550,18939,7041,2406,42206,34217
ATTCTCTTCGAGCTTC,sample,169210,167463,7470,159993,26237,133756,83850,6925,29046,3003,112896,10932,6099,3186,9479,17669
AAGTTCGTCGAGCTTC,sample,201517,198708,15529,183179,25411,157768,73302,5189,47496,5292,120798,26489,9405,2570,10421,15477
GGTTGCGTCGAGCTTC,sample,271514,268889,11238,257651,65230,192421,136526,9105,29942,2826,166468,14022,5047,2296,54081,45026
TCCTCCGTCGAGCTTC,sample,332598,330046,11952,318094,54582,263512,191486,16063,36911,4639,228397,14413,5037,2746,50093,38051
ACGTAAGTCGAGCTTC,sample,232836,230295,11377,218918,27956,190962,113551,5776,52165,5426,165716,14044,6421,2420,38400,19936
AGTACCATCGAGCTTC,sample,391018,387660,20697,366963,69580,297383,202154,12116,48157,6081,250311,28875,7049,2776,59253,50555
TTCGTAATCGAGCTTC,sample,314319,311203,15400,295803,51916,243887,170430,11888,38229,4021,208659,19319,6859,2520,38659,35778
TGAGCGCGCGAGCTTC,sample,199319,196817,20053,176764,29001,147763,51290,5262,50574,5464,101864,35173,12147,2824,13403,17303
GGACCTCTCGAGCTTC,sample,162037,159537,14212,145325,17442,127883,51400,3164,40276,4616,91676,28427,8615,1879,14112,11611
GACGGAGACGAGCTTC,sample,216836,213534,18254,195280,29051,166229,73032,3888,52279,6039,125311,30991,9681,2315,18431,18650
GGACGTAGCGAGCTTC,sample,244236,241682,14159,227523,41277,186246,105287,9219,42703,4465,147990,24572,8254,2301,28554,27359
TGGACGAGCGAGCTTC,sample,188338,184456,22080,162376,16801,145575,33972,2014,60380,6559,94352,42650,12171,2603,6198,10597
GGCCAGAGCGAGCTTC,sample,265455,263192,13535,249657,50209,199448,132203,12514,32721,3593,164924,18417,8337,3074,28339,34225
ACGACTTCCGAGCTTC,sample,317041,314474,9919,304555,61205,243350,201463,15195,17326,1520,218789,7846,3119,2354,62898,43267
CATGATTCCGAGCTTC,sample,298829,296753,14461,282292,57999,224293,134104,11540,46904,6765,181008,24980,8680,2939,29864,38152
AATCCGTCCGAGCTTC,sample,346877,344339,20170,324169,60762,263407,126525,9347,74417,7188,200942,45930,11501,3497,46342,42382
GTCCTGCCCGAGCTTC,sample,415517,412534,14652,397882,53234,344648,237175,17907,58334,7349,295509,23883,8487,4438,31590,37980
GCCTGAACCGAGCTTC,sample,315399,313212,12660,300552,47183,253369,169221,14458,42214,5183,211435,22293,7911,2787,40943,33926
AACTCGTACGAGCTTC,sample,304446,302494,10063,292431,45937,246494,180288,16676,34386,4416,214674,10728,4754,2528,46558,32833
ACCAATGCCGAGCTTC,sample,198053,196588,5137,191451,27110,164341,114150,10227,28010,3437,142160,8517,3721,2274,22924,18669
GAAGGCGCCGAGCTTC,sample,150899,149619,6391,143228,12335,130893,63152,5428,44876,6738,108028,10699,5217,2437,5508,7892
AAGAGCGCCGAGCTTC,sample,198640,196885,13170,183715,34048,149667,87660,5794,34704,4366,122364,17143,7639,2175,26035,22405
TATCAGTTGTAGAATG,sample,97709,95965,5351,90614,16865,73749,39543,4240,20467,2062,60010,7437,4039,1318,9291,10531
ATTCTCTTGTAGAATG,Pos_Ctrl,359657,349972,28903,321069,10893,310176,260179,22901,18602,2382,278781,6112,8459,14406,12421,3132
AAGTTCGTGTAGAATG,sample,240759,237536,7862,229674,26527,203147,140346,12254,31199,6534,171545,12814,4883,2113,26228,16718
ACGTAAGTGTAGAATG,sample,95063,93425,10900,82525,6885,75640,21624,1815,31053,3446,52677,17702,8401,2344,1916,3623
TAGTACGGGTAGAATG,sample,309227,305844,22557,283287,42778,240509,129039,9513,60078,6334,189117,35545,10965,3514,27796,28476
TTAGAAGTGTAGAATG,sample,320417,317425,18219,299206,47876,251330,179953,10482,38238,4204,218191,18453,8050,3223,47030,35638
GGACCTCTGTAGAATG,Pos_Ctrl,153640,149342,13575,135767,5582,130185,109277,9398,8068,1034,117345,2408,7956,11228,9625,2239
CAAGGCCTGTAGAATG,sample,303842,301618,11360,290258,60905,229353,186718,15141,18021,1775,204739,7698,4278,3237,52687,43072
GGCCAGAGGTAGAATG,sample,275757,272331,22692,249639,31225,218414,107580,8807,57011,5441,164591,39575,11297,2771,23873,20793
CGAGGCAGGTAGAATG,Pos_Ctrl,111678,109792,7186,102606,3719,98887,83594,8150,4801,664,88395,1678,7237,10298,4845,1137
CCATGAAGGTAGAATG,sample,321125,317938,22496,295442,35439,260003,132185,10275,65382,6690,197567,45471,11139,3239,22830,22256
GTCCTGCCGTAGAATG,sample,253479,251921,6874,245047,27433,217614,170001,13903,23580,2665,193581,7465,4027,3074,25324,18410
ACCAATGCGTAGAATG,Pos_Ctrl,72393,71771,3462,68309,2885,65424,55042,6304,2781,379,57823,918,6648,9017,3619,909
GAAGGCGCGTAGAATG,sample,187335,185945,7260,178685,26184,152501,93354,7482,37057,4419,130411,10189,4846,1859,24543,17735
GTCTTAGCGTAGAATG,sample,210254,208492,12789,195703,25353,170350,75767,5397,50613,4734,126380,33839,10710,3086,9320,15587
GTACCGTAGTAGAATG,sample,233025,231708,5612,226096,26230,199866,149947,15753,23913,3217,173860,7036,3701,2507,20239,18507
ATTCTCTTCAATAGTC,sample,190832,187961,17149,170812,21604,149208,50412,4136,53479,5836,103891,35345,9131,2050,7603,13070
ACGTAAGTCAATAGTC,sample,133707,132367,8807,123560,21824,101736,53169,3440,29820,3044,82989,12263,6207,1914,15718,15117
TGAGCGCGCAATAGTC,sample,294731,290719,32469,258250,26547,231703,53644,3327,90454,9740,144098,74538,15789,3665,14304,16033
TTCCGTCTCAATAGTC,sample,256211,254334,14085,240249,36499,203750,117731,7885,46490,5224,164221,26420,7999,2636,40985,25285
CATAACCTCAATAGTC,sample,190324,188915,15671,173244,18619,154625,72210,6063,44768,4886,116978,26698,10076,3360,17067,11766
CCAGAGCGCAATAGTC,sample,179793,177693,7325,170368,32340,138028,114635,5674,14169,952,128804,2598,1466,1145,32228,23147
ACCTCGAGCAATAGTC,sample,229980,227712,12403,215309,26006,189303,115176,12738,36200,4462,151376,20727,6566,2051,24830,18457
ACGACTTCCAATAGTC,sample,210331,208224,13721,194503,24903,169600,104689,8329,34713,3706,139402,18163,6263,1988,27191,14772
TTGGTACCCAATAGTC,sample,236292,234588,7515,227073,41532,185541,151762,10590,14683,2082,166445,6424,3320,1951,36976,28053
GCCTGAACCAATAGTC,sample,223851,222103,17174,204929,23696,181233,81844,6814,51854,5889,133698,34832,11439,2770,17992,15604
ACCAATGCCAATAGTC,sample,117327,116334,8757,107577,15379,92198,50695,3597,21972,3039,72667,12895,6230,1716,12459,9625
TGCTTCGCCAATAGTC,sample,165492,164056,8005,156051,25086,130965,85786,6864,22823,2482,108609,13010,4932,1600,26762,17863
AAGAGCGCCAATAGTC,sample,174645,173330,14032,159298,21152,138146,61436,5200,40040,4244,101476,27226,10091,2425,13786,13123
TTGGTTAACAATAGTC,sample,171584,170396,6118,164278,32942,131336,101267,7674,15531,1667,116798,5197,3833,1716,19108,21762
GTACCGTACAATAGTC,sample,188468,187402,8037,179365,26498,152867,95054,9063,29178,4402,124232,15170,6121,2044,20801,17916
GGCATATACAATAGTC,sample,154680,153553,2947,150606,30090,120516,95296,11611,10230,881,105526,2498,1697,1385,20139,22717
ATTCTCTTCGTTACTC,sample,382415,378000,18102,359898,49100,310798,210159,15074,54186,4985,264345,26394,8322,2500,46216,32664
TCCAACTTCGTTACTC,Neg_Ctrl,5831,2531,1592,939,168,771,415,20,203,22,618,111,378,157,115,30
AAGTTCGTCGTTACTC,sample,274875,271766,15018,256748,32191,224557,138932,14308,44419,4763,183351,22135,8888,3460,19690,21018
ACGTAAGTCGTTACTC,sample,37569,36850,1353,35497,5922,29575,20399,2355,4534,616,24933,1671,2137,1361,4044,3824
AGTACCATCGTTACTC,sample,482038,477360,40577,436783,62460,374323,130304,9268,125929,14424,256233,94398,16584,4733,32443,39678
ACGTTATGCGTTACTC,sample,331505,328689,20890,307799,76190,231609,128688,9606,56144,5661,184832,31510,9855,3483,29488,49379
TGAGCGCGCGTTACTC,sample,274275,271511,20589,250922,53195,197727,93657,6202,53370,7282,147027,37216,11163,2440,30667,35393
TCGCATCTCGTTACTC,Neg_Ctrl,4206,2127,1399,728,127,601,285,18,190,15,475,93,295,129,89,34
CCAGAGCGCGTTACTC,sample,428363,424517,26124,398393,54471,343922,186506,13803,84947,11824,271453,46842,10505,3001,71958,38450
CGAGGCAGCGTTACTC,sample,402260,399409,15519,383890,68359,315531,232507,21237,41418,4270,273925,16099,4499,2429,58755,51873
CCATGAAGCGTTACTC,Neg_Ctrl,4488,2313,1206,1107,171,936,541,53,178,20,719,144,460,247,145,49
CGGATTACCGTTACTC,sample,458557,454992,20540,434452,84908,349544,268151,24331,35192,4066,303343,17804,4248,2442,70148,61135
ACCAATGCCGTTACTC,sample,298202,295880,16903,278977,40328,238649,131232,10112,55652,5996,186884,35657,9704,2546,32833,28900
TGCTTCGCCGTTACTC,Neg_Ctrl,3272,1565,803,762,135,627,376,30,151,17,527,53,358,201,86,29
AAGAGCGCCGTTACTC,sample,325452,323402,11180,312222,41995,270227,206247,16592,31576,3334,237823,12478,6806,4570,33301,31022
GTCTTAGCCGTTACTC,sample,341445,338792,16934,321858,60563,261295,160552,12985,55303,7667,215855,24788,8932,2881,39048,38959
GGCATATACGTTACTC,sample,308771,306542,10551,295991,51617,244374,181953,14092,34323,4011,216276,9995,4382,2292,45918,36509
CTTCATGACGTTACTC,sample,323012,319674,27186,292488,42407,250081,117344,7324,67780,8099,185124,49534,12598,3006,35830,28759
GACCGGAACGTTACTC,sample,350394,348101,21755,326346,77397,248949,190921,13499,31442,3766,222363,9321,2822,1815,71888,51457
CCTCTAGATGGACTGC,sample,310754,306340,25786,280554,43905,236649,135413,11245,49131,5000,184544,35860,10153,3192,39575,29297
TAGTACGGTGGACTGC,sample,207079,204607,14439,190168,34672,155496,90287,6329,33914,4320,124201,20646,6677,2143,34500,22997
TGAGCGCGTGGACTGC,sample,122980,120979,10759,110220,21583,88637,48325,3312,21148,2180,69473,13672,7278,2171,17426,14093
TTAGAAGTTGGACTGC,sample,215829,213553,11785,201768,28077,173691,106674,5756,39208,6061,145882,15992,6103,2322,32975,19835
TCGCATCTTGGACTGC,sample,75255,74284,3435,70849,13425,57424,37044,3056,12462,1477,49506,3385,3227,1759,9753,9004
ACTATACTTGGACTGC,sample,106127,104931,5374,99557,24581,74976,52388,3557,12380,1273,64768,5378,4064,2182,16974,15677
GTTAGCCGTGGACTGC,sample,185827,184171,12024,172147,38299,133848,91961,6107,21268,2688,113229,11824,5648,2392,32445,26207
GGAGGACGTGGACTGC,sample,77556,76534,5877,70657,9454,61203,30623,2279,19253,2235,49876,6813,4690,1794,9668,6352
CCGCAACGTGGACTGC,sample,137097,135103,11175,123928,22385,101543,53792,3848,23656,2423,77448,17824,7234,2251,19208,14957
CTTGATAGTGGACTGC,sample,119129,117433,9281,108152,19971,88181,51540,3286,20485,2322,72025,10548,6598,2668,15306,13297
TGGACGAGTGGACTGC,sample,159272,157290,11294,145996,26843,119153,69529,5112,25900,2989,95429,15623,6963,1900,17080,17169
CGAGGCAGTGGACTGC,sample,261433,259380,10690,248690,48042,200648,162749,11073,20767,1453,183516,4606,2331,1660,49277,31862
AATCCGTCTGGACTGC,sample,203290,201349,11258,190091,25895,164196,89736,6723,46486,5158,136222,16093,7240,2619,16961,19079
CGTACGTCTGGACTGC,sample,232078,229833,15260,214573,32852,181721,97186,5471,44001,4913,141187,30150,10198,2562,36401,22260
AGTCCGCATGGACTGC,sample,223562,221582,12592,208990,39718,169272,119029,11058,24690,2943,143719,11552,4200,1843,45717,27963
CTAGGACCTGGACTGC,sample,123087,121852,10334,111518,14317,97201,48704,3329,27552,2769,76256,14847,7266,2142,14576,9574
GTTAGGACTGGACTGC,sample,307574,305511,15724,289787,39518,250269,149636,13302,53765,6404,203401,27162,8949,2886,45908,26528
CGTATGAATGGACTGC,sample,231600,229510,14261,215249,37468,177781,103759,8163,36819,4942,140578,24098,7713,2294,30138,26987
AATATATCTGGACTGC,sample,236326,234366,10319,224047,27899,196148,141385,10582,25953,2834,167338,15394,7522,3294,21656,19261
AAGAGCGCTGGACTGC,sample,162915,161727,10101,151626,23132,128494,56117,5865,42009,4635,98126,19868,8056,2475,14976,15509
GTCTTAGCTGGACTGC,sample,161506,160470,7547,152923,34468,118455,70003,6363,25413,3453,95416,13223,7130,2574,11159,23347
GGCATATATGGACTGC,sample,169900,168848,6322,162526,34487,128039,89502,6275,18936,2393,108438,10933,5629,1896,32386,23021
TCGCCTGATGGACTGC,sample,126772,125824,6436,119388,16925,102463,43705,4186,35237,4458,78942,14877,6358,2021,5643,10707
TTATTCGATGGACTGC,sample,282035,280440,11794,268646,34561,234085,170153,10447,31629,3845,201782,18011,8526,3564,33068,24789
ATGACCGATGGACTGC,sample,65976,65432,2721,62711,20128,42583,26192,2252,9050,1468,35242,3621,3612,1725,7860,12012
TATCAGTTCCTTGAGC,sample,290651,288128,10199,277929,37295,240634,165428,14514,43394,5999,208822,11299,5857,4075,17630,26325
AGTACCATCCTTGAGC,sample,224929,223110,11839,211271,47575,163696,108733,8734,28974,3137,137707,14118,6374,2512,30058,30169
TTCGTAATCCTTGAGC,Pos_Ctrl,222422,215942,23180,192762,8365,184397,153721,13495,11916,1628,165637,3637,8713,12807,11598,3521
TAGTACGGCCTTGAGC,sample,355646,351521,34990,316531,46768,269763,134254,8375,69857,7186,204111,50091,11137,2973,54353,31966
AATGGTAACCTTGAGC,sample,163878,161565,15831,145734,31345,114389,46635,3881,35863,3882,82498,24128,8733,2366,11849,19823
TTAGAAGTCCTTGAGC,sample,303747,300591,16711,283880,31719,252161,126010,8734,85197,9233,211207,22987,6791,2394,20015,20979
CATAACCTCCTTGAGC,sample,132641,131174,7587,123587,17313,106274,69388,4798,20463,2379,89851,9246,5974,3186,12988,12317
GTTAGCCGCCTTGAGC,Pos_Ctrl,126629,123858,12752,111106,5202,105904,89692,7987,5632,790,95324,1803,7776,10575,7612,2488
GGAGGACGCCTTGAGC,sample,146042,144702,8099,136603,20116,116487,62069,5467,33051,3529,95120,12371,6851,2787,5235,12697
CCGCAACGCCTTGAGC,sample,211220,209747,6185,203562,38518,165044,128241,10254,18875,2921,147116,4753,4293,3426,23910,27925
GGACGTAGCCTTGAGC,sample,346653,344006,12074,331932,70084,261848,217909,14911,20470,2126,238379,6432,2607,1956,71239,50458
ACGACTTCCCTTGAGC,sample,502942,499266,36951,462315,77188,385127,214648,18496,79618,9089,294266,63276,12181,3903,76844,50336
AATCCGTCCCTTGAGC,sample,218048,215573,16688,198885,27683,171202,82811,5972,48574,6971,131385,26874,9057,2488,15522,18198
TTGGTACCCCTTGAGC,Pos_Ctrl,143294,141418,11730,129688,5640,124048,104753,9906,6362,862,111115,2165,8056,11383,7792,2270
CTAGGACCCCTTGAGC,sample,297291,294194,24817,269377,37093,232284,104042,5418,68913,7532,172955,46379,11411,2810,32149,22601
GTTAGGACCCTTGAGC,sample,242735,240530,11017,229513,41770,187743,120541,9587,38468,3238,159009,15909,7006,2766,20997,29456
ACCAATGCCCTTGAGC,sample,345040,342283,15814,326469,46789,279680,175893,14411,55935,7940,231828,25501,7085,2769,52615,33198
TGCTTCGCCCTTGAGC,sample,308435,305665,24981,280684,29991,250693,132141,8172,68527,8014,200668,33839,10049,2889,35735,20682
TTGGTTAACCTTGAGC,sample,258937,257243,9502,247741,37190,210551,142872,10967,40104,3905,182976,12703,6239,3263,26036,25729
GGCATATACCTTGAGC,sample,266479,264540,15141,249399,35219,214180,122401,9711,50163,6303,172564,25602,9150,3290,22824,23495
TCAATATACCTTGAGC,sample,289823,287391,20378,267013,39933,227080,113300,9199,64750,7425,178050,32406,10958,3171,32440,27635
TCGCCTGACCTTGAGC,sample,236488,234500,13789,220711,32225,188486,98746,8725,50749,6386,149495,23880,7852,2537,21657,22090
AGGTCGGACCTTGAGC,Pos_Ctrl,128456,126724,10377,116347,5236,111111,94244,8855,5466,748,99710,1798,7726,10972,7527,2244
TATCAGTTCGATATCC,sample,379977,376019,24618,351401,62780,288621,195023,15420,44804,5138,239827,28236,10491,4554,39045,40868
ATTCTCTTCGATATCC,sample,139791,137769,11618,126151,22859,103292,64339,5862,19017,2386,83356,11688,6566,2787,15670,13954
GGTTGCGTCGATATCC,sample,188616,186755,8814,177941,33680,144261,96788,7528,25158,3124,121946,11663,6976,3789,21190,23168
ACGTAAGTCGATATCC,sample,396255,390516,40149,350367,40401,309966,125912,6324,98269,9968,224181,69493,13532,3511,45784,25572
AGTACCATCGATATCC,sample,223575,220684,16762,203922,39530,164392,105167,7741,28307,3817,133474,19360,8638,3807,27525,25530
ATGCCTGGCGATATCC,sample,192855,191048,10957,180091,41759,138332,97364,6255,20588,2233,117952,11892,5938,2401,35473,28773
AATGGTAACGATATCC,sample,144919,143331,7722,135609,17597,118012,65642,4400,33807,4310,99449,9853,5598,2624,15363,13004
ACTATACTCGATATCC,sample,118766,117532,4493,113039,18850,94189,62498,5476,18381,2073,80879,5761,4844,3520,4729,12734
GGAGGACGCGATATCC,sample,273003,270707,11970,258737,44495,214242,155783,11975,29052,2941,184835,14491,6722,2981,37245,29394
GGACGTAGCGATATCC,sample,228089,225292,20883,204409,35504,168905,78107,5723,49359,5753,127466,29963,10064,2418,19951,22971
TGGACGAGCGATATCC,sample,323746,321691,11315,310376,58315,252061,212005,14611,18770,2439,230775,4236,2382,1968,65842,41615
GACGATAACGATATCC,sample,367710,363907,24202,339705,45488,294217,158006,15308,67652,6430,225658,46821,12109,3276,44139,32481
CCATGAAGCGATATCC,sample,359088,356011,19990,336021,37666,298355,173811,14681,63514,7680,237325,38669,10687,3325,30326,26016
AATCCGTCCGATATCC,sample,405306,402342,19558,382784,61605,321179,215017,16705,58150,6426,273167,24881,8254,3635,54080,44965
GTCCTGCCCGATATCC,sample,235771,233700,15231,218469,31253,187216,93801,6958,54569,6452,148370,25436,7904,2606,17356,21398
TTGGTACCCGATATCC,sample,475111,472114,26599,445515,70452,375063,239310,19798,64258,9410,303568,42287,11020,4458,38933,49058
ACGTATTACGATATCC,sample,263940,262121,10813,251308,37438,213870,122317,11433,52359,5965,174676,21796,7475,2820,25845,26006
CGTATGAACGATATCC,sample,226445,225005,9057,215948,27433,188515,110948,10150,44729,4965,155677,17723,6731,2793,22571,18153
GAAGGCGCCGATATCC,sample,203478,202226,12849,189377,22097,167280,72082,5906,57298,7209,129380,24785,9036,2839,13821,14369
AAGAGCGCCGATATCC,sample,222834,221453,7218,214235,49436,164799,109482,9716,30008,3488,139490,12105,5852,2497,26778,33338
GTACCGTACGATATCC,sample,187215,186291,7679,178612,40603,138009,80392,6946,28170,2980,108562,19521,8695,2687,29728,26194
TCGCCTGACGATATCC,sample,110877,110247,3717,106530,20200,86330,54919,5550,18689,2373,73608,4799,3805,2293,10207,13717
TTATTCGACGATATCC,sample,95948,95415,5486,89929,16030,73899,30391,2673,27132,3120,57523,10583,6342,2269,5650,10501
ATTCTCTTATCTGACC,sample,308976,307203,11486,295717,54719,240998,143867,12250,49639,6837,193506,28405,9559,3314,47161,36703
TCCTCCGTATCTGACC,sample,216668,214900,8198,206702,30928,175774,121386,9131,31825,3747,153211,9685,5009,2821,23569,22762
ACGTAAGTATCTGACC,sample,156805,154992,12069,142923,24963,117960,62145,3525,29514,2785,91659,19991,7674,1832,26338,16148
AGTACCATATCTGACC,sample,241017,238582,16615,221967,26542,195425,98380,6918,59024,7279,157404,23824,8254,2780,19510,18115
TTCGTAATATCTGACC,sample,230985,229297,9602,219695,49652,170043,134195,6816,20499,2399,154694,6134,3745,1844,54685,34977
ACGTTATGATCTGACC,Neg_Ctrl,3360,1917,964,953,195,758,452,33,159,21,611,93,398,210,149,69
ATGCCTGGATCTGACC,sample,174681,173264,6214,167050,32969,134081,112752,8319,8916,651,121668,3443,1809,1655,43639,23397
AATGGTAAATCTGACC,sample,84413,83132,7553,75579,11087,64492,32762,2827,15931,1721,48693,11251,5628,1907,5208,6849
TTAGAAGTATCTGACC,sample,38752,38189,3493,34696,7655,27041,17213,996,5263,610,22476,2959,3359,1660,6393,5129
GCCTTGCTATCTGACC,sample,201791,199027,17680,181347,27127,154220,72977,5219,41456,4154,114433,30414,9167,2706,20269,17180
GGAGGACGATCTGACC,Neg_Ctrl,2646,1365,777,588,106,482,293,10,90,12,383,77,248,128,78,27
TGGACGAGATCTGACC,sample,214850,213324,7918,205406,40259,165147,131339,9980,15976,1654,147315,6198,2981,1758,40599,27596
CCATGAAGATCTGACC,sample,212263,210330,12318,198012,28923,169089,103979,9605,31663,3263,135642,20579,7850,2447,27952,19191
AGTCCGCAATCTGACC,sample,308029,305864,11824,294040,45266,248774,205294,12255,20341,3433,225635,7451,2890,1988,56911,33285
CTAGGACCATCTGACC,Neg_Ctrl,2724,1478,639,839,167,672,400,25,152,10,552,85,359,184,118,45
GCCTGAACATCTGACC,sample,253079,251227,14334,236893,42383,194510,123645,8892,34926,4097,158571,22950,9275,2672,34331,28398
AATATATCATCTGACC,sample,173138,171799,8573,163226,24389,138837,88802,8486,27058,3327,115860,11164,5299,1760,22191,17132
CCAATTCCATCTGACC,sample,186651,185106,11241,173865,29671,144194,82783,5787,33200,3831,115983,18593,7022,2258,29605,20720
GTACCGTAATCTGACC,sample,219652,217908,14139,203769,32999,170770,99125,7780,37182,3956,136307,22727,7151,2376,30337,23651
GGCATATAATCTGACC,sample,167691,166462,8213,158249,30518,127731,84282,6273,25265,1860,109547,10051,5305,1867,30317,21152
TCGCCTGAATCTGACC,sample,139536,138113,11370,126743,21313,105430,50754,3295,29088,3294,79842,18999,7508,1930,10864,13621
CTTCATGAATCTGACC,sample,82776,81914,3402,78512,16129,62383,38942,3419,13590,1242,52532,5190,3694,1514,8940,11104
AGGTCGGAATCTGACC,sample,240906,239315,12471,226844,55623,171221,129586,9603,21791,1370,151377,8871,4520,2173,40843,38336
TTATTCGAATCTGACC,Neg_Ctrl,2868,1862,655,1207,217,990,319,25,344,41,663,261,454,156,93,87
GGAGAGTTCTTCTTAC,sample,323847,321635,10177,311458,58497,252961,207546,13363,19913,4195,227459,7944,3002,2351,58077,42649
TATCAGTTCTTCTTAC,sample,276308,274043,13050,260993,34763,226230,165020,12914,31907,3891,196927,12498,6032,3279,32473,25021
TCCAACTTCTTCTTAC,sample,182458,180594,13062,167532,20677,146855,78387,5757,39107,4663,117494,18941,8751,3410,17715,14054
AAGTTCGTCTTCTTAC,sample,248219,245697,17294,228403,41441,186962,115475,7124,36946,4760,152421,22657,8284,2939,28061,29521
TCCTCCGTCTTCTTAC,sample,169229,167669,8253,159416,32876,126540,89233,5664,18614,2324,107847,10705,5629,2030,33455,21688
ATGCCTGGCTTCTTAC,sample,78083,77051,6538,70513,19445,51068,31367,1941,10434,1104,41801,6222,4497,1557,12163,12246
TAGTACGGCTTCTTAC,sample,96257,94563,10888,83675,12321,71354,30368,1607,22068,2306,52436,15005,6950,1623,11737,7542
TTAGAAGTCTTCTTAC,sample,138754,137343,7923,129420,24758,104662,67958,4563,19145,2104,87103,10892,5341,2007,26932,17258
TCGCATCTCTTCTTAC,sample,102652,100910,10884,90026,16320,73706,31396,2151,22379,2339,53775,15441,7085,1777,9634,9979
CAAGGCCTCTTCTTAC,sample,229167,226998,7581,219417,31952,187465,135078,10998,31257,3306,166335,6826,3500,2663,31228,24745
GACGATAACTTCTTAC,sample,268581,265960,10518,255442,12225,243217,205924,17197,14358,1907,220282,3831,5995,6928,9027,8463
GGCCAGAGCTTCTTAC,sample,178397,176842,9351,167491,29175,138316,98022,8844,21279,1744,119301,8427,4645,1762,30311,21646
AGTCCGCACTTCTTAC,sample,235063,233261,9862,223399,48685,174714,128929,9007,24243,2451,153172,10084,5471,2171,47178,33719
GTCCTGCCCTTCTTAC,sample,222127,220384,8163,212221,47248,164973,135541,9568,16034,1347,151575,2483,1919,1645,40862,33572
CTAGGACCCTTCTTAC,sample,280699,278839,10308,268531,54162,214369,178903,15676,13577,2064,192480,4149,2101,1619,53094,38650
GTTAGGACCTTCTTAC,sample,259641,257772,10850,246922,48479,198443,128361,10386,33384,5182,161745,21130,8647,2820,28565,32445
CGTATGAACTTCTTAC,sample,215861,214214,10771,203443,28242,175201,100271,7665,39969,4286,140240,23010,7115,2520,23276,18921
AATATATCCTTCTTAC,sample,18983,18708,1369,17339,3292,14047,5083,486,5472,597,10555,2409,2741,921,516,2067
GAAGGCGCCTTCTTAC,sample,176379,175077,10557,164520,26190,138330,74821,6279,34579,3793,109400,18858,8682,2722,18644,17554
GTACCGTACTTCTTAC,sample,206308,204766,13723,191043,45423,145620,80838,5495,30856,3992,111694,24439,8795,2242,26893,29167
TCGCCTGACTTCTTAC,sample,241439,239956,9385,230571,36025,194546,127011,10846,33427,3480,160438,19782,8254,2518,30924,25310
ATGACCGACTTCTTAC,sample,145137,144296,4244,140052,35855,104197,79818,6996,11326,1559,91144,4498,2571,1875,21770,23267
GGTTGCGTACTTCTAC,sample,42978,42440,1340,41100,8312,32788,25843,2134,3214,394,29057,1203,2549,2339,5470,5573
CCTCTAGAACTTCTAC,sample,175728,173600,10726,162874,24559,138315,84749,5913,28514,3635,113263,15504,5510,2114,27593,17524
AATGGTAAACTTCTAC,sample,225665,223725,12425,211300,45501,165799,91648,6884,39128,4196,130776,23943,8630,2540,30114,30772
CATAACCTACTTCTAC,sample,290265,288345,10802,277543,63206,214337,161926,13303,24926,2331,186852,11851,4395,2506,50106,44667
CCAGAGCGACTTCTAC,sample,120041,118844,7650,111194,22346,88848,48562,4397,23555,2831,72117,9503,5458,1682,9336,15397
GTTAGCCGACTTCTAC,sample,241579,238881,23688,215193,33328,181865,54017,3281,66021,6717,120038,51829,12067,2560,13257,20750
GGAGGACGACTTCTAC,sample,187108,185256,11152,174104,23615,150489,91330,6538,32241,3933,123571,16447,7088,2403,17342,16132
ACCTCGAGACTTCTAC,sample,142481,141570,6456,135114,30545,104569,67379,5280,19604,2527,86983,9779,6291,3016,17108,21039
TGGACGAGACTTCTAC,sample,255677,253579,14340,239239,39308,199931,123989,9723,39430,4654,163419,22135,8467,2651,39739,27010
CATTGCAGACTTCTAC,sample,69227,68753,2620,66133,14016,52117,36473,3276,8549,1127,45022,2692,4230,3255,6736,9313
CGAGGCAGACTTCTAC,sample,146997,145600,8447,137153,16399,120754,62705,4759,38468,4133,101173,10689,5984,2383,13571,11230
CCATGAAGACTTCTAC,sample,274746,272652,11741,260911,49625,211286,160731,10185,24815,2972,185546,12583,6106,2951,37452,33002
CATGATTCACTTCTAC,sample,172162,170827,8815,162012,25808,136204,74646,5536,38141,3544,112787,14337,5954,2452,15035,18142
AATCCGTCACTTCTAC,sample,228848,227103,12335,214768,43079,171689,115681,7243,28650,3348,144331,16767,7548,2714,34099,29221
GTCCTGCCACTTCTAC,sample,78061,77338,5387,71951,14286,57665,29635,2236,16348,1688,45983,7758,5560,1868,9725,9664
CGTATGAAACTTCTAC,sample,148437,147240,9639,137601,17055,120546,63214,5465,31894,3876,95108,16097,7361,2705,9209,11596
TGCTTCGCACTTCTAC,sample,200887,198843,16814,182029,20354,161675,72999,7364,46272,6262,119271,28778,8431,2323,22039,13467
CCAATTCCACTTCTAC,sample,197111,195655,7691,187964,24402,163562,117429,8676,22971,3638,140400,10848,5480,2247,33574,18122
GTACCGTAACTTCTAC,sample,251009,249302,10524,238778,38412,200366,156512,12431,20921,3163,177433,7339,4709,2843,32030,26949
GGTTGCGTAGAAGTAA,sample,1501,1457,195,1262,231,1031,552,45,251,15,803,168,506,269,153,147
ACGTTATGAGAAGTAA,sample,323986,321641,12954,308687,61582,247105,169520,12187,40473,4409,209993,20516,6644,2150,71388,45146
ATGCCTGGAGAAGTAA,sample,118367,117267,6698,110569,22962,87607,39706,3111,28840,3145,68546,12805,5973,1815,9861,13911
TAGTACGGAGAAGTAA,sample,126690,125803,5817,119986,25563,94423,54910,3769,22146,2590,77056,11008,6192,2531,16621,17609
TTAGAAGTAGAAGTAA,sample,384086,381286,20633,360653,45433,315220,167064,11635,91572,10889,258636,34060,8731,2902,33861,28874
TTCCGTCTAGAAGTAA,sample,322269,318877,22106,296771,47887,248884,111244,7707,80082,10568,191326,39283,9022,2783,28194,29442
GCCTTGCTAGAAGTAA,sample,258922,256340,16674,239666,44858,194808,103548,8807,53116,5669,156664,23668,8233,2471,29520,29864
CATAACCTAGAAGTAA,sample,145207,144067,11666,132401,21489,110912,59703,3686,27628,2808,87331,17087,7872,2284,22185,13542
ACTATACTAGAAGTAA,sample,442578,440097,11466,428631,90496,338135,268390,20978,35205,3335,303595,10227,4053,2538,85795,64448
ACCTCGAGAGAAGTAA,sample,196618,195285,9656,185629,24810,160819,105119,8004,29574,3653,134693,14469,6744,1981,30471,17738
CATTGCAGAGAAGTAA,sample,47602,47191,4402,42789,4597,38192,14077,1498,13352,1557,27429,7708,6402,2429,962,2684
CCATGAAGAGAAGTAA,sample,217454,215914,13253,202661,29917,172744,96817,9057,41681,4171,138498,21018,8663,2774,23396,18967
CATGATTCAGAAGTAA,sample,485912,481872,39872,442000,62848,379152,185235,18248,95730,10315,280965,69624,17758,5032,34680,40493
AATCCGTCAGAAGTAA,sample,142798,141915,10469,131446,18374,113072,50682,4288,32500,3704,83182,21898,10423,3701,6451,12313
ACGTATTAAGAAGTAA,sample,366530,363997,20252,343745,54062,289683,138201,10397,81188,8934,219389,50963,11330,3586,35641,34848
AACTCGTAAGAAGTAA,sample,325364,323496,9492,314004,59994,254010,200288,19236,23704,2681,223992,8101,4416,2304,47177,41149
CGTATGAAAGAAGTAA,sample,381859,379282,17147,362135,56534,305601,188451,21332,58424,7439,246875,29955,9768,3148,35722,39453
TTGGCCTCAGAAGTAA,sample,295079,293304,12080,281224,32628,248596,178917,15009,33369,3334,212286,17967,7674,3800,26289,23069
ACCAATGCAGAAGTAA,sample,749806,744896,49956,694940,55086,639854,232385,21245,251435,28467,483820,106322,19128,6368,32638,30137
AAGAGCGCAGAAGTAA,sample,198267,196981,8960,188021,23619,164402,99647,6976,37271,4398,136918,16110,7836,3160,26286,15535
GTCTTAGCAGAAGTAA,sample,155926,155021,5093,149928,31660,118268,81342,8685,16594,2108,97936,9539,5914,2276,16985,20649
Short,Non_sample,0,NA,NA,NA,NA,NA,NA,NA,NA,NA,NA,NA,NA,NA,NA,NA
Unselected,Non_sample,0,NA,NA,NA,NA,NA,NA,NA,NA,NA,NA,NA,NA,NA,NA,NA
Undetermined,Non_sample,287207901,NA,NA,NA,NA,NA,NA,NA,NA,NA,NA,NA,NA,NA,NA,NA
