Barcode,Sample,Barcoded_Reads,Trimmed_Reads,Unmapped_Reads,Mapped_Reads,Multimapped_Reads,Uniquely_Mapped_Reads,Exon_Reads,Ambiguous_Exon_Reads,Intron_Reads,Ambiguous_Intron_Reads,Gene_Reads,Intergenic_Reads,No_of_Genes,No_of_Transcripts,Mitochondrial_Reads,Ribosomal_Reads
GTCGTTCTCGTTGGTT,sample,534,518,49,469,102,367,228,26,67,7,295,39,208,131,62,66
AGCTGAATCGTTGGTT,sample,602,587,85,502,104,398,274,15,67,6,341,36,219,147,73,67
CATAATGGCGTTGGTT,sample,643,625,136,489,76,413,269,16,83,5,352,40,245,136,75,53
CATACTCCCGTTGGTT,sample,104265,103601,6515,97086,20799,76287,43050,3402,18820,2251,61870,8764,5605,2022,12982,13815
ATTCAAGGCGTTGGTT,sample,606,586,115,471,71,400,251,7,81,10,332,51,240,133,63,44
TCTCAGGACGTTGGTT,sample,24986,24831,971,23860,9302,14558,11133,1159,1388,142,12521,736,1836,1697,2694,5172
GATGCGTTCGTTGGTT,sample,230940,229525,7977,221548,56719,164829,138536,9530,12110,1113,150646,3540,2238,2024,49260,41058
TGCGCGTTCGTTGGTT,sample,327289,325528,17236,308292,60218,248074,180765,14858,31741,2500,212506,18210,7141,3294,49696,43760
ACGCTTAACGTTGGTT,sample,221335,219983,14567,205416,35310,170106,94869,6829,43459,5382,138328,19567,9065,3725,18647,24410
ATACCGCCCGTTGGTT,sample,214905,213636,8750,204886,47749,157137,109646,8001,23453,2590,133099,13447,7091,2937,29075,33784
CGTCGAGGCGTTGGTT,sample,215854,214860,7213,207647,40889,166758,111814,7878,33547,4389,145361,9130,4851,2245,27896,28348
CAGCTTCGCGTTGGTT,sample,240435,238214,21508,216706,51546,165160,80806,6342,41643,4589,122449,31780,9250,2242,26783,33411
CGCGGTCGCGTTGGTT,sample,266751,265387,7999,257388,62118,195270,155161,10265,20140,2512,175301,7192,3933,1914,44958,43760
TAACGCCACGTTGGTT,sample,23372,23207,764,22443,5631,16812,11848,1029,2445,310,14293,1180,2249,1593,1856,3789
CGCGAGACCGTTGGTT,sample,280035,278701,8893,269808,63896,205912,151701,10946,27964,2927,179665,12374,6283,2400,44822,43859
CCTAACTACGTTGGTT,sample,269499,268284,6840,261444,55072,206372,152228,9969,31678,3923,183906,8574,2605,1672,47671,40614
TCTAGGTTCTATCGTT,sample,1059,1037,73,964,235,729,450,29,153,9,603,88,335,200,156,150
GTCGTTCTCTATCGTT,sample,103647,103064,6023,97041,18546,78495,44284,4001,18530,2514,62814,9166,5005,2062,12181,12865
CATAATGGCTATCGTT,sample,64822,64377,5512,58865,12327,46538,26030,2163,10779,1364,36809,6202,5940,3296,4161,8055
TCGAACGACTATCGTT,sample,93930,93186,6779,86407,12971,73436,41304,2558,19511,2131,60815,7932,5080,2430,8508,9392
CCGCAGTCCTATCGTT,sample,106812,106163,4873,101290,24474,76816,57448,3231,10583,990,68031,4564,3950,2065,19347,16891
CCGTACGCCTATCGTT,sample,86450,85762,5749,80013,12978,67035,38918,2786,15965,1709,54883,7657,5271,2122,10372,9130
CTAACCGGCTATCGTT,sample,22671,22468,2262,20206,6331,13875,5812,447,5109,612,10921,1895,3531,1600,690,3697
AGCAGAGCCTATCGTT,sample,349090,346445,22424,324021,41884,282137,172755,14226,59400,5792,232155,29964,9803,3091,28484,28524
GTCGCGAACTATCGTT,sample,276499,274499,19221,255278,51781,203497,124218,9105,41514,4623,165732,24037,9700,2504,38299,36059
TCAATCAGCTATCGTT,sample,208292,207232,10698,196534,31558,164976,96800,6269,37683,3910,134483,20314,6787,2169,24278,21776
CGCGAGACCTATCGTT,sample,184901,183897,6029,177868,35267,142601,108630,9873,16341,2087,124971,5670,4422,2549,18497,25525
CGTAGAACCTATCGTT,sample,209799,208910,6249,202661,47909,154752,116303,12087,16727,2600,133030,7035,4744,2016,28231,33627
TTAACTGACTATCGTT,sample,50433,50205,3613,46592,8790,37802,16827,1795,11223,1477,28050,6480,5436,1544,4132,5851
ATATGCAACTATCGTT,sample,485,482,27,455,97,358,228,12,62,13,290,43,191,123,54,61
CTGGTCTTGTCTTCTT,Pos_Ctrl,5657,5590,464,5126,362,4764,3891,402,295,43,4186,133,1897,1601,394,211
GTCGTTCTGTCTTCTT,sample,101439,101061,3027,98034,22203,75831,49573,3740,15712,2269,65285,4537,3779,2261,12408,16076
AGAGTTCTGTCTTCTT,sample,170651,169688,8478,161210,23116,138094,79712,5537,35273,3642,114985,13930,6360,2868,15731,16101
TATACGGAGTCTTCTT,Pos_Ctrl,88492,86807,8441,78366,3684,74682,62489,5371,4778,622,67267,1422,7392,9100,5190,1904
TCATCGAAGTCTTCTT,sample,279370,277379,13559,263820,38316,225504,151102,11043,37302,4710,188404,21347,7804,2691,30579,28097
TCATACCAGTCTTCTT,sample,61173,60373,6585,53788,6192,47596,24658,2081,13324,1460,37982,6073,4779,1741,6435,4221
TGATTCCGGTCTTCTT,sample,70564,70021,4995,65026,12529,52497,34192,1751,10131,1193,44323,5230,4051,1768,12590,8452
CCGCAGTCGTCTTCTT,sample,138349,136367,11045,125322,17506,107816,61664,3743,28583,3728,90247,10098,4994,2174,13289,11687
TGGATCAAGTCTTCTT,sample,38175,37518,5450,32068,4033,28035,12169,830,8877,1065,21046,5094,4561,1498,3334,2483
ATGGCGTTGTCTTCTT,sample,63166,62398,3681,58717,13350,45367,30468,2350,8891,929,39359,2729,3307,2104,9827,9186
AGCGTCTTGTCTTCTT,sample,199062,197858,10329,187529,25505,162024,97697,5650,42264,4284,139961,12129,6098,2426,24173,18762
CGGTTGGTGTCTTCTT,sample,125081,123801,10191,113610,18139,95471,54563,3294,22851,2439,77414,12324,6705,2084,15642,13184
GCTCTTCTGTCTTCTT,sample,115996,114547,15184,99363,14394,84969,30782,1878,26988,2869,57770,22452,9615,1699,11771,9626
CCTAGCGGGTCTTCTT,sample,107013,106094,9151,96943,19686,77257,45524,2815,16446,1694,61970,10778,5949,1724,14782,13790
GGCGACGAGTCTTCTT,sample,153049,151737,7721,144016,25348,118668,84876,6865,16566,1764,101442,8597,4782,1854,25941,18357
GCGTTACCGTCTTCTT,sample,198766,197108,10669,186439,33274,153165,108094,9935,21441,2752,129535,10943,6396,2701,25523,23526
CAGCTTCGGTCTTCTT,sample,105826,105228,4344,100884,21846,79038,59773,5652,8202,1165,67975,4246,3416,1816,12692,15301
TCTCCTAGGTCTTCTT,sample,138284,137256,6831,130425,32886,97539,67646,4599,16220,1877,83866,7197,4515,1597,21023,21936
TCAATCAGGTCTTCTT,sample,194918,193828,10137,183691,34125,149566,91415,5383,31150,4396,122565,17222,7259,1957,27144,24095
TAACGCCAGTCTTCTT,sample,263238,261648,13577,248071,38107,209964,138491,11334,37493,4537,175984,18109,7860,2883,23440,27505
GACTAACCGTCTTCTT,sample,152138,151137,6907,144230,17164,127066,84256,4344,25176,4004,109432,9286,4549,1901,18569,13189
CGCGAGACGTCTTCTT,sample,214307,212824,15354,197470,22347,175123,91542,6373,51992,4684,143534,20532,8768,2462,15316,14692
CCTAACTAGTCTTCTT,Pos_Ctrl,68198,67148,5510,61638,2931,58707,49246,4522,3379,472,52625,1088,6640,8111,3773,1538
ATATGCAAGTCTTCTT,sample,106583,106111,4798,101313,21621,79692,49030,3977,16359,2323,65389,8003,5913,2343,10158,14121
AACCGGTTTAGGCTCT,sample,4398,4280,269,4011,1210,2801,1629,125,560,64,2189,423,861,464,682,747
TCTAGGTTTAGGCTCT,sample,334525,332682,27671,305011,68505,236506,102334,7474,69745,6744,172079,50209,13722,3669,32276,43990
CTGGTCTTTAGGCTCT,sample,269480,268072,14424,253648,75607,178041,123999,9106,25664,2883,149663,16389,6341,2296,46473,48551
AGAGTTCTTAGGCTCT,sample,187705,186161,20289,165872,26414,139458,55446,3627,45884,5100,101330,29401,10317,2625,15860,18004
CATAATGGTAGGCTCT,sample,311263,309549,10871,298678,77313,221365,181415,11511,18531,1750,199946,8158,4559,2884,42873,53725
CCGCAGTCTAGGCTCT,sample,363433,359276,23335,335941,60010,275931,177202,11769,53778,4226,230980,28956,7721,3048,42420,41362
GGCAGGTTTAGGCTCT,sample,337243,333320,22212,311108,44000,267108,161863,12613,61084,7619,222947,23929,8339,3207,30515,30824
GATGCGTTTAGGCTCT,sample,188433,186590,12075,174515,28631,145884,88844,6416,34954,3747,123798,11923,5853,2348,27837,20248
AGCGTCTTTAGGCTCT,sample,331708,328029,14733,313296,77781,235515,174106,12797,31519,4344,205625,12749,5872,2642,53492,53014
TAGCGAGTTAGGCTCT,sample,58999,58457,5178,53279,8229,45050,25736,1443,10923,1247,36659,5701,4477,1548,8429,5613
GCTCTTCTTAGGCTCT,sample,176323,174848,10719,164129,22471,141658,81570,5558,35596,4006,117166,14928,6163,2191,18565,17593
CTAACCGGTAGGCTCT,sample,213228,208100,13651,194449,39759,154690,93683,5492,34220,4144,127903,17151,7145,2187,25084,27890
GCTGCTTCTAGGCTCT,sample,205718,204293,11347,192946,34701,158245,116781,5938,21523,1619,138304,12384,5670,1950,28764,25730
AAGTAGAGTAGGCTCT,sample,125282,124553,6623,117930,37029,80901,45470,3419,19959,2053,65429,10000,6051,2267,9876,24051
CGTAGAACTAGGCTCT,sample,283318,281584,11604,269980,40233,229747,154925,13941,42011,5494,196936,13376,6315,2649,28363,29798
CTGGTCTTTTGACTAT,sample,245431,243924,11916,232008,54781,177227,114627,8836,32197,3186,146824,18381,6050,2367,34547,37536
GTCGTTCTTTGACTAT,Neg_Ctrl,1382,889,424,465,66,399,234,9,106,6,340,44,233,110,47,40
AGAGTTCTTTGACTAT,sample,80903,80166,5697,74469,17733,56736,39597,2022,8879,1154,48476,5084,3488,1599,12978,12130
AGCTGAATTTGACTAT,sample,162130,160271,13535,146736,19979,126757,63609,3174,39582,3673,103191,16719,6557,2082,15802,13170
GACGTATGTTGACTAT,sample,150443,148270,18184,130086,23896,106190,56556,4268,25255,2909,81811,17202,7301,2111,15958,16098
GGAGAAGCTTGACTAT,Neg_Ctrl,1977,1239,673,566,86,480,263,9,106,9,369,93,259,130,60,130
TGATTCCGTTGACTAT,Pos_Ctrl,62126,59684,8962,50722,2630,48092,40167,3370,3058,411,43225,1086,6427,7078,3139,1399
TACGCGAGTTGACTAT,sample,140874,137648,18620,119028,11045,107983,44019,2462,38733,4303,82752,18466,7839,2344,7690,7040
ATGGCGTTTTGACTAT,Pos_Ctrl,102720,99841,12419,87422,4164,83258,69641,5963,5279,686,74920,1689,7130,9115,4552,2264
TAGCGAGTTTGACTAT,sample,176507,175139,11585,163554,35432,128122,84343,6507,20774,2948,105117,13550,6180,1878,29976,24573
CCTAGCGGTTGACTAT,Pos_Ctrl,41610,40748,4946,35802,1819,33983,28484,2358,2212,300,30696,629,5743,6038,2032,971
GGCGACGATTGACTAT,sample,79782,78771,10721,68050,12122,55928,26000,1627,14745,1849,40745,11707,6723,1396,8071,7796
TGCGCTCCTTGACTAT,sample,172316,170559,13151,157408,28334,129074,78859,6152,25449,2484,104308,16130,7975,2636,16032,19593
ATACCGCCTTGACTAT,sample,126502,125368,11976,113392,16186,97206,47421,2871,25454,2766,72875,18694,7877,1916,16052,10925
CGTCGAGGTTGACTAT,Pos_Ctrl,50800,49968,4952,45016,2183,42833,35843,3403,2484,345,38327,758,6010,6989,2253,1105
TCTCCTAGTTGACTAT,sample,129680,128794,11497,117297,18750,98547,54906,4542,21289,2366,76195,15444,7844,1933,13550,13303
AAGTAGAGTTGACTAT,sample,187878,186545,14739,171806,28530,143276,74368,5620,33359,3211,107727,26718,8166,1785,21105,18196
TCAATCAGTTGACTAT,sample,124238,123534,5765,117769,29762,88007,61428,4742,13323,1900,74751,6614,4079,1558,18808,19898
TAACGCCATTGACTAT,sample,156058,155145,6883,148262,32062,116200,83012,5964,17862,1486,100874,7876,3836,1582,27706,21985
AGATACTATTGACTAT,sample,232411,230811,16797,214014,32220,181794,103718,8650,39074,5596,142792,24756,7350,2307,24979,24051
GCGCAATATTGACTAT,Neg_Ctrl,1192,855,359,496,63,433,255,23,97,8,352,50,251,137,53,28
TATACGGATGCAGTTG,sample,78255,77429,5922,71507,13102,58405,33820,2294,13698,1431,47518,7162,4702,1507,13212,9222
CTAGCGACTGCAGTTG,sample,106405,104200,11012,93188,10951,82237,38713,2358,25817,2947,64530,12402,6286,2235,8649,7508
TCATACCATGCAGTTG,sample,156707,154517,12233,142284,26904,115380,69256,4286,24246,2594,93502,14998,7105,2672,14952,18195
ATACGTTCTGCAGTTG,sample,169703,167549,12460,155089,24413,130676,87671,4866,21721,2297,109392,14121,7540,2860,21825,16412
TGGATCAATGCAGTTG,sample,68076,67459,6503,60956,12714,48242,23861,1607,12342,1325,36203,9107,5659,1729,7276,8046
GATGCGTTTGCAGTTG,sample,187570,186202,7220,178982,25057,153925,95925,4756,37084,4254,133009,11906,4239,1909,25642,17886
TAGCGAGTTGCAGTTG,sample,75231,74753,3023,71730,21006,50724,37558,2705,6410,759,43968,3292,3350,1934,10771,13857
GGCGACGATGCAGTTG,sample,106477,105459,7805,97654,15418,82236,44341,3660,22180,2148,66521,9907,6209,2019,10026,10493
TAACGAAGTGCAGTTG,sample,137065,136044,7783,128261,18354,109907,65610,4652,25695,3942,91305,10008,5433,2050,16271,13496
GCTGCTTCTGCAGTTG,sample,138125,136713,10167,126546,13678,112868,57861,4062,33069,3567,90930,14309,6391,2069,12509,9480
GCCTATTCTGCAGTTG,sample,99472,98844,3488,95356,18721,76635,56282,3869,11445,1265,67727,3774,3357,2107,16593,13610
CGTCGAGGTGCAGTTG,sample,88790,88142,6382,81760,15427,66333,36207,2311,16267,1878,52474,9670,5440,1388,13063,10447
CGCGGTCGTGCAGTTG,sample,119789,118951,6607,112344,17985,94359,60283,4208,17882,1961,78165,10025,6010,1918,13594,12936
TTATGACGTGCAGTTG,sample,102059,101470,4648,96822,25331,71491,48315,3889,11944,1444,60259,5899,4216,1542,13941,16357
TCTCCTAGTGCAGTTG,sample,190786,189326,12952,176374,20826,155548,69167,4462,50716,6330,119883,24873,8154,2324,10684,13688
AGATACTATGCAGTTG,sample,125378,124567,10016,114551,21461,93090,45119,3655,24407,2905,69526,17004,7806,1895,12049,14782
GACGTATGTCATGCTG,sample,107449,106745,5048,101697,27850,73847,55492,3963,8992,964,64484,4436,3988,2361,14765,18306
CATAATGGTCATGCTG,sample,53882,53304,4305,48999,10837,38162,22595,1368,7549,873,30144,5777,3997,1182,8074,7182
GAGCCTCCTCATGCTG,sample,95376,94167,8973,85194,11300,73894,35819,2365,20072,2184,55891,13454,7752,2588,9049,7729
GCAACTAGTCATGCTG,Neg_Ctrl,710,427,207,220,24,196,91,6,78,1,169,20,126,50,22,20
TGGATCAATCATGCTG,sample,170385,168930,13078,155852,26247,129605,80628,3808,26308,2719,106936,16142,6266,1945,28511,18559
GGCAGGTTTCATGCTG,sample,86882,84513,6325,78188,10847,67341,42716,2972,14503,1463,57219,5687,4340,2189,9139,7730
TGCGCGTTTCATGCTG,Neg_Ctrl,763,454,227,227,21,206,101,7,58,4,159,36,110,52,14,13
AGCGTCTTTCATGCTG,sample,86287,82106,9700,72406,10611,61795,34667,1742,14128,1399,48795,9859,5977,1302,15402,6989
CATTCGGTTCATGCTG,sample,71614,69886,5532,64354,12843,51511,33364,2444,9421,1012,42785,5270,4825,2248,9015,9179
TAGCGAGTTCATGCTG,sample,51079,50705,3910,46795,10514,36281,21505,1250,7317,740,28822,5469,3516,1195,8523,6951
GCTCTTCTTCATGCTG,sample,113430,112486,8952,103534,13974,89560,48513,3847,23348,2694,71861,11158,6285,2157,9079,9206
GAGATTCTTCATGCTG,sample,74428,73676,7488,66188,10814,55374,30141,2071,13107,1384,43248,8671,5189,1453,9047,7060
CTAAGCATTCATGCTG,sample,59297,58466,8318,50148,6015,44133,14912,1139,15701,1784,30613,10597,5766,1274,2654,4400
CCTAGCGGTCATGCTG,sample,48581,48058,4114,43944,7480,36464,21722,1663,7678,869,29400,4532,3900,1208,7096,5279
CTAACCGGTCATGCTG,Neg_Ctrl,494,309,128,181,33,148,105,1,19,2,124,21,97,58,16,11
AGCAGAGCTCATGCTG,sample,36050,35690,4310,31380,6693,24687,9538,664,8224,810,17762,5451,3858,975,2708,4278
GTCGCGAATCATGCTG,sample,99601,98658,9939,88719,11951,76768,40004,3309,18013,1924,58017,13518,7425,1662,11196,7653
CGTCGAGGTCATGCTG,sample,86529,85847,5773,80074,14297,65777,35266,3121,15244,1738,50510,10408,5381,1334,11616,10017
CAGCTTCGTCATGCTG,Neg_Ctrl,587,328,155,173,20,153,89,4,38,1,127,21,90,37,31,7
AAGTAGAGTCATGCTG,sample,125124,124166,9126,115040,16497,98543,57178,4473,21550,2167,78728,13175,6918,1990,15594,11352
ATTCTACCTCATGCTG,sample,133848,132610,12962,119648,12137,107511,51727,3375,30472,4119,82199,17818,8557,2120,12476,8278
CTGGTCTTTTAGGCGG,Pos_Ctrl,107344,103026,13223,89803,4438,85365,71351,5640,5597,759,76948,2018,7496,9233,5731,2031
AGAGTTCTTTAGGCGG,sample,168303,166897,8668,158229,41290,116939,82854,6657,16102,1828,98956,9498,4943,2165,27098,29433
TATACGGATTAGGCGG,Pos_Ctrl,86386,83043,10751,72292,3473,68819,57357,4794,4584,609,61941,1475,7154,8595,4557,1672
GGAGAAGCTTAGGCGG,sample,238397,235374,21896,213478,42482,170996,97106,5131,39979,4705,137085,24075,9164,2422,33978,29445
CATACTCCTTAGGCGG,sample,208911,204908,22126,182782,23094,159688,89777,5162,41708,3993,131485,19048,7502,2249,26839,16431
CTAGCGACTTAGGCGG,sample,182416,179175,13498,165677,32351,133326,92457,5096,20415,1808,112872,13550,6353,1992,31210,22265
TCGAACGATTAGGCGG,sample,200426,199059,7280,191779,46858,144921,124173,6451,10558,1382,134731,2357,1788,1461,43635,32013
TCTCAGGATTAGGCGG,sample,131612,128599,16025,112574,11854,100720,40858,2500,34819,4163,75677,18380,7612,2187,6942,7221
TGGATCAATTAGGCGG,sample,165829,163754,12951,150803,23518,127285,75782,5267,28660,3026,104442,14550,6694,2116,26559,16890
GATGCGTTTTAGGCGG,sample,172443,170922,7926,162996,30372,132624,103492,8281,13992,2095,117484,4764,3332,1847,28588,22042
AGCGTCTTTTAGGCGG,sample,195586,192894,21313,171581,20337,151244,72531,4725,42359,4785,114890,26844,9696,2569,18934,13369
AAGGTCTGTTAGGCGG,sample,63314,62728,2806,59922,21223,38699,30401,2298,4291,461,34692,1248,2141,1589,9415,12820
GCTGCTTCTTAGGCGG,sample,270546,267655,16932,250723,34598,216125,155771,9278,30919,3155,186690,17002,7359,3051,26055,24249
AGCAGAGCTTAGGCGG,sample,366851,363875,27411,336464,29856,306608,162586,13739,84143,9541,246729,36599,10734,3317,23937,18979
ATACCGCCTTAGGCGG,sample,154131,152478,16330,136148,14353,121795,64151,4470,28157,3570,92308,21447,8519,2403,13446,9085
CGCGGTCGTTAGGCGG,sample,217152,215446,14838,200608,35970,164638,89414,8482,37015,4197,126429,25530,9405,2461,26403,24860
ATTCTACCTTAGGCGG,sample,207636,206346,9021,197325,23497,173828,114946,8098,33849,4986,148795,11949,5509,2339,23105,18616
CCTAACTATTAGGCGG,sample,191164,190024,8865,181159,29122,152037,109669,8418,20861,2281,130530,10808,5841,1920,30094,21452
TTAACTGATTAGGCGG,sample,236839,235447,13182,222265,32590,189675,124841,12402,30252,3565,155093,18615,6176,2102,35216,23652
ATATGCAATTAGGCGG,sample,146913,146004,8638,137366,23081,114285,62845,5695,27500,2693,90345,15552,7609,2173,14281,15599
AGCTGAATTCAGATAC,sample,165847,163390,21605,141785,20787,120998,57020,3577,32554,3456,89574,24391,9714,2109,16747,13116
CATACTCCTCAGATAC,sample,125175,123657,11204,112453,16219,96234,56181,3523,22709,2421,78890,11400,6219,1845,18475,11413
CTAGCGACTCAGATAC,sample,29718,29211,4565,24646,3658,20988,10332,578,5337,638,15669,4103,3767,1332,2285,2453
CGTCGCCATCAGATAC,sample,63089,61701,7154,54547,6203,48344,22105,1467,15893,1921,37998,6958,4538,1539,5563,3915
TCATACCATCAGATAC,sample,104859,103574,8845,94729,14092,80637,53720,3187,15452,1860,69172,6418,5441,3016,9677,9619
GCAACTAGTCAGATAC,sample,63497,62948,5925,57023,10715,46308,25420,1899,10643,1163,36063,7183,4558,1530,7553,6839
GACTCAAGTCAGATAC,sample,74311,72518,12837,59681,5802,53879,17507,1303,18966,2231,36473,13872,6900,1528,4515,3135
CCGCAGTCTCAGATAC,sample,147135,145061,17370,127691,17110,110581,55227,3493,29091,2508,84318,20262,7737,1652,16451,10847
TCTCAGGATCAGATAC,sample,92999,92006,8093,83913,10255,73658,39498,2413,19613,2510,59111,9624,5202,1541,8594,6842
CATTCGGTTCAGATAC,sample,73425,72861,3865,68996,14337,54659,40057,2905,7615,977,47672,3105,3192,1939,11441,10199
GGCGTACCTCAGATAC,sample,130983,130161,5746,124415,17112,107303,79839,5919,13877,1516,93716,6152,4579,2210,14304,12930
GTCGCGAATCAGATAC,sample,165230,164036,12071,151965,20908,131057,76340,4645,26775,2955,103115,20342,7383,1854,17333,14704
TAACGCCATCAGATAC,sample,176790,175776,9285,166491,32086,134405,88233,7501,22055,2666,110288,13950,5155,1841,27375,22069
GACTAACCTCAGATAC,sample,129614,128810,7042,121768,16499,105269,66503,4690,22118,3057,88621,8901,4748,1941,11518,11232
CGTAGAACTCAGATAC,sample,142717,141443,11487,129956,12855,117101,64942,5055,28666,2700,93608,15738,7273,2292,11124,8841
AGATACTATCAGATAC,sample,131886,130850,12571,118279,16427,101852,54020,4244,23990,2498,78010,17100,7702,1800,16282,10775
GTCGTTCTTCGCTAGG,Neg_Ctrl,1312,941,337,604,86,518,293,36,125,12,418,52,288,169,70,45
GACGTATGTCGCTAGG,sample,120413,118829,9653,109176,16885,92291,61068,3676,17518,1756,78586,8273,5559,2273,17080,12422
CATAATGGTCGCTAGG,sample,51225,49851,10993,38858,4415,34443,10560,667,12476,1404,23036,9336,5869,1280,3484,2421
TATACGGATCGCTAGG,sample,164164,161732,14778,146954,17096,129858,74101,4539,31174,3971,105275,16073,6572,2338,15436,12141
GGAGAAGCTCGCTAGG,Neg_Ctrl,1683,1302,511,791,119,672,363,15,147,12,510,135,346,167,111,75
CATACTCCTCGCTAGG,sample,50916,50083,5424,44659,11190,33469,20215,1495,6648,777,26863,4334,4428,2445,4883,6941
ATTCAAGGTCGCTAGG,sample,61574,59945,10275,49670,6746,42924,17992,1145,12895,1399,30887,9493,6731,2270,3694,3906
TGATTCCGTCGCTAGG,sample,43068,42434,4705,37729,7354,30375,16926,846,7273,787,24199,4543,4329,1557,6083,4863
TACGCGAGTCGCTAGG,sample,34691,33827,4549,29278,3639,25639,12713,706,6585,674,19298,4961,4258,1548,3501,2235
CCGCAGTCTCGCTAGG,sample,35332,34488,6278,28210,3975,24235,9154,436,7855,854,17009,5936,4512,1055,2736,2391
CCGTACGCTCGCTAGG,sample,26376,25925,2801,23124,3839,19285,11257,688,4118,434,15375,2788,3479,1722,3542,2688
GGCAGGTTTCGCTAGG,sample,35057,34346,4933,29413,4731,24682,12374,724,6239,641,18613,4704,4347,1570,4179,2971
AGCGTCTTTCGCTAGG,sample,169119,167458,15815,151643,21949,129694,72009,4152,32726,3158,104735,17649,7831,2126,19760,15316
CATTCGGTTCGCTAGG,sample,175550,173446,17508,155938,20504,135434,68083,4610,34688,3836,102771,24217,9101,2143,23387,12784
TAGCGAGTTCGCTAGG,sample,152859,151682,6354,145328,27773,117555,93504,5239,12467,1299,105971,5046,2825,1646,29954,20548
GCTCTTCTTCGCTAGG,sample,176840,174971,14048,160923,23502,137421,86155,6845,26433,2606,112588,15382,7276,2393,24999,16366
CTAACCGGTCGCTAGG,sample,149972,147988,15809,132179,17910,114269,57939,3761,29830,3483,87769,19256,8662,2017,16709,11552
GCTGCTTCTCGCTAGG,sample,158362,157041,9176,147865,24921,122944,80994,4761,21773,2092,102767,13324,6135,2289,24862,17728
GCCTATTCTCGCTAGG,sample,90951,88774,22942,65832,5245,60587,8309,604,25855,2762,34164,23057,9539,1127,1546,2405
AGCAGAGCTCGCTAGG,sample,187492,185900,12698,173202,28569,144633,88153,7184,30643,3096,118796,15557,6613,2142,23606,20103
TGCGCTCCTCGCTAGG,sample,211894,209468,19551,189917,23316,166601,86381,7053,40874,4309,127255,27984,8733,2432,18982,16593
GCGTTACCTCGCTAGG,sample,185523,183316,17292,166024,19186,146838,80219,4333,34196,2771,114415,25319,8852,2456,11823,12011
GGCGTACCTCGCTAGG,sample,158810,157397,9762,147635,23819,123816,81380,5523,21806,2034,103186,13073,6181,2038,18079,16727
CGTCGAGGTCGCTAGG,sample,132374,131092,8705,122387,13298,109089,60513,4244,28513,2801,89026,13018,5794,2266,14340,10461
CGCGGTCGTCGCTAGG,sample,173686,172594,7103,165491,28199,137292,112663,7631,11532,1069,124195,4397,3574,2146,36636,22007
TTATGACGTCGCTAGG,sample,196051,194093,19273,174820,23076,151744,76130,4745,39205,3472,115335,28192,9762,2393,26834,15310
ATGAATAGTCGCTAGG,sample,157950,156331,14362,141969,17683,124286,65801,3802,32338,3479,98139,18866,7451,1810,23152,12316
AAGTAGAGTCGCTAGG,sample,117124,115993,10152,105841,15586,90255,54588,3466,19394,2334,73982,10473,6685,3165,11103,10216
TAACGCCATCGCTAGG,sample,216568,215293,6979,208314,30635,177679,145649,10478,14113,2019,159762,5420,3827,2377,48055,23684
ATTCTACCTCGCTAGG,Pos_Ctrl,49972,48964,5497,43467,2108,41359,34533,3044,2605,314,37138,863,6197,6773,2548,1013
GACTAACCTCGCTAGG,sample,176810,175148,12844,162304,19671,142633,76372,5047,38739,4430,115111,18045,7268,2103,20698,13393
CGTAGAACTCGCTAGG,sample,151338,149794,13349,136445,21367,115078,62198,5047,28371,3625,90569,15837,7085,1834,19810,14327
GCGCAATATCGCTAGG,sample,208209,206411,20750,185661,19091,166570,77911,4783,54131,6733,132042,23012,9003,2825,13439,12592
CTGGTCTTCCGTTGCG,sample,312797,308943,27171,281772,41785,239987,138908,9728,53195,5479,192103,32677,9176,2625,43498,28174
GTCGTTCTCCGTTGCG,sample,265390,263536,12653,250883,56936,193947,154009,9731,19233,1872,173242,9102,3224,2126,46096,41795
AGAGTTCTCCGTTGCG,sample,113129,111255,13673,97582,22943,74639,39191,2809,18541,1650,57732,12448,6964,2485,8204,14099
TACGCGAGCCGTTGCG,sample,206318,204074,15561,188513,37576,150937,102898,7770,24020,2277,126918,13972,5850,2318,35315,25478
GACTCAAGCCGTTGCG,sample,130850,129330,11492,117838,20268,97570,54548,3465,24128,3690,78676,11739,5342,1734,21328,13415
CCGCAGTCCCGTTGCG,sample,167099,165707,17340,148367,24026,124341,61411,4226,33167,3938,94578,21599,9412,2764,16980,14734
CCATTCTTCCGTTGCG,sample,88063,87236,8223,79013,17027,61986,39700,2961,11295,1223,50995,6807,5006,2499,9338,11975
TAGCGAGTCCGTTGCG,sample,242743,240448,23426,217022,35497,181525,99344,7004,41835,4115,141179,29227,9486,2645,26246,23434
GAGATTCTCCGTTGCG,sample,136194,135085,6800,128285,21936,106349,79046,5430,14198,1502,93244,6173,5258,2976,17084,16048
TAACGAAGCCGTTGCG,sample,226726,225118,17711,207407,31838,175569,98153,10143,37169,4350,135322,25754,8795,1870,24982,21524
CGCGGTCGCCGTTGCG,sample,241790,239573,19944,219629,41138,178491,105717,9025,34498,4059,140215,25192,8117,2461,29653,27951
ATTCTACCCCGTTGCG,sample,189922,188273,14106,174167,17650,156517,85542,6050,41392,4201,126934,19332,7635,2259,19828,11957
AACCGGTTAGGCCAAG,sample,203798,202448,14983,187465,36020,151445,83370,5972,38608,3412,121978,20083,8499,2501,24913,24670
AGAGTTCTAGGCCAAG,sample,205829,203848,11625,192223,34942,157281,120987,6935,20010,2558,140997,6791,4482,2312,36786,26203
TCGAACGAAGGCCAAG,sample,73823,73105,4485,68620,24195,44425,31678,2165,6729,711,38407,3142,2911,1743,9961,14464
CCGCAGTCAGGCCAAG,sample,186309,184038,14460,169578,29064,140514,97665,5985,22254,2654,119919,11956,6207,2168,31218,20641
AGCGTCTTAGGCCAAG,sample,235877,234010,11795,222215,33732,188483,138391,9841,27247,2914,165638,10090,5437,3546,26044,25275
CGGTTGGTAGGCCAAG,sample,236316,234796,9941,224855,46722,178133,146092,10299,15460,2034,161552,4248,2184,1704,44373,33186
CATTCGGTAGGCCAAG,sample,258735,255992,19802,236190,36790,199400,128146,8107,37281,3359,165427,22507,8268,2715,32053,26121
TAGCGAGTAGGCCAAG,sample,127739,126637,9685,116952,22637,94315,64386,3739,14800,1574,79186,9816,5788,2382,21141,15995
CTAACCGGAGGCCAAG,sample,146250,144837,11919,132918,22478,110440,67885,4811,22817,2154,90702,12773,6399,1836,22772,15682
GGCGACGAAGGCCAAG,sample,156747,155396,9601,145795,27032,118763,85446,5391,16511,1722,101957,9693,5540,2215,21003,19631
TAACGAAGAGGCCAAG,sample,117230,116251,8728,107523,16897,90626,53157,2720,21494,2483,74651,10772,5826,1716,20956,12551
GCCTATTCAGGCCAAG,sample,188545,187095,11363,175732,27868,147864,92130,6502,33813,3774,125943,11645,5615,2086,18577,20020
TGCGCTCCAGGCCAAG,sample,60964,60365,3817,56548,7958,48590,36147,3347,6002,591,42149,2503,3754,2550,8042,5748
GGCGTACCAGGCCAAG,sample,182107,180741,13512,167229,24795,142434,75807,5007,42560,4295,118367,14765,6387,2176,17879,17505
CGTCGAGGAGGCCAAG,sample,115443,114581,7231,107350,10151,97199,52391,3489,27923,3061,80314,10335,6198,2715,6712,6901
TCTCCTAGAGGCCAAG,sample,245223,243813,10698,233115,41223,191892,135962,10341,29300,3421,165262,12868,6402,2248,38008,29205
ATGAATAGAGGCCAAG,sample,54147,53683,5125,48558,8440,40118,19738,1640,10744,1179,30482,6817,5563,1793,3982,5640
TCAATCAGAGGCCAAG,sample,142607,141822,4761,137061,22465,114596,77252,4587,22222,2672,99474,7863,4960,2749,12380,15665
TAACGCCAAGGCCAAG,sample,203985,202934,12738,190196,33035,157161,86814,5757,35845,4119,122659,24626,9478,2093,32262,22285
GACTAACCAGGCCAAG,Neg_Ctrl,1376,984,274,710,96,614,348,35,127,12,475,92,331,175,73,43
TTAACTGAAGGCCAAG,sample,5576,5516,184,5332,1432,3900,3064,279,398,25,3462,134,842,812,672,940
GAGCCTCCAGAACCGC,sample,162690,159488,20547,138941,17713,121228,55988,3433,35476,3991,91464,22340,9095,2285,15296,11359
TCGAACGAAGAACCGC,sample,139267,137332,15651,121681,20247,101434,52722,4211,23689,2647,76411,18165,7488,1829,17644,14251
GGTAGAGAAGAACCGC,sample,232206,229411,20929,208482,41556,166926,88158,5361,42165,4824,130323,26418,9793,2269,33187,27309
ATTCAAGGAGAACCGC,sample,252134,250110,10902,239208,45424,193784,165352,9689,12299,1927,177651,4517,2795,2423,50390,34377
TGATTCCGAGAACCGC,sample,159369,157174,14467,142707,20218,122489,63151,4390,35245,4638,98396,15065,6989,2278,18016,14184
TCTCAGGAAGAACCGC,sample,155168,154127,6953,147174,33094,114080,80308,4990,19712,2878,100020,6192,4708,3128,17371,22918
TGGATCAAAGAACCGC,sample,270421,267004,33836,233168,35482,197686,93825,6616,54522,5925,148347,36798,10714,2260,41215,24315
TGCGCGTTAGAACCGC,sample,149829,148557,9738,138819,19377,119442,68258,4805,32083,3351,100341,10945,5850,2409,14733,13413
ACGCTTAAAGAACCGC,sample,83661,82763,10361,72402,10853,61549,28433,1745,17326,1668,45759,12377,7118,2056,7610,7102
TAGCGAGTAGAACCGC,sample,124627,123343,12119,111224,22232,88992,51452,3320,18614,1826,70066,13780,7163,2447,17917,14594
CCTAGCGGAGAACCGC,sample,82378,81647,7262,74385,11688,62697,42035,3085,9488,1202,51523,6887,5196,2306,9458,8194
GCGTTACCAGAACCGC,sample,166238,164659,16043,148616,25238,123378,76510,5628,24878,2525,101388,13837,6551,2152,17968,16372
GGCGTACCAGAACCGC,sample,81575,80760,7165,73595,11594,62001,33298,2082,15717,1825,49015,9079,6115,2117,8741,7768
CGCGGTCGAGAACCGC,sample,209216,206068,26609,179459,23360,156099,70881,5451,42917,4196,113798,32654,11979,2670,15419,13908
TAACGCCAAGAACCGC,sample,292981,290523,19540,270983,25657,245326,130955,8607,67614,8347,198569,29803,8156,2396,21906,18325
GACTAACCAGAACCGC,sample,196994,195496,14147,181349,33884,147465,94921,6363,27892,3529,122813,14760,7973,2917,18470,23786
CCTAACTAAGAACCGC,sample,173409,172020,16697,155323,26880,128443,66539,4074,33202,3515,99741,21113,8057,1920,20046,18303
GCGCAATAAGAACCGC,sample,160295,159430,4959,154471,27554,126917,99976,8856,12675,1160,112651,4250,3297,2232,20782,20446
TATACGGACATCAAGC,sample,180636,178365,14681,163684,29372,134312,78715,4871,29914,3926,108629,16886,7593,2152,24076,19609
GAGCCTCCCATCAAGC,sample,124881,123448,11443,112005,20687,91318,50903,3370,22405,2133,73308,12507,6277,2249,16403,14026
CGTCGCCACATCAAGC,sample,222752,217846,28893,188953,24446,164507,81868,5570,41685,4417,123553,30967,10560,3731,10816,15167
ATACGTTCCATCAAGC,sample,189143,187129,13872,173257,33797,139460,97199,7896,18993,3010,116192,12362,4901,2061,29605,23206
GATGCGTTCATCAAGC,sample,218533,216172,19830,196342,27756,168586,100805,4382,36341,4340,137146,22718,8532,2169,30010,19235
GCTCTTCTCATCAAGC,sample,243737,242014,11158,230856,40762,190094,148221,8409,22738,2209,170959,8517,3632,2071,42168,30871
CCTAGCGGCATCAAGC,sample,154116,152425,13116,139309,20683,118626,70248,4106,25962,2754,96210,15556,7091,2183,20751,14401
GCCTATTCCATCAAGC,sample,97846,97063,9824,87239,25760,61479,34460,2503,12736,1468,47196,10312,5510,1665,9745,15529
CGTCGAGGCATCAAGC,Pos_Ctrl,62610,61342,6771,54571,2572,51999,43506,4110,2980,417,46486,986,6355,7589,2826,1253
CGCGGTCGCATCAAGC,sample,150175,149163,10758,138405,20595,117810,71305,4677,26118,3095,97423,12615,6274,2139,17004,13465
TAACGCCACATCAAGC,sample,270394,268677,17803,250874,27073,223801,117530,8857,62294,7999,179824,27121,8624,2395,23540,19023
GACTAACCCATCAAGC,sample,152131,151206,7737,143469,20590,122879,76796,6331,26474,3455,103270,9823,4750,2037,18686,14475
CTGGTCTTAGAGAGCC,sample,202545,200979,11322,189657,45623,144034,107369,8178,17161,2337,124530,8989,3860,1872,35470,33401
CATAATGGAGAGAGCC,sample,206817,202809,29138,173671,23296,150375,73655,5048,39594,4923,113249,27155,11502,3314,14035,14676
TATACGGAAGAGAGCC,sample,132586,131606,8394,123212,26288,96924,64870,4469,15908,1743,80778,9934,4888,1821,22450,17814
CATACTCCAGAGAGCC,sample,80368,79722,4442,75280,19422,55858,41472,2695,7382,743,48854,3566,3999,2776,11923,12864
ATACGTTCAGAGAGCC,sample,120843,119049,12094,106955,15843,91112,50862,3249,22977,2998,73839,11026,6713,2562,12606,11270
CCATTCTTAGAGAGCC,sample,145696,144322,11688,132634,21223,111411,64974,4556,24217,3136,89191,14528,6614,1881,21366,14583
AGCGTCTTAGAGAGCC,sample,229323,227047,21517,205530,28097,177433,96950,6627,45912,5462,142862,22482,8914,2800,25597,20422
CGTCGAGGAGAGAGCC,sample,147150,146072,8690,137382,19116,118266,81750,6027,18110,1899,99860,10480,6023,2494,15675,13458
CGCGGTCGAGAGAGCC,sample,121022,120127,8413,111714,16362,95352,59839,3969,20270,1863,80109,9411,4756,1714,18119,12033
GACTAACCAGAGAGCC,sample,119392,118648,5773,112875,19813,93062,66396,4493,13182,1638,79578,7353,5651,2655,11001,13531
CGTAGAACAGAGAGCC,sample,161448,160374,9518,150856,25215,125641,79580,5327,24754,2484,104334,13496,6745,2048,21488,17941
TCTAGGTTAGCATTGA,sample,341695,337756,26380,311376,54818,256558,147698,8124,59550,8641,207248,32545,7848,2623,45371,40356
AGAGTTCTAGCATTGA,sample,237160,234259,15857,218402,37642,180760,114771,7814,33749,3068,148520,21358,7488,2192,37775,27132
CGTCGCCAAGCATTGA,sample,99725,97896,8988,88908,11856,77052,46765,3289,16456,1600,63221,8942,6783,3628,7504,7843
GCAACTAGAGCATTGA,sample,104640,103894,5426,98468,15483,82985,56589,4218,13779,1787,70368,6612,5498,3045,9582,11219
ATACGTTCAGCATTGA,sample,156776,154741,11818,142923,9301,133622,59563,2811,45958,5862,105521,19428,6677,2155,2964,5585
CCGCAGTCAGCATTGA,sample,214303,212252,12599,199653,36815,162838,119934,7901,22445,2389,142379,10169,5851,2961,31937,26379
ATGGCGTTAGCATTGA,sample,327263,323803,26889,296914,40798,256116,146702,9621,64219,6836,210921,28738,7780,2754,35719,28121
AGCGTCTTAGCATTGA,sample,144155,142883,11303,131580,20428,111152,62400,3859,26193,2661,88593,16039,8731,3496,16771,13504
ACGCTTAAAGCATTGA,sample,179854,178534,8302,170232,41137,129095,98445,7588,15986,2060,114431,5016,3854,2674,24746,28091
CATTCGGTAGCATTGA,sample,209359,207965,11052,196913,32245,164668,115571,6940,25689,3959,141260,12509,6425,2383,40528,23959
AAGGTCTGAGCATTGA,sample,271362,269289,13750,255539,55316,200223,145941,11333,26018,2638,171959,14293,7634,3501,32244,38202
GGCGACGAAGCATTGA,sample,101379,100471,7232,93239,11838,81401,42509,2819,23445,2229,65954,10399,5185,1989,11163,8514
GCTGCTTCAGCATTGA,sample,252310,250651,17441,233210,43038,190172,121793,8173,33875,4170,155668,22161,7913,2701,31844,31454
GCCTATTCAGCATTGA,sample,224354,223131,7531,215600,44199,171401,129655,10071,21020,2177,150675,8478,4814,2241,35837,31057
ATACCGCCAGCATTGA,sample,240329,238917,8330,230587,44203,186384,138018,10871,24690,2839,162708,9966,5390,2679,28488,31200
GGCGTACCAGCATTGA,sample,136487,135587,7779,127808,19609,108199,60305,4476,27543,3459,87848,12416,5844,1897,18406,13654
CAGCTTCGAGCATTGA,Neg_Ctrl,1240,684,299,385,53,332,194,12,75,12,269,39,195,113,38,18
TAACGCCAAGCATTGA,sample,283528,282092,8774,273318,38744,234574,176377,14325,25640,2891,202017,15341,6721,2557,27446,27867
CGTAGAACAGCATTGA,sample,37515,37342,1191,36151,11841,24310,15086,1054,5293,586,20379,2291,2498,1352,4305,7144
CTGGTCTTAATTACCA,sample,137941,134724,24326,110398,11623,98775,40486,2348,32162,3314,72648,20465,8358,2460,8702,7230
GACGTATGAATTACCA,sample,134979,133105,11086,122019,21993,100026,68598,5106,17176,1559,85774,7587,5444,2400,17610,16304
TATACGGAAATTACCA,sample,60260,59001,8595,50406,6654,43752,24647,1632,10217,1025,34864,6231,4687,1758,8637,4300
TGATTCCGAATTACCA,sample,275962,274151,16993,257158,44451,212707,137230,8908,38061,4829,175291,23679,8636,2619,38192,31438
CCGTACGCAATTACCA,sample,127250,126585,8190,118395,18266,100129,58245,4851,22868,2639,81113,11526,7068,2800,13129,12676
ATGGCGTTAATTACCA,sample,63170,62780,4413,58367,14188,44179,29129,1937,7829,1203,36958,4081,3725,1642,10701,9206
AGCGTCTTAATTACCA,sample,191061,190057,7600,182457,36179,146278,109575,7131,18215,1654,127790,9703,4210,2221,28941,26286
ACGCTTAAAATTACCA,sample,79113,78083,18146,59937,4080,55857,10644,672,24317,2726,34961,17498,8902,1934,1239,1658
CATTCGGTAATTACCA,sample,162232,160912,11230,149682,22135,127547,72772,4397,31859,3444,104631,15075,6661,1955,20092,15407
GGCGACGAAATTACCA,sample,188468,186977,14418,172559,25704,146855,85200,4505,32025,4420,117225,20705,7353,1666,31223,18826
TAACGAAGAATTACCA,sample,151222,150415,5540,144875,42622,102253,76123,6068,13492,1421,89615,5149,4419,2335,18986,28007
GCTGCTTCAATTACCA,sample,178364,177067,9573,167494,20526,146968,94963,7019,30162,3361,125125,11463,5311,2927,14390,14608
GCCTATTCAATTACCA,sample,168725,167655,4423,163232,25595,137637,114678,10390,9277,991,123955,2301,2534,2275,19004,19475
AGCAGAGCAATTACCA,sample,181932,180797,6059,174738,34714,140024,111492,10689,12926,1625,124418,3292,2454,1868,26022,25610
ATACCGCCAATTACCA,sample,263732,261371,27799,233572,25107,208465,92230,6171,61425,6258,153655,42381,12170,2585,25907,16802
GCGTTACCAATTACCA,sample,108044,106893,11689,95204,12406,82798,40192,3377,21812,2767,62004,14650,6587,1589,8938,7733
CGTCGAGGAATTACCA,sample,53399,52760,6961,45799,5203,40596,19280,932,11485,1280,30765,7619,4756,1411,5732,3166
CAGCTTCGAATTACCA,sample,158693,157594,7501,150093,27553,122540,91213,6944,15540,1550,106753,7293,5182,2805,19847,20108
TCTCCTAGAATTACCA,sample,92452,91424,9097,82327,9056,73271,38284,2877,19398,1930,57682,10782,6514,2232,7214,5986
ATGAATAGAATTACCA,sample,96364,95229,11668,83561,9347,74214,30144,1951,23037,2604,53181,16478,6777,1704,6787,5632
AAGTAGAGAATTACCA,sample,162806,161201,14023,147178,19435,127743,81036,6265,22196,2576,103232,15670,6439,1611,26198,13183
TAACGCCAAATTACCA,sample,220247,218362,19653,198709,32000,166709,100251,5224,35872,4661,136123,20701,7989,2277,24846,20205
TTAACTGAAATTACCA,sample,152005,151040,10117,140923,26063,114860,74441,5550,19470,2533,93911,12866,5353,1952,20322,18951
ATATGCAAAATTACCA,sample,130551,129659,6691,122968,19167,103801,67398,4522,20019,2728,87417,9134,4412,1782,14146,13193
AACCGGTTTAGATGAC,sample,167528,166792,11019,155773,32331,123442,73172,6093,26699,3066,99871,14412,7873,2619,22385,22219
CTGGTCTTTAGATGAC,Pos_Ctrl,93276,91675,10242,81433,4397,77036,64917,5797,4309,611,69226,1402,7108,8897,5663,2326
AGAGTTCTTAGATGAC,sample,270032,267339,23185,244154,39319,204835,127527,8729,40420,4451,167947,23708,8589,2544,44434,25993
CATAATGGTAGATGAC,sample,224643,222703,12426,210277,23440,186837,122805,7094,39710,4593,162515,12635,5461,2311,32424,16964
GGAGAAGCTAGATGAC,sample,306514,302417,32574,269843,40771,229072,118675,7198,58565,6050,177240,38584,10879,2676,40776,27305
GAGCCTCCTAGATGAC,sample,134701,133439,8971,124468,29189,95279,62814,3812,16939,1682,79753,10032,4653,1839,22685,20351
CATACTCCTAGATGAC,Pos_Ctrl,89408,85561,11975,73586,3837,69749,58260,4905,4548,600,62808,1436,7127,8422,4814,2064
TGATTCCGTAGATGAC,Pos_Ctrl,84917,82874,10140,72734,3484,69250,58021,5007,4331,602,62352,1289,6875,8450,4425,2042
GCAACTAGTAGATGAC,sample,90016,89263,3614,85649,11718,73931,44476,2942,18230,2240,62706,6043,3178,1400,7578,8272
CCGTACGCTAGATGAC,sample,89328,88706,5458,83248,16527,66721,45322,3668,11399,1385,56721,4947,4854,2719,9859,11489
TGGATCAATAGATGAC,sample,249799,247554,16122,231432,38143,193289,139303,11099,26143,3332,165446,13412,6576,2792,30360,29109
TGCGCGTTTAGATGAC,sample,77106,76291,8063,68228,14878,53350,30466,2006,11445,1242,41911,8191,5959,2452,8345,9533
CGGTTGGTTAGATGAC,sample,68181,67256,9980,57276,8542,48734,23483,1929,12450,1385,35933,9487,6139,1994,5165,5565
GAGATTCTTAGATGAC,sample,225484,222759,23075,199684,22680,177004,93033,5541,47139,5884,140172,25407,9035,2448,25853,16302
ATACCGCCTAGATGAC,sample,230098,228349,14323,214026,24950,189076,113393,8291,42591,5810,155984,18991,7520,2288,20997,17508
GCGTTACCTAGATGAC,sample,285229,282475,20737,261738,26820,234918,152065,11344,41828,4538,193893,25143,9006,3107,20055,18464
CGTCGAGGTAGATGAC,sample,198710,196827,18408,178419,23174,155245,86715,6131,34919,3893,121634,23587,9011,2150,17803,15307
TCTCCTAGTAGATGAC,sample,254025,252119,18256,233863,28097,205766,120900,10409,43589,4244,164489,26624,9405,2508,27860,18436
AAGTAGAGTAGATGAC,sample,181739,179871,17815,162056,29151,132905,72681,4790,31624,3570,104305,20240,8412,2360,15135,19164
TAACGCCATAGATGAC,sample,204791,203278,10262,193016,31166,161850,123980,8596,16334,1954,140314,10986,6589,3415,21651,22351
GACTAACCTAGATGAC,sample,220523,218758,15165,203593,22150,181443,108751,8838,41732,4540,150483,17582,6906,1966,22159,16275
GTCGTTCTGTTCAGAA,sample,100302,98433,13502,84931,15332,69599,35111,2119,18486,2232,53597,11651,7302,2619,9995,9291
GGTAGAGAGTTCAGAA,sample,163886,161599,11911,149688,14739,134949,76378,4345,35604,4100,111982,14522,6276,2511,12279,9918
TCATACCAGTTCAGAA,sample,119346,117069,14971,102098,11048,91050,37153,1825,32353,3815,69506,15904,8032,2332,9357,7047
CCGCAGTCGTTCAGAA,sample,174105,169871,31247,138624,11837,126787,37910,1946,51996,6318,89906,28617,11941,2532,8813,6085
CCGTACGCGTTCAGAA,sample,83396,82415,6633,75782,15841,59941,40889,2138,10181,1002,51070,5731,4451,1792,13752,10933
TGGATCAAGTTCAGAA,sample,86411,85586,6297,79289,16379,62910,42312,2708,10972,1186,53284,5732,4443,2424,11268,11399
GGCAGGTTGTTCAGAA,sample,151099,148212,20642,127570,8949,118621,41627,2489,51867,5986,93494,16652,8632,3090,5318,5420
CTAAGCATGTTCAGAA,sample,14000,13915,599,13316,2181,11135,6790,645,2627,314,9417,759,1842,1214,1147,1592
CCTAGCGGGTTCAGAA,sample,46601,46308,2463,43845,8252,35593,23745,1882,6656,760,30401,2550,2933,1639,7282,5847
AGCAGAGCGTTCAGAA,sample,227357,226102,8063,218039,39542,178497,132751,9261,23692,2025,156443,10768,5001,2005,40260,29130
GCGTTACCGTTCAGAA,sample,190914,189876,8319,181557,28882,152675,100803,8581,26316,3186,127119,13789,6597,2176,21636,20534
TTATGACGGTTCAGAA,sample,199631,198771,5891,192880,34490,158390,112663,9823,25722,2927,138385,7255,5107,3265,18891,24819
AGATACTAGTTCAGAA,sample,148949,148360,5399,142961,46190,96771,76094,4600,10548,1284,86642,4245,2552,1292,21810,28837
CCTAACTAGTTCAGAA,Pos_Ctrl,34308,33990,1782,32208,1583,30625,25610,2911,1474,151,27084,479,5241,6267,1825,784
ATATGCAAGTTCAGAA,sample,154515,153905,5604,148301,29653,118648,77147,6864,23769,2442,100916,8426,4804,1969,17396,20229
CTGGTCTTTTCTGGTT,sample,152875,150903,13848,137055,21583,115472,65003,3272,28781,3505,93784,14911,7713,2806,17957,14780
GTCGTTCTTTCTGGTT,Neg_Ctrl,1746,1257,782,475,56,419,146,14,88,85,234,86,147,76,40,40
GACGTATGTTCTGGTT,sample,164671,163375,11561,151814,32342,119472,81823,5270,19324,1999,101147,11056,6020,2147,27301,21755
CTAGCGACTTCTGGTT,Neg_Ctrl,1233,819,417,402,48,354,183,8,96,8,279,59,190,102,55,31
TCATCGAATTCTGGTT,sample,183514,181531,14239,167292,26420,140872,65625,4974,40180,4301,105805,25792,9625,2299,19241,17665
GCAACTAGTTCTGGTT,Neg_Ctrl,808,494,221,273,39,234,115,7,67,6,182,39,130,66,38,22
GACTCAAGTTCTGGTT,sample,85412,84284,6943,77341,14859,62482,40546,2305,10818,1316,51364,7497,4408,1688,13803,10678
CGGTTGGTTTCTGGTT,sample,251957,250073,12614,237459,35904,201555,132088,8457,39850,3904,171938,17256,6213,1962,40580,26161
CATTCGGTTTCTGGTT,sample,96398,95171,12137,83034,11217,71817,31309,2301,20674,2487,51983,15046,7263,1660,8833,6736
CTAAGCATTTCTGGTT,sample,83708,83167,4881,78286,17233,61053,39801,2562,10832,853,50633,7005,4532,1460,14484,11990
TGCGCTCCTTCTGGTT,sample,172418,171076,14165,156911,19019,137892,65090,5460,38008,4753,103098,24581,8622,1979,9858,12465
CGTCGAGGTTCTGGTT,sample,191373,190274,7897,182377,31464,150913,109537,9686,19654,2209,129191,9827,5358,2145,27027,21520
TCTCCTAGTTCTGGTT,sample,195863,194743,12252,182491,22321,160170,84160,5524,45108,4911,129268,20467,8305,2519,15756,15680
TAACGCCATTCTGGTT,sample,741,729,71,658,92,566,370,33,92,12,462,59,306,190,93,67
AGCTGAATGTTCGGTT,sample,175096,172955,14690,158265,25961,132304,88729,6063,22888,2125,111617,12499,6181,2520,23378,17318
CATAATGGGTTCGGTT,sample,185203,181679,23248,158431,11118,147313,52991,3186,62050,6665,115041,22421,8816,2747,6749,6864
TATACGGAGTTCGGTT,sample,179257,176593,16390,160203,21684,138519,83099,5055,29402,2782,112501,18181,7559,2259,24206,14613
CGTCGCCAGTTCGGTT,sample,196225,193893,14341,179552,26166,153386,97707,6854,28309,3003,126016,17513,6890,1960,29709,18958
TCATACCAGTTCGGTT,sample,227106,224327,11225,213102,26056,187046,130582,8267,32432,4218,163014,11547,5139,2217,26372,19190
TGATTCCGGTTCGGTT,sample,76391,75557,5630,69927,13875,56052,37192,2455,10297,1113,47489,4995,3679,1694,11337,9467
CCGTACGCGTTCGGTT,sample,150679,147844,18932,128912,15372,113540,55212,3440,29971,3675,85183,21242,9168,2347,13758,10082
TCTCAGGAGTTCGGTT,sample,165099,163648,7617,156031,28712,127319,99385,6909,13712,1830,113097,5483,4240,2996,20408,21516
ATGGCGTTGTTCGGTT,sample,114408,113434,5756,107678,23720,83958,64433,3700,9538,950,73971,5337,4116,1909,19700,16556
AGCGTCTTGTTCGGTT,sample,273036,269218,29015,240203,25099,215104,98461,7423,68383,7186,166844,33651,10612,3501,19508,18025
CATTCGGTGTTCGGTT,sample,246676,244497,19604,224893,30340,194553,75617,6459,61359,6646,136976,44472,11881,2790,21483,20914
CTAAGCATGTTCGGTT,sample,229015,226732,17308,209424,29162,180262,99270,6133,44218,6295,143488,24346,8146,2420,30009,20135
TAACGAAGGTTCGGTT,sample,210496,208953,13532,195421,30018,165403,103608,6104,30768,3149,134376,21774,8260,1903,33340,21221
GCGTTACCGTTCGGTT,sample,252426,251012,7448,243564,47034,196530,145314,14269,23058,3822,168372,10067,5161,2508,27512,33370
CGCGGTCGGTTCGGTT,sample,161755,160671,9385,151286,21546,129740,77507,5278,27372,3415,104879,16168,7371,2209,20209,14102
ATGAATAGGTTCGGTT,sample,254545,252844,13012,239832,25363,214469,126328,9527,51346,6311,177674,20957,7850,2952,16680,17371
TCAATCAGGTTCGGTT,sample,107425,106865,4922,101943,20324,81619,57410,3743,13356,1045,70766,6065,4719,1698,17642,14299
GACTAACCGTTCGGTT,sample,214413,213370,8694,204676,39444,165232,122751,9150,20136,2580,142887,10615,5731,2270,29520,28750
GCGCAATAGTTCGGTT,Neg_Ctrl,1186,745,299,446,52,394,241,8,88,10,329,47,234,132,54,21
ATATGCAAGTTCGGTT,sample,562,557,55,502,87,415,272,16,72,9,344,46,216,144,70,62
GACGTATGTGGCGGTT,sample,166555,163725,18341,145384,25444,119940,69047,4069,24901,2682,93948,19241,7602,1899,25075,17151
CATAATGGTGGCGGTT,sample,120966,119444,11063,108381,20461,87920,49081,3730,20585,2398,69666,12126,7459,2729,13229,13847
CGTCGCCATGGCGGTT,sample,159841,157928,10718,147210,19533,127677,69965,4198,36216,4111,106181,13187,5857,2364,18280,14223
TCATCGAATGGCGGTT,sample,248462,245207,21439,223768,41856,181912,111931,6438,35477,3648,147408,24418,8308,2673,34451,28451
TCATACCATGGCGGTT,sample,186061,183625,13449,170176,37088,133088,95666,5693,19443,2508,115109,9778,5702,2447,27362,25898
TACGCGAGTGGCGGTT,sample,267518,263021,27942,235079,33729,201350,104967,7500,50239,5741,155206,32903,10975,2609,37416,23336
TCTCAGGATGGCGGTT,sample,365864,362807,25874,336933,48504,288429,181435,11930,58889,6344,240324,29831,10661,4102,35545,34726
GGCAGGTTTGGCGGTT,sample,195684,191069,26814,164255,19163,145092,61777,4579,42200,4227,103977,32309,10980,3110,14504,11114
AGCGTCTTTGGCGGTT,sample,98910,97629,8522,89107,18775,70332,31269,2021,22970,2896,54239,11176,6535,2062,5658,12645
TAGCGAGTTGGCGGTT,sample,106483,104865,10938,93927,13219,80708,44693,2246,19693,2112,64386,11964,6717,2138,12934,8474
AAGGTCTGTGGCGGTT,sample,277649,275387,18704,256683,54898,201785,147789,10684,25424,3241,173213,14647,5150,2274,41591,36886
CTAACCGGTGGCGGTT,sample,271890,269424,15628,253796,27829,225967,133490,9434,54359,6936,187849,21748,8727,3953,17205,19162
GGCGACGATGGCGGTT,sample,75610,74294,7392,66902,11480,55422,27027,2292,14391,1476,41418,10236,5830,1578,8007,7060
GCTGCTTCTGGCGGTT,sample,307718,305537,15737,289800,43867,245933,134995,12906,60315,8090,195310,29627,9034,3184,25276,31577
GCGTTACCTGGCGGTT,sample,104889,103735,6845,96890,14477,82413,55110,4385,14410,1707,69520,6801,5982,3223,11024,10573
GGCGTACCTGGCGGTT,sample,52455,51544,5653,45891,5957,39934,20912,1176,11364,1289,32276,5193,4445,1757,5334,3849
CGTCGAGGTGGCGGTT,sample,162593,161188,8997,152191,19293,132898,85438,7400,27429,3062,112867,9569,6258,2965,15202,13409
ATGAATAGTGGCGGTT,sample,424434,421454,30686,390768,60666,330102,182301,9801,81157,6814,263458,50029,11968,2904,55617,40833
TTAACTGATGGCGGTT,sample,8660,8571,366,8205,1366,6839,4897,441,955,76,5852,470,1289,902,954,975
CTAGCGACTCCTTATT,sample,102181,101326,8735,92591,13908,78683,38439,2470,21423,2505,59862,13846,6610,1802,13217,9473
TCGAACGATCCTTATT,sample,82758,82168,4699,77469,14981,62488,40598,3261,10590,1335,51188,6704,4808,1730,14073,10879
GCAACTAGTCCTTATT,sample,34947,34635,2634,32001,5341,26660,13663,1011,6931,748,20594,4307,3466,1180,3992,3543
ATACGTTCTCCTTATT,sample,68546,67863,5770,62093,10683,51410,31289,2148,10785,1306,42074,5882,4395,1524,10728,7397
TGGATCAATCCTTATT,sample,111955,111183,6465,104718,15614,89104,54504,3957,18116,2074,72620,10453,5746,1891,16689,11334
ACGCTTAATCCTTATT,sample,62946,62317,5847,56470,11565,44905,23438,1589,10828,1197,34266,7853,5640,1980,7159,7117
CATTCGGTTCCTTATT,sample,78676,78115,3886,74229,15008,59221,43816,3009,8404,893,52220,3099,3308,1911,11318,10594
TAGCGAGTTCCTTATT,sample,60335,59851,3892,55959,9434,46525,33680,2228,6231,758,39911,3628,3483,1918,9735,6587
GAGATTCTTCCTTATT,sample,106675,105584,11245,94339,13343,80996,40930,2714,20414,1967,61344,14971,7079,1995,11513,8909
CTAAGCATTCCTTATT,sample,84812,84313,4347,79966,20048,59918,42603,2899,8477,899,51080,5040,3469,1838,14343,13655
AAGGTCTGTCCTTATT,sample,124866,123908,8212,115696,19637,96059,60961,4307,18012,1840,78973,10939,5467,2229,16915,14159
GGCGACGATCCTTATT,sample,59874,59231,4397,54834,8839,45995,31696,2047,7299,855,38995,4098,3638,1533,9916,6485
ATACCGCCTCCTTATT,sample,96719,95902,7955,87947,8872,79075,45994,2474,19359,2272,65353,8976,5359,1981,8988,6231
CGTCGAGGTCCTTATT,Pos_Ctrl,37028,36349,3851,32498,1593,30905,26045,2189,1824,241,27869,606,5361,5785,1618,834
CAGCTTCGTCCTTATT,sample,106488,105827,4310,101517,19189,82328,62517,4427,9806,1606,72323,3972,3271,1672,15837,13707
CGCGGTCGTCCTTATT,sample,101399,100750,3683,97067,20398,76669,56213,3593,11423,1077,67636,4363,3028,1325,14595,14728
TTATGACGTCCTTATT,sample,69122,68536,4201,64335,11007,53328,34777,2836,10058,1255,44835,4402,4178,2103,8294,7780
TCTCCTAGTCCTTATT,sample,155080,153883,9841,144042,25461,118581,77619,5833,20541,1801,98160,12787,6938,2079,14882,17775
ATGAATAGTCCTTATT,sample,155562,154543,7317,147226,19687,127539,95412,6668,15614,1699,111026,8146,5698,2785,18245,13468
GACTAACCTCCTTATT,sample,115806,114241,16813,97428,10621,86807,34097,3124,25701,2592,59798,21293,8319,1645,10377,6449
CGTAGAACTCCTTATT,sample,126866,125852,7187,118665,18775,99890,66071,5701,16897,1923,82968,9298,5170,2548,11783,13105
GACGTATGAATAAGGT,sample,149215,147107,12217,134890,18329,116561,65635,4364,31169,2987,96804,12406,6278,2502,17832,13742
CATAATGGAATAAGGT,sample,176093,174328,9439,164889,25192,139697,89638,6394,30344,3550,119982,9771,4591,2253,25401,18230
TATACGGAAATAAGGT,sample,178617,176693,11690,165003,29434,135569,90161,5440,23299,2863,113460,13806,6181,2281,29485,20877
GAGCCTCCAATAAGGT,sample,262883,258340,28888,229452,34888,194564,107059,7982,42738,5099,149797,31686,10022,3174,24647,23464
CTAGCGACAATAAGGT,sample,256429,253695,16340,237355,27589,209766,121579,5523,55960,5618,177539,21086,7154,2478,28934,18270
TCGAACGAAATAAGGT,sample,117747,115503,15899,99604,11803,87801,39430,1988,26490,2809,65920,17084,7874,2251,13931,6330
TACGCGAGAATAAGGT,sample,201300,198453,17002,181451,19650,161801,79110,4985,48833,5886,127943,22987,7168,2461,18617,13235
TGGATCAAAATAAGGT,sample,141464,138919,18449,120470,14251,106219,51201,2121,30156,3297,81357,19444,9117,2254,15479,9262
ATGGCGTTAATAAGGT,Pos_Ctrl,120545,117854,12228,105626,4782,100844,84324,7199,6505,881,90829,1935,7621,9948,6825,2470
ACGCTTAAAATAAGGT,sample,138223,136704,10389,126315,14803,111512,58752,4191,31463,4051,90215,13055,6003,2207,15061,10705
GAGATTCTAATAAGGT,sample,206466,204331,18960,185371,29714,155657,75688,4357,43404,5814,119092,26394,9299,2052,24797,19161
AAGGTCTGAATAAGGT,sample,144717,143060,10960,132100,14652,117448,66391,4431,29930,3716,96321,12980,6995,2822,11934,10041
CCTAGCGGAATAAGGT,Pos_Ctrl,34560,33925,3329,30596,1551,29045,24360,2216,1679,205,26039,585,5338,5501,2035,763
GGCGACGAAATAAGGT,sample,137424,135128,14929,120199,17594,102605,58443,2774,22972,2879,81415,15537,7834,2170,22769,11932
AGCAGAGCAATAAGGT,sample,229104,227553,10897,216656,52263,164393,111231,7465,29248,3373,140479,13076,6705,2373,30980,35837
GGCGTACCAATAAGGT,sample,161014,159674,6867,152807,21714,131093,98965,5154,19560,1881,118525,5533,3878,2351,21069,17015
TCTCCTAGAATAAGGT,sample,264373,262851,12868,249983,27607,222376,134287,9400,50042,6936,184329,21711,7729,2864,24672,19524
ATGAATAGAATAAGGT,sample,381150,379130,16023,363107,57456,305651,218761,11907,45349,5381,264110,24253,7611,2667,66037,42454
TCAATCAGAATAAGGT,sample,238443,237115,8616,228499,40313,188186,135878,10769,28717,3012,164595,9810,4728,2027,34134,28736
TAACGCCAAATAAGGT,sample,327407,325801,11874,313927,59011,254916,187128,17712,29440,3118,216568,17518,5668,2264,49611,43029
CCTAACTAAATAAGGT,sample,1086,1068,130,938,123,815,527,51,142,27,669,68,419,268,121,90
TTAACTGAAATAAGGT,sample,71456,71181,2134,69047,15152,53895,36624,3691,8755,1047,45379,3778,3379,1581,9402,10541
ATATGCAAAATAAGGT,sample,60442,60146,2694,57452,9913,47539,24540,2912,13201,1632,37741,5254,4339,1966,2870,6731
AGCTGAATCAGGACCA,sample,154330,152572,13421,139151,23818,115333,65843,3173,26900,2984,92743,16433,7291,2227,21455,16804
GGTAGAGACAGGACCA,sample,135122,132973,16013,116960,13560,103400,48533,2447,31100,3771,79633,17549,8388,2653,12556,8375
CGTCGCCACAGGACCA,sample,308949,306143,21117,285026,40742,244284,147373,9260,51369,5135,198742,31147,9715,3288,34018,27481
GCAACTAGCAGGACCA,sample,146477,145385,8268,137117,13230,123887,63453,5039,36742,4057,100195,14596,7067,2288,13603,8374
TACGCGAGCAGGACCA,sample,320534,318390,19095,299295,46505,252790,177787,14028,34126,4433,211913,22416,6256,2308,52027,34455
ATACGTTCCAGGACCA,sample,229253,227080,15676,211404,33421,177983,116003,8316,30595,3370,146598,19699,8787,3071,31789,23137
CCGTACGCCAGGACCA,sample,314406,311851,20638,291213,50949,240264,162477,8129,40761,4770,203238,24127,7231,2408,52417,35559
TCTCAGGACAGGACCA,sample,134406,132377,15985,116392,20436,95956,51742,2282,23448,2541,75190,15943,7460,2389,16552,13357
CGGTTGGTCAGGACCA,sample,228758,226979,12087,214892,36618,178274,121715,9663,31284,3423,152999,12189,6214,2393,35890,26990
CATTCGGTCAGGACCA,sample,422741,418242,26812,391430,41635,349795,241693,17426,54166,6572,295859,29938,10946,4386,41760,27703
AGCAGAGCCAGGACCA,sample,154732,153330,15166,138164,17358,120806,55924,3305,34342,3674,90266,23561,9022,1917,17792,11150
TGCGCTCCCAGGACCA,sample,162477,160525,13199,147326,18967,128359,76708,4826,26428,3206,103136,17191,6956,2046,21273,13002
CAGCTTCGCAGGACCA,Neg_Ctrl,1406,857,444,413,68,345,207,11,70,7,277,50,207,109,43,26
TTATGACGCAGGACCA,sample,321253,318762,21616,297146,34917,262229,165642,13609,48679,5376,214321,28923,9562,2877,35293,24885
TCTCCTAGCAGGACCA,sample,218449,216220,16297,199923,29798,170125,101030,8402,35083,4803,136113,20807,7332,1725,30362,20585
ATGAATAGCAGGACCA,sample,114854,113645,10461,103184,13560,89624,50954,3712,19801,2381,70755,12776,7116,2930,8511,8442
TCAATCAGCAGGACCA,sample,292851,290283,24070,266213,35627,230586,123874,8231,53148,5804,177022,39529,11677,2724,31053,24557
AGATACTACAGGACCA,sample,186779,184919,13656,171263,25310,145953,87999,7127,30016,4494,118015,16317,7724,2372,20255,16886
TTAACTGACAGGACCA,sample,218214,216789,10397,206392,34548,171844,116324,7980,29926,3228,146250,14386,6597,1971,33128,24504
AACCGGTTCCTCGTTG,sample,195138,193812,8656,185156,37979,147177,108907,8848,20782,1961,129689,6679,4652,2239,38464,26712
CTGGTCTTCCTCGTTG,sample,194474,190899,28607,162292,21433,140859,64241,2729,40644,4082,104885,29163,9896,2210,21825,12916
GACGTATGCCTCGTTG,sample,136939,135935,6171,129764,24889,104875,83551,6466,9373,1323,92924,4162,2856,2231,25080,19181
TATACGGACCTCGTTG,sample,145933,143797,15593,128204,18759,109445,59634,3847,25334,2675,84968,17955,7362,2176,19276,12170
GAGCCTCCCCTCGTTG,sample,213874,211480,15818,195662,16588,179074,92515,4397,54180,8500,146695,19482,6595,2315,19424,11944
CTAGCGACCCTCGTTG,sample,140155,138661,9289,129372,25717,103655,74054,5849,14504,1793,88558,7455,4975,2480,23293,17683
TCGAACGACCTCGTTG,sample,126263,124855,10271,114584,21250,93334,62220,4434,15782,1600,78002,9298,5835,1834,21801,14924
CGTCGCCACCTCGTTG,sample,135408,133889,10486,123403,20149,103254,73188,4997,14607,1643,87795,8819,5542,2620,15018,14125
TCATCGAACCTCGTTG,sample,296066,294177,18996,275181,25310,249871,129280,8246,72282,8644,201562,31419,9321,2713,21293,16766
ATACGTTCCCTCGTTG,sample,211096,208875,14000,194875,20957,173918,101497,6760,42734,4424,144231,18503,6760,2421,22173,14226
TGGATCAACCTCGTTG,sample,121448,120409,5797,114612,21051,93561,73118,4906,9787,1795,82905,3955,3968,2815,14586,14558
TGCGCGTTCCTCGTTG,Neg_Ctrl,1431,929,436,493,72,421,219,11,112,5,331,74,222,108,52,42
GCTCTTCTCCTCGTTG,sample,198246,196761,11186,185575,32712,152863,107585,8632,21279,2639,128864,12728,5843,2273,29259,24106
CTAACCGGCCTCGTTG,Neg_Ctrl,1294,719,337,382,62,320,171,16,73,14,244,46,180,102,29,18
GGCGACGACCTCGTTG,sample,92852,91728,9494,82234,19311,62923,33527,1984,15613,1661,49140,10138,6076,1647,11570,12037
GGCGTACCCCTCGTTG,sample,192318,190969,6650,184319,23175,161144,119916,7708,22381,3367,142297,7772,3982,1811,22062,17854
GTCGCGAACCTCGTTG,sample,263407,261103,22757,238346,29817,208529,115738,8657,43614,5452,159352,35068,9752,2664,20220,19455
TTATGACGCCTCGTTG,sample,220190,218243,13476,204767,25126,179641,110616,9012,35178,7090,145794,17745,6865,2867,16601,18053
ATTCTACCCCTCGTTG,Pos_Ctrl,72816,71067,8043,63024,2936,60088,50439,4303,3711,452,54150,1183,6646,8098,2962,1490
TTAACTGACCTCGTTG,sample,204976,203652,19246,184406,21913,162493,63483,4200,53418,5480,116901,35912,13478,3086,14847,14396
CGTCGCCATTGCGGAC,sample,170496,169408,9401,160007,16065,143942,82235,5926,37208,5136,119443,13437,6001,2838,16099,11040
ATTCAAGGTTGCGGAC,sample,247916,246219,15588,230631,25532,205099,111739,6968,53788,6218,165527,26386,7600,2330,19849,17166
TGATTCCGTTGCGGAC,sample,359689,356973,30281,326692,33569,293123,138441,8955,89924,8297,228365,47506,11786,3539,35112,21866
CCGTACGCTTGCGGAC,sample,79097,78007,6233,71774,8301,63473,31790,1970,19351,2453,51141,7909,4849,1537,8143,5617
TGGATCAATTGCGGAC,sample,207285,205918,11174,194744,35061,159683,109462,8380,26103,2975,135565,12763,7243,3187,28732,24160
GGCAGGTTTTGCGGAC,sample,252569,250627,16377,234250,29827,204423,134754,9626,36286,4506,171040,19251,7400,2230,38281,20053
GATGCGTTTTGCGGAC,sample,239466,237392,14621,222771,21471,201300,121775,8060,47147,7076,168922,17242,6603,2811,18512,14131
GAGATTCTTTGCGGAC,sample,213086,211168,14343,196825,23061,173764,96229,5925,46113,5490,142342,20007,7559,2499,18586,15204
CTAACCGGTTGCGGAC,sample,175125,173388,12311,161077,18939,142138,93986,6571,26454,2487,120440,12640,6913,3138,15943,13830
ATACCGCCTTGCGGAC,sample,198307,196911,10604,186307,18346,167961,86393,8504,48222,5052,134615,19790,6833,1978,9284,10900
GCGTTACCTTGCGGAC,sample,249236,247430,12317,235113,33773,201340,141855,12245,30482,2592,172337,14166,6622,2438,19617,23576
GGCGTACCTTGCGGAC,sample,205358,203631,15279,188352,17809,170543,92800,6779,44951,5779,137751,20234,7364,2007,15917,12858
GTCGCGAATTGCGGAC,sample,199965,198425,9495,188930,19654,169276,102423,8506,39121,4532,141544,14694,6513,2602,18833,13220
CGTCGAGGTTGCGGAC,sample,243849,241937,17836,224101,28468,195633,114790,9698,42025,3996,156815,25124,9089,3031,25284,19661
AAGTAGAGTTGCGGAC,sample,36628,36339,2198,34141,5052,29089,19570,1267,5293,575,24863,2384,2785,1293,6287,3534
TCAATCAGTTGCGGAC,sample,290191,288405,19412,268993,24383,244610,121895,8476,75301,11158,197196,27780,9499,2669,15854,15141
GGAGAAGCTCCATTGG,sample,118204,116595,11216,105379,13715,91664,54772,3669,19682,2482,74454,11059,5423,1970,14256,10138
GAGCCTCCTCCATTGG,sample,35790,35419,2764,32655,13262,19393,12503,630,3703,362,16206,2195,2454,1083,5147,7024
CTAGCGACTCCATTGG,sample,106780,105290,11738,93552,15741,77811,43308,2891,18002,2258,61310,11352,5622,1579,15240,10955
TCATACCATCCATTGG,sample,85601,84353,10815,73538,11112,62426,35188,2087,14072,1814,49260,9265,5636,1849,11269,7591
TGGATCAATCCATTGG,sample,45058,44525,4338,40187,8803,31384,20430,1274,5614,699,26044,3367,3063,1497,7606,5620
ATGGCGTTTCCATTGG,sample,41201,40563,4581,35982,6572,29410,16877,959,5998,678,22875,4898,3627,1416,5348,4379
ACGCTTAATCCATTGG,sample,138475,137096,13567,123529,16931,106598,58237,4105,25430,2758,83667,16068,7634,2195,17782,12077
TAGCGAGTTCCATTGG,sample,142737,141530,8597,132933,16063,116870,73138,4116,26070,3377,99208,10169,4478,1768,19938,11616
AAGGTCTGTCCATTGG,sample,97752,96852,9111,87741,14371,73370,48460,3608,11927,1162,60387,8213,5197,1835,11205,9912
CCTAGCGGTCCATTGG,sample,89886,88957,9744,79213,10001,69212,34300,2186,19571,1870,53871,11285,5844,1582,8867,6388
GGCGACGATCCATTGG,sample,153371,151730,15205,136525,17757,118768,56465,3965,31129,3318,87594,23891,9497,2762,11014,11366
GCTGCTTCTCCATTGG,sample,123429,122663,8008,114655,26766,87889,51154,4192,18206,1505,69360,12832,7036,2265,14495,18008
TGCGCTCCTCCATTGG,sample,183478,182308,11554,170754,24720,146034,89613,7314,26162,2482,115775,20463,7111,2043,26382,17480
GGCGTACCTCCATTGG,sample,124488,123750,6273,117477,14500,102977,69489,4489,18534,2494,88023,7971,5235,2319,13465,10493
TTATGACGTCCATTGG,sample,157234,156374,8124,148250,22730,125520,82124,6471,22274,2782,104398,11869,5536,1929,20801,14648
TCTCCTAGTCCATTGG,sample,65255,64907,3665,61242,10390,50852,29305,2175,12345,1127,41650,5900,4476,1392,8840,7032
GACTAACCTCCATTGG,Neg_Ctrl,889,634,178,456,82,374,211,11,94,5,305,53,217,107,52,34
CTAGCGACCATAGGCG,sample,170104,168380,9623,158757,24107,134650,99055,6400,20004,2189,119059,7002,4754,3021,22952,17369
ATTCAAGGCATAGGCG,sample,87323,86204,8997,77207,9564,67643,33884,2441,19985,2391,53869,8942,5125,1793,11723,5959
TGATTCCGCATAGGCG,sample,142662,141067,12197,128870,22321,106549,73009,5248,17239,2180,90248,8873,5327,2439,20913,15726
GACTCAAGCATAGGCG,sample,120183,119144,6400,112744,26261,86483,69917,4259,8282,764,78199,3261,2388,1792,26332,18455
ATACGTTCCATAGGCG,sample,78049,77130,6638,70492,14894,55598,36156,2529,9964,1137,46120,5812,4841,2727,10316,9968
CCGCAGTCCATAGGCG,sample,106947,105752,8228,97524,14288,83236,49824,3881,19778,2268,69602,7485,5147,2200,13177,10437
GGCAGGTTCATAGGCG,sample,54777,53746,9226,44520,6322,38198,11647,749,13497,1421,25144,10884,6162,1157,3505,3758
CATTCGGTCATAGGCG,sample,261562,259464,21366,238098,29876,208222,115213,9611,47633,4695,162846,31070,10760,3336,24154,21030
TAGCGAGTCATAGGCG,sample,204780,203434,10877,192557,37770,154787,110387,7976,23343,2643,133730,10438,4954,2838,26719,26824
GCTCTTCTCATAGGCG,sample,7537,7480,269,7211,1488,5723,4624,424,437,74,5061,164,1200,1157,896,1035
GAGATTCTCATAGGCG,sample,260539,258953,9750,249203,46180,203023,169275,11846,17244,1392,186519,3266,2336,1874,45128,34067
GCCTATTCCATAGGCG,sample,303275,300723,27463,273260,35806,237454,109578,7409,67158,6981,176736,46328,10877,2356,31407,21727
CAGCTTCGCATAGGCG,sample,181361,180303,11383,168920,31946,136974,89441,6224,24624,2454,114065,14231,6857,2206,24206,23367
CGCGGTCGCATAGGCG,sample,171123,169884,11328,158556,23371,135185,76590,5238,31971,3784,108561,17602,7682,2135,19931,15127
GACTAACCCATAGGCG,sample,221294,220118,8839,211279,48164,163115,128801,10742,15955,1309,144756,6308,3848,2468,33917,33764
CCTAACTACATAGGCG,sample,288296,286759,17328,269431,49477,219954,145050,9370,37239,3718,182289,24577,6897,2172,52070,35742
ATATGCAACATAGGCG,sample,257715,256360,10740,245620,45146,200474,152506,9781,24131,3467,176637,10589,5447,2248,46474,31895
CTGGTCTTTTGGAGAG,Pos_Ctrl,105742,103619,11198,92421,4902,87519,73756,6227,5191,672,78947,1673,7365,9252,6473,2853
AGAGTTCTTTGGAGAG,sample,130908,129757,9997,119760,25189,94571,60472,4350,20293,2279,80765,7177,4995,2726,16390,17419
CATAATGGTTGGAGAG,sample,149145,147791,8104,139687,22301,117386,76380,4329,26409,2651,102789,7617,4212,2161,19275,16340
GAGCCTCCTTGGAGAG,sample,125926,124659,8398,116261,22221,94040,68231,4203,12988,1492,81219,7126,5049,2474,22188,16080
CATACTCCTTGGAGAG,sample,50251,49587,3401,46186,7432,38754,24255,1788,8024,1021,32279,3666,4135,2485,5273,5247
TCATACCATTGGAGAG,sample,284937,283144,9790,273354,56311,217043,180679,10736,19861,1731,200540,4036,2273,1493,49969,41563
TGATTCCGTTGGAGAG,Pos_Ctrl,32799,32144,3895,28249,1475,26774,22266,1925,1810,237,24076,536,5307,5202,1839,755
ATACGTTCTTGGAGAG,sample,162863,161026,15115,145911,19104,126807,73752,4970,29920,3938,103672,14227,7688,3309,13462,12236
CCGCAGTCTTGGAGAG,sample,79122,77939,7888,70051,13423,56628,33942,2119,11816,1350,45758,7401,5406,1940,10608,9134
TGGATCAATTGGAGAG,sample,158325,156013,20624,135389,18831,116558,48910,3005,34087,3445,82997,27111,9881,1871,16552,12833
GATGCGTTTTGGAGAG,sample,69529,68195,11207,56988,9048,47940,17994,1098,14844,1526,32838,12478,6435,1416,6727,5263
ACGCTTAATTGGAGAG,sample,240190,238451,10981,227470,46225,181245,147381,9792,16662,868,164043,6542,3002,1985,42532,34454
TAGCGAGTTTGGAGAG,sample,122569,121604,5317,116287,16808,99479,71787,5471,15319,1743,87106,5159,3966,2972,13041,12345
GCTCTTCTTTGGAGAG,sample,99018,98062,8346,89716,14682,75034,41739,2289,17845,2289,59584,10872,6349,1802,15070,10024
GCTGCTTCTTGGAGAG,sample,248634,246975,11132,235843,41021,194822,147732,9202,23976,2533,171708,11379,6185,2731,41574,29885
AGCAGAGCTTGGAGAG,sample,128331,126876,12619,114257,21976,92281,47858,2447,24538,2658,72396,14780,7542,1952,15226,14340
TGCGCTCCTTGGAGAG,sample,224423,221067,28925,192142,22651,169491,74543,5224,46604,5269,121147,37851,12068,3527,16185,13813
ATACCGCCTTGGAGAG,sample,67560,66862,5522,61340,11950,49390,29401,2103,11439,1470,40840,4977,4750,1897,8601,8287
CGCGGTCGTTGGAGAG,sample,175769,174099,12658,161441,21942,139499,91307,6558,23198,2696,114505,15740,6299,2043,26776,14661
ATGAATAGTTGGAGAG,sample,295061,291888,24515,267373,21776,245597,117856,9463,75916,10719,193772,31643,8749,2697,16092,15227
CGCGAGACTTGGAGAG,sample,205806,204423,9406,195017,28864,166153,114523,9882,28257,3039,142780,10452,4460,1764,28168,20652
CGTAGAACTTGGAGAG,sample,233807,231431,18415,213016,24580,188436,109516,7501,43437,4661,152953,23321,8935,2776,20652,17223
GCGCAATATTGGAGAG,sample,243990,242471,9309,233162,48075,185087,137831,10225,24848,2764,162679,9419,5522,2735,30065,33852
TCTAGGTTTTCAAGCC,sample,283672,281573,14722,266851,49939,216912,171356,11743,19634,2477,190990,11702,4848,3002,34502,35877
AGCTGAATTTCAAGCC,sample,125824,124356,11152,113204,17097,96107,55511,3128,23631,2498,79142,11339,6058,2653,13030,12368
GACGTATGTTCAAGCC,sample,111547,109903,10185,99718,12875,86843,47833,3233,23702,2960,71535,9115,5425,2247,12222,8901
GGAGAAGCTTCAAGCC,sample,75608,74742,5218,69524,13658,55866,43018,3159,6518,548,49536,2623,3638,2554,10220,9759
GGTAGAGATTCAAGCC,sample,112034,110872,6456,104416,13184,91232,54852,3323,23170,2731,78022,7156,4536,2392,13054,9570
ATTCAAGGTTCAAGCC,sample,117331,116105,9379,106726,14349,92377,55838,2874,21290,2361,77128,10014,5120,1857,17249,9505
GCAACTAGTTCAAGCC,sample,72442,71933,3866,68067,11810,56257,36979,3137,10080,1224,47059,4837,4081,2061,9432,8995
TCTCAGGATTCAAGCC,sample,230420,227167,46061,181106,19160,161946,42033,2654,60084,6681,102117,50494,14996,3250,10845,10558
GGCAGGTTTTCAAGCC,sample,149823,148377,12757,135620,21156,114464,68765,5030,24109,2259,92874,14301,6280,2040,19815,14674
ATGGCGTTTTCAAGCC,sample,11648,11577,1033,10544,3673,6871,3723,217,1581,172,5304,1178,1702,864,791,1992
TGCGCGTTTTCAAGCC,sample,238963,236053,21726,214327,20895,193432,122614,7576,38921,4542,161535,19779,7098,3589,14870,15068
GCTCTTCTTTCAAGCC,sample,85154,84122,9594,74528,9639,64889,28864,1837,21060,2570,49924,10558,6199,2108,3868,5891
GGCGACGATTCAAGCC,sample,157149,154837,20617,134220,14836,119384,56457,3709,33614,3450,90071,22154,9132,2474,11869,8762
TAACGAAGTTCAAGCC,sample,220523,217577,30828,186749,21938,164811,72312,4341,50169,4775,122481,33214,11293,2608,18130,12855
GCTGCTTCTTCAAGCC,sample,104450,103695,5590,98105,19575,78530,55425,4114,12745,1215,68170,5031,3807,2076,13914,13138
TGCGCTCCTTCAAGCC,sample,137089,136084,7847,128237,24112,104125,74273,6558,14103,1449,88376,7742,4880,2236,16450,16358
CGTCGAGGTTCAAGCC,Pos_Ctrl,43913,42816,4997,37819,1759,36060,30174,2660,2289,292,32463,645,5771,6314,1979,847
CGCGGTCGTTCAAGCC,sample,75177,74646,5429,69217,6697,62520,33886,2273,17563,1883,51449,6915,5230,2401,5530,4326
TCAATCAGTTCAAGCC,sample,192177,191021,8424,182597,33079,149518,112897,9065,17295,2156,130192,8105,4194,1770,28714,23593
TAACGCCATTCAAGCC,sample,49428,48869,3318,45551,7521,38030,25956,1979,6456,729,32412,2910,2948,1435,7828,5305
GACTAACCTTCAAGCC,sample,194927,192862,18577,174285,21851,152434,81552,6394,34676,3729,116228,26083,9755,2238,17510,14511
TCTAGGTTAACTTAAC,sample,205750,204496,7548,196948,45205,151743,121917,6944,15510,1693,137427,5679,2342,1571,43263,33186
GTCGTTCTAACTTAAC,Neg_Ctrl,1069,721,327,394,57,337,189,16,77,6,266,49,164,88,43,34
GGAGAAGCAACTTAAC,sample,129877,128232,14183,114049,17482,96567,49426,2975,24086,2550,73512,17530,7586,2385,14404,12264
TCGAACGAAACTTAAC,sample,132900,131301,12577,118724,23114,95610,58029,4656,18825,2228,76854,11872,6503,2592,16033,15441
GGTAGAGAAACTTAAC,sample,181512,178836,21510,157326,22950,134376,70625,3984,32114,3594,102739,24059,9842,2545,20721,15614
GCAACTAGAACTTAAC,Neg_Ctrl,758,485,193,292,51,241,119,6,50,7,169,59,119,63,30,25
TGGATCAAAACTTAAC,sample,149318,147994,7919,140075,24402,115673,87949,6113,13562,1524,101511,6525,3187,1617,25979,17755
GATGCGTTAACTTAAC,sample,240218,238791,11921,226870,37109,189761,138285,9089,23772,2890,162057,15725,5180,1934,38871,26376
CTAAGCATAACTTAAC,sample,169200,167644,14836,152808,24193,128615,64285,4574,37004,3658,101289,19094,8568,2374,17722,17401
AGCAGAGCAACTTAAC,sample,96079,95272,6033,89239,15409,73830,43738,2190,17401,2185,61139,8316,5010,1783,8539,10749
ATACCGCCAACTTAAC,sample,57665,57339,3671,53668,10786,42882,26521,2019,8712,1109,35233,4521,4367,1605,7715,7440
ATGAATAGAACTTAAC,sample,347111,345111,25522,319589,28410,291179,139010,12067,94935,11787,233945,33380,11781,3928,15082,19363
ATTCTACCAACTTAAC,sample,120025,119476,4914,114562,18120,96442,61899,4803,18372,2680,80271,8688,4822,1842,13908,12595
GACTAACCAACTTAAC,sample,88874,88512,3816,84696,15271,69425,46046,3951,12405,1357,58451,5666,4426,1510,11868,11260
AGATACTAAACTTAAC,sample,109209,108767,4120,104647,17814,86833,53984,5281,18408,1945,72392,7215,4742,2118,9047,13094
TCTAGGTTATACTTGA,sample,13076,13015,421,12594,3909,8685,6521,730,1002,106,7523,326,1676,1474,1222,2470
CTGGTCTTATACTTGA,sample,222949,221335,14827,206508,40360,166148,110072,7899,28023,3337,138095,16817,7711,3327,25266,28926
AGCTGAATATACTTGA,sample,224025,221392,24810,196582,29108,167474,79742,5934,45865,5128,125607,30805,9948,2294,31000,18656
CTAGCGACATACTTGA,sample,220770,217283,28642,188641,22321,166320,70127,4574,51444,5855,121571,34320,10363,2374,25524,14386
GGTAGAGAATACTTGA,sample,245436,243873,14132,229741,41238,188503,133749,10639,22665,2672,156414,18778,5826,2341,38857,29161
ATTCAAGGATACTTGA,sample,147459,146162,12666,133496,15976,117520,62236,3968,33937,3979,96173,13400,6626,2476,12520,11328
TACGCGAGATACTTGA,sample,162514,160899,14658,146241,26174,120067,73829,4295,24420,2791,98249,14732,6225,1921,24827,18574
GACTCAAGATACTTGA,sample,114483,113490,9213,104277,16742,87535,54936,4189,16612,2014,71548,9784,5801,2089,16208,12167
TCTCAGGAATACTTGA,sample,44880,44118,8120,35998,4429,31569,11916,713,10647,1139,22563,7154,5717,1823,2878,2547
GATGCGTTATACTTGA,sample,422781,419093,42220,376873,34912,341961,188395,9404,84117,9611,272512,50434,11863,2951,25233,25681
TGCGCGTTATACTTGA,sample,161569,160248,8464,151784,19837,131947,78690,6093,30951,3288,109641,12925,5536,2303,18823,14210
AGCGTCTTATACTTGA,sample,247751,245632,16415,229217,41960,187257,125319,6646,30447,3411,155766,21434,7148,2311,39355,30017
CGGTTGGTATACTTGA,sample,182472,181199,11449,169750,32919,136831,94208,6496,22062,2328,116270,11737,5614,1985,27376,23548
CCTAGCGGATACTTGA,sample,26457,26115,2106,24009,3284,20725,12537,774,4488,507,17025,2419,2634,1034,5335,2238
TAACGAAGATACTTGA,sample,95482,94762,7124,87638,11754,75884,43516,3335,18579,2153,62095,8301,4818,1843,13161,8385
ATACCGCCATACTTGA,sample,115610,114426,9308,105118,12621,92497,54570,3552,21644,2493,76214,10238,6239,2449,13110,8555
GCGTTACCATACTTGA,sample,124051,123253,4074,119179,26097,93082,78042,6076,6369,1041,84411,1554,1734,1511,23455,18607
GGCGTACCATACTTGA,sample,101378,100425,7579,92846,13470,79376,49455,3352,16007,1712,65462,8850,6282,2299,9312,9009
CAGCTTCGATACTTGA,Neg_Ctrl,1033,633,245,388,76,312,191,6,68,5,259,42,189,101,38,30
TCTCCTAGATACTTGA,sample,190145,188863,8863,180000,25836,154164,110266,9354,21730,2840,131996,9974,5521,2237,29258,19301
AAGTAGAGATACTTGA,sample,202402,200888,13665,187223,32257,154966,108029,4814,24075,2944,132104,15104,5602,1897,30262,22501
ATTCTACCATACTTGA,sample,114755,113630,8241,105389,10149,95240,58144,4049,21775,2380,79919,8892,6040,3179,7094,7066
GACTAACCATACTTGA,sample,74878,74281,6307,67974,12499,55475,32671,2537,11161,1157,43832,7949,5259,1696,8718,8737
CGCGAGACATACTTGA,sample,229514,227177,21018,206159,25865,180294,97444,6859,43894,4636,141338,27461,9332,2293,24625,18029
CGTAGAACATACTTGA,sample,197200,195581,11174,184407,29490,154917,109428,7756,24000,2743,133428,10990,6994,3155,20353,20557
CCTAACTAATACTTGA,sample,193150,191692,10080,181612,19758,161854,104053,8063,34300,3844,138353,11594,4973,2352,20265,14243
GCGCAATAATACTTGA,sample,182155,180827,8390,172437,27315,145122,106245,7211,19005,1704,125250,10957,4125,1989,24542,20491
ATATGCAAATACTTGA,sample,214752,213483,12192,201291,33868,167423,105194,7917,31844,3408,137038,19060,7943,2462,22697,24108
TCTAGGTTATCCGCGA,sample,224994,223638,12897,210741,29522,181219,111074,7667,41071,5954,152145,15453,5859,2577,24580,22018
CTAGCGACATCCGCGA,sample,235725,229769,55889,173880,23510,150370,38863,2309,55206,5871,94069,48121,14756,2402,13075,13127
TCATACCAATCCGCGA,sample,178914,176481,23241,153240,21851,131389,55509,3120,40859,4841,96368,27060,8645,1906,17120,13611
GCAACTAGATCCGCGA,sample,96634,95958,4009,91949,11192,80757,53115,3759,16180,2039,69295,5664,3841,2253,8463,8431
CCGCAGTCATCCGCGA,sample,163735,161136,19880,141256,17454,123802,58330,3651,34763,3307,93093,23751,8199,2114,16789,11290
TCTCAGGAATCCGCGA,sample,156301,154991,8087,146904,29855,117049,89320,5684,13526,1706,102846,6813,2879,1746,30314,22695
GGCAGGTTATCCGCGA,sample,186454,184707,11231,173476,28879,144597,108614,6479,17646,1989,126260,9869,4565,1796,36076,22181
GATGCGTTATCCGCGA,sample,159485,157862,15282,142580,19478,123102,62489,4871,35223,4236,97712,16283,6788,2242,16205,12962
AGCGTCTTATCCGCGA,sample,186066,184226,16178,168048,24256,143792,85746,5320,34740,3851,120486,14135,5609,2073,20173,16780
GCCTATTCATCCGCGA,sample,254182,251050,28762,222288,30573,191715,102876,7022,46700,4757,149576,30360,9677,2713,25641,21050
TGCGCTCCATCCGCGA,sample,223743,221575,17733,203842,23508,180334,112509,8456,36328,5304,148837,17737,8547,3042,19081,16951
GCGTTACCATCCGCGA,sample,206974,204700,24129,180571,28032,152539,76299,5321,38885,3910,115184,28124,10041,2178,25798,18533
TTATGACGATCCGCGA,sample,248474,246959,8161,238798,41218,197580,160018,13126,16074,1868,176092,6494,3571,2179,31741,30723
ATGAATAGATCCGCGA,sample,233358,231609,16831,214778,30649,184129,114162,7729,36377,4340,150539,21521,8409,2429,18570,21524
ATTCTACCATCCGCGA,sample,295340,293507,20030,273477,37797,235680,143353,13457,45141,4387,188494,29342,10018,2648,34095,27833
CGTAGAACATCCGCGA,sample,204218,202587,19691,182896,23169,159727,76487,5470,43273,5052,119760,29445,10660,2406,19183,15860
AGATACTAATCCGCGA,sample,103768,103124,8283,94841,19471,75370,48545,2941,14479,1738,63024,7667,5033,1712,12343,12805
ATATGCAAATCCGCGA,sample,118014,117525,4607,112918,26541,86377,62004,5340,11647,1253,73651,6133,4438,1588,16690,15902
TCTAGGTTAGGACTCA,sample,219793,218163,13370,204793,42672,162121,107280,7284,29508,3170,136788,14879,6549,2466,30682,30413
CTGGTCTTAGGACTCA,sample,248524,246252,11921,234331,30581,203750,125189,7621,49746,6208,174935,14986,5826,2354,28758,20639
AGAGTTCTAGGACTCA,sample,213755,211007,17265,193742,30888,162854,103250,6420,30787,3029,134037,19368,7373,2317,33505,21578
GAGCCTCCAGGACTCA,sample,185840,183698,18261,165437,28933,136504,75496,6328,32671,2885,108167,19124,7472,2288,23224,19465
GGTAGAGAAGGACTCA,sample,161496,159447,13667,145780,12777,133003,61892,3256,44963,5078,106855,17814,6327,2036,13823,8911
GCAACTAGAGGACTCA,sample,114311,113547,6400,107147,12877,94270,50578,3420,26945,2681,77523,10646,6045,2035,12924,8965
CCGTACGCAGGACTCA,sample,113656,112592,6335,106257,20005,86252,61255,3816,13897,1914,75152,5370,4544,2273,18885,14171
TGGATCAAAGGACTCA,sample,192100,190002,17659,172343,22132,150211,88145,5976,33387,3688,121532,19015,7431,1992,30606,16312
GGCAGGTTAGGACTCA,sample,42231,41656,5032,36624,5227,31397,14794,1013,8928,985,23722,5677,4226,1333,4655,3227
ATGGCGTTAGGACTCA,sample,92371,90726,13480,77246,9507,67739,28737,1708,20782,2278,49519,14234,7338,1658,9325,5608
GCTCTTCTAGGACTCA,sample,185740,183817,16138,167679,25201,142478,83233,6314,33231,3310,116464,16390,7255,2404,21362,18379
CTAAGCATAGGACTCA,sample,243683,240988,23053,217935,35545,182390,105750,5962,41569,6312,147319,22797,8910,2344,31604,24221
AGCAGAGCAGGACTCA,sample,260105,258404,10945,247459,30902,216557,124182,10692,53332,8167,177514,20184,6805,2073,17797,21958
GCGTTACCAGGACTCA,sample,191796,189882,15776,174106,19737,154369,79144,6760,36742,3860,115886,27863,7384,1933,20852,14032
GTCGCGAAAGGACTCA,sample,281449,279404,15188,264216,35037,229179,162341,9584,33128,4498,195469,19628,7057,2166,42605,26034
AAGTAGAGAGGACTCA,sample,261635,258932,27822,231110,23711,207399,88744,5688,67468,8264,156212,37235,10815,2717,12054,13584
TAACGCCAAGGACTCA,sample,235235,233811,9853,223958,35861,188097,130759,11458,27028,3715,157787,15137,6573,2350,31763,26032
CCTAACTAAGGACTCA,Pos_Ctrl,48627,48063,3499,44564,2124,42440,35915,3294,2226,319,38141,686,5974,6964,2478,1018
GACGTATGTATTGAAC,sample,72822,72083,7270,64813,11215,53598,33031,2230,10729,1200,43760,6408,5134,1898,9657,7927
GGAGAAGCTATTGAAC,sample,208554,206719,12294,194425,35553,158872,109670,7485,25959,3108,135629,12650,7054,3328,20716,26134
TCGAACGATATTGAAC,sample,187395,184688,19744,164944,19331,145613,68774,4355,42093,4966,110867,25425,9644,2238,20147,13673
GGTAGAGATATTGAAC,sample,122970,121770,11165,110605,18002,92603,53201,3858,21371,2070,74572,12103,6204,2143,17303,12723
ATTCAAGGTATTGAAC,sample,240205,237430,24447,212983,17272,195711,89071,5661,67873,7387,156944,25719,8520,2535,16039,10861
CCGCAGTCTATTGAAC,sample,86925,86182,4805,81377,15532,65845,49247,4063,7985,816,57232,3734,3593,2336,10879,11358
TGCGCGTTTATTGAAC,sample,160097,158323,14868,143455,16527,126928,73349,4741,28259,3767,101608,16812,8476,3139,14827,10433
CGGTTGGTTATTGAAC,sample,104162,103400,4427,98973,27600,71373,57660,4124,6338,740,63998,2511,2977,2307,14308,18949
TAGCGAGTTATTGAAC,sample,163505,162213,13109,149104,24699,124405,76030,5159,25864,3393,101894,13959,6399,1849,25779,18337
CTAACCGGTATTGAAC,sample,126695,125620,7507,118113,15114,102999,62078,4242,25605,2694,87683,8380,4781,1752,13466,11020
GTCGCGAATATTGAAC,sample,158054,156858,9071,147787,18736,129051,81573,5367,25728,2276,107301,14107,6257,1618,24634,12388
CGTCGAGGTATTGAAC,sample,227749,226522,7244,219278,36629,182649,148629,11817,14742,1239,163371,6222,4644,2675,29605,27342
CGCGGTCGTATTGAAC,sample,91882,90944,7953,82991,8104,74887,38991,2199,20561,2782,59552,10354,5602,1732,11133,5137
ATTCTACCTATTGAAC,sample,143688,142556,7361,135195,12079,123116,78990,6009,24497,3602,103487,10018,5097,1833,17343,8002
CCTAACTATATTGAAC,sample,129889,128937,7640,121297,16375,104922,70992,5974,17746,2054,88738,8156,4926,2123,16871,11971
GTCGTTCTGTTCAACT,sample,177734,174362,23150,151212,11574,139638,49436,2958,48048,4905,97484,34291,12297,2865,11416,6339
AGAGTTCTGTTCAACT,sample,94955,94031,5356,88675,12547,76128,53672,2991,12013,1584,65685,5868,4281,1560,15539,8853
AGCTGAATGTTCAACT,sample,114880,113616,6680,106936,12191,94745,66823,5345,13432,1783,80255,7362,5112,2154,13533,9029
GAGCCTCCGTTCAACT,sample,74162,73193,6181,67012,6633,60379,32097,2462,15026,1401,47123,9393,5238,1285,9628,4618
CATACTCCGTTCAACT,sample,132236,130733,9003,121730,11642,110088,68984,4699,24565,2566,93549,9274,5972,2721,11522,8179
TCATCGAAGTTCAACT,sample,114257,112861,10055,102806,10680,92126,53768,3216,19970,2226,73738,12946,6545,1768,13590,6909
ATTCAAGGGTTCAACT,sample,94705,93675,6553,87122,9463,77659,50463,3985,13534,1541,63997,8136,4877,1723,12822,6585
CCGCAGTCGTTCAACT,sample,58102,57527,4109,53418,9814,43604,30463,2362,6932,654,37395,3193,3001,1356,10540,7072
TCTCAGGAGTTCAACT,sample,66941,66186,5012,61174,11525,49649,32185,2151,9099,827,41284,5387,3948,1929,7749,7919
TGGATCAAGTTCAACT,sample,85727,85091,3730,81361,9788,71573,46560,2661,15369,2417,61929,4566,2920,2197,9111,7715
GGCAGGTTGTTCAACT,sample,17930,17524,3511,14013,1935,12078,3741,237,4409,455,8150,3236,2971,724,1099,1131
CGGTTGGTGTTCAACT,sample,41733,41286,3287,37999,7970,30029,19954,1341,5164,510,25118,3060,2955,1690,6170,5465
ACGCTTAAGTTCAACT,sample,65606,64905,4420,60485,11267,49218,33975,2524,7409,780,41384,4530,4000,2049,8430,8150
CATTCGGTGTTCAACT,sample,94628,93605,7524,86081,10716,75365,38633,2775,22211,2283,60844,9463,5441,2051,9131,7800
TAGCGAGTGTTCAACT,sample,36119,35680,3707,31973,6275,25698,15250,1005,5202,490,20452,3751,3075,1139,5352,4191
TAACGAAGGTTCAACT,sample,26609,26294,3248,23046,3577,19469,9958,610,5112,550,15070,3239,3461,1350,2722,2182
TGCGCTCCGTTCAACT,sample,66071,65441,4167,61274,11476,49798,36565,2586,6847,788,43412,3012,3408,2145,8025,8376
GCGTTACCGTTCAACT,sample,63713,63195,5305,57890,11072,46818,34029,1923,6125,675,40154,4066,2820,1399,12937,7963
GGCGTACCGTTCAACT,sample,44600,44136,3367,40769,7183,33586,21881,1464,6054,893,27935,3294,3024,1448,7602,5236
GTCGCGAAGTTCAACT,sample,41778,41229,4560,36669,5305,31364,18065,1003,7489,874,25554,3933,3836,1433,5858,3691
CAGCTTCGGTTCAACT,sample,56102,55422,4554,50868,10065,40803,24657,1791,7828,758,32485,5769,3337,1426,7408,6671
TTATGACGGTTCAACT,sample,72732,72019,6137,65882,8266,57616,32093,2773,13369,1336,45462,8045,5500,1869,6186,5928
ATGAATAGGTTCAACT,sample,61275,60759,3558,57201,7905,49296,34336,2592,7185,789,41521,4394,3538,1591,6787,5442
TCAATCAGGTTCAACT,sample,62262,61394,8538,52856,4460,48396,17457,1323,16008,1841,33465,11767,6887,1214,3603,2681
TAACGCCAGTTCAACT,sample,105704,104657,8411,96246,8605,87641,48597,3109,21178,2865,69775,11892,5890,1923,8565,5311
GACTAACCGTTCAACT,sample,53254,52826,2774,50052,5691,44361,30494,2406,6650,779,37144,4032,3448,1532,6484,4067
GCGCAATAGTTCAACT,Neg_Ctrl,502,403,112,291,37,254,134,15,46,4,180,55,113,74,41,19
AACCGGTTCTGAGGTT,sample,192455,190318,16195,174123,19800,154323,83101,5988,39619,4041,122720,21574,8310,2797,15403,13642
TATACGGACTGAGGTT,sample,219170,216148,24440,191708,26728,164980,80359,5290,45384,5299,125743,28648,9144,2330,25388,17603
CATACTCCCTGAGGTT,sample,220104,218062,10544,207518,22196,185322,120499,8761,39562,4278,160061,12222,5717,2997,22762,17327
TCATACCACTGAGGTT,sample,385968,381040,42306,338734,33539,305195,142054,10802,84914,7865,226968,59560,12616,3146,35192,21546
ATTCAAGGCTGAGGTT,sample,355064,350927,32244,318683,24478,294205,145054,9002,90442,9953,235496,39754,11132,3832,16607,15798
GCAACTAGCTGAGGTT,sample,138707,137584,9619,127965,16195,111770,66166,3992,23750,2272,89916,15590,7054,2484,12335,10986
ATACGTTCCTGAGGTT,sample,184561,182769,14178,168591,20565,148026,80287,6960,35026,3633,115313,22120,7453,1740,25902,14062
CCGTACGCCTGAGGTT,sample,154148,152592,11505,141087,29005,112082,63785,4379,25281,4060,89066,14577,4444,1646,20786,19670
GGCAGGTTCTGAGGTT,sample,150587,149199,10887,138312,20720,117592,70986,4311,24724,3232,95710,14339,6394,2120,26877,15051
GATGCGTTCTGAGGTT,sample,112626,111691,9511,102180,23113,79067,47591,3081,16393,1880,63984,10122,6166,2654,15089,15655
TGCGCGTTCTGAGGTT,sample,148313,147050,9353,137697,35029,102668,59409,3799,23766,2807,83175,12887,6881,2717,11986,22289
CCATTCTTCTGAGGTT,sample,112422,111233,7128,104105,20147,83958,57808,3856,13072,1528,70880,7694,4505,2014,20067,14633
CGGTTGGTCTGAGGTT,sample,250777,248070,20013,228057,29988,198069,115975,7186,44982,4780,160957,25146,8220,2913,26469,20004
TAGCGAGTCTGAGGTT,sample,197669,196271,12489,183782,34973,148809,91654,7020,32464,4371,124118,13300,5744,2416,21803,24880
GCTCTTCTCTGAGGTT,sample,184736,183203,15851,167352,31059,136293,75425,6099,31670,3338,107095,19761,7077,2106,21825,21820
CTAAGCATCTGAGGTT,sample,133540,132363,10885,121478,11671,109807,50883,3602,37279,4469,88162,13574,7200,3039,8078,7763
GGCGACGACTGAGGTT,sample,105408,103902,11017,92885,14495,78390,38525,2328,20427,2169,58952,14941,7819,2466,9895,9775
GCTGCTTCCTGAGGTT,sample,165215,163982,9451,154531,27523,127008,90212,5962,20107,2429,110319,8298,5303,2642,29517,20638
ATACCGCCCTGAGGTT,sample,164876,163814,10395,153419,26240,127179,90733,6209,17654,2177,108387,10406,5319,1871,32046,18351
GTCGCGAACTGAGGTT,sample,161924,160771,12136,148635,22793,125842,70466,5460,28895,3059,99361,17962,8217,2339,23026,14887
CGCGGTCGCTGAGGTT,sample,118306,117576,5678,111898,19270,92628,55800,6104,18316,2183,74116,10225,5272,1504,16940,13847
ATGAATAGCTGAGGTT,sample,111054,110593,2997,107596,19251,88345,61023,7589,13413,1272,74436,5048,2895,1651,11019,14117
AACCGGTTAGACCGTT,sample,199503,197814,12965,184849,23011,161838,87219,5479,42611,4881,129830,21648,7132,2084,25496,15924
GTCGTTCTAGACCGTT,sample,168732,166448,17518,148930,18469,130461,70666,5131,31066,3448,101732,20150,8114,2170,20696,12119
AGCTGAATAGACCGTT,sample,344885,341546,20265,321281,31948,289333,173913,15409,66127,8617,240040,25267,8357,3184,35173,22047
TCATACCAAGACCGTT,sample,133854,132319,12669,119650,18734,100916,63312,4581,19429,2351,82741,11243,7074,2714,19634,12493
TGATTCCGAGACCGTT,sample,199887,197656,17386,180270,37930,142340,77781,5348,32814,3749,110595,22648,8807,2832,19581,24496
CCTAGCGGAGACCGTT,sample,58916,58407,3766,54641,12248,42393,30265,2035,6180,670,36445,3243,2945,1715,8558,8745
GTCGCGAAAGACCGTT,sample,62136,61755,2726,59029,7783,51246,32894,3339,10289,1328,43183,3396,3323,1853,5808,5508
CGCGGTCGAGACCGTT,sample,143237,142270,10748,131522,18169,113353,36492,3211,38502,4122,74994,31026,11659,2431,8029,11108
TCAATCAGAGACCGTT,sample,203037,202076,8311,193765,27390,166375,102866,9660,33740,4305,136606,15804,6671,2020,25707,19798
ATTCTACCAGACCGTT,sample,328763,327154,13341,313813,44266,269547,189139,13769,41827,5436,230966,19376,8949,3413,44778,31348
GACTAACCAGACCGTT,sample,221190,219932,7879,212053,35364,176689,131299,10239,23090,2459,154389,9602,4894,1855,34808,25036
CGTAGAACAGACCGTT,sample,191908,191010,9391,181619,27834,153785,113012,9495,19197,1540,132209,10541,6179,2161,36289,20545
GCGCAATAAGACCGTT,sample,153406,152590,6347,146243,20624,125619,88644,7101,19018,1710,107662,9146,5360,1733,21855,13516
AACCGGTTCTTGAGTT,sample,30554,30394,2488,27906,5923,21983,10857,641,5885,697,16742,3903,3906,1181,3862,3756
CATAATGGCTTGAGTT,sample,330446,327531,23815,303716,41877,261839,148634,9966,59286,6783,207920,37170,9845,2833,41357,31918
TCGAACGACTTGAGTT,sample,325808,323223,23091,300132,37313,262819,151011,11193,59442,6804,210453,34369,10436,2633,49055,24231
TCATCGAACTTGAGTT,sample,304732,302768,12660,290108,34339,255769,200756,15895,26076,2427,226832,10615,5546,2331,44359,23837
CCGCAGTCCTTGAGTT,sample,256173,254324,13330,240994,46637,194357,131256,9472,30168,4034,161424,19427,8035,2897,32367,32399
GATGCGTTCTTGAGTT,sample,263559,261792,10333,251459,27224,224235,137927,9265,55677,6632,193604,14734,4476,2481,31378,19934
TGCGCGTTCTTGAGTT,sample,121057,119874,11455,108419,14973,93446,51001,3663,21762,2287,72763,14733,7149,2126,14162,10353
GGCGACGACTTGAGTT,sample,170617,169337,8626,160711,36129,124582,86253,7624,19664,1558,105917,9483,4792,2461,20802,26087
GTCGCGAACTTGAGTT,sample,264694,262892,11863,251029,45431,205598,158664,10455,23824,3136,182488,9519,5203,2966,34782,32854
CGTCGAGGCTTGAGTT,sample,48985,48432,4820,43612,7051,36561,19643,1260,9310,822,28953,5526,4160,1582,6159,4599
GACTAACCCTTGAGTT,sample,72051,71266,8495,62771,7527,55244,25375,1893,14779,1505,40154,11692,5971,1654,4487,4762
CGCGAGACCTTGAGTT,sample,282190,280577,9895,270682,45707,224975,175584,14364,22575,2221,198159,10231,5203,2379,37746,32778
AACCGGTTTCGGAGTT,sample,167551,166128,13102,153026,15909,137117,75064,5160,37280,5101,112344,14512,7189,2755,12230,11476
CTGGTCTTTCGGAGTT,sample,147052,145228,14238,130990,13565,117425,51415,3465,39660,4839,91075,18046,6801,1874,11695,9969
GTCGTTCTTCGGAGTT,sample,49392,48706,4625,44081,5693,38388,19859,1519,10811,983,30670,5216,4093,1421,5372,3827
CATAATGGTCGGAGTT,sample,66406,65437,7826,57611,7793,49818,24903,1419,12850,1365,37753,9281,5453,1249,8753,4931
TATACGGATCGGAGTT,sample,132639,130464,17553,112911,12574,100337,37424,2424,31885,3251,69309,25353,10818,2152,9062,7675
GGTAGAGATCGGAGTT,sample,199213,197421,10711,186710,25354,161356,105717,9424,26577,3566,132294,16072,6284,1883,35834,18136
GCAACTAGTCGGAGTT,sample,39559,39118,2934,36184,4957,31227,17515,1209,7700,911,25215,3892,3602,1513,4463,3481
CCGTACGCTCGGAGTT,sample,109472,108337,10857,97480,16108,81372,48745,3489,15622,2526,64367,10990,5337,1366,14210,9276
AAGGTCTGTCGGAGTT,sample,117427,116625,5857,110768,12820,97948,67365,4567,15719,1976,83084,8321,4879,1734,21899,9334
TAACGAAGTCGGAGTT,sample,88350,87685,4548,83137,12633,70504,48786,3606,11717,1579,60503,4816,4110,2227,12607,9207
GCTGCTTCTCGGAGTT,sample,78187,77466,6475,70991,11412,59579,36837,2274,12291,1301,49128,6876,5148,1932,10688,7667
GCCTATTCTCGGAGTT,sample,130333,129086,10605,118481,16960,101521,59835,3470,20726,2308,80561,15182,7797,2186,19072,12192
CGTCGAGGTCGGAGTT,Pos_Ctrl,32615,32035,2636,29399,1321,28078,23754,2056,1509,201,25263,558,5292,5535,2220,564
CGCGGTCGTCGGAGTT,sample,97327,96670,9908,86762,12527,74235,39610,2413,17813,1929,57423,12470,7065,1707,10462,7163
AGATACTATCGGAGTT,sample,237205,235633,17950,217683,26514,191169,108383,8317,41167,6184,149550,27118,8752,2328,31674,17281
TTAACTGATCGGAGTT,sample,74771,74388,1825,72563,13065,59498,45429,3831,6588,831,52017,2819,2839,1948,10225,9376
ATATGCAATCGGAGTT,sample,108742,108136,5295,102841,15052,87789,60576,4837,12914,1742,73490,7720,4900,1742,14791,10587
CTGGTCTTTGAACCTT,Pos_Ctrl,127731,124405,12898,111507,5240,106267,88641,7982,6635,864,95276,2145,7748,10233,6833,2507
AGAGTTCTTGAACCTT,sample,145917,144883,9685,135198,15544,119654,66827,5480,32893,4413,99720,10041,5493,2267,15508,10936
TATACGGATGAACCTT,sample,301700,299107,20298,278809,23482,255327,88773,5704,84515,11825,173288,64510,7323,2578,16628,16494
GAGCCTCCTGAACCTT,sample,434752,429764,37566,392198,26805,365393,168049,9776,131011,13452,299060,43105,12904,4155,20932,15858
GGTAGAGATGAACCTT,Pos_Ctrl,121561,118465,11558,106907,4501,102406,85637,7450,6492,799,92129,2028,7702,10083,6249,1894
TCATACCATGAACCTT,sample,343076,341074,12620,328454,54085,274369,222353,24616,19151,3250,241504,4999,3003,1741,57323,41649
TACGCGAGTGAACCTT,sample,210590,208995,9606,199389,33683,165706,120649,8626,23859,3661,144508,8911,5313,2287,31746,24425
CCGCAGTCTGAACCTT,sample,168197,166174,19103,147071,17333,129738,53436,4327,39894,4309,93330,27772,9232,2206,17514,11313
GGCAGGTTTGAACCTT,sample,387178,384255,15521,368734,34985,333749,239879,19035,51135,8013,291014,15687,6060,3299,37631,25965
ATGGCGTTTGAACCTT,Pos_Ctrl,158657,156086,13649,142437,5920,136517,114630,10312,8064,1113,122694,2398,7826,11250,7550,2621
CCATTCTTTGAACCTT,sample,188969,186693,12981,173712,17492,156220,85421,7298,41986,6143,127407,15372,6970,2544,16815,11966
AGCGTCTTTGAACCTT,sample,203469,202107,9492,192615,32739,159876,124854,10040,15788,2556,140642,6638,4388,2613,33920,23805
CGGTTGGTTGAACCTT,sample,77979,77290,6307,70983,13114,57869,34236,2571,12147,1460,46383,7455,5038,1782,10761,8651
ACGCTTAATGAACCTT,sample,146355,144872,12122,132750,17320,115430,61690,4046,28945,3571,90635,17178,7754,2115,21616,12293
TAGCGAGTTGAACCTT,sample,176662,174738,18496,156242,19485,136757,57570,3589,40626,4794,98196,30178,8728,2170,15854,12704
CCTAGCGGTGAACCTT,Pos_Ctrl,52622,51594,4548,47046,1984,45062,38011,3436,2521,262,40532,832,6192,7179,2498,842
GCTGCTTCTGAACCTT,sample,191644,190168,11283,178885,27336,151549,116413,7659,16641,1820,133054,9016,5494,3173,21832,21050
GCCTATTCTGAACCTT,sample,100003,99029,6105,92924,11490,81434,51320,3150,17946,2299,69266,6719,4960,2675,10206,8070
GCGTTACCTGAACCTT,sample,200797,199066,16576,182490,26890,155600,87448,7464,34173,4301,121621,22214,8834,2679,24994,19776
TCTCCTAGTGAACCTT,sample,235988,234377,14083,220294,34596,185698,99491,8260,44153,5102,143644,28692,7433,2126,27846,24400
AAGTAGAGTGAACCTT,sample,229234,227389,14440,212949,28638,184311,99171,9120,39792,4674,138963,31554,10925,3193,19008,18891
ATTCTACCTGAACCTT,Pos_Ctrl,91971,90251,7987,82264,3401,78863,65895,6266,4592,628,70487,1482,7125,9381,4009,1167
CGTAGAACTGAACCTT,sample,118809,117838,5755,112083,15904,96179,73189,4812,11035,1048,84224,6095,4907,2320,14471,12176
AGATACTATGAACCTT,sample,391565,388783,22538,366245,34225,332020,219577,17210,52095,6596,271672,36542,9771,2944,41956,22975
CCTAACTATGAACCTT,sample,217781,216244,11778,204466,19440,185026,117086,9591,37485,4911,154571,15953,6201,2471,22464,12526
GCGCAATATGAACCTT,sample,385788,382934,30606,352328,35270,317058,154476,10435,81527,8199,236003,62421,13341,3552,32576,24698
AGAGTTCTACCGAATT,sample,173157,171960,7177,164783,36048,128735,102324,7609,11863,1207,114187,5732,3234,1984,34667,25386
CATAATGGACCGAATT,sample,254962,252638,20136,232502,32146,200356,119940,8964,41987,3765,161927,25700,9549,3122,31114,21398
GGAGAAGCACCGAATT,sample,137398,136316,6724,129592,21110,108482,74673,7116,17321,1643,91994,7729,4406,1713,27979,14807
GGTAGAGAACCGAATT,sample,337214,335482,12976,322506,50831,271675,218435,18806,22990,2630,241425,8814,3909,2388,55832,37681
ATTCAAGGACCGAATT,sample,218027,216940,6425,210515,34074,176441,137680,8906,19312,2432,156992,8111,4230,1834,24166,25636
CCGCAGTCACCGAATT,sample,167916,165682,15216,150466,23471,126995,75372,5132,26961,2952,102333,16578,8440,3388,10505,16814
CCATTCTTACCGAATT,sample,51869,50900,8409,42491,6415,36076,18255,1538,9787,942,28042,5554,4605,1684,4574,5072
AGCGTCTTACCGAATT,sample,170697,169204,12267,156937,28362,128575,84780,6247,23034,2167,107814,12347,6373,2647,23296,19491
CGGTTGGTACCGAATT,sample,176737,175282,9520,165762,31472,134290,101243,6178,17432,1563,118675,7874,4901,2175,31072,22130
ACGCTTAAACCGAATT,sample,245855,243496,14194,229302,26247,203055,145351,10089,28843,3726,174194,15046,6507,3197,20546,20366
CTAACCGGACCGAATT,sample,140351,139266,7587,131679,18215,113464,71197,4878,25042,3092,96239,9255,5110,2301,15953,13967
GGCGACGAACCGAATT,sample,188789,187093,10822,176271,30376,145895,95512,6823,27427,2546,122939,13587,5784,2503,21677,22394
GCCTATTCACCGAATT,sample,121381,120261,7129,113132,14874,98258,58899,4426,24133,2804,83032,7996,5739,3374,10585,11564
TGCGCTCCACCGAATT,sample,208306,205559,21193,184366,23332,161034,71784,3619,43989,4387,115773,37255,11796,2732,21227,16183
ATACCGCCACCGAATT,sample,118769,117473,9168,108305,18943,89362,60079,4210,15649,1497,75728,7927,5362,2481,15850,14092
GCGTTACCACCGAATT,sample,158018,156602,10311,146291,28585,117706,76482,4935,23685,2741,100167,9863,6270,2425,20852,20657
GGCGTACCACCGAATT,sample,127747,126526,11242,115284,18159,97125,59777,4360,19051,2020,78828,11917,6202,2192,17450,12888
CAGCTTCGACCGAATT,Neg_Ctrl,1577,1025,614,411,60,351,209,14,77,6,286,45,205,112,39,16
CGTAGAACACCGAATT,sample,185856,184795,8630,176165,23887,152278,106412,9159,22440,2171,128852,12096,6537,2703,23315,17237
TTAACTGAACCGAATT,sample,273779,272228,11255,260973,39894,221079,146343,13026,33858,3590,180201,24262,7062,2440,35509,26219
ATATGCAAACCGAATT,sample,207781,205955,13625,192330,26308,166022,99829,7514,34048,4364,133877,20267,8337,2412,21728,17432
GTCGTTCTGGTCTGGT,Neg_Ctrl,1164,717,352,365,52,313,187,7,67,10,254,42,178,95,56,24
CTAGCGACGGTCTGGT,sample,266433,264252,13363,250889,36155,214734,148629,10061,33505,2959,182134,19580,7343,2333,43243,26240
GGTAGAGAGGTCTGGT,sample,199212,198012,7582,190430,28766,161664,120440,9919,22168,3131,142608,6006,3887,2187,27075,21549
CGTCGCCAGGTCTGGT,Neg_Ctrl,1654,1097,490,607,78,529,306,12,112,15,418,84,284,148,85,44
TCATACCAGGTCTGGT,sample,264814,262698,12362,250336,26055,224281,144145,10374,45172,6012,189317,18578,6941,2757,22300,18099
GATGCGTTGGTCTGGT,sample,116695,115674,6382,109292,21434,87858,59071,3658,15425,2351,74496,7353,5147,2116,18082,14883
TGCGCGTTGGTCTGGT,Neg_Ctrl,1066,684,379,305,45,260,126,4,67,9,193,54,134,60,37,21
CCATTCTTGGTCTGGT,sample,120936,119636,8533,111103,18588,92515,53139,3545,22519,2691,75658,10621,6322,2150,17189,12637
CGGTTGGTGGTCTGGT,sample,95088,94237,5356,88881,13683,75198,54572,4324,11587,1348,66159,3367,3171,1476,21046,10437
GCTCTTCTGGTCTGGT,sample,255942,251267,34094,217173,18675,198498,61251,5369,79846,8119,141097,43913,13763,3193,11466,10877
CTAACCGGGGTCTGGT,Neg_Ctrl,819,565,297,268,31,237,110,10,91,4,201,22,128,61,29,26
GCTGCTTCGGTCTGGT,sample,162170,160590,12237,148353,21475,126878,75693,4520,28934,3358,104627,14373,7081,2389,23204,15567
GGCGTACCGGTCTGGT,sample,81668,81027,5034,75993,13563,62430,42591,2855,11612,1420,54203,3952,3065,1533,15744,10032
TCAATCAGGGTCTGGT,sample,261268,259357,27874,231483,28881,202602,78762,4829,61434,6531,140196,51046,15511,3182,19419,18720
ATTCTACCGGTCTGGT,sample,259506,257655,12843,244812,28967,215845,147325,10754,33779,4348,181104,19639,8111,3069,27331,21692
GACTAACCGGTCTGGT,Neg_Ctrl,1237,906,272,634,87,547,315,24,112,14,427,82,306,160,75,45
ATATGCAAGGTCTGGT,sample,127877,126972,8659,118313,12565,105748,51732,3635,28926,2954,80658,18501,8004,2516,8975,8258
AACCGGTTCGACGTTA,sample,380636,376626,36229,340397,44840,295557,167601,13384,68490,7255,236091,38827,10949,3529,39046,29407
TCTAGGTTCGACGTTA,sample,386699,383055,25572,357483,48495,308988,191763,10344,64350,6838,256113,35693,10218,3007,46288,32690
GTCGTTCTCGACGTTA,sample,205989,204302,7830,196472,39158,157314,122051,9546,16417,2245,138468,7055,4102,2595,28241,28646
CATACTCCCGACGTTA,sample,398467,394637,26971,367666,54999,312667,214735,16491,49273,4518,264008,27650,7494,2915,53222,41928
CCGCAGTCCGACGTTA,sample,253773,251619,13965,237654,40587,197067,137496,11339,27622,4007,165118,16603,5407,1768,34062,28357
TGGATCAACGACGTTA,sample,194366,192331,15781,176550,25931,150619,88020,4834,33650,3360,121670,20755,8676,3064,23469,19158
TGCGCGTTCGACGTTA,sample,469084,465536,25116,440420,36404,404016,202865,14540,130194,19590,333059,36827,5795,2190,36541,27311
CGGTTGGTCGACGTTA,sample,85509,84268,10540,73728,10793,62935,29704,2065,18502,2245,48206,10419,6435,2334,8847,6916
CATTCGGTCGACGTTA,sample,290930,289043,9544,279499,44690,234809,179885,17134,26493,3587,206378,7710,4644,2734,40207,34469
GAGATTCTCGACGTTA,sample,264269,262255,16668,245587,32745,212842,135851,9760,42623,3920,178474,20688,7764,2396,33868,23306
CCTAGCGGCGACGTTA,sample,139811,138567,9738,128829,25344,103485,60800,4467,22476,2450,83276,13292,6672,2511,14284,18182
CTAACCGGCGACGTTA,sample,203989,202629,14035,188594,34089,154505,82566,5292,38257,4206,120823,24184,7934,2368,25285,23531
TGCGCTCCCGACGTTA,sample,334227,331665,21497,310168,43221,266947,165755,13767,52393,6723,218148,28309,9895,2666,39372,29817
ATACCGCCCGACGTTA,sample,92148,91385,7409,83976,7207,76769,27152,2608,31304,3727,58456,11978,6032,1957,3452,4283
GCGTTACCCGACGTTA,sample,213631,212385,8879,203506,21995,181511,98604,8208,51115,6670,149719,16914,5788,2194,21047,16154
ATGAATAGCGACGTTA,sample,307372,305652,14800,290852,39137,251715,160578,11861,51459,5210,212037,22607,7627,2137,36192,27864
TCAATCAGCGACGTTA,sample,157722,156995,5873,151122,29168,121954,78477,8956,19019,2088,97496,13414,6619,2236,18629,19695
GACTAACCCGACGTTA,sample,188409,187760,4492,183268,26537,156731,130970,13365,7970,1414,138940,3012,3494,2977,18904,18964
CGTAGAACCGACGTTA,sample,86227,85878,2500,83378,13788,69590,50333,4775,9318,1444,59651,3720,2686,1708,10447,10271
CCTAACTACGACGTTA,sample,209526,208694,9966,198728,32482,166246,116137,11441,22019,2535,138156,14114,7287,2285,27290,21495
GTCGTTCTTACTAAGT,sample,243850,241845,12111,229734,36584,193150,159659,11078,12822,1521,172481,8070,5499,3835,21710,26558
CATACTCCTACTAAGT,sample,170215,168002,14991,153011,22932,130079,66886,3830,35339,3762,102225,20262,7731,1916,18072,15141
CGTCGCCATACTAAGT,sample,238251,235180,19725,215455,18364,197091,97009,7063,58185,6649,155194,28185,10178,2860,19342,12377
TGCGCGTTTACTAAGT,sample,40893,40547,2383,38164,5386,32778,21191,1087,6816,1042,28007,2642,2821,1844,4743,3785
CCATTCTTTACTAAGT,sample,69525,68938,4993,63945,11297,52648,35380,2205,10007,1066,45387,3990,3064,1624,10400,8160
AGCGTCTTTACTAAGT,sample,14828,14525,3224,11301,1160,10141,2916,163,3621,395,6537,3046,3065,795,789,610
ACGCTTAATACTAAGT,sample,166127,164524,15600,148924,19835,129089,71081,5006,27864,3091,98945,22047,8304,2079,27976,13128
GAGATTCTTACTAAGT,sample,203869,202455,14143,188312,21316,166996,96846,8648,35499,3705,132345,22298,7894,2240,23367,15447
AAGGTCTGTACTAAGT,sample,70928,70328,4205,66123,11222,54901,32312,2181,13291,1490,45603,5627,5128,2718,6801,8086
CCTAGCGGTACTAAGT,sample,47096,46692,2382,44310,5549,38761,23877,1235,9456,1310,33333,2883,3025,1687,6722,4062
ATACCGCCTACTAAGT,sample,114613,113145,11393,101752,10811,90941,48266,3428,24894,3272,73160,11081,6429,2534,10659,7211
GCGTTACCTACTAAGT,sample,54065,53558,4415,49143,7117,42026,24330,1871,10047,1161,34377,4617,4021,1692,7206,4736
CGTCGAGGTACTAAGT,sample,97561,96441,9218,87223,12296,74927,42845,2563,16670,1788,59515,11061,5775,1394,17682,8114
CAGCTTCGTACTAAGT,sample,106627,105735,6394,99341,14657,84684,59200,3566,14110,1381,73310,6427,4532,2314,13935,11110
ATGAATAGTACTAAGT,sample,63987,63258,6498,56760,5549,51211,24844,2138,13372,1501,38216,9356,5253,1541,5501,3359
CCTAACTATACTAAGT,sample,136185,135288,6738,128550,20393,108157,77470,6254,13596,1249,91066,9588,4832,1629,22728,14947
GACGTATGTTGCCGCT,sample,250085,247872,13411,234461,40165,194296,151503,9909,21399,2025,172902,9460,4524,2061,49140,30757
GGAGAAGCTTGCCGCT,sample,222476,216728,36192,180536,13778,166758,60712,3681,64286,7610,124998,30469,11908,3994,7587,7520
GAGCCTCCTTGCCGCT,sample,333858,329148,31439,297709,34714,262995,137107,8805,66413,6378,203520,44292,10989,2694,47314,25168
TCGAACGATTGCCGCT,sample,303265,300066,20142,279924,41364,238560,174149,10744,33391,3939,207540,16337,5801,2786,38058,31847
GCAACTAGTTGCCGCT,sample,170999,169957,7104,162853,27648,135205,92603,8610,21203,2063,113806,10726,4514,1826,27996,21551
TACGCGAGTTGCCGCT,sample,552177,547285,37409,509876,55484,454392,244979,22123,105882,11990,350861,69418,13785,3979,60906,38259
GACTCAAGTTGCCGCT,sample,511250,506970,37179,469791,54065,415726,232870,16505,103497,11419,336367,51435,12890,3913,49168,36209
ATACGTTCTTGCCGCT,sample,365376,362330,20372,341958,35996,305962,186867,10581,67157,9848,254024,31509,8212,2775,36458,24140
TCTCAGGATTGCCGCT,sample,195490,193968,11830,182138,29659,152479,97012,7576,32387,3962,129399,11542,5898,2993,26006,20371
ATGGCGTTTTGCCGCT,sample,216756,215521,10659,204862,31127,173735,121040,7223,30233,3022,151273,12217,6280,2887,34045,21630
CAGCTTCGTTGCCGCT,sample,236170,234004,15419,218585,29341,189244,112254,6524,39834,4862,152088,25770,9374,3106,21026,19757
TAACGCCATTGCCGCT,sample,207627,206017,12702,193315,13831,179484,93379,8536,49855,5978,143234,21736,7691,2535,12658,8399
ATTCTACCTTGCCGCT,sample,265488,263725,9749,253976,33071,220905,174271,11817,24138,1931,198409,8748,4721,2133,34052,24895
GACTAACCTTGCCGCT,sample,234844,233524,9787,223737,39223,184514,129637,9029,31008,4871,160645,9969,5181,2191,21839,28525
AGATACTATTGCCGCT,sample,299359,297147,17327,279820,37269,242551,153985,10225,43304,4182,197289,30855,9459,2267,36912,26777
GCGCAATATTGCCGCT,sample,418747,415802,26563,389239,50142,339097,189614,13776,79290,7855,268904,48562,12265,3485,55504,32655
CTGGTCTTTTCGACCT,sample,365950,361022,28774,332248,50233,282015,181095,13033,51148,5431,232243,31308,9816,3297,39064,37028
AGAGTTCTTTCGACCT,sample,186540,184485,14372,170113,28965,141148,87832,7001,27497,3493,115329,15325,7405,2431,23627,19337
GGAGAAGCTTCGACCT,sample,140564,138066,19021,119045,12067,106978,48174,3056,32263,3866,80437,19619,7754,2107,12635,7499
GAGCCTCCTTCGACCT,sample,348769,341672,36961,304711,44035,260676,161662,11299,50917,6408,212579,30390,8826,3278,33851,30108
CGTCGCCATTCGACCT,sample,311480,307011,26890,280121,28841,251280,130918,10181,72830,7175,203748,30176,8570,2345,36779,20077
TCATCGAATTCGACCT,sample,212239,209447,17507,191940,22289,169651,99367,7727,42046,4838,141413,15673,6146,2322,27655,15896
AGCGTCTTTTCGACCT,sample,465270,461613,29082,432531,54119,378412,263774,18908,58814,5072,322588,31844,8508,2699,63680,40300
TAGCGAGTTTCGACCT,sample,177463,175997,11492,164505,29150,135355,92284,6850,22222,3137,114506,10862,5991,3209,19851,21656
GCTCTTCTTTCGACCT,sample,280878,277783,26984,250799,45081,205718,99670,6321,53295,5703,152965,40729,12451,3485,29419,32256
GGCGACGATTCGACCT,sample,218283,215525,26313,189212,21123,168089,66531,3737,52221,5251,118752,40349,11389,2698,22606,13800
GCTGCTTCTTCGACCT,sample,249892,246968,21884,225084,28402,196682,118720,7278,39548,4735,158268,26401,9556,3442,19330,19274
TGCGCTCCTTCGACCT,sample,121670,120778,6192,114586,25347,89239,57875,4573,16796,2469,74671,7526,4822,2399,14498,17098
TCTCCTAGTTCGACCT,sample,357445,355371,17861,337510,51468,286042,191853,16709,43177,5125,235030,29178,11199,3710,42917,34296
TCAATCAGTTCGACCT,sample,229877,228172,11082,217090,39112,177978,131502,10993,23009,3255,154511,9219,5070,2172,33360,28173
TAACGCCATTCGACCT,sample,230085,228936,10152,218784,24910,193874,116596,9480,44055,5608,160651,18135,7448,2751,23025,17642
TTAACTGATTCGACCT,sample,33032,32789,1381,31408,5604,25804,17097,1553,4797,576,21894,1781,2553,1312,3840,3955
AACCGGTTTCCAGACT,sample,284322,283000,10008,272992,50883,222109,180758,14621,18287,2000,199045,6443,2970,2349,52976,36381
TATACGGATCCAGACT,sample,234626,232627,13916,218711,35524,183187,136352,9246,23045,2694,159397,11850,5180,2248,31897,26781
GGAGAAGCTCCAGACT,sample,190033,187485,18304,169181,25347,143834,89681,6717,26358,3090,116039,17988,6704,1857,24015,17475
CGTCGCCATCCAGACT,sample,180101,178520,10950,167570,18298,149272,93585,6361,31238,3950,124823,14138,6173,2061,23163,13882
GACTCAAGTCCAGACT,sample,175382,173689,10960,162729,25774,136955,100386,6051,20212,2304,120598,8002,5314,2268,24840,19310
TGGATCAATCCAGACT,sample,66857,66094,4644,61450,13527,47923,36597,2733,5669,554,42266,2370,3129,2548,8410,9565
GATGCGTTTCCAGACT,sample,54278,53634,4564,49070,6197,42873,23435,1385,11007,1314,34442,5732,4693,2202,6669,4235
ACGCTTAATCCAGACT,sample,163246,161455,9115,152340,21801,130539,99597,6822,15755,1571,115352,6794,3176,1547,31195,16056
GAGATTCTTCCAGACT,sample,141923,140658,9135,131523,13356,118167,69250,4587,31491,3125,100741,9714,4093,1740,16611,10162
GGCGACGATCCAGACT,sample,55626,55124,3765,51359,7085,44274,28190,1784,9634,1245,37824,3421,3324,1842,6370,5153
GCCTATTCTCCAGACT,sample,72200,71469,6434,65035,10033,55002,32902,2126,11083,1251,43985,7640,5285,1756,12259,6897
TGCGCTCCTCCAGACT,Pos_Ctrl,35368,34646,3483,31163,1369,29794,24971,2217,1818,225,26789,563,5389,5574,2065,491
GCGTTACCTCCAGACT,sample,124465,123309,6831,116478,19164,97314,70725,4830,12152,1222,82877,8385,4181,2316,18369,14275
CGTCGAGGTCCAGACT,Pos_Ctrl,33665,32776,3681,29095,1350,27745,23324,1945,1708,234,25032,534,5389,5429,1986,640
CGCGGTCGTCCAGACT,sample,36820,36423,2992,33431,4123,29308,17769,1152,6216,639,23985,3532,3346,1261,5017,2927
TTATGACGTCCAGACT,sample,137490,136511,6810,129701,15207,114494,87507,5578,12750,1426,100257,7233,4726,2353,18368,10842
TCTCCTAGTCCAGACT,sample,123710,122639,7233,115406,11953,103453,67174,4094,21814,2338,88988,8033,4749,1725,15471,9145
TAACGCCATCCAGACT,sample,174732,173175,13618,159557,19679,139878,79113,4585,32894,4027,112007,19259,7707,1942,24031,14239
AGATACTATCCAGACT,sample,44779,44023,6516,37507,4307,33200,16872,1063,7913,973,24785,6379,4588,1198,3802,2656
GAGCCTCCACCATTAT,sample,322512,320265,14943,305322,56230,249092,203881,13179,22520,2174,226401,7338,3296,2063,62764,42171
TACGCGAGACCATTAT,sample,304788,301976,22185,279791,40442,239349,153206,11278,47009,5413,200215,22443,7761,2653,43786,28458
GACTCAAGACCATTAT,sample,288326,286036,14679,271357,44661,226696,170132,11062,30055,3470,200187,11977,5483,2675,45880,32802
CCGCAGTCACCATTAT,sample,144970,143112,15738,127374,16869,110505,66604,4146,22744,2124,89348,14887,6238,1983,21921,10763
AGCGTCTTACCATTAT,sample,389565,387050,19017,368033,57897,310136,225620,16214,43516,4808,269136,19978,7293,2386,63397,42271
CATTCGGTACCATTAT,sample,267240,264462,12705,251757,34933,216824,158995,10478,32086,4505,191081,10760,5448,2405,37322,23698
TGCGCTCCACCATTAT,sample,275566,273289,18389,254900,32809,222091,129001,8555,55470,6815,184471,22250,7236,2632,34801,25207
TCTCCTAGACCATTAT,sample,344130,341644,16432,325212,33209,292003,194466,14140,51444,6178,245910,25775,10187,3905,35456,22805
TCAATCAGACCATTAT,sample,308379,306880,11076,295804,44924,250880,190050,14691,29789,3791,219839,12559,4824,2023,57481,32940
GACTAACCACCATTAT,sample,241942,239957,18809,221148,25509,195639,115051,6734,43396,4313,158447,26145,9720,2313,25649,18820
AACCGGTTCAATGGAT,sample,533033,530304,17513,512791,106511,406280,342727,23145,26822,4773,369549,8813,3210,2258,93672,75243
CATAATGGCAATGGAT,sample,176435,175140,7985,167155,27863,139292,104707,8581,17841,2499,122548,5664,4331,2524,26821,21116
CATACTCCCAATGGAT,sample,298829,295301,26786,268515,29561,238954,129635,11133,59556,7001,189191,31629,10074,2969,26618,20741
CTAGCGACCAATGGAT,sample,320251,317625,20127,297498,38102,259396,151210,12646,60784,7620,211994,27136,8025,3307,30563,25083
TCGAACGACAATGGAT,sample,284652,282247,14975,267272,22647,244625,141221,8559,65402,8165,206623,21278,6892,2600,29015,15166
GGTAGAGACAATGGAT,sample,194927,192696,21905,170791,29547,141244,66568,4692,35352,3892,101920,30740,8457,1881,18266,18672
TGGATCAACAATGGAT,sample,239156,237462,13723,223739,47773,175966,111461,7639,33718,4290,145179,18858,7806,3012,25644,32835
GGCAGGTTCAATGGAT,sample,321839,319309,20907,298402,33817,264585,154783,12781,62814,8199,217597,26008,7911,3292,26375,25162
ATGGCGTTCAATGGAT,sample,402871,400315,18405,381910,41883,340027,219688,12884,73347,11389,293035,22719,5725,2597,45650,32914
CATTCGGTCAATGGAT,sample,219006,217215,12237,204978,22175,182803,116016,6918,42456,4852,158472,12561,5668,2067,35186,15940
GAGATTCTCAATGGAT,sample,249874,247726,15764,231962,22577,209385,113910,7850,59552,7229,173462,20844,7269,3072,22481,16059
CTAAGCATCAATGGAT,sample,391338,387739,26309,361430,45870,315560,183714,12934,75931,10679,259645,32302,8235,3334,31837,32092
CCTAGCGGCAATGGAT,sample,151427,150549,5019,145530,24498,121032,93937,8533,11756,1409,105693,5397,3526,2738,16423,18433
ATACCGCCCAATGGAT,Neg_Ctrl,4035,3050,1871,1179,160,1019,572,30,228,39,800,150,542,273,138,58
GTCGCGAACAATGGAT,sample,261375,258573,27521,231052,31357,199695,93335,6500,55207,6298,148542,38355,11243,2886,29885,21467
CAGCTTCGCAATGGAT,Neg_Ctrl,1277,802,318,484,90,394,225,16,91,8,316,54,230,127,53,34
CGCGGTCGCAATGGAT,sample,195916,194266,13987,180279,27610,152669,84936,7465,32400,3683,117336,24185,9144,2764,18575,18503
ATTCTACCCAATGGAT,sample,447471,443611,22385,421226,44299,376927,291556,17958,39161,4465,330717,23787,8410,3465,29660,30719
CCTAACTACAATGGAT,Pos_Ctrl,97663,96218,6823,89395,3835,85560,72108,7016,4479,544,76587,1413,7230,9656,5190,1420
TCTAGGTTAGATTCAT,sample,351366,348043,22255,325788,28450,297338,165153,9150,83125,8318,248278,31592,7540,2589,30164,18880
GAGCCTCCAGATTCAT,sample,233917,231433,17431,214002,29728,184274,111555,7705,38470,4570,150025,21974,8870,2464,36894,21320
CTAGCGACAGATTCAT,sample,252086,249026,20930,228096,17933,210163,124495,6634,45936,4884,170431,28214,9384,2795,14714,11685
CGTCGCCAAGATTCAT,sample,199022,197408,12245,185163,31715,153448,98430,7434,28470,3981,126900,15133,6320,2034,30005,22249
ATACGTTCAGATTCAT,sample,179641,176553,23534,153019,11582,141437,47666,2650,55352,5845,103018,29924,9839,2336,6823,6138
TGGATCAAAGATTCAT,sample,300367,298092,17620,280472,27862,252610,140233,9915,70501,8799,210734,23162,7760,2324,32726,19653
GGCAGGTTAGATTCAT,sample,242505,240668,24138,216530,31686,184844,105903,9666,38820,4020,144723,26435,6991,2317,27148,22421
ATGGCGTTAGATTCAT,sample,234518,232491,15074,217417,29150,188267,130944,8380,29060,2648,160004,17235,7501,2762,34305,21104
ACGCTTAAAGATTCAT,sample,132662,129860,20125,109735,14237,95498,32955,2033,32028,3407,64983,25075,10561,2281,8586,8470
AAGGTCTGAGATTCAT,sample,197327,195073,17574,177499,21148,156351,77035,5291,41607,4530,118642,27888,9815,2444,24655,14650
TAACGAAGAGATTCAT,sample,142330,141038,15427,125611,13770,111841,42668,2700,35020,3412,77688,28041,10096,2222,14008,9271
ATACCGCCAGATTCAT,sample,225704,223876,26649,197227,29075,168152,76186,4811,46337,5142,122523,35676,12552,2717,29043,19825
GGCGTACCAGATTCAT,sample,113030,112310,7346,104964,13169,91795,50354,3825,24764,3061,75118,9791,6366,2754,10795,8683
TCAATCAGAGATTCAT,sample,98935,97907,4782,93125,12424,80701,50799,3452,17237,2660,68036,6553,3167,1592,9921,9207
GCGCAATAAGATTCAT,sample,32323,32126,889,31237,6335,24902,19016,1670,2736,276,21752,1204,2054,1484,3905,4225
TTAACTGAAGATTCAT,sample,68955,68673,1969,66704,15597,51107,37155,3719,6111,729,43266,3393,3531,1940,6373,10890
AGAGTTCTCAATCTTG,sample,686380,681454,37121,644333,73682,570651,366459,26623,123506,18322,489965,35741,6357,2715,96747,61287
AGCTGAATCAATCTTG,sample,529812,526111,23577,502534,74754,427780,330766,27806,42095,6082,372861,21031,6358,3079,68777,56595
TATACGGACAATCTTG,sample,374988,370575,32190,338385,57247,281138,154698,9969,65877,6991,220575,43603,11010,3010,51190,39246
GAGCCTCCCAATCTTG,sample,230543,227174,23899,203275,26833,176442,93804,5631,47283,4990,141087,24734,8363,2073,31403,17979
CGTCGCCACAATCTTG,sample,307859,304226,28500,275726,27723,248003,113244,7260,76126,8661,189370,42712,11354,3439,21310,18600
TGATTCCGCAATCTTG,sample,238583,236786,10773,226013,31478,194535,129515,9330,36811,3959,166326,14920,6349,2411,28851,23519
TCTCAGGACAATCTTG,sample,232098,230196,18120,212076,33582,178494,114303,6319,31363,3474,145666,23035,8303,2475,32611,23257
TGCGCGTTCAATCTTG,sample,272483,268750,32124,236626,24282,212344,94371,7551,61889,7404,156260,41129,11024,2918,24934,17199
GCTCTTCTCAATCTTG,sample,262286,259009,20752,238257,26105,212152,121681,7476,55335,7448,177016,20212,7338,3066,23499,18584
CCTAGCGGCAATCTTG,sample,96106,94758,12876,81882,8616,73266,28556,2075,23468,2705,52024,16462,7643,1633,9617,5311
GCGTTACCCAATCTTG,sample,173981,172837,7845,164992,30803,134189,103077,6163,16187,1752,119264,7010,4739,2426,30120,22932
GGCGTACCCAATCTTG,sample,93028,91527,9758,81769,12246,69523,42252,2425,13813,1585,56065,9448,5526,1879,11947,8224
CGCGGTCGCAATCTTG,sample,291087,288794,15111,273683,35511,238172,177779,12674,28888,3388,206667,15443,5739,2152,49496,25889
TCAATCAGCAATCTTG,sample,156101,154791,11912,142879,22512,120367,67429,5921,27021,3506,94450,16490,7071,2160,21861,15106
TAACGCCACAATCTTG,sample,282340,280773,13300,267473,48028,219445,166651,14453,26204,2039,192855,10098,4521,1889,53558,34365
GACTAACCCAATCTTG,sample,271661,269380,20449,248931,35105,213826,131727,9259,40740,5202,172467,26898,7609,2448,38762,24589
GCGCAATACAATCTTG,Neg_Ctrl,1569,1056,469,587,87,500,303,26,99,12,402,60,257,140,88,30
AGAGTTCTCGTTCCGA,sample,396635,392659,27157,365502,45014,320488,209358,14041,66282,6078,275640,24729,8024,3476,41946,33843
GGAGAAGCCGTTCCGA,sample,221010,218727,17685,201042,27246,173796,108220,6802,36610,4964,144830,17200,7026,1970,35888,19899
TGATTCCGCGTTCCGA,sample,202569,200181,22350,177831,26570,151261,70702,5403,38913,4493,109615,31750,9761,1901,21730,17016
GCAACTAGCGTTCCGA,sample,153999,152767,11082,141685,18541,123144,78912,6263,22517,2526,101429,12926,7133,2235,21394,13336
CCGCAGTCCGTTCCGA,sample,147344,145660,10576,135084,17826,117258,79140,5147,20486,2728,99626,9757,5582,2101,21826,13379
TCTCAGGACGTTCCGA,sample,177249,175478,17198,158280,25779,132501,75188,6013,31079,3275,106267,16946,7461,2758,20688,17079
GGCAGGTTCGTTCCGA,sample,237516,235064,19816,215248,32388,182860,106541,7600,39343,4966,145884,24410,8648,2581,30417,22601
GATGCGTTCGTTCCGA,sample,256978,254572,23564,231008,26200,204808,107295,7047,61031,6721,168326,22714,7950,2483,30715,19006
AGCGTCTTCGTTCCGA,sample,432262,429661,25504,404157,54748,349409,222604,17176,64700,7559,287304,37370,10503,3159,64279,38400
GCCTATTCCGTTCCGA,sample,474865,468384,71625,396759,52524,344235,140334,8164,100261,10706,240595,84770,18396,4405,43522,32599
GCGTTACCCGTTCCGA,sample,184835,183627,9535,174092,31076,143016,94508,6603,26922,3082,121430,11901,6057,2509,28068,21609
CGTCGAGGCGTTCCGA,sample,113877,113211,4136,109075,19654,89421,71314,4362,9349,1370,80663,3026,2859,1598,26660,14521
TCTCCTAGCGTTCCGA,sample,501062,497645,28108,469537,45363,424174,298823,19321,58110,6636,356933,41284,11533,4679,39466,27231
TAACGCCACGTTCCGA,sample,219410,218213,12321,205892,31549,174343,103992,8563,37302,3741,141294,20745,8277,2098,34396,20607
CGCGAGACCGTTCCGA,sample,292277,290752,16119,274633,41680,232953,144223,11219,41957,4083,186180,31471,10916,3140,29644,28257
CGTAGAACCGTTCCGA,sample,111057,110580,6463,104117,15257,88860,52319,4905,20709,2826,73028,8101,5719,2010,13428,10556
ATATGCAACGTTCCGA,sample,564,555,65,490,66,424,235,19,105,9,340,56,245,145,71,47
TCTAGGTTCAATTCGG,sample,234703,230858,24364,206494,28645,177849,97831,8000,37735,5160,135566,29123,9161,2385,29799,19563
CTGGTCTTCAATTCGG,Pos_Ctrl,144484,138595,17032,121563,5636,115927,96218,7956,8176,985,104394,2592,7860,10278,7853,2666
TATACGGACAATTCGG,sample,295977,293193,18785,274408,38465,235943,177413,12479,28454,2483,205867,15114,7000,2695,46108,26708
CATACTCCCAATTCGG,Pos_Ctrl,117665,111345,13491,97854,4569,93285,77840,6709,5957,819,83797,1960,7559,9743,5679,2238
ATTCAAGGCAATTCGG,sample,192508,190801,9661,181140,15434,165706,96581,5684,45720,4509,142301,13212,5065,2043,20497,10804
TACGCGAGCAATTCGG,sample,294162,291173,17222,273951,29401,244550,168857,10462,42428,4182,211285,18621,5809,2824,27421,22840
GACTCAAGCAATTCGG,Pos_Ctrl,92937,89552,9450,80102,3299,76803,64144,5483,4919,608,69063,1649,7175,8958,4789,1382
TGGATCAACAATTCGG,sample,122558,121250,11027,110223,17238,92985,47161,3116,25301,3093,72462,14314,7491,1907,12591,10842
ATGGCGTTCAATTCGG,Pos_Ctrl,82213,79649,9263,70386,3337,67049,56251,4693,4193,485,60444,1427,7170,8165,5038,1642
CGGTTGGTCAATTCGG,sample,138418,136902,14234,122668,18295,104373,54323,3348,26039,2739,80362,17924,7913,2759,16405,12378
CATTCGGTCAATTCGG,sample,110276,108566,14271,94295,15895,78400,36636,3084,23015,2656,59651,13009,8190,3219,7410,10090
GAGATTCTCAATTCGG,Pos_Ctrl,114989,113402,7991,105411,4243,101168,84734,8007,5816,817,90550,1794,7612,10503,6313,1669
AAGGTCTGCAATTCGG,sample,194086,192475,11108,181367,28950,152417,109407,8921,21561,2316,130968,10212,6254,3515,20547,21109
CTAACCGGCAATTCGG,sample,163839,162418,12332,150086,27282,122804,72745,5174,25512,2975,98257,16398,6791,2548,20901,19476
GGCGACGACAATTCGG,sample,255532,253701,15341,238360,39582,198778,117887,8894,39231,4597,157118,28169,9892,3484,25244,26119
TAACGAAGCAATTCGG,sample,200629,199395,10643,188752,35186,153566,96926,7447,31492,2593,128418,15108,6247,2751,28275,24002
AGCAGAGCCAATTCGG,Pos_Ctrl,69146,68459,4501,63958,3131,60827,51249,5113,3008,414,54257,1043,6781,8501,4721,1435
CGTCGAGGCAATTCGG,Pos_Ctrl,52447,51945,3303,48642,2354,46288,39129,3967,2228,286,41357,678,6270,7524,3568,1106
TTATGACGCAATTCGG,sample,247665,246469,11545,234924,33689,201235,121624,12396,44577,4714,166201,17924,7153,2653,29107,23806
ATGAATAGCAATTCGG,sample,159403,158657,7154,151503,21919,129584,87917,10214,20203,1960,108120,9290,5080,2096,17691,14863
AAGTAGAGCAATTCGG,sample,88830,88412,2654,85758,13655,72103,52512,4859,9891,1255,62403,3586,2822,1649,10238,9618
CGCGAGACCAATTCGG,sample,1129,1106,115,991,154,837,566,50,130,15,696,76,440,307,120,94
CCTAACTACAATTCGG,sample,16617,16506,580,15926,3251,12675,9827,1225,1021,129,10848,473,1706,1488,2077,2265
TTAACTGACAATTCGG,sample,3886,3799,183,3616,591,3025,2308,297,273,38,2581,109,638,581,437,425
CTGGTCTTAACTCCGG,sample,375614,373564,18333,355231,45143,310088,166291,12372,77362,8353,243653,45710,12266,4159,33701,31163
AGAGTTCTAACTCCGG,sample,310497,308389,15516,292873,47685,245188,178721,14515,33946,3532,212667,14474,6675,3087,40683,34179
AGCTGAATAACTCCGG,sample,351535,348170,28675,319495,46473,273022,147641,8825,60285,5969,207926,50302,12220,3844,32673,30578
GGAGAAGCAACTCCGG,sample,295385,291371,32844,258527,36911,221616,110855,8071,53902,5330,164757,43458,14431,3661,28762,23380
ATTCAAGGAACTCCGG,sample,240385,238581,15127,223454,32277,191177,114908,7034,42001,3825,156909,23409,7436,2240,33458,22482
ATACGTTCAACTCCGG,sample,142392,140651,11934,128717,12993,115724,71050,5166,24795,3062,95845,11651,7361,3126,23953,9246
GGCAGGTTAACTCCGG,sample,77201,76525,7775,68750,15391,53359,29100,2303,11931,1378,41031,8647,5448,2301,8571,10095
GATGCGTTAACTCCGG,sample,144515,143389,9496,133893,34820,99073,68950,4725,15835,1730,84785,7833,4495,2179,22895,24015
CCATTCTTAACTCCGG,sample,198008,196397,11883,184514,23906,160608,101225,6226,36319,3366,137544,13472,6155,2795,21675,18245
CGGTTGGTAACTCCGG,sample,145826,144607,9413,135194,27769,107425,65698,4197,24254,3185,89952,10091,6392,2302,19283,19497
GCTCTTCTAACTCCGG,sample,130777,129559,8951,120608,14301,106307,59276,4481,28254,3341,87530,10955,5792,2304,14376,9652
GAGATTCTAACTCCGG,sample,200518,199217,13062,186155,28834,157321,84681,6863,35432,4949,120113,25396,8284,2146,27764,20310
CCTAGCGGAACTCCGG,sample,123927,122955,6902,116053,22284,93769,66519,4718,14042,2206,80561,6284,4451,2390,17805,16128
GGCGACGAAACTCCGG,sample,197453,195737,14008,181729,32095,149634,92492,6047,29829,2759,122321,18507,7906,2244,36052,24121
ATACCGCCAACTCCGG,sample,194793,193138,12206,180932,19043,161889,87463,6467,44794,6000,132257,17165,6427,2425,17636,12821
GCGTTACCAACTCCGG,sample,196423,194139,16001,178138,13796,164342,75840,4131,57798,7732,133638,18841,7909,3262,9752,9153
CGTCGAGGAACTCCGG,sample,163901,162705,7491,155214,26481,128733,96351,5928,17111,1999,113462,7344,5049,2582,21833,18627
CAGCTTCGAACTCCGG,sample,213786,211922,13982,197940,22106,175834,95491,4387,49295,6545,144786,20116,7225,2263,20641,14998
TCTCCTAGAACTCCGG,sample,157851,156822,10055,146767,17203,129564,85563,7136,20762,2169,106325,13934,6365,1899,14696,12477
GACTAACCAACTCCGG,sample,210301,207780,21113,186667,18971,167696,85341,6468,39674,4051,125015,32162,11784,2770,23371,12711
AGATACTAAACTCCGG,sample,171056,168454,19584,148870,18156,130714,68121,4228,31871,3316,99992,23178,8055,1859,18222,11672
TCTAGGTTCCTGAAGG,sample,435391,429992,36237,393755,30879,362876,177494,11940,114134,13350,291628,45958,9801,3110,35245,22099
GTCGTTCTCCTGAAGG,Neg_Ctrl,1457,957,435,522,69,453,248,15,108,10,356,72,234,115,70,25
CATACTCCCCTGAAGG,sample,185210,182546,16400,166146,13944,152202,76984,4850,41838,5413,118822,23117,7865,2371,17791,9010
CTAGCGACCCTGAAGG,Neg_Ctrl,1948,1457,828,629,70,559,281,17,155,13,436,93,300,129,64,64
TCATACCACCTGAAGG,sample,166822,165002,12072,152930,30277,122653,84888,4186,19695,2182,104583,11702,6340,2287,29810,21967
ATTCAAGGCCTGAAGG,sample,219510,215553,19918,195635,17390,178245,94158,6079,49447,5890,143605,22671,8447,3132,18988,11175
TACGCGAGCCTGAAGG,sample,307516,302388,30639,271749,31362,240387,118839,9198,62034,6592,180873,43724,11377,3119,26825,19831
TCTCAGGACCTGAAGG,sample,191610,187797,23244,164553,22080,142473,69215,5301,36877,4207,106092,26873,9664,2715,19421,13891
TGGATCAACCTGAAGG,sample,108805,106671,12655,94016,13322,80694,45826,3041,18148,2095,63974,11584,7081,2863,9534,9449
ATGGCGTTCCTGAAGG,sample,191829,187691,38419,149272,9869,139403,34370,2155,58365,6234,92735,38279,13413,3515,4182,4363
TGCGCGTTCCTGAAGG,Neg_Ctrl,1473,1015,551,464,46,418,207,19,127,8,334,57,229,103,44,26
CCATTCTTCCTGAAGG,sample,27289,26848,5121,21727,2370,19357,7352,516,6127,692,13479,4670,3935,1164,2092,1366
CTAAGCATCCTGAAGG,Neg_Ctrl,1165,812,485,327,38,289,128,6,77,4,205,74,151,71,35,30
TGCGCTCCCCTGAAGG,Neg_Ctrl,1291,938,453,485,61,424,231,14,110,15,341,54,237,123,57,25
CAGCTTCGCCTGAAGG,Neg_Ctrl,1091,668,377,291,33,258,138,12,56,12,194,40,159,82,15,20
TCTCCTAGCCTGAAGG,sample,204044,202584,12397,190187,21155,169032,109003,7481,29337,4641,138340,18570,6746,1731,33811,14874
ATGAATAGCCTGAAGG,sample,72224,71000,7391,63609,13054,50555,24030,1340,13360,1341,37390,10484,6576,1606,8105,8245
AAGTAGAGCCTGAAGG,sample,86875,85780,9118,76662,7986,68676,35465,2758,17565,1805,53030,11083,6720,1924,8122,5061
ATTCTACCCCTGAAGG,sample,228765,226964,14580,212384,34974,177410,115948,9372,32104,3368,148052,16618,4298,1863,29838,24447
GCGCAATACCTGAAGG,sample,202203,200107,20090,180017,18116,161901,79515,4711,43487,6147,123002,28041,9890,2160,20059,11656
TTAACTGACCTGAAGG,sample,188496,187202,19603,167599,16885,150714,54518,3426,49185,5379,103703,38206,12517,2698,13502,9660
GTCGTTCTAATATTCG,sample,251174,248613,19327,229286,25918,203368,114006,7684,51720,5976,165726,23982,8744,2903,27786,18242
GACGTATGAATATTCG,sample,261701,259395,14689,244706,43025,201681,147617,12387,25504,2298,173121,13875,6015,2296,43663,31784
CGTCGCCAAATATTCG,sample,291197,288522,14303,274219,26677,247542,149228,9809,61781,7317,211009,19407,6547,2706,22436,19308
GACTCAAGAATATTCG,sample,156921,155578,8533,147045,24390,122655,94344,6540,13076,1649,107420,7046,4863,2659,28540,17134
ATACGTTCAATATTCG,sample,208015,206330,9473,196857,31236,165621,121871,8178,22294,2659,144165,10619,4712,2434,33766,23104
GATGCGTTAATATTCG,sample,169865,167403,18981,148422,18927,129495,55032,3260,41338,4990,96370,24875,9562,2549,16038,12535
CCATTCTTAATATTCG,sample,214358,211804,22064,189740,24453,165287,76470,5456,50766,5761,127236,26834,9821,3069,17173,15834
CGGTTGGTAATATTCG,sample,265769,264048,12177,251871,42620,209251,168482,13635,20439,1334,188921,5361,3200,1776,54346,31994
AAGGTCTGAATATTCG,sample,223985,222540,9243,213297,29312,183985,136075,9563,25205,3645,161280,9497,5123,2247,32561,23126
TAACGAAGAATATTCG,sample,260162,258082,16045,242037,23334,218703,115151,7183,64592,7939,179743,23838,7599,2598,26184,16315
ATACCGCCAATATTCG,sample,188748,187470,12245,175225,30171,145054,88968,6659,29584,4149,118552,15694,7410,2446,24495,21409
CGCGGTCGAATATTCG,sample,93411,92650,5650,87000,11010,75990,50807,4068,13138,1413,63945,6564,4605,1728,15606,7568
TTATGACGAATATTCG,sample,48050,47803,1867,45936,6643,39293,23328,2264,9232,1144,32560,3325,3007,1469,4682,4526
ATTCTACCAATATTCG,Pos_Ctrl,117723,116561,6468,110093,4537,105556,89618,8517,5172,564,94790,1685,7482,10768,6315,1783
CGTAGAACAATATTCG,sample,165307,163222,18105,145117,16319,128798,62018,4971,35399,4111,97417,22299,8661,2458,15197,10110
GTCGTTCTAGTCTCCG,sample,260948,258139,19187,238952,33094,205858,128645,5629,42510,4435,171155,24639,8415,2452,41614,22129
AGAGTTCTAGTCTCCG,sample,254961,251668,21163,230505,29129,201376,113049,7724,43637,5124,156686,31842,8548,2470,29397,19352
CATAATGGAGTCTCCG,sample,124513,123349,6933,116416,16070,100346,70151,5036,16710,1447,86861,7002,4206,1823,20423,12462
TCATCGAAAGTCTCCG,sample,110716,109338,52689,56649,7160,49489,23094,1412,13462,1553,36556,9968,5229,1514,4859,20622
GACTCAAGAGTCTCCG,sample,261120,258839,14880,243959,34199,209760,142555,8281,33686,3322,176241,21916,5845,2316,45503,24185
CCGTACGCAGTCTCCG,sample,259902,257932,13289,244643,24804,219839,142342,7919,46568,5358,188910,17652,6444,2260,31733,17631
GGCAGGTTAGTCTCCG,sample,287015,284806,17807,266999,33035,233964,151310,10866,40069,3555,191379,28164,9080,2940,32080,22530
CATTCGGTAGTCTCCG,sample,275590,273402,20731,252671,28153,224518,120307,9927,53495,6513,173802,34276,10837,3229,29372,19061
TAGCGAGTAGTCTCCG,sample,296008,294516,12033,282483,38062,244421,182146,14579,32390,4662,214536,10644,5022,2654,41616,27644
AAGGTCTGAGTCTCCG,sample,180088,179022,7763,171259,35768,135491,98541,7921,18172,1806,116713,9051,5378,1781,29640,25079
GCTGCTTCAGTCTCCG,sample,86348,85791,5725,80066,14881,65185,39825,2866,13823,1921,53648,6750,5194,2536,10685,10481
GCCTATTCAGTCTCCG,sample,180911,179949,11455,168494,31173,137321,79597,6055,31630,3459,111227,16580,7492,2248,25463,23124
TTATGACGAGTCTCCG,sample,1710,1690,91,1599,191,1408,976,94,205,27,1181,106,584,473,149,141
TCTCCTAGAGTCTCCG,sample,126375,125761,3396,122365,17500,104865,76018,8586,14692,1530,90710,4039,3587,2515,11689,12279
AAGTAGAGAGTCTCCG,sample,139339,138604,6196,132408,15709,116699,61574,5239,34147,3651,95721,12088,6016,1928,10950,11039
CCTAACTAAGTCTCCG,sample,189855,188929,7280,181649,33381,148268,102327,10007,20652,2302,122979,12980,5505,2103,25777,25175
AGCTGAATTGCCTACG,sample,113380,112401,5766,106635,20049,86586,57026,4232,15473,2172,72499,7683,5257,2435,11488,13671
GGAGAAGCTGCCTACG,sample,178676,176390,17338,159052,16097,142955,75413,6173,34296,4090,109709,22983,9016,2374,20150,11493
TACGCGAGTGCCTACG,sample,123968,122304,10909,111395,11002,100393,50743,3915,27858,3081,78601,14796,7314,2271,12540,6876
ATACGTTCTGCCTACG,sample,119668,118436,7919,110517,17838,92679,68462,4516,12603,1306,81065,5792,4332,2060,19883,13012
GGCAGGTTTGCCTACG,sample,164422,163003,10530,152473,13777,138696,77670,5135,36511,5690,114181,13690,6223,2235,16150,9431
ACGCTTAATGCCTACG,sample,109571,108640,6822,101818,12969,88849,59821,3058,16628,1891,76449,7451,4060,1711,18727,9195
GAGATTCTTGCCTACG,sample,155325,154435,7504,146931,22205,124726,90421,6683,16671,1951,107092,9000,6074,3117,17537,16176
AAGGTCTGTGCCTACG,sample,100037,99249,5299,93950,17901,76049,56005,5168,9084,1667,65089,4125,2959,1737,16354,13042
ATACCGCCTGCCTACG,sample,717,704,121,583,83,500,250,18,125,20,375,87,268,137,57,58
GTCGCGAATGCCTACG,sample,81216,80662,4874,75788,14089,61699,37617,2619,13472,1520,51089,6471,4572,1950,11660,9396
CGCGGTCGTGCCTACG,sample,77605,77158,4707,72451,6507,65944,35668,2891,17439,2190,53107,7756,4727,1870,8226,4701
ATGAATAGTGCCTACG,sample,153739,152884,9470,143414,20939,122475,76748,6031,22924,2704,99672,14068,7064,1883,22141,14341
GACTAACCTGCCTACG,Neg_Ctrl,830,581,207,374,54,320,187,12,68,12,255,41,191,123,40,25
ATATGCAATGCCTACG,sample,57206,56964,1860,55104,10393,44711,34232,3009,4712,574,38944,2184,2629,1848,7295,7247
GACGTATGCTTAGTTC,sample,231704,229203,17711,211492,20109,191383,94909,6419,58896,6461,153805,24698,8724,2713,17196,13875
TATACGGACTTAGTTC,sample,291172,287956,21232,266724,29256,237468,132613,6748,65675,7023,198288,25409,8758,2989,27619,21348
GGAGAAGCCTTAGTTC,sample,177966,176722,7286,169436,37070,132366,107452,6913,12803,1682,120255,3516,1996,1230,46729,28604
CTAGCGACCTTAGTTC,sample,285716,282206,19675,262531,27818,234713,134517,11021,57152,5662,191669,26361,7880,2655,25747,19950
GCAACTAGCTTAGTTC,sample,115635,114709,6353,108356,13040,95316,53744,4931,26369,3310,80113,6962,4243,2247,9934,10475
CCGTACGCCTTAGTTC,sample,371197,366615,34910,331705,33673,298032,128616,7575,87811,9652,216427,64378,14824,3790,35275,23693
TCTCAGGACTTAGTTC,sample,367388,364225,19007,345218,48528,296690,224438,13796,37313,4495,261751,16648,7656,3034,41076,36997
GGCAGGTTCTTAGTTC,sample,226893,224801,16856,207945,30437,177508,108793,12205,30598,3515,139391,22397,8276,2904,25642,20892
TAGCGAGTCTTAGTTC,sample,224045,222788,9473,213315,42649,170666,139288,8961,15244,1759,154532,5414,2146,1656,50562,33279
GAGATTCTCTTAGTTC,sample,134360,132297,11169,121128,12616,108512,59662,3970,29377,3378,89039,12125,5455,2064,15342,8594
ATACCGCCCTTAGTTC,sample,147718,146801,7495,139306,18550,120756,70668,5226,32112,3619,102780,9131,4319,1991,23071,13512
TCAATCAGCTTAGTTC,sample,160903,159922,8620,151302,17544,133758,76579,5906,29483,3449,106062,18341,6902,1759,25885,11824
AACCGGTTCGAGCTTC,sample,353078,350981,13940,337041,64573,272468,181342,13053,54958,6840,236300,16275,5584,3263,36652,47354
GAGCCTCCCGAGCTTC,sample,158093,154473,20430,134043,14245,119798,53172,4174,37323,3642,90495,21487,9171,2250,14138,8805
CATACTCCCGAGCTTC,sample,276298,273796,13764,260032,22472,237560,125634,8760,73324,9025,198958,20817,7476,2863,27770,14942
CGTCGCCACGAGCTTC,sample,263081,260362,14864,245498,30448,215050,131849,10310,48807,5607,180656,18477,6455,2429,25887,21569
ATACGTTCCGAGCTTC,sample,195994,194369,13860,180509,35443,145066,89015,4813,30463,3059,119478,17716,7782,2219,29738,25212
GATGCGTTCGAGCTTC,sample,291715,289927,14217,275710,52351,223359,159097,11482,34901,2804,193998,15075,5616,2379,40923,39266
AGCGTCTTCGAGCTTC,sample,319847,317305,23497,293808,41380,252428,122350,7773,70084,8290,192434,43931,11586,3027,40496,29104
CGGTTGGTCGAGCTTC,sample,215737,214163,11739,202424,40422,162002,104738,8776,31397,3134,136135,13957,6886,2361,30411,27945
ACGCTTAACGAGCTTC,sample,146040,145037,9401,135636,43687,91949,53288,2938,18703,2028,71991,14992,5284,1264,23540,26352
GCTCTTCTCGAGCTTC,sample,264777,262779,15757,247022,39448,207574,131008,8158,40113,4592,171121,23703,8608,2839,40096,29288
AAGGTCTGCGAGCTTC,sample,157861,154654,23115,131539,14692,116847,46826,3490,35756,4103,82582,26672,10784,2691,10985,9230
AGCAGAGCCGAGCTTC,sample,200623,199542,7929,191613,40733,150880,115227,8039,16773,1937,132000,8904,4467,2190,41687,28229
CGTCGAGGCGAGCTTC,sample,237872,236359,10986,225373,38060,187313,137961,9047,24755,3188,162716,12362,6684,2548,32143,27216
ATGAATAGCGAGCTTC,sample,218295,216456,12919,203537,24107,179430,102820,8048,43114,4589,145934,20859,7421,2214,28692,15610
CGTAGAACCGAGCTTC,sample,198904,197133,15138,181995,20967,161028,89934,7086,35432,4025,125366,24551,9109,2719,18429,14943
CCTAACTACGAGCTTC,sample,225566,224098,11553,212545,34301,178244,104818,8301,39129,4702,143947,21294,9137,2379,33517,24936
TTAACTGACGAGCTTC,sample,172016,170995,6619,164376,25350,139026,87030,8123,29967,2138,116997,11768,5956,1842,21022,18782
AACCGGTTGTAGAATG,sample,11927,11732,510,11222,1663,9559,6237,526,1956,266,8193,574,1777,1343,1126,1188
CTGGTCTTGTAGAATG,Pos_Ctrl,155269,148963,16366,132597,5984,126613,105677,8880,8140,1293,113817,2623,8068,10829,8459,2823
GACGTATGGTAGAATG,sample,188014,186523,8844,177679,30149,147530,124348,7333,10292,875,134640,4682,2626,2061,30076,24150
TCATCGAAGTAGAATG,sample,299054,295665,23427,272238,30299,241939,139825,10015,51379,4749,191204,35971,9883,2825,36678,20758
GCAACTAGGTAGAATG,Pos_Ctrl,31446,31031,1958,29073,1460,27613,22587,2242,1928,228,24515,628,5493,6005,1740,778
TACGCGAGGTAGAATG,sample,295232,291398,23149,268249,25539,242710,143348,9491,57100,6613,200448,26158,9780,3687,23922,16771
CCGCAGTCGTAGAATG,sample,315292,312007,21171,290836,36565,254271,169589,12927,42896,3975,212485,24884,8779,2794,38451,26673
TGGATCAAGTAGAATG,sample,98861,97420,10107,87313,13134,74179,39593,2518,18011,2349,57604,11708,6905,2308,11477,8819
CCATTCTTGTAGAATG,sample,329705,327007,15829,311178,32460,278718,169600,9725,66865,8274,236465,24254,7289,2548,38290,23412
CATTCGGTGTAGAATG,sample,237041,235622,10706,224916,48479,176437,132026,9625,21665,2515,153691,10606,5290,2364,49568,35922
GCTCTTCTGTAGAATG,Pos_Ctrl,96112,94865,6678,88187,3685,84502,71232,6556,4694,561,75926,1459,7265,9619,5843,1377
GGCGACGAGTAGAATG,sample,307699,305545,17934,287611,48683,238928,155473,14080,42088,5126,197561,22161,7636,2355,44028,34596
CGCGGTCGGTAGAATG,Pos_Ctrl,56494,55769,3530,52239,2307,49932,42271,4007,2395,377,44666,882,6435,7922,3348,848
ATTCTACCGTAGAATG,sample,306746,304987,15970,289017,36244,252773,167212,8003,46122,6197,213334,25239,8059,2217,49296,25883
AGATACTAGTAGAATG,sample,186791,185913,6570,179343,37028,142315,109349,10240,15146,1443,124495,6137,3754,1619,32722,25574
CCTAACTAGTAGAATG,sample,260799,259439,9376,250063,30026,220037,141328,11007,45641,4954,186969,17107,6984,2576,27286,21959
TTAACTGAGTAGAATG,sample,46930,46582,1563,45019,6392,38627,25651,2161,7425,828,33076,2562,2364,1090,6513,4615
AACCGGTTCAATAGTC,sample,1091,1058,103,955,217,738,499,37,120,19,619,63,373,245,138,148
CATAATGGCAATAGTC,sample,125582,124325,8655,115670,12421,103249,58715,4778,24022,2588,82737,13146,5220,1774,16689,8683
TCATCGAACAATAGTC,sample,140252,138350,13075,125275,13427,111848,62003,3276,26796,3049,88799,16724,7104,1786,20044,9451
TGATTCCGCAATAGTC,sample,131899,130521,9043,121478,12217,109261,65384,4517,24490,3122,89874,11748,5665,1810,16766,8828
TACGCGAGCAATAGTC,sample,107894,106683,6289,100394,11761,88633,54940,4176,19494,1938,74434,8085,4347,1795,13992,7906
GACTCAAGCAATAGTC,sample,286666,283217,25147,258070,24679,233391,129938,10043,58745,6727,188683,27938,9512,2893,27385,17294
CCGTACGCCAATAGTC,sample,204461,202575,13028,189547,29608,159939,104510,6974,31807,3007,136317,13641,6949,2119,29860,21831
GGCAGGTTCAATAGTC,sample,220042,218389,13174,205215,22955,182260,106743,7687,44122,6314,150865,17394,6611,2751,20933,18098
GATGCGTTCAATAGTC,sample,279028,277095,14845,262250,28796,233454,163937,10338,35370,3654,199307,20155,7920,3349,24899,20684
GCTCTTCTCAATAGTC,sample,129025,128146,9099,119047,14688,104359,59800,4394,22061,2350,81861,15754,7119,1717,16928,9966
GAGATTCTCAATAGTC,sample,236594,235119,17000,218119,27101,191018,115284,7407,39071,5174,154355,24082,8697,2703,28440,19502
CTAACCGGCAATAGTC,sample,112208,111595,4794,106801,15769,91032,64807,5176,13147,1818,77954,6084,3643,1566,20948,11051
GCTGCTTCCAATAGTC,sample,150416,149638,6991,142647,30534,112113,73199,6414,19701,2416,92900,10383,6081,2186,18973,21379
GTCGCGAACAATAGTC,sample,118429,117862,6459,111403,14760,96643,52934,6854,21262,2245,74196,13348,7405,1931,10479,10263
CGCGGTCGCAATAGTC,sample,49455,49179,2800,46379,7544,38835,24621,2180,6868,841,31489,4325,3849,1347,4061,4873
TTATGACGCAATAGTC,sample,68920,68682,1727,66955,15051,51904,40242,4266,4966,487,45208,1943,2263,1727,7728,10157
AAGTAGAGCAATAGTC,sample,128144,127503,4921,122582,13280,109302,63433,5374,26372,3180,89805,10943,5479,2156,10735,9432
GACTAACCCAATAGTC,sample,127763,126487,13567,112920,11208,101712,41893,2533,30884,3585,72777,22817,9438,1844,10897,6316
GCGCAATACAATAGTC,sample,214476,213161,11825,201336,30314,171022,120238,8135,25716,2563,145954,14370,5236,1824,31117,21685
TTAACTGACAATAGTC,sample,183321,182465,6843,175622,23023,152599,113202,9638,18522,2359,131724,8878,4891,1806,32863,17106
CTGGTCTTCGTTACTC,sample,550597,546724,32620,514104,72143,441961,270084,20685,88107,9986,358191,53099,12709,4566,65939,50516
GTCGTTCTCGTTACTC,Neg_Ctrl,3127,1953,1036,917,127,790,442,40,172,12,614,124,377,221,127,93
CATAATGGCGTTACTC,sample,256252,255009,13306,241703,38041,203662,132508,10716,34533,3885,167041,22020,9861,3411,28193,27025
CATACTCCCGTTACTC,sample,286087,282938,19352,263586,38996,224590,161885,9278,33241,2980,195126,17206,7426,2861,41287,28051
TCGAACGACGTTACTC,sample,205519,203335,15601,187734,32589,155145,96676,7074,31612,3546,128288,16237,7738,2657,32564,22340
GGTAGAGACGTTACTC,sample,346807,344129,18186,325943,51217,274726,214580,15185,27279,4210,241859,13472,5958,3017,55120,39093
ATTCAAGGCGTTACTC,sample,194139,192294,10837,181457,28387,153070,113250,8835,21420,2700,134670,6865,4892,2885,27499,22225
GCAACTAGCGTTACTC,sample,85090,84523,6772,77751,11330,66421,38866,3483,15670,1769,54536,6633,5227,2257,9202,7890
TACGCGAGCGTTACTC,Neg_Ctrl,2249,1676,594,1082,123,959,549,28,221,31,770,130,483,227,132,113
GACTCAAGCGTTACTC,sample,351110,345338,42442,302896,29156,273740,126592,6961,78131,8921,204723,53135,13778,3806,28210,17409
CCGTACGCCGTTACTC,sample,243093,240404,19999,220405,35362,185043,118122,7365,34699,3854,152821,21003,7966,3127,27371,25202
TCTCAGGACGTTACTC,sample,144483,143110,11047,132063,28626,103437,70169,3829,17610,2028,87779,9801,4815,1967,25815,19963
TGGATCAACGTTACTC,sample,244768,241619,24103,217516,26138,191378,86073,5331,67572,10133,153645,22269,8312,3350,13663,18104
TGCGCGTTCGTTACTC,sample,229265,227668,11218,216450,25744,190706,115004,6750,48868,5166,163872,14918,5742,2358,30820,18117
CCATTCTTCGTTACTC,sample,278646,276852,12635,264217,50002,214215,158073,9617,29943,3168,188016,13414,5719,2580,47542,37658
CATTCGGTCGTTACTC,sample,330798,328400,22753,305647,52696,252951,161957,10680,46002,5166,207959,29146,8553,2615,46064,36602
GAGATTCTCGTTACTC,Neg_Ctrl,2231,1726,541,1185,171,1014,632,38,216,23,848,105,534,283,158,116
GGCGACGACGTTACTC,sample,363135,360602,22283,338319,64744,273575,188419,11275,45471,5605,233890,22805,7580,2659,59579,47273
GCTGCTTCCGTTACTC,sample,333657,331016,23463,307553,59732,247821,172622,8893,39923,3883,212545,22500,8681,2948,51097,42179
AGCAGAGCCGTTACTC,sample,106552,105386,10989,94397,19894,74503,35496,2608,21375,2511,56871,12513,7320,2540,11007,12792
GGCGTACCCGTTACTC,sample,132504,131287,12765,118522,19805,98717,54632,3689,22960,3119,77592,14317,7078,1872,20408,13257
GTCGCGAACGTTACTC,sample,230482,228681,14416,214265,43236,171029,110341,7917,32874,2934,143215,16963,7289,3016,33857,30768
CGCGGTCGCGTTACTC,sample,224963,223313,11028,212285,29689,182596,113792,8818,38026,4929,151818,17031,7132,2414,26491,20523
TTATGACGCGTTACTC,Neg_Ctrl,1844,1370,456,914,130,784,518,31,155,12,673,68,420,226,128,66
TCAATCAGCGTTACTC,sample,266452,264596,15028,249568,26079,223489,135527,12314,49010,4520,184537,22118,7624,2619,26859,18415
CATAATGGTGGACTGC,sample,68944,68027,6139,61888,12431,49457,29340,2080,9578,1020,38918,7439,5491,1992,8395,8679
GGTAGAGATGGACTGC,sample,217243,214430,17465,196965,28865,168100,105828,7982,32256,3912,138084,18122,7438,2499,27911,20625
GCAACTAGTGGACTGC,sample,60897,60376,3660,56716,10639,46077,30121,2495,8860,955,38981,3646,4109,2341,7491,7634
TACGCGAGTGGACTGC,sample,268741,265217,19435,245782,22818,222964,123363,8023,62125,5963,185488,23490,8298,3003,22855,15718
GACTCAAGTGGACTGC,sample,189162,185979,20979,165000,18480,146520,60077,3810,42995,4586,103072,35052,11080,2415,19281,11062
TGGATCAATGGACTGC,sample,148700,146923,10852,136071,14995,121076,66577,4348,33354,4233,99931,12564,6424,2718,14249,11187
ATGGCGTTTGGACTGC,sample,121448,120394,7944,112450,19596,92854,60331,3948,17554,2093,77885,8928,5868,2327,18652,14011
CCATTCTTTGGACTGC,sample,61555,60829,6160,54669,7730,46939,25974,1526,11349,1483,37323,6607,4983,1741,8557,4848
CATTCGGTTGGACTGC,sample,118974,118230,5226,113004,29873,83131,61410,4171,12048,1343,73458,4159,3694,2543,18131,19768
GGCGACGATGGACTGC,sample,182455,181479,7303,174176,35875,138301,107375,7437,15082,1598,122457,6809,4484,2531,28312,25765
TAACGAAGTGGACTGC,sample,66804,66429,2796,63633,9389,54244,31810,1931,14750,1992,46560,3761,3904,2415,6880,7230
GCTGCTTCTGGACTGC,sample,163081,162278,8375,153903,33715,120188,75440,6220,22630,2303,98070,13595,6073,2376,26364,23412
ATACCGCCTGGACTGC,sample,132308,130501,15297,115204,12965,102239,42199,2657,34734,3846,76933,18803,9079,2495,10238,8199
ATGAATAGTGGACTGC,sample,215563,213904,12697,201207,22038,179169,114587,8560,35760,3378,150347,16884,6997,2539,20824,15480
ATTCTACCTGGACTGC,sample,161417,160059,12294,147765,19527,128238,75247,5363,27745,2689,102992,17194,8074,2112,24183,13554
CGCGAGACTGGACTGC,sample,188621,187255,10821,176434,21240,155194,101424,8571,28067,2891,129491,14241,7623,2720,20690,15410
CGTAGAACTGGACTGC,sample,219770,217912,15744,202168,21077,181091,102514,8622,44844,5216,147358,19895,8698,3107,17637,14740
CCTAACTATGGACTGC,sample,151952,150780,9253,141527,15510,126017,74782,5372,28258,3541,103040,14064,6597,1868,16917,10547
CTGGTCTTCCTTGAGC,sample,246741,244619,20727,223892,27589,196303,102466,7067,46978,5590,149444,34202,9914,2650,33550,18962
AGCTGAATCCTTGAGC,sample,455926,449133,46711,402422,47795,354627,206354,16335,74752,8425,281106,48761,11690,3726,36113,32306
GAGCCTCCCCTTGAGC,Pos_Ctrl,158280,152090,18640,133450,6070,127380,106341,9152,8275,982,114616,2630,8045,10975,7866,3031
CTAGCGACCCTTGAGC,sample,384491,379088,44922,334166,38249,295917,121111,8947,90068,10536,211179,65255,13925,3128,36033,24738
TCGAACGACCTTGAGC,sample,361584,357460,33110,324350,45585,278765,168208,10170,53104,5362,221312,41921,12547,3832,42135,30747
GGTAGAGACCTTGAGC,sample,352586,348567,25682,322885,28115,294770,168527,10213,74672,8107,243199,33251,8982,2954,32091,19395
ATTCAAGGCCTTGAGC,sample,338262,335706,16399,319307,46435,272872,215849,15121,29198,1690,245047,11014,4631,2149,69276,35446
GCAACTAGCCTTGAGC,sample,58796,58266,3912,54354,8474,45880,28725,2386,10115,1142,38840,3512,3786,2590,5040,6602
GACTCAAGCCTTGAGC,sample,324861,320880,26196,294684,38160,256524,149728,9415,61625,6547,211353,29209,9012,3144,35373,26088
GGCAGGTTCCTTGAGC,Pos_Ctrl,88108,85788,10157,75631,3705,71926,60485,4972,4581,576,65066,1312,7301,8746,5370,1805
ATGGCGTTCCTTGAGC,sample,94517,93635,7659,85976,18317,67659,47591,3464,9455,1020,57046,6129,4902,2514,13656,12537
CCATTCTTCCTTGAGC,sample,174787,173779,8571,165208,27747,137461,83527,5900,33583,3493,117110,10958,5193,2183,19323,18364
CGGTTGGTCCTTGAGC,sample,149696,147809,22991,124818,11701,113117,41781,2468,39742,4543,81523,24583,9878,2304,10820,6968
ACGCTTAACCTTGAGC,sample,155275,153765,11875,141890,18291,123599,75443,5840,25690,3150,101133,13476,6868,2174,22105,12668
TAGCGAGTCCTTGAGC,sample,315830,313937,20702,293235,43632,249603,131838,10730,60265,6473,192103,40297,11194,2869,43157,30476
AAGGTCTGCCTTGAGC,sample,223815,221940,15970,205970,24327,181643,110052,8007,38835,3861,148887,20888,8706,2737,30412,16602
GCTGCTTCCCTTGAGC,Pos_Ctrl,76103,74795,7865,66930,3222,63708,53514,4535,3840,575,57354,1244,7174,8481,4769,1611
GCCTATTCCCTTGAGC,sample,241655,239788,16096,223692,29477,194215,113148,5782,48134,5288,161282,21863,7440,2498,34928,20276
ATACCGCCCCTTGAGC,sample,180111,178322,22007,156315,21341,134974,56031,4222,39828,4427,95859,30466,10648,2622,15792,13861
TTATGACGCCTTGAGC,sample,329351,327059,19910,307149,41644,265505,170454,10634,47822,5080,218276,31515,8469,2562,45922,29285
CCTAACTACCTTGAGC,Pos_Ctrl,79545,78739,4939,73800,3325,70475,59439,6231,3274,434,62713,1097,6862,9291,3978,1388
GCGCAATACCTTGAGC,sample,211804,210492,11959,198533,35443,163090,99038,7485,34850,3669,133888,18048,9105,3019,24640,25621
AGCTGAATCGATATCC,sample,268129,266215,12602,253613,35183,218430,151193,9752,38003,4590,189196,14892,5841,2397,40462,25206
GACGTATGCGATATCC,sample,158990,157426,12493,144933,23701,121232,63251,4650,32005,3295,95256,18031,8181,2540,18601,15832
TATACGGACGATATCC,sample,288323,286650,11080,275570,33924,241646,161552,10209,51158,4840,212710,13887,5151,2480,45793,26339
GAGCCTCCCGATATCC,sample,346423,344520,15905,328615,58281,270334,199509,11540,34753,3584,234262,20948,7265,2718,58127,42496
TCGAACGACGATATCC,sample,220590,219069,11171,207898,29697,178201,113906,7780,35079,3736,148985,17700,7458,2528,28591,22684
TCATACCACGATATCC,sample,460666,455345,35897,419448,46124,373324,235905,17521,67037,7965,302942,44896,11363,4461,39978,33412
GACTCAAGCGATATCC,sample,224119,221574,14765,206809,26083,180726,107794,8205,44010,5023,151804,15694,6688,2584,27916,17873
ATACGTTCCGATATCC,sample,320590,317930,15946,301984,47553,254431,200110,13008,26445,2943,226555,11925,7220,4137,34947,34297
CCGTACGCCGATATCC,sample,237386,233607,23833,209774,26082,183692,97384,7170,42088,4562,139472,32488,10464,2805,31103,17505
GGCAGGTTCGATATCC,sample,280142,277564,21404,256160,40798,215362,138128,9060,36117,4604,174245,27453,9089,2833,33365,28190
ATGGCGTTCGATATCC,sample,337384,334970,20546,314424,55108,259316,181252,13047,39682,5287,220934,20048,7313,2634,43466,39519
ACGCTTAACGATATCC,sample,269414,267487,16390,251097,35022,216075,152619,10663,32140,3908,184759,16745,8598,3749,32719,24610
CTAAGCATCGATATCC,sample,270782,269094,15172,253922,51203,202719,141981,10094,29903,3179,171884,17562,6935,2185,40293,35678
TAACGAAGCGATATCC,sample,245753,244337,9163,235174,37068,198106,139342,9915,34691,4142,174033,10016,4485,1922,48811,27120
TGCGCTCCCGATATCC,sample,212046,210653,9893,200760,30592,170168,104595,7036,40611,5289,145206,12637,5267,2379,26336,22547
CGTCGAGGCGATATCC,sample,226522,224352,20653,203699,29600,174099,91117,5048,44223,4359,135340,29352,10481,2730,31549,21187
TTATGACGCGATATCC,sample,267083,265732,10885,254847,27830,227017,155739,17185,34550,4057,190289,15486,5837,2513,30375,19341
TCTCCTAGCGATATCC,sample,331999,329364,29078,300286,35336,264950,129566,8268,65769,8642,195335,52705,14732,3835,32051,23554
ATTCTACCCGATATCC,sample,272532,270971,12941,258030,41964,216066,159990,10710,26790,2239,186780,16337,6165,2213,38313,30919
AGATACTACGATATCC,sample,235896,234335,10798,223537,34017,189520,132756,12863,27454,2554,160210,13893,6526,2645,30916,25168
CCTAACTACGATATCC,sample,262456,260939,14108,246831,45672,201159,130307,12310,33051,3597,163358,21894,8598,2754,30692,31944
GCGCAATACGATATCC,sample,251107,249833,9101,240732,45228,195504,143277,13963,23796,2894,167073,11574,5824,2357,29377,33411
AGAGTTCTATCTGACC,sample,70577,69707,9951,59756,7930,51826,23082,1462,15777,1774,38859,9731,6715,2463,4610,4959
CATAATGGATCTGACC,sample,86870,86269,5779,80490,9738,70752,38283,3455,18122,2373,56405,8519,5303,2226,7193,6693
GAGCCTCCATCTGACC,sample,80786,80333,2906,77427,12797,64630,48672,4473,8004,870,56676,2611,3043,2297,9263,9164
CATACTCCATCTGACC,Neg_Ctrl,905,581,276,305,31,274,175,9,65,6,240,19,188,97,37,23
CTAGCGACATCTGACC,sample,96263,95716,4603,91113,13746,77367,51466,3972,14093,1703,65559,6133,4474,2365,10569,9407
GGTAGAGAATCTGACC,sample,199370,197784,12205,185579,27342,158237,110618,7239,23572,2223,134190,14585,6303,2654,19974,19083
GCAACTAGATCTGACC,sample,82744,82089,3982,78107,8268,69839,42051,3253,16694,2025,58745,5816,3655,1791,8640,6180
GATGCGTTATCTGACC,Neg_Ctrl,641,529,108,421,59,362,232,19,75,5,307,31,211,124,55,35
GAGATTCTATCTGACC,sample,136053,134976,9531,125445,24921,100524,70751,3919,15200,1510,85951,9144,5514,2259,19247,16867
GCCTATTCATCTGACC,Neg_Ctrl,712,454,171,283,35,248,140,10,56,6,196,36,147,72,41,20
CGTCGAGGATCTGACC,sample,173715,172130,13698,158432,17710,140722,84940,5458,35447,4430,120387,10447,6511,3230,15039,12580
TTATGACGATCTGACC,sample,207834,206799,9388,197411,33867,163544,123543,11115,17808,1964,141351,9114,5940,3036,21831,24269
TCAATCAGATCTGACC,sample,200383,199315,6853,192462,26177,166285,130905,10773,15432,2503,146337,6672,4648,3094,18454,19289
TAACGCCAATCTGACC,sample,188365,187167,9269,177898,20094,157804,100109,7196,33043,4033,133152,13423,6441,2475,20913,14659
GCGCAATAATCTGACC,Neg_Ctrl,605,356,132,224,41,183,106,8,44,6,150,19,115,56,20,15
AGCTGAATCTTCTTAC,sample,92733,91979,4129,87850,15147,72703,47296,3665,14123,1241,61419,6378,3184,1622,14895,11268
GACGTATGCTTCTTAC,sample,11467,11280,947,10333,1540,8793,4925,390,2147,261,7072,1070,1758,1006,1337,1016
GAGCCTCCCTTCTTAC,sample,1089,1073,113,960,185,775,458,36,169,20,627,92,395,226,128,123
CATACTCCCTTCTTAC,sample,677,661,81,580,89,491,311,24,89,12,400,55,271,172,68,65
TCGAACGACTTCTTAC,sample,6283,6172,482,5690,837,4853,2712,201,1241,130,3953,569,1564,855,602,562
GGTAGAGACTTCTTAC,sample,107910,107294,6525,100769,16919,83850,51060,4401,16324,1934,67384,10131,5557,1910,13599,11118
CCATTCTTCTTCTTAC,sample,159603,158473,5892,152581,27263,125318,104065,6907,9883,880,113948,3583,3753,3318,19420,20527
AGCGTCTTCTTCTTAC,sample,232673,230642,17702,212940,45305,167635,77998,5478,46208,4604,124206,33347,9802,2581,19987,31565
AAGGTCTGCTTCTTAC,sample,92633,92056,6109,85947,18904,67043,46649,2640,10046,1052,56695,6656,5119,2065,14011,13267
ATACCGCCCTTCTTAC,sample,222542,221181,10062,211119,34610,176509,116001,6704,36503,5039,152504,12262,5017,2151,31539,24269
GTCGCGAACTTCTTAC,sample,139168,138360,6298,132062,21373,110689,75844,5894,19825,2209,95669,6917,4962,2860,18385,15562
CGCGGTCGCTTCTTAC,sample,205668,204480,9310,195170,28456,166714,117019,8639,25955,3303,142974,11798,6131,2016,28782,20689
ATTCTACCCTTCTTAC,sample,252556,251117,15740,235377,32364,203013,113466,9618,44275,4240,157741,31414,11274,3191,26148,21661
GACTAACCCTTCTTAC,sample,339420,336696,32101,304595,27633,276962,115776,7568,85349,9915,201125,58354,16743,4303,19335,16119
CGTAGAACCTTCTTAC,sample,190111,188975,9325,179650,22235,157415,87845,7089,40894,4818,128739,16769,7152,2287,19842,14781
AGATACTACTTCTTAC,sample,115092,114601,5509,109092,18529,90563,54163,3955,20734,2323,74897,9388,5141,1546,15960,12733
AGCTGAATACTTCTAC,sample,1211,1196,117,1079,221,858,544,34,175,13,719,92,451,275,126,150
GGAGAAGCACTTCTAC,sample,630,613,75,538,70,468,287,20,101,7,388,53,262,151,66,56
CTAGCGACACTTCTAC,sample,682,667,82,585,87,498,295,22,100,14,395,67,284,148,67,56
GCAACTAGACTTCTAC,sample,145051,143815,10148,133667,8393,125274,61778,3916,42330,5068,104108,12182,5920,2451,6667,6150
ATACGTTCACTTCTAC,sample,198250,196384,11388,184996,24769,160227,106088,7858,32928,3666,139016,9687,5175,3033,21585,19403
CCGTACGCACTTCTAC,sample,109198,107774,9945,97829,14039,83790,50493,3502,18379,2257,68872,9159,4349,1640,17043,10490
TGGATCAAACTTCTAC,sample,210431,208898,11144,197754,31967,165787,118493,9046,24122,2683,142615,11443,5825,2567,29991,24320
ATGGCGTTACTTCTAC,sample,137998,136968,6513,130455,19551,110904,81572,5411,15647,1645,97219,6629,4743,2266,21401,15016
CCATTCTTACTTCTAC,sample,130295,129521,6049,123472,25159,98313,70119,6150,13876,1780,83995,6388,4595,2217,21558,18423
TAGCGAGTACTTCTAC,sample,145029,144267,4279,139988,34131,105857,85415,6457,8736,1866,94151,3383,3176,2470,25218,23584
GCTCTTCTACTTCTAC,sample,117089,116231,8891,107340,18127,89213,57139,3513,15132,2077,72271,11352,6308,2093,16907,12614
GAGATTCTACTTCTAC,sample,163224,162463,5977,156486,28084,128402,103034,7916,10980,1214,114014,5258,4249,2791,22353,20762
GGCGACGAACTTCTAC,sample,154900,153753,13870,139883,19401,120482,65251,3973,27684,3229,92935,20345,9856,2567,17000,13313
TGCGCTCCACTTCTAC,sample,159846,158973,5797,153176,29119,124057,104839,7356,8202,998,113041,2662,2053,1725,33704,21325
GCGTTACCACTTCTAC,sample,81569,80996,4065,76931,14383,62548,38842,3314,12456,2161,51298,5775,3930,1474,13681,9688
CGTCGAGGACTTCTAC,sample,149695,148652,8264,140388,18991,121397,84492,6549,18585,1592,103077,10179,6183,2668,17161,11957
CAGCTTCGACTTCTAC,sample,178826,177764,9114,168650,17072,151578,85743,6072,41615,4967,127358,13181,5644,2145,17314,12550
CGCGGTCGACTTCTAC,sample,123933,123284,3843,119441,21892,97549,78801,7014,8063,1102,86864,2569,2659,2297,17825,15559
TCTCCTAGACTTCTAC,sample,158502,157589,5397,152192,16146,136046,97139,8189,22050,3384,119189,5284,4014,2722,15085,11441
ATTCTACCACTTCTAC,sample,157730,156784,10283,146501,19192,127309,72569,5269,28762,3006,101331,17703,7763,2238,20472,13609
CGTAGAACACTTCTAC,sample,115698,115017,6383,108634,12078,96556,51083,3401,27349,3153,78432,11570,5573,1972,10138,8699
AGATACTAACTTCTAC,sample,179246,177609,15586,162023,17240,144783,68048,5126,41861,4854,109909,24894,8704,2156,16461,11727
ATATGCAAACTTCTAC,sample,165903,164873,14331,150542,16241,134301,60017,5327,39373,3825,99390,25759,10412,2538,15578,9844
AACCGGTTAGAAGTAA,sample,40453,40053,1570,38483,5004,33479,20122,1493,8572,842,28694,2450,2792,1628,4062,3465
AGCTGAATAGAAGTAA,sample,940,920,94,826,129,697,400,33,151,14,551,99,356,189,96,80
TATACGGAAGAAGTAA,sample,878,860,110,750,87,663,385,18,157,18,542,85,371,194,106,66
CATACTCCAGAAGTAA,sample,764,749,96,653,81,572,342,23,129,9,471,69,321,168,87,54
CTAGCGACAGAAGTAA,sample,959,941,121,820,111,709,392,36,167,26,559,88,393,207,70,75
TCATACCAAGAAGTAA,sample,173293,171545,10117,161428,21923,139505,102517,7614,18759,1443,121276,9172,5457,2564,22066,16517
TGATTCCGAGAAGTAA,sample,240455,238639,14979,223660,34013,189647,140855,8828,22267,2489,163122,15208,6354,2343,33297,25583
ATACGTTCAGAAGTAA,sample,418279,413502,31238,382264,36862,345402,191139,11841,100132,9867,291271,32423,9275,3380,29507,27908
TCTCAGGAAGAAGTAA,sample,124066,122674,9042,113632,16858,96774,69482,4736,12756,1747,82238,8053,5145,2090,24096,12193
AGCGTCTTAGAAGTAA,sample,151238,150098,6024,144074,27454,116620,81587,6698,19941,1919,101528,6475,3992,1676,22233,18904
ACGCTTAAAGAAGTAA,sample,200034,198478,20175,178303,20870,157433,67283,3851,51137,5128,118420,30034,11085,2614,21227,13759
TAGCGAGTAGAAGTAA,sample,391780,389060,32152,356908,45156,311752,142904,9948,83863,9175,226767,65862,13527,4114,33500,29959
GCTCTTCTAGAAGTAA,sample,249145,247715,6817,240898,23858,217040,142434,11144,45914,5093,188348,12455,4008,2396,25201,17992
CCTAGCGGAGAAGTAA,sample,229081,227575,12856,214719,24009,190710,106175,6590,48065,6371,154240,23509,7994,2645,21909,16496
CTAACCGGAGAAGTAA,sample,243574,242244,11347,230897,33793,197104,135211,11739,28894,3734,164105,17526,8100,2766,29534,25603
GCTGCTTCAGAAGTAA,sample,167538,166206,27719,138487,23006,115481,36693,2349,43058,5042,79751,28339,12735,3595,8044,13049
GCCTATTCAGAAGTAA,sample,166984,166004,10130,155874,27358,128516,82382,5416,23442,2453,105824,14823,7229,2386,25938,18326
ATACCGCCAGAAGTAA,sample,132487,131620,7738,123882,15900,107982,61038,3848,30412,3503,91450,9181,5429,2198,16590,11618
GGCGTACCAGAAGTAA,sample,215227,214006,10061,203945,31220,172725,120965,9654,27384,3417,148349,11305,5047,2747,26202,22661
TTATGACGAGAAGTAA,sample,196112,194759,10669,184090,29455,154635,101548,6950,29584,2991,131132,13562,6496,2256,27625,21169
TCTCCTAGAGAAGTAA,sample,121583,120884,6902,113982,15169,98813,67592,4676,16087,2105,83679,8353,4932,2123,16615,10661
CGCGAGACAGAAGTAA,sample,262328,260712,12531,248181,39200,208981,153273,12536,29314,3050,182587,10808,6297,2341,38354,27543
CGTAGAACAGAAGTAA,sample,72921,72560,4372,68188,10343,57845,30345,3290,14803,1957,45148,7450,5770,1861,5268,6981
Short,Non_sample,0,NA,NA,NA,NA,NA,NA,NA,NA,NA,NA,NA,NA,NA,NA,NA
Unselected,Non_sample,2641454,NA,NA,NA,NA,NA,NA,NA,NA,NA,NA,NA,NA,NA,NA,NA
Undetermined,Non_sample,285638790,NA,NA,NA,NA,NA,NA,NA,NA,NA,NA,NA,NA,NA,NA,NA
