Barcode,Sample,Barcoded_Reads,Trimmed_Reads,Unmapped_Reads,Mapped_Reads,Multimapped_Reads,Uniquely_Mapped_Reads,Exon_Reads,Ambiguous_Exon_Reads,Intron_Reads,Ambiguous_Intron_Reads,Gene_Reads,Intergenic_Reads,No_of_Genes,No_of_Transcripts,Mitochondrial_Reads,Ribosomal_Reads
GGAGAGTTCGTTGGTT,sample,120,119,9,110,30,80,45,0,21,1,66,13,33,11,18,14
TCCAACTTCGTTGGTT,sample,86921,86590,2218,84372,29641,54731,33975,2604,12292,1574,46267,4286,2060,1010,15496,18269
AAGTTCGTCGTTGGTT,sample,31115,30965,1442,29523,8124,21399,9815,703,7374,849,17189,2658,2426,938,3019,5259
TTCGTAATCGTTGGTT,sample,138993,138446,2383,136063,52901,83162,61609,2792,15159,1457,76768,2145,1309,1043,29492,30744
TTCTAATGCGTTGGTT,sample,110301,109757,5136,104621,28674,75947,37808,2030,22026,2780,59834,11303,4870,1296,19069,18219
ATGCCTGGCGTTGGTT,sample,85092,84667,5546,79121,20052,59069,22636,1606,21814,2128,44450,10885,5423,1268,8270,12806
TGAGCGCGCGTTGGTT,sample,2108,2084,148,1936,698,1238,590,50,357,36,947,205,382,187,206,384
CAACCGCGCGTTGGTT,sample,306,305,6,299,127,172,82,2,66,4,148,18,66,30,34,69
AATGGTAACGTTGGTT,sample,112,99,23,76,21,55,39,0,9,0,48,7,27,18,10,15
GCCTTGCTCGTTGGTT,sample,302,291,22,269,82,187,66,6,64,7,130,44,64,28,20,44
GACGGAGACGTTGGTT,sample,73,73,1,72,20,52,32,1,12,0,44,7,21,12,9,13
ACCTCGAGCGTTGGTT,sample,68,61,6,55,10,45,23,1,15,1,38,5,25,13,7,10
GGCCAGAGCGTTGGTT,sample,111,108,4,104,32,72,33,0,18,3,51,18,26,11,13,19
CGAGGCAGCGTTGGTT,sample,202,196,21,175,36,139,53,2,41,11,94,32,53,19,9,26
ACGACTTCCGTTGGTT,sample,68,65,4,61,14,47,23,0,9,2,32,13,18,9,8,10
CATGATTCCGTTGGTT,sample,201,191,14,177,54,123,58,1,34,8,92,22,53,26,10,35
AGTCCGCACGTTGGTT,sample,285,284,18,266,124,142,72,11,43,3,115,13,53,32,35,66
CTAGGACCCGTTGGTT,sample,1605,1581,90,1491,270,1221,534,46,461,41,995,139,401,179,103,182
GTTAGGACCGTTGGTT,sample,12594,12529,382,12147,4327,7820,4711,319,1885,249,6596,656,1055,561,1697,2539
TTGGCCTCCGTTGGTT,sample,56675,56462,2317,54145,13168,40977,17460,1141,15750,1434,33210,5192,3215,1101,5679,8637
GAAGGCGCCGTTGGTT,sample,3838,3809,98,3711,1671,2040,1189,113,535,86,1724,117,503,313,399,862
AAGAGCGCCGTTGGTT,sample,1470,1454,78,1376,429,947,345,20,385,23,730,174,330,122,108,244
CCAATTCCCGTTGGTT,sample,89,86,10,76,16,60,17,9,18,5,35,11,20,8,6,11
TTGGTTAACGTTGGTT,sample,74,74,5,69,20,49,30,1,13,0,43,5,27,16,6,13
TCAATATACGTTGGTT,sample,131,129,2,127,40,87,38,0,31,3,69,15,29,10,22,27
GGAGAGTTCTATCGTT,sample,498,496,21,475,161,314,206,14,79,2,285,13,95,48,112,100
AGTACCATCTATCGTT,sample,123000,122483,3059,119424,38739,80685,56535,2789,16754,1387,73289,3220,1920,1083,29315,25407
CAACCGCGCTATCGTT,sample,45491,45203,2616,42587,6553,36034,14130,707,14136,1847,28266,5214,3120,1044,2457,4612
TTAGAAGTCTATCGTT,sample,117328,116942,1930,115012,40222,74790,58902,2121,10271,1278,69173,2218,1363,948,30190,24777
CCAGAGCGCTATCGTT,sample,55198,54854,3648,51206,12627,38579,20620,1327,9858,1001,30478,5773,3922,1676,5736,7908
GTTAGCCGCTATCGTT,sample,80245,79871,2234,77637,22636,55001,36808,3094,10326,878,47134,3895,2574,1384,11077,15048
ACCTCGAGCTATCGTT,sample,73717,73459,2561,70898,24276,46622,31463,2122,9349,1299,40812,2389,2289,1240,12488,14816
CATTGCAGCTATCGTT,sample,58561,58190,5239,52951,10899,42052,15415,1136,14690,1746,30105,9065,4717,1186,3349,7081
CGTACGTCCTATCGTT,sample,84591,84102,4675,79427,19868,59559,34945,2352,13408,1677,48353,7177,3845,1451,9626,13228
TTGGTACCCTATCGTT,sample,108489,107636,10641,96995,18054,78941,31716,1799,26913,2492,58629,16021,6013,1216,12355,12101
TGCTTCGCCTATCGTT,sample,84391,83637,8611,75026,9114,65912,22909,1365,25293,2884,48202,13461,5419,1354,3261,6096
AAGAGCGCCTATCGTT,sample,73031,72505,4925,67580,16514,51066,23187,1386,16390,1996,39577,8107,4591,1407,8363,10780
CCAATTCCCTATCGTT,sample,41365,41057,3717,37340,5797,31543,10739,886,12235,1312,22974,6371,3506,1133,1764,3823
GTACCGTACTATCGTT,sample,4832,4789,266,4523,1063,3460,1506,102,1189,190,2695,473,889,401,356,693
CTTCATGACTATCGTT,sample,157,152,9,143,25,118,50,2,42,4,92,20,49,21,11,20
ATGACCGACTATCGTT,sample,78,75,12,63,9,54,33,0,11,1,44,9,23,12,11,9
GGAGAGTTGTCTTCTT,sample,1681,1663,55,1608,399,1209,622,33,370,82,992,102,352,155,200,265
TATCAGTTGTCTTCTT,sample,88420,87924,7389,80535,20913,59622,26719,1484,19148,1775,45867,10496,4077,1155,8526,12735
GGTTGCGTGTCTTCTT,sample,87493,86958,3947,83011,24478,58533,36514,1628,12797,1371,49311,6223,2680,932,18504,16008
CCTCTAGAGTCTTCTT,Pos_Ctrl,42083,41263,3197,38066,2171,35895,29865,2536,2510,298,32375,686,4817,4683,2928,1220
TTCTAATGGTCTTCTT,sample,65970,65599,3238,62361,18187,44174,26511,2120,9667,891,36178,4985,3513,1474,8300,11794
CAACCGCGGTCTTCTT,sample,63342,63003,1512,61491,20766,40725,31190,877,7045,750,38235,863,1064,779,19082,13186
CAAGGCCTGTCTTCTT,sample,77953,77126,9091,68035,11694,56341,14843,863,23317,2496,38160,14822,5914,1109,3043,7166
CCAGAGCGGTCTTCTT,sample,48320,48015,3007,45008,5482,39526,16801,1432,13927,1512,30728,5854,3219,1252,2581,3976
ACCTCGAGGTCTTCTT,sample,76473,76033,2788,73245,19212,54033,36891,2141,10886,1147,47777,2968,1880,911,18601,13286
CCATGAAGGTCTTCTT,sample,21984,21742,2614,19128,3375,15753,5405,311,5787,616,11192,3634,2503,675,1665,2137
CGTACGTCGTCTTCTT,sample,53718,53357,2897,50460,12233,38227,21283,1400,8936,1062,30219,5546,3569,1301,8106,8211
CGGATTACGTCTTCTT,sample,88689,88250,2364,85886,28470,57416,39659,2426,11450,1316,51109,2565,1066,841,19080,18901
AATATATCGTCTTCTT,sample,85219,84438,9213,75225,13663,61562,18914,1173,23480,2683,42394,15312,5804,1243,3949,8667
GTCTTAGCGTCTTCTT,sample,62467,62079,4068,58011,11499,46512,17206,1224,15847,1964,33053,10271,5153,1247,3253,7948
CCAATTCCGTCTTCTT,sample,40099,39763,3832,35931,8399,27532,11116,647,9049,1052,20165,5668,3337,809,4483,5156
AGGTCGGAGTCTTCTT,Pos_Ctrl,558,552,35,517,60,457,293,24,83,11,376,46,167,80,61,51
ACGTAAGTTAGGCTCT,sample,96649,95834,6515,89319,16713,72606,37342,2462,19596,2138,56938,11068,4461,1418,4971,11253
ACGTTATGTAGGCTCT,sample,75334,74643,5719,68924,22165,46759,22891,1417,13587,1399,36478,7465,4493,1502,6226,13003
CAACCGCGTAGGCTCT,sample,116973,116154,9176,106978,24173,82805,28863,1205,31233,4112,60096,17392,6544,1274,8824,15807
TTCCGTCTTAGGCTCT,sample,246732,245618,7136,238482,71637,166845,108404,6414,38920,3538,147324,9569,2466,1228,50089,47000
CAAGGCCTTAGGCTCT,sample,154351,153275,8233,145042,19928,125114,55869,3706,44693,4815,100562,16031,5118,1645,9546,14600
CATAACCTTAGGCTCT,sample,144762,143894,7713,136181,31126,105055,57554,3551,28454,3229,86008,12267,4886,1539,18077,21000
ACTATACTTAGGCTCT,sample,163889,162881,5487,157394,48010,109384,70203,4785,23523,2339,93726,8534,3545,1425,24765,30693
GACGGAGATAGGCTCT,sample,174594,173653,5632,168021,52372,115649,77457,4423,24982,2664,102439,6123,2765,1356,34581,34567
TGGACGAGTAGGCTCT,sample,173004,171747,9034,162713,37391,125322,68506,3194,30557,3946,99063,19119,4700,1284,31340,26430
CGAGGCAGTAGGCTCT,sample,123901,123084,7221,115863,23677,92186,45507,4078,26786,4001,72293,11814,5339,1581,13325,15819
AATCCGTCTAGGCTCT,sample,166833,165987,4248,161739,52299,109440,77520,4857,20054,2440,97574,4569,1774,1142,34698,34101
AGTCCGCATAGGCTCT,sample,64258,63797,3671,60126,16743,43383,20501,1929,13830,1340,34331,5783,3445,1032,5391,10450
GCCTGAACTAGGCTCT,sample,127416,126466,5789,120677,34712,85965,53011,2559,21540,2418,74551,6437,2738,1059,24461,22402
AACTCGTATAGGCTCT,sample,104909,104286,3917,100369,25331,75038,46055,2129,17774,2240,63829,6840,3236,1186,19328,17768
AAGAGCGCTAGGCTCT,sample,122120,121262,8159,113103,22155,90948,39013,2269,29860,3630,68873,16176,5940,1311,12202,14833
CCAATTCCTAGGCTCT,sample,103219,102548,4100,98448,26053,72395,43683,2774,17205,2366,60888,6367,3430,1187,15688,17526
GTACCGTATAGGCTCT,sample,118808,118257,3999,114258,32587,81671,48706,3165,22397,2348,71103,5055,2901,1298,18640,21585
AGGTCGGATAGGCTCT,sample,166780,165754,12969,152785,37026,115759,46954,2468,37872,4131,84826,24334,8265,1569,18969,24691
TCCAACTTTTGACTAT,Neg_Ctrl,295,176,64,112,29,83,42,0,33,2,75,6,33,17,12,8
AAGTTCGTTTGACTAT,sample,78050,77408,6700,70708,9727,60981,22825,1460,21742,2528,44567,12426,4888,1363,4578,6616
AGTACCATTTGACTAT,Neg_Ctrl,521,394,224,170,41,129,54,6,53,4,107,12,52,20,24,19
ATGCCTGGTTGACTAT,sample,75899,75291,6686,68605,14833,53772,20893,1495,18184,2131,39077,11069,5164,1325,4223,9662
TGAGCGCGTTGACTAT,sample,84724,84082,5165,78917,19394,59523,32287,2318,15130,2364,47417,7424,3369,1098,12631,13779
TTAGAAGTTTGACTAT,sample,39339,39151,917,38234,12795,25439,18397,1156,4502,395,22899,989,1396,1049,5591,8061
TTCCGTCTTTGACTAT,Pos_Ctrl,4110,4053,499,3554,212,3342,2738,219,276,19,3014,90,1100,705,270,152
CATAACCTTTGACTAT,sample,58188,57654,4737,52917,9192,43725,19287,478,14453,1424,33740,8083,3884,831,8593,6082
CCAGAGCGTTGACTAT,sample,60967,60494,2909,57585,12731,44854,23070,1620,13383,1250,36453,5531,2691,737,7511,8777
CCGCAACGTTGACTAT,Pos_Ctrl,6837,6683,749,5934,311,5623,4715,368,410,32,5125,98,1665,1246,465,194
CCATGAAGTTGACTAT,sample,105922,104840,13864,90976,13104,77872,15064,1109,33257,4154,48321,24288,7555,1134,2246,7888
ACGACTTCTTGACTAT,sample,126040,124761,17258,107503,14013,93490,16779,1187,40124,4418,56903,30982,9036,1436,2493,8460
CATGATTCTTGACTAT,sample,82404,81814,5805,76009,12833,63176,29153,1974,20832,1851,49985,9366,4147,1246,9323,9078
AATCCGTCTTGACTAT,Pos_Ctrl,43593,42957,4038,38919,2179,36740,30668,2760,2246,267,32914,799,4891,4763,2787,1197
CGTACGTCTTGACTAT,sample,73860,73067,8703,64364,8120,56244,16429,1119,22625,2301,39054,13770,5738,1219,3953,4904
ACGTATTATTGACTAT,sample,72598,72016,4869,67147,9729,57418,24456,2365,19569,2672,44025,8356,3718,1109,3796,6522
TTGGCCTCTTGACTAT,Pos_Ctrl,37899,37324,3809,33515,1789,31726,26397,2303,2090,309,28487,627,4631,4378,2214,942
CTTCATGATTGACTAT,sample,71304,70611,8352,62259,9585,52674,13395,832,21102,2516,34497,14829,5816,1053,3786,6041
TTATTCGATTGACTAT,Neg_Ctrl,196,136,32,104,18,86,30,5,37,0,67,14,48,19,7,9
TCCAACTTTGCAGTTG,sample,103572,103015,5875,97140,30023,67117,40482,2053,15295,1502,55777,7785,3478,1124,18635,19175
GGTTGCGTTGCAGTTG,sample,43831,43424,1668,41756,11536,30220,19311,1374,6589,527,25900,2419,2367,1306,3996,7591
ACGTTATGTGCAGTTG,sample,58733,58212,5760,52452,9932,42520,14626,946,15871,1901,30497,9176,4705,1112,3829,6543
TAGTACGGTGCAGTTG,sample,116502,115673,6906,108767,26967,81800,39241,2312,24894,2162,64135,13191,4302,1112,17461,17570
TTAGAAGTTGCAGTTG,sample,56961,56414,4288,52126,8742,43384,16222,1128,15955,2146,32177,7933,4220,1196,4051,6104
GCCTTGCTTGCAGTTG,sample,36521,36265,1977,34288,8265,26023,14641,775,6520,802,21161,3285,2610,1161,5679,5514
CCAGAGCGTGCAGTTG,sample,39895,39541,2501,37040,3475,33565,15897,1025,10226,1311,26123,5106,3201,1194,668,2094
GTTAGCCGTGCAGTTG,sample,36673,36314,2063,34251,5205,29046,13205,931,9534,979,22739,4397,2595,815,1519,3738
GGAGGACGTGCAGTTG,sample,88487,87667,9723,77944,9593,68351,15461,1375,27010,3017,42471,21488,7331,1021,4023,5960
ACCTCGAGTGCAGTTG,sample,46067,45766,2127,43639,7600,36039,16636,1224,11850,1803,28486,4526,2694,832,4159,5373
TGGACGAGTGCAGTTG,sample,110381,109569,7117,102452,19303,83149,33421,1668,26754,3286,60175,18020,6113,1190,11557,13287
CCATGAAGTGCAGTTG,sample,82277,81857,2872,78985,22795,56190,34173,2357,13240,1683,47413,4737,2886,1414,12543,14777
TTGGTACCTGCAGTTG,sample,105119,104301,9718,94583,15474,79109,27870,2226,27714,3274,55584,18025,6683,1285,7883,10086
AAGAGCGCTGCAGTTG,sample,75158,74554,4028,70526,9831,60695,28422,1742,21024,2026,49446,7481,3869,1319,6588,6907
GTACCGTATGCAGTTG,sample,80149,79742,1671,78071,26960,51111,34589,2257,10337,2073,44926,1855,1308,886,14610,17352
GGCATATATGCAGTTG,sample,72231,71950,1900,70050,26297,43753,32812,1831,7145,823,39957,1142,1218,964,13698,15755
TCGCCTGATGCAGTTG,sample,74854,74388,6319,68069,15086,52983,15485,954,19646,1940,35131,14958,6025,1011,4590,9436
CTTCATGATGCAGTTG,sample,56889,56459,4200,52259,10590,41669,16644,1319,14341,1542,30985,7823,4115,1157,3855,7229
ATGACCGATGCAGTTG,sample,111,110,2,108,16,92,34,0,33,2,67,23,34,11,1,9
TATCAGTTTCATGCTG,sample,114457,113629,11321,102308,10398,91910,12117,787,41006,4474,53123,33526,9435,1331,1551,6176
AGTACCATTCATGCTG,sample,110893,110248,5500,104748,27242,77506,41178,2710,20704,2779,61882,10135,3544,1272,12792,18655
ACGTTATGTCATGCTG,sample,74628,74242,2699,71543,19647,51896,33079,1969,11910,1306,44989,3632,2472,935,16344,13555
TTCTAATGTCATGCTG,sample,68197,67708,4304,63404,13684,49720,25810,1203,13883,1775,39693,7049,3634,1085,8888,9228
TGAGCGCGTCATGCTG,sample,64463,64030,3719,60311,14781,45530,24391,1381,12576,1172,36967,6010,3101,925,10696,10376
GGACCTCTTCATGCTG,Neg_Ctrl,225,214,54,160,17,143,76,2,38,1,114,26,53,20,23,15
TCGCATCTTCATGCTG,sample,156654,155317,17139,138178,15618,122560,25701,1081,50354,4905,76055,40519,11121,1743,6558,9486
GCCTTGCTTCATGCTG,sample,51085,50574,5147,45427,7278,38149,11436,711,14825,1493,26261,9684,4287,714,2326,4806
ACTATACTTCATGCTG,sample,89966,89209,8460,80749,12161,68588,22435,1207,24636,3487,47071,16823,5318,901,6678,7791
GACGGAGATCATGCTG,sample,69767,69305,3597,65708,11684,54024,26503,2128,16905,2378,43408,6110,2368,814,7257,8352
CCAGAGCGTCATGCTG,sample,73486,73017,5427,67590,11994,55596,26868,2291,15766,2502,42634,8169,3460,976,7085,8478
GGAGGACGTCATGCTG,sample,86866,86091,9279,76812,11074,65738,15219,1376,26160,2832,41379,20151,7064,1119,2926,6863
GGACGTAGTCATGCTG,Neg_Ctrl,252,183,78,105,16,89,26,2,34,2,60,25,27,10,14,9
GGCCAGAGTCATGCTG,sample,91354,90557,9329,81228,18444,62784,25104,1313,20067,2082,45171,14218,6480,1215,11220,11709
CATTGCAGTCATGCTG,sample,55408,55021,3626,51395,11457,39938,21015,1056,11761,947,32776,5159,2797,894,9738,7883
CGAGGCAGTCATGCTG,sample,56198,55714,4989,50725,7972,42753,14145,929,17009,1869,31154,8801,4337,1023,2723,5365
CGTACGTCTCATGCTG,Neg_Ctrl,241,204,50,154,26,128,67,1,33,5,100,22,50,23,18,14
GTTAGGACTCATGCTG,sample,32349,32159,1502,30657,7973,22684,13931,976,5557,551,19488,1669,1676,811,5921,5326
GCCTGAACTCATGCTG,sample,54070,53641,3209,50432,11744,38688,19373,1049,10620,1416,29993,6230,3238,914,6783,8124
ACGTATTATCATGCTG,sample,36815,36646,1065,35581,12824,22757,15643,1660,4157,464,19800,833,1421,1053,3704,7666
AATATATCTCATGCTG,Neg_Ctrl,261,215,68,147,34,113,49,2,35,4,84,23,45,19,9,24
GTCTTAGCTCATGCTG,sample,45615,45284,1852,43432,8395,35037,19120,1075,9751,1316,28871,3775,2299,883,5207,5851
AGGTCGGATCATGCTG,sample,62427,61970,3718,58252,13371,44881,24412,1712,11448,1191,35860,6118,3375,1075,7619,9263
TTATTCGATCATGCTG,sample,38354,38125,2383,35742,7858,27884,11028,834,9931,964,20959,5127,3505,843,4277,5334
ATGACCGATCATGCTG,sample,116,114,12,102,26,76,18,9,29,9,47,11,28,12,3,12
TATCAGTTTTAGGCGG,sample,132976,132290,4027,128263,38251,90012,50432,4538,24026,3066,74458,7950,2477,916,13559,24951
TCCTCCGTTTAGGCGG,sample,187972,186619,13432,173187,34762,138425,65844,5165,42311,4416,108155,20689,5520,1354,16736,24030
ACGTAAGTTTAGGCGG,sample,158973,157877,6272,151605,39866,111739,68285,5175,22589,3569,90874,12121,5206,1707,11112,26415
CCTCTAGATTAGGCGG,Pos_Ctrl,151615,149381,9611,139770,6331,133439,110612,10587,8457,1017,119069,2766,6738,9286,6509,2735
TTCGTAATTTAGGCGG,sample,163076,161914,5257,156657,33281,123376,71508,6292,32099,3155,103607,10322,4085,1532,14044,22170
TGAGCGCGTTAGGCGG,sample,84100,83612,2307,81305,21805,59500,39375,2516,12478,1347,51853,3784,2737,1404,14966,15214
CAACCGCGTTAGGCGG,sample,40370,40063,2483,37580,9201,28379,14494,818,8045,989,22539,4033,2774,987,5411,6112
GCCTTGCTTTAGGCGG,sample,83831,83130,5089,78041,17147,60894,27734,2166,19292,2242,47026,9460,4691,1230,6919,11740
CAAGGCCTTTAGGCGG,sample,98875,98284,3984,94300,24266,70034,43621,3415,16805,1010,60426,5183,2471,1022,12502,16366
CATAACCTTTAGGCGG,sample,20047,19877,1706,18171,3739,14432,6466,613,4363,478,10829,2512,2076,726,1686,2326
TGGACGAGTTAGGCGG,sample,99341,98550,7230,91320,14873,76447,32358,2369,25276,3054,57634,13390,4600,985,10270,10335
ACGACTTCTTAGGCGG,sample,126774,125584,13794,111790,19342,92448,23733,1756,37502,3551,61235,25906,7419,1273,6079,12859
GTCCTGCCTTAGGCGG,sample,24626,24386,2307,22079,3916,18163,6493,387,6670,591,13163,4022,2790,858,1127,2470
TTGGTACCTTAGGCGG,sample,101417,100613,6059,94554,19188,75366,28718,1844,26529,2638,55247,15637,5493,1288,8155,13136
CGGATTACTTAGGCGG,sample,114219,113428,5001,108427,24271,84156,44113,3439,24277,2684,68390,9643,4073,1168,16703,17277
AACTCGTATTAGGCGG,sample,95129,94526,3881,90645,27982,62663,41195,1617,13074,2614,54269,4163,1985,886,16588,18153
GGCATATATTAGGCGG,sample,69098,68556,6034,62522,9785,52737,19417,1304,19908,2114,39325,9994,4240,1026,2972,6882
TCAATATATTAGGCGG,sample,50787,50468,1208,49260,10170,39090,23860,1405,10089,1304,33949,2432,1962,1174,4963,7391
TCGCCTGATTAGGCGG,sample,99714,98966,5965,93001,17394,75607,33408,2470,24300,3056,57708,12373,4671,1239,10256,12293
GACCGGAATTAGGCGG,sample,102,97,3,94,23,71,38,6,10,1,48,16,32,28,3,16
TTCGTAATTCAGATAC,sample,130629,129521,11822,117699,20709,96990,33741,3119,33029,4239,66770,22862,6871,1226,7636,13384
TAGTACGGTCAGATAC,sample,124100,123274,6865,116409,24263,92146,41730,4119,25971,2990,67701,17336,5374,1201,11125,16742
TGAGCGCGTCAGATAC,sample,97598,96690,12503,84187,11107,73080,15113,1223,30674,2943,45787,23127,7411,1010,3038,6591
AATGGTAATCAGATAC,sample,102501,101502,7970,93532,14066,79466,32747,2730,26131,2872,58878,14986,4854,958,7977,9241
GCCTTGCTTCAGATAC,sample,68884,68534,2100,66434,19142,47292,31069,2646,9512,1234,40581,2831,1986,802,11335,13033
CATAACCTTCAGATAC,sample,78896,78023,10448,67575,5275,62300,14221,972,26255,2558,40476,18294,5726,887,862,2784
ACTATACTTCAGATAC,sample,81840,81098,10485,70613,11024,59589,11770,1200,25893,2720,37663,18006,6314,858,1916,5929
GGAGGACGTCAGATAC,sample,47421,47027,2473,44554,8451,36103,19007,1427,9928,1123,28935,4618,2914,940,3750,5599
CCGCAACGTCAGATAC,sample,67995,67599,1881,65718,15828,49890,35396,3620,7527,1162,42923,2185,1499,974,11112,11290
CATTGCAGTCAGATAC,sample,60626,60203,2765,57438,11524,45914,26945,1588,10914,1354,37859,5113,3017,955,7340,8163
CATGATTCTCAGATAC,sample,70655,70145,3288,66857,18817,48040,27734,1581,12293,1736,40027,4696,2340,780,9826,12980
GCCTGAACTCAGATAC,sample,61477,61093,3425,57668,12871,44797,22938,1129,12822,1307,35760,6601,3660,966,7279,8874
CCAATTCCTCAGATAC,sample,45399,44901,6658,38243,5245,32998,6709,534,13630,1433,20339,10692,4290,662,1228,3293
TTATTCGATCAGATAC,sample,33835,33631,2307,31324,8691,22633,9592,884,7297,996,16889,3864,2519,718,3268,5447
GACCGGAATCAGATAC,sample,64,64,4,60,10,50,20,0,17,2,37,11,20,8,10,7
TCCAACTTTCGCTAGG,Neg_Ctrl,281,173,38,135,40,95,36,7,29,10,65,13,31,18,13,12
GGTTGCGTTCGCTAGG,sample,144278,142907,14731,128176,16162,112014,31060,2816,42831,4809,73891,30498,8475,1291,8168,10372
ACGTAAGTTCGCTAGG,sample,78373,77673,2934,74739,17982,56757,31899,2853,15307,1570,47206,5128,2521,700,9937,12821
AGTACCATTCGCTAGG,Neg_Ctrl,575,459,213,246,45,201,83,7,75,6,158,30,63,28,27,15
GGACCTCTTCGCTAGG,sample,82084,81398,8444,72954,10786,62168,21598,1460,21203,2259,42801,15648,5866,1121,5041,6944
GCCTTGCTTCGCTAGG,sample,81074,80404,7308,73096,10507,62589,19187,1502,24361,2830,43548,14709,5804,1014,3985,6515
ACTATACTTCGCTAGG,sample,76561,76009,3784,72225,13898,58327,31735,2230,15286,1643,47021,7433,3906,1206,5221,9273
GGAGGACGTCGCTAGG,sample,101741,100858,9179,91679,12950,78729,25369,1798,28251,3245,53620,20066,6432,1067,8802,8337
CTTGATAGTCGCTAGG,sample,72324,71583,8488,63095,8852,54243,13450,1180,21008,2174,34458,16431,6314,970,2388,5733
ACCTCGAGTCGCTAGG,sample,65594,65089,3014,62075,14165,47910,26391,1816,11865,1551,38256,6287,2794,864,8260,10214
TGGACGAGTCGCTAGG,sample,37239,36971,1960,35011,5172,29839,13268,1204,10243,1429,23511,3695,2339,839,2238,3807
GACGATAATCGCTAGG,sample,72083,71629,3535,68094,15534,52560,31788,2379,12583,1511,44371,4299,2115,952,7896,10585
CATTGCAGTCGCTAGG,sample,69141,68589,4483,64106,11684,52422,26497,1680,14580,1896,41077,7769,3761,972,8678,7926
CGAGGCAGTCGCTAGG,sample,57411,56908,6472,50436,6849,43587,14354,1041,15635,1822,29989,10735,5066,1071,2961,4376
AATCCGTCTCGCTAGG,sample,43432,43067,3390,39677,4584,35093,11062,667,13290,1770,24352,8304,3292,1073,1864,3158
AGTCCGCATCGCTAGG,sample,35968,35721,1219,34502,8703,25799,17863,1356,4647,410,22510,1523,1435,990,5473,6036
TTGGTACCTCGCTAGG,sample,57586,57150,3260,53890,12871,41019,21995,1416,10984,1048,32979,5576,2996,858,6061,8696
AATATATCTCGCTAGG,sample,26286,26010,2490,23520,4316,19204,8982,528,5676,694,14658,3324,2661,971,1553,2717
GTCTTAGCTCGCTAGG,sample,93817,93169,7487,85682,14908,70774,20825,1204,26392,2604,47217,19749,7197,1110,7447,9915
TTGGTTAATCGCTAGG,sample,76651,75939,9419,66520,9008,57512,11906,720,23559,2780,35465,18547,6732,965,2744,6033
GTACCGTATCGCTAGG,Pos_Ctrl,31024,30743,2407,28336,1462,26874,22330,2064,1685,244,24015,551,4215,4091,2013,744
GGCATATATCGCTAGG,sample,27789,27584,1973,25611,5069,20542,8459,615,7141,851,15600,3476,2480,812,1863,3340
CTTCATGATCGCTAGG,sample,86012,85180,10897,74283,7386,66897,8669,383,29759,2885,38428,25201,7934,964,1876,4395
GACCGGAATCGCTAGG,sample,90,89,4,85,7,78,38,5,22,0,60,13,36,19,3,4
GGAGAGTTCCGTTGCG,sample,78729,78382,3188,75194,19819,55375,31864,1791,15252,1952,47116,4516,2664,1073,14981,13755
TATCAGTTCCGTTGCG,sample,60159,59772,4244,55528,6842,48686,20140,1303,17993,2377,38133,6873,3675,1422,2075,4552
TTCGTAATCCGTTGCG,sample,71213,70693,5050,65643,16223,49420,26227,1306,13687,1688,39914,6512,3605,1103,11664,10447
TAGTACGGCCGTTGCG,sample,42368,42150,1703,40447,13039,27408,17092,870,6659,747,23751,2040,1794,810,7096,8005
AATGGTAACCGTTGCG,sample,93631,93060,3907,89153,21879,67274,42099,1970,15531,1866,57630,5808,2527,945,21613,15318
GCCTTGCTCCGTTGCG,sample,51996,51605,4154,47451,12346,35105,14735,878,11917,1297,26652,6278,4199,1219,3645,7986
CAAGGCCTCCGTTGCG,sample,91313,90579,7254,83325,17667,65658,28681,1741,19858,2494,48539,12884,5394,1201,10736,11549
CATAACCTCCGTTGCG,sample,28560,28347,2395,25952,5705,20247,10544,609,5546,559,16090,2989,2217,818,4198,3654
GGACGTAGCCGTTGCG,sample,68885,68497,4114,64383,16634,47749,26602,1384,12649,1569,39251,5545,2787,868,12664,11001
CATTGCAGCCGTTGCG,sample,67189,66761,3470,63291,16468,46823,29061,1626,10364,1440,39425,4332,2483,1024,10271,11349
AATCCGTCCCGTTGCG,sample,88349,87502,11372,76130,11575,64555,15843,859,26217,2417,42060,19219,7073,1104,4563,6997
CTAGGACCCCGTTGCG,sample,63786,63412,1677,61735,17259,44476,30110,2024,9810,1168,39920,1364,1162,820,12138,11941
CGGATTACCCGTTGCG,sample,33223,32952,3048,29904,7633,22271,7705,537,8138,820,15843,5071,3327,828,2212,4683
GCCTGAACCCGTTGCG,sample,80526,79842,6830,73012,15271,57741,21876,1299,19344,2087,41220,13135,4900,1068,8168,10549
AACTCGTACCGTTGCG,sample,52000,51639,3142,48497,10402,38095,18633,1211,11614,1187,30247,5450,3180,1053,4384,7131
TGCTTCGCCCGTTGCG,sample,51028,50658,3655,47003,10020,36983,16304,1302,10811,1701,27115,6865,3831,1057,4653,6749
AAGAGCGCCCGTTGCG,sample,41497,41084,5868,35216,6506,28710,8482,533,10467,1231,18949,7997,3955,843,1758,4096
GTACCGTACCGTTGCG,sample,62754,62439,1815,60624,21428,39196,26583,1355,8134,403,34717,2721,1556,947,10815,13193
GGCATATACCGTTGCG,sample,68266,67731,8074,59657,12185,47472,13944,737,17636,2042,31580,13113,5180,908,4254,7680
AGGTCGGACCGTTGCG,sample,70854,70198,11146,59052,6449,52603,9315,649,23046,2314,32361,17279,6678,1097,1321,3482
AAGTTCGTAGGCCAAG,sample,80307,79617,6902,72715,17439,55276,20296,1164,20372,1928,40668,11516,5325,1175,6267,11552
GGTTGCGTAGGCCAAG,sample,161114,159305,19666,139639,20003,119636,29498,1872,47457,5069,76955,35740,10121,1713,9024,12848
ATGCCTGGAGGCCAAG,sample,66869,66429,3756,62673,17095,45578,25497,1335,12027,1438,37524,5281,3059,1038,11709,11403
TTAGAAGTAGGCCAAG,sample,113337,112268,13438,98830,15100,83730,26020,1341,30472,3044,56492,22853,7011,1543,4491,9645
GGACCTCTAGGCCAAG,sample,68179,67582,6441,61141,12031,49110,20290,1906,15834,1767,36124,9313,4866,1409,4557,7322
TCGCATCTAGGCCAAG,sample,58956,58554,2517,56037,10977,45060,24802,1763,13014,1339,37816,4142,2724,1197,6530,7763
GCCTTGCTAGGCCAAG,sample,59631,59166,3494,55672,12248,43424,24741,1568,10514,1310,35255,5291,3143,1093,9159,8389
CATAACCTAGGCCAAG,sample,98665,97589,12599,84990,14234,70756,18439,981,27610,3076,46049,20650,6747,1079,3465,8702
GACGGAGAAGGCCAAG,sample,89097,88266,9219,79047,14352,64695,30580,1514,18913,1962,49493,11726,5231,1288,12419,9458
CCAGAGCGAGGCCAAG,sample,35883,35627,2079,33548,7589,25959,15058,1119,6225,742,21283,2815,2444,1158,3950,5025
CTTGATAGAGGCCAAG,sample,86264,85684,3321,82363,21193,61170,38015,2791,13645,1548,51660,5171,2659,1104,14574,14680
ACCTCGAGAGGCCAAG,sample,138439,137114,14384,122730,16140,106590,27903,1474,40427,4204,68330,32582,9997,1763,8978,10445
AGTCCGCAAGGCCAAG,sample,163546,161727,26727,135000,14309,120691,28008,2061,48645,4957,76653,37020,11552,2142,6382,8327
CGGATTACAGGCCAAG,sample,31407,31111,3047,28064,6187,21877,9300,529,7093,770,16393,4185,2886,719,3252,3896
GCCTGAACAGGCCAAG,sample,59102,58533,6319,52214,12736,39478,12849,706,14654,1402,27503,9867,4629,862,3894,7966
AACTCGTAAGGCCAAG,sample,60053,59513,6492,53021,6175,46846,13277,915,19653,2153,32930,10848,4950,1158,1346,3906
CGTATGAAAGGCCAAG,sample,63327,62805,4429,58376,9847,48529,19084,1246,17986,2156,37070,8057,3749,1108,3796,6653
TTGGCCTCAGGCCAAG,sample,39741,39386,3892,35494,4591,30903,9664,635,13136,1561,22800,5907,3489,879,1519,2979
ACCAATGCAGGCCAAG,sample,36821,36488,3346,33142,6620,26522,11641,590,8709,902,20350,4680,3147,901,3923,4254
GAAGGCGCAGGCCAAG,sample,51905,51554,2238,49316,12832,36484,21354,1656,8692,1033,30046,3749,2937,1355,4670,8478
AAGAGCGCAGGCCAAG,sample,77501,76985,4310,72675,17371,55304,27739,1727,15527,1607,43266,8704,4608,1283,8813,11663
CCAATTCCAGGCCAAG,sample,119263,118254,12164,106090,20301,85789,27750,2101,29556,3185,57306,23197,8265,1662,8936,12885
GGCATATAAGGCCAAG,Neg_Ctrl,382,282,121,161,42,119,49,3,36,3,85,28,47,24,11,32
AGGTCGGAAGGCCAAG,sample,81136,80647,5016,75631,13146,62485,31557,1800,18706,2249,50263,8173,3834,1304,8411,9266
ATGACCGAAGGCCAAG,sample,5862,5830,218,5612,2229,3383,2088,167,767,104,2855,257,619,367,755,1221
GGAGAGTTAGAACCGC,sample,213416,211947,19376,192571,26117,166454,60647,3795,56793,6240,117440,38979,8802,1853,14727,18459
ACGTAAGTAGAACCGC,sample,138630,136825,22979,113846,13588,100258,19911,1198,41695,4554,61606,32900,9909,1539,5984,7830
AGTACCATAGAACCGC,sample,79183,78339,11109,67230,11697,55533,13124,1112,23051,2340,36175,15906,5851,1009,3414,7358
TAGTACGGAGAACCGC,sample,56680,56262,4309,51953,10707,41246,17915,1250,14099,1626,32014,6356,3627,1241,3134,6966
AATGGTAAAGAACCGC,sample,51611,51297,2311,48986,12536,36450,18796,1281,11065,1505,29861,3803,2745,1273,4316,8059
TTAGAAGTAGAACCGC,sample,96741,96224,2890,93334,26268,67066,45485,3058,13349,1383,58834,3791,2478,1372,18921,17624
TCGCATCTAGAACCGC,sample,109634,109100,2610,106490,37190,69300,49632,2320,14418,1442,64050,1488,1154,926,22330,23499
GCCTTGCTAGAACCGC,sample,53899,53533,3634,49899,7804,42095,18543,1397,15132,1374,33675,5649,3100,1138,3054,5282
GTTAGCCGAGAACCGC,sample,55888,55490,4135,51355,13072,38283,18184,1346,10971,1080,29155,6702,3685,1224,6086,8403
GGAGGACGAGAACCGC,sample,71827,71418,3780,67638,15204,52434,31952,1827,12720,1196,44672,4739,3381,1467,12023,10303
ACCTCGAGAGAACCGC,sample,76109,75524,5262,70262,15495,54767,28111,1704,15801,1673,43912,7478,4179,1417,8734,10416
ACGACTTCAGAACCGC,sample,18296,18168,969,17199,3682,13517,8174,518,3234,374,11408,1217,1532,788,3137,2474
AGTCCGCAAGAACCGC,sample,77551,76858,6619,70239,11277,58962,20505,1478,21380,2384,41885,13215,5403,1273,3990,7753
CGGATTACAGAACCGC,sample,40092,39718,3986,35732,3998,31734,9945,633,13095,1223,23040,6838,3439,923,723,2516
TTGGCCTCAGAACCGC,sample,46786,46429,3464,42965,10861,32104,14168,1080,10220,1097,24388,5539,3409,894,3975,6764
TGCTTCGCAGAACCGC,sample,63190,62827,2463,60364,19426,40938,28126,2146,7685,598,35811,2383,2070,1186,8405,12052
GAAGGCGCAGAACCGC,sample,22994,22766,1268,21498,4090,17408,8399,600,5374,694,13773,2341,1910,836,2210,2820
GTCTTAGCAGAACCGC,sample,49066,48689,4899,43790,10855,32935,12600,1009,10955,1215,23555,7156,4256,1110,2549,7005
TTGGTTAAAGAACCGC,sample,110505,109942,3872,106070,30326,75744,49716,2798,16123,2529,65839,4578,2084,1043,16688,20670
TCAATATAAGAACCGC,sample,106189,105211,12280,92931,16050,76881,22534,1444,28918,3294,51452,20691,7037,1169,6063,10448
AGGTCGGAAGAACCGC,sample,81825,81107,8017,73090,11973,61117,20221,1230,22634,2670,42855,14362,6004,1147,5825,7810
GACCGGAAAGAACCGC,sample,94,91,9,82,12,70,35,3,20,2,55,10,31,11,10,10
TATCAGTTCATCAAGC,sample,174366,173335,9613,163722,38588,125134,50856,3110,38280,4786,89136,28102,8808,1635,16208,25815
TCCAACTTCATCAAGC,sample,66974,66537,2895,63642,18836,44806,26841,1340,11386,1390,38227,3849,2785,1106,11543,12321
TCCTCCGTCATCAAGC,sample,98295,97657,5447,92210,26608,65602,42214,2444,13902,1128,56116,5914,3413,1172,17581,17004
AGTACCATCATCAAGC,sample,65283,64801,4154,60647,11909,48738,21667,1209,16973,2146,38640,6743,3651,1184,5518,8480
TTCTAATGCATCAAGC,sample,52524,52009,5366,46643,8590,38053,14644,1042,12900,1470,27544,7997,4347,1224,2213,5628
GGACCTCTCATCAAGC,sample,40915,40593,3574,37019,3312,33707,13085,909,12159,1475,25244,6079,3290,1032,730,1833
GGCCAGAGCATCAAGC,sample,69658,69100,6470,62630,8080,54550,19420,1032,21783,2437,41203,9878,4319,1077,2397,5105
CGAGGCAGCATCAAGC,sample,74737,74163,3606,70557,12433,58124,32853,1638,15681,2199,48534,5753,3008,1281,10253,9305
AATCCGTCCATCAAGC,sample,42640,42105,7717,34388,2924,31464,6248,448,13729,1456,19977,9583,4508,801,360,1419
CGGATTACCATCAAGC,sample,93355,92511,8471,84040,10793,73247,19262,1515,28036,3087,47298,21347,7831,1426,4229,7236
GCCTGAACCATCAAGC,sample,71372,70844,6176,64668,10933,53735,19684,1241,18750,1929,38434,12131,4796,1022,4217,7028
TTGGCCTCCATCAAGC,Pos_Ctrl,47868,47349,3436,43913,2045,41868,34847,3352,2401,406,37248,862,4971,5289,2669,1076
AATATATCCATCAAGC,sample,92752,91976,8805,83171,9193,73978,28143,1759,26647,3177,54790,14252,5611,1480,4310,5822
ACCAATGCCATCAAGC,sample,62657,62322,1854,60468,20184,40284,27491,1155,8219,1484,35710,1935,1359,658,11033,12983
AAGAGCGCCATCAAGC,sample,47311,46925,2294,44631,11291,33340,18228,979,9720,951,27948,3462,2387,992,3936,7624
GTCTTAGCCATCAAGC,sample,76325,75716,6948,68768,8331,60437,18653,1090,24563,3049,43216,13082,5508,1191,2525,5523
TTGGTTAACATCAAGC,sample,100493,99846,6650,93196,22553,70643,38372,1840,18576,2221,56948,9634,3774,1129,16018,15350
GTACCGTACATCAAGC,sample,107350,106413,12689,93724,16449,77275,22906,1424,28026,3166,50932,21753,7239,1135,7841,10571
ATGACCGACATCAAGC,sample,73957,73333,9103,64230,9775,54455,13954,1073,22155,2265,36109,15008,5927,1054,2449,6169
TATCAGTTAGAGAGCC,sample,81780,81492,1903,79589,25284,54305,39768,2405,8105,783,47873,3244,1567,816,10957,16242
GGTTGCGTAGAGAGCC,sample,54408,54014,2703,51311,15376,35935,18986,1064,9925,1085,28911,4875,2898,996,8010,9673
ACGTAAGTAGAGAGCC,sample,111685,110564,16113,94451,18622,75829,22371,876,28285,3260,50656,21037,8064,1226,8622,11389
CCTCTAGAAGAGAGCC,sample,36988,36640,3729,32911,9102,23809,10493,609,7274,629,17767,4804,2908,955,3829,5373
TTCGTAATAGAGAGCC,sample,50402,49947,5838,44109,7080,37029,14232,894,13361,1698,27593,6844,3708,1106,3170,4225
TAGTACGGAGAGAGCC,sample,71962,71591,2252,69339,21214,48125,35365,2401,7702,908,43067,1749,1591,1107,12926,13956
AATGGTAAAGAGAGCC,sample,70832,70505,1942,68563,23009,45554,33420,1447,8049,1430,41469,1208,1033,787,16777,14877
TTAGAAGTAGAGAGCC,sample,63186,62759,4108,58651,10931,47720,25217,1486,12566,1731,37783,6720,3462,1240,6552,7029
CAAGGCCTAGAGAGCC,sample,30284,29970,3456,26514,5272,21242,9158,537,6781,786,15939,3980,2918,785,3462,3360
CATAACCTAGAGAGCC,sample,37317,37093,1976,35117,9525,25592,17661,1046,4359,644,22020,1882,1387,879,7304,6533
GTTAGCCGAGAGAGCC,sample,56663,55985,8018,47967,4457,43510,9841,686,19016,1781,28857,12186,5273,895,1635,2506
GGCCAGAGAGAGAGCC,sample,35473,35262,1996,33266,9762,23504,12054,929,6650,858,18704,3013,2433,1012,2533,6148
CGAGGCAGAGAGAGCC,sample,70227,69773,4251,65522,12783,52739,25113,1348,17748,1739,42861,6791,3327,1014,9987,8770
CCATGAAGAGAGAGCC,sample,57434,57113,2853,54260,11627,42633,21351,1614,12388,1449,33739,5831,3027,996,7485,8270
GTCCTGCCAGAGAGCC,sample,87969,87287,9663,77624,12508,65116,16919,1281,24824,2722,41743,19370,7343,1223,3880,7722
AATATATCAGAGAGCC,sample,75736,75397,3608,71789,21254,50535,30818,1471,12104,1307,42922,4835,2421,849,11691,13866
GTCTTAGCAGAGAGCC,sample,40354,40143,1121,39022,7538,31484,18955,1315,7974,1139,26929,2101,1747,1071,4592,5276
GTACCGTAAGAGAGCC,sample,82053,81752,2860,78892,26008,52884,37661,2843,8578,665,46239,3137,1811,1003,14716,16230
TCAATATAAGAGAGCC,sample,106729,106228,5823,100405,25028,75377,46567,3458,16422,1790,62989,7140,3724,1703,13096,17103
CTTCATGAAGAGAGCC,sample,61124,60513,8294,52219,7847,44372,11100,745,17549,1806,28649,13172,5893,960,1984,4974
GGAGAGTTAGCATTGA,sample,154408,153420,8010,145410,35422,109988,55453,4621,29246,3621,84699,17047,4963,1300,16187,21744
ATTCTCTTAGCATTGA,sample,211147,209432,18574,190858,24353,166505,45630,3678,62952,6249,108582,47996,9867,1794,9542,15867
AAGTTCGTAGCATTGA,sample,91203,90470,7571,82899,22620,60279,20120,1957,22101,2351,42221,13750,5711,1226,4515,14280
ACGTAAGTAGCATTGA,sample,142919,142244,3857,138387,50797,87590,65477,3936,14454,1632,79931,2091,1487,1116,30909,31252
ACGTTATGAGCATTGA,sample,96048,95308,5115,90193,19132,71061,34297,1861,22451,2829,56748,9623,4102,1205,10531,13196
TGAGCGCGAGCATTGA,sample,92975,92414,3134,89280,28173,61107,37956,3360,14479,1088,52435,4224,2503,1034,17311,18161
TCGCATCTAGCATTGA,sample,61508,60955,4590,56365,8945,47420,14775,942,18585,2136,33360,10982,4765,935,2278,6012
CATAACCTAGCATTGA,sample,75573,74974,4542,70432,13414,57018,24341,1687,19172,1688,43513,10130,4254,1030,3175,8735
ACTATACTAGCATTGA,sample,72062,71504,4730,66774,13446,53328,21236,2082,18329,1510,39565,10171,4477,847,4573,8783
GTTAGCCGAGCATTGA,sample,62004,61587,2647,58940,13553,45387,26756,2908,9173,895,35929,5655,2623,1081,3908,9068
GGAGGACGAGCATTGA,sample,70984,70316,7320,62996,10056,52940,15251,1333,19899,1938,35150,14519,5578,917,3684,6421
ACCTCGAGAGCATTGA,sample,90454,89885,4026,85859,16373,69486,34659,2171,21861,2571,56520,8224,3488,986,10131,11618
ACGACTTCAGCATTGA,sample,84660,83986,5208,78778,13664,65114,29857,1736,20342,2193,50199,10986,4643,1023,9157,9656
CATGATTCAGCATTGA,sample,115806,114953,8047,106906,20116,86790,38821,2730,27585,2752,66406,14902,5110,1130,12412,13955
GTCCTGCCAGCATTGA,sample,80867,80442,1942,78500,26221,52279,39410,1846,8584,926,47994,1513,1127,862,12999,17199
GTTAGGACAGCATTGA,sample,115284,114245,13193,101052,12140,88912,19495,1111,35636,3733,55131,28937,9137,1540,2883,7539
GCCTGAACAGCATTGA,sample,55429,54907,4406,50501,6631,43870,17547,1333,15491,1871,33038,7628,4114,1177,2845,4422
AACTCGTAAGCATTGA,sample,81827,81246,5438,75808,14192,61616,27570,1788,18359,2510,45929,11389,4972,1112,6148,9796
TTGGCCTCAGCATTGA,sample,93621,92852,8301,84551,7944,76607,25675,1585,30393,3520,56068,15434,5480,1113,2565,5324
AATATATCAGCATTGA,Neg_Ctrl,474,413,134,279,53,226,109,3,67,11,176,36,88,36,23,31
GAAGGCGCAGCATTGA,sample,107365,106505,8611,97894,10947,86947,34401,2631,31083,3752,65484,15080,5659,1455,5925,7138
AAGAGCGCAGCATTGA,sample,96923,96069,6337,89732,16752,72980,32097,2255,23791,2765,55888,12072,4437,1136,7527,11881
TTGGTTAAAGCATTGA,sample,59284,58853,3136,55717,15445,40272,21009,970,10873,1084,31882,6336,3592,1066,6865,9951
GTACCGTAAGCATTGA,sample,54709,54250,3584,50666,13854,36812,15747,977,11501,1011,27248,7576,3712,974,3624,8801
TCGCCTGAAGCATTGA,sample,94644,93932,5700,88232,20703,67529,36086,2913,17699,1563,53785,9268,4020,1148,9561,13843
TTATTCGAAGCATTGA,sample,78172,77474,5846,71628,12292,59336,21917,1602,21567,2411,43484,11839,4871,1095,4866,8040
GACCGGAAAGCATTGA,sample,160,158,12,146,26,120,54,1,44,1,98,20,46,17,19,18
TCCTCCGTAATTACCA,sample,124875,123855,10784,113071,18056,95015,32583,2038,34450,4122,67033,21822,6892,1234,5693,11525
TTCGTAATAATTACCA,sample,265955,264077,19045,245032,33629,211403,86073,7593,63094,6279,149167,48364,10455,2207,16495,22598
TTCTAATGAATTACCA,sample,55469,55136,2095,53041,16898,36143,20993,1119,8757,1161,29750,4113,2626,1196,6901,10835
ATGCCTGGAATTACCA,sample,41917,41681,2128,39553,11707,27846,15154,887,7229,852,22383,3724,2317,762,5270,7301
CAACCGCGAATTACCA,sample,66837,66333,3548,62785,12814,49971,25188,1304,15982,1459,41170,6038,3198,1094,9211,8699
GTTAGCCGAATTACCA,sample,88314,87570,8588,78982,7241,71741,17596,889,30655,3348,48251,19253,6280,1023,2059,4254
GGACGTAGAATTACCA,sample,76107,75393,9746,65647,9467,56180,14590,1207,22988,2030,37578,15365,5470,880,2971,5488
CTTGATAGAATTACCA,sample,86503,85740,8110,77630,12588,65042,27548,1432,20299,2055,47847,13708,5025,1037,4632,8527
GACGATAAAATTACCA,sample,85199,84551,5695,78856,14825,64031,29631,1902,20992,1704,50623,9802,3995,1073,7594,10437
GGCCAGAGAATTACCA,sample,54261,53874,3756,50118,12727,37391,21065,1617,8758,1163,29823,4788,2712,1005,5180,7758
CGAGGCAGAATTACCA,sample,131574,130294,15912,114382,10727,103655,17479,1044,44755,5120,62234,35257,9502,1418,3007,7079
CATGATTCAATTACCA,sample,73509,73038,2907,70131,16977,53154,34712,2714,10645,1336,45357,3747,2615,1141,10985,11917
AGTCCGCAAATTACCA,sample,81558,81118,2132,78986,20667,58319,42895,2380,10937,1304,53832,803,1030,805,15842,14533
GTCCTGCCAATTACCA,sample,89222,88604,4799,83805,20191,63614,35166,1790,16891,1885,52057,7882,3797,1126,11866,13931
GCCTGAACAATTACCA,sample,69208,68634,6255,62379,6888,55491,22045,1728,20504,2690,42549,8524,4382,1317,4624,4572
ACGTATTAAATTACCA,sample,86344,85599,7182,78417,10182,68235,24128,1614,26035,3420,50163,13038,4768,1206,3471,6755
AACTCGTAAATTACCA,sample,93252,92627,9020,83607,16405,67202,28921,2010,21108,2515,50029,12648,5183,1032,10394,10967
CGTATGAAAATTACCA,sample,93560,92876,4176,88700,21119,67581,33547,2273,21083,1808,54630,8870,3822,1085,12218,14219
TTGGCCTCAATTACCA,sample,50244,49815,4443,45372,7683,37689,15384,1282,12210,1401,27594,7412,3660,907,4523,5419
AATATATCAATTACCA,sample,77855,77099,7742,69357,7674,61683,18425,881,26291,3140,44716,12946,5001,1016,2175,4903
AAGAGCGCAATTACCA,sample,68950,68285,8041,60244,7205,53039,15157,1516,21363,2289,36520,12714,4955,954,2090,4534
CCAATTCCAATTACCA,sample,56407,56045,2263,53782,12792,40990,24650,1903,9494,1018,34144,3925,2824,1282,6053,8804
GTACCGTAAATTACCA,sample,90084,89256,9546,79710,10278,69432,21588,1350,27102,2983,48690,16409,5847,1121,3708,6491
CTTCATGAAATTACCA,sample,42513,41822,8228,33594,4116,29478,6055,414,12023,1354,18078,9632,5147,965,929,2322
ATTCTCTTTAGATGAC,Pos_Ctrl,80966,80545,3798,76747,3582,73165,61584,6315,3556,400,65140,1310,5707,7223,4623,1499
AAGTTCGTTAGATGAC,sample,141379,140431,9565,130866,21418,109448,50157,3717,32770,3598,82927,19206,5781,1432,10061,15180
ACGTTATGTAGATGAC,Pos_Ctrl,39653,39201,3171,36030,2115,33915,28401,2470,2111,287,30512,646,4825,4628,2872,1170
TTCTAATGTAGATGAC,sample,136553,135574,13518,122056,19197,102859,27903,939,39249,4875,67152,29893,7867,1347,5087,11345
AATGGTAATAGATGAC,sample,96237,95563,2843,92720,22908,69812,48621,2961,12499,1117,61120,4614,2442,1099,10932,15344
TTCCGTCTTAGATGAC,Pos_Ctrl,12148,12006,1146,10860,689,10171,8493,795,612,72,9105,199,2398,1971,993,440
CAAGGCCTTAGATGAC,sample,97936,97283,7656,89627,15646,73981,30285,2678,24081,1933,54366,15004,5130,1037,8570,10298
CATAACCTTAGATGAC,sample,104275,103623,5675,97948,18325,79623,36307,2951,25560,2821,61867,11984,3931,943,10704,12389
ACTATACTTAGATGAC,sample,84340,83488,13609,69879,5587,64292,7596,415,28513,3231,36109,24537,7480,886,782,2648
CCAGAGCGTAGATGAC,sample,50145,49763,3238,46525,5401,41124,17037,1556,12982,1271,30019,8278,4136,1071,1303,3265
GGAGGACGTAGATGAC,sample,99286,98573,5396,93177,15772,77405,40023,2995,20279,2321,60302,11787,4515,1260,9796,11378
CCGCAACGTAGATGAC,sample,90664,90011,5971,84040,13450,70590,30242,1974,23982,2150,54224,12242,5011,1154,7548,9522
GACGATAATAGATGAC,sample,34176,33969,1572,32397,4618,27779,12664,1049,8998,1115,21662,3953,2546,962,1458,3175
GGCCAGAGTAGATGAC,sample,68203,67683,3551,64132,12867,51265,30465,2098,11979,1473,42444,5250,3329,1073,10218,8791
CATTGCAGTAGATGAC,sample,81906,81541,2042,79499,21710,57789,40640,3055,11278,1121,51918,1695,1064,790,14221,14811
GCCTGAACTAGATGAC,sample,40541,40164,4245,35919,5515,30404,9182,617,11871,1388,21053,7346,3947,867,1810,3615
AACTCGTATAGATGAC,sample,52600,52201,2445,49756,11487,38269,19362,1819,11334,1038,30696,4716,2599,889,4757,7845
CGTATGAATAGATGAC,sample,55697,55321,3278,52043,12753,39290,20721,1807,10427,958,31148,5377,3424,1077,5527,7909
AATATATCTAGATGAC,sample,147092,145825,16976,128849,15698,113151,21575,1223,48199,4795,69774,37359,9569,1534,3478,9866
TGCTTCGCTAGATGAC,sample,56433,56133,1496,54637,17884,36753,26669,1326,7165,569,33834,1024,1021,682,10180,11430
GTCTTAGCTAGATGAC,sample,186663,185049,21088,163961,17056,146905,43147,2999,59446,6718,102593,34595,10682,1903,8180,10606
CCAATTCCTAGATGAC,sample,73875,73257,6919,66338,11192,55146,22091,1619,18990,1693,41081,10753,5149,1142,3280,7146
ATTCTCTTGTTCAGAA,sample,83634,83133,3130,80003,20228,59775,34554,1584,15425,2366,49979,5846,2373,754,9470,14573
ACGTAAGTGTTCAGAA,sample,52218,51714,5232,46482,5876,40606,13713,645,17528,1549,31241,7171,4012,1219,1996,3910
CCTCTAGAGTTCAGAA,sample,49923,49622,1989,47633,14984,32649,22218,803,6623,750,28841,2255,1899,835,12317,9830
ATGCCTGGGTTCAGAA,sample,32096,31882,1806,30076,5727,24349,12293,737,7782,921,20075,2616,2350,1059,3662,4024
CAACCGCGGTTCAGAA,sample,20616,20486,914,19572,6136,13436,8324,442,3184,460,11508,1026,1532,841,3004,3948
TTAGAAGTGTTCAGAA,sample,20324,20118,2052,18066,4577,13489,5762,392,4154,461,9916,2720,2326,891,1498,2797
TTCCGTCTGTTCAGAA,sample,8925,8869,615,8254,2224,6030,3426,326,1290,132,4716,856,1216,741,639,1353
GACGGAGAGTTCAGAA,sample,72243,71811,3709,68102,16943,51159,28691,1542,13196,1173,41887,6557,2982,943,13185,11613
CTTGATAGGTTCAGAA,sample,67140,66581,5335,61246,10783,50463,15542,971,18997,2064,34539,12889,5692,1093,4532,7236
TGGACGAGGTTCAGAA,sample,51973,51551,5299,46252,8444,37808,12687,937,14038,1709,26725,8437,4325,974,3818,5485
AATCCGTCGTTCAGAA,sample,60112,59814,1940,57874,15253,42621,27978,1216,9948,820,37926,2659,1802,858,12051,11038
CGTACGTCGTTCAGAA,sample,31356,31114,1170,29944,8558,21386,11970,1018,5929,607,17899,1862,1732,807,3332,5461
AGTCCGCAGTTCAGAA,sample,68618,68058,6029,62029,10228,51801,21485,1238,17352,1772,38837,9954,4944,1127,6552,7226
TTGGTACCGTTCAGAA,sample,31276,31050,3909,27141,5955,21186,6970,463,7538,780,14508,5435,3954,1092,1545,3796
CTAGGACCGTTCAGAA,sample,39275,39051,1188,37863,11225,26638,17122,1004,5868,623,22990,2021,2065,1084,4153,7298
GTTAGGACGTTCAGAA,sample,56412,56200,1719,54481,15590,38891,23927,1781,9904,656,33831,2623,1666,830,8791,10597
ACGTATTAGTTCAGAA,sample,65199,64817,4153,60664,14386,46278,19325,1430,14862,1736,34187,8925,4416,1211,4222,8876
CGTATGAAGTTCAGAA,sample,114145,113139,13972,99167,11380,87787,18139,882,37519,4135,55658,27112,8761,1451,3914,6917
ACCAATGCGTTCAGAA,sample,62927,62370,5495,56875,8495,48380,17783,998,18521,2033,36304,9045,4368,1112,3498,5612
GAAGGCGCGTTCAGAA,sample,47792,47522,3698,43824,10118,33706,12232,1175,11778,1568,24010,6953,3702,924,2375,6525
AAGAGCGCGTTCAGAA,sample,51825,51536,2405,49131,11073,38058,18774,1263,11248,1181,30022,5592,3024,1067,5835,7493
CCAATTCCGTTCAGAA,sample,70999,70593,4198,66395,16682,49713,22705,1296,14586,1825,37291,9301,3996,950,8892,11125
GGCATATAGTTCAGAA,sample,53869,53664,2168,51496,13060,38436,18706,1378,12000,1440,30706,4912,3031,976,6160,8675
TCGCCTGAGTTCAGAA,sample,63156,62805,2867,59938,16149,43789,22607,1323,13019,1729,35626,5111,3113,952,8369,10360
AGGTCGGAGTTCAGAA,Pos_Ctrl,29230,29105,1055,28050,1485,26565,22063,2590,1279,137,23342,496,4006,4427,1709,626
TTATTCGAGTTCAGAA,sample,55046,54790,2431,52359,13966,38393,22829,1489,8718,948,31547,4409,2750,1031,7448,8934
ATTCTCTTTTCTGGTT,sample,132385,131496,9552,121944,18920,103024,38395,2038,37803,3653,76198,21135,5923,1423,12681,13825
TCCAACTTTTCTGGTT,Neg_Ctrl,326,168,63,105,23,82,41,5,14,0,55,22,28,19,8,6
AAGTTCGTTTCTGGTT,sample,85941,85287,7878,77409,12261,65148,27663,1676,21022,2085,48685,12702,4787,1168,8189,8071
GGTTGCGTTTCTGGTT,sample,63095,62447,7115,55332,6288,49044,14600,923,19864,2727,34464,10930,4738,1139,1860,3962
ACGTAAGTTTCTGGTT,sample,74291,73806,4840,68966,16405,52561,29292,1298,13467,1498,42759,7006,3956,1220,11481,11016
CCTCTAGATTCTGGTT,sample,20836,20645,632,20013,5838,14175,10486,744,1935,325,12421,685,1477,1244,2772,3794
ACGTTATGTTCTGGTT,sample,63621,63265,2838,60427,19465,40962,26041,1952,8472,1468,34513,3029,1802,921,13578,12300
TTCTAATGTTCTGGTT,Neg_Ctrl,255,140,51,89,27,62,23,2,20,7,43,10,24,13,8,7
TTAGAAGTTTCTGGTT,sample,51866,51541,1874,49667,10881,38786,24103,1354,8496,1115,32599,3718,2578,1461,6018,7621
GGACCTCTTTCTGGTT,Neg_Ctrl,293,229,92,137,13,124,57,9,18,11,75,29,38,18,13,13
GCCTTGCTTTCTGGTT,sample,57153,56595,7134,49461,9220,40241,12803,1091,14222,1448,27025,10677,4858,1056,4076,5762
ACCTCGAGTTCTGGTT,sample,49697,49422,3442,45980,9306,36674,13301,1091,13543,1220,26844,7519,3926,966,1861,6003
GGCCAGAGTTCTGGTT,sample,45247,44848,4640,40208,6640,33568,14864,969,10764,1187,25628,5784,3432,1144,3784,4387
CATTGCAGTTCTGGTT,sample,33583,33301,2909,30392,4211,26181,11478,762,8418,890,19896,4633,3084,1201,934,2851
CGAGGCAGTTCTGGTT,sample,34932,34633,3015,31618,10758,20860,7150,350,7207,815,14357,5338,2594,552,2785,5947
CATGATTCTTCTGGTT,sample,79733,79010,8070,70940,12914,58026,20398,1301,20168,2077,40566,14082,5709,1053,6498,8378
AGTCCGCATTCTGGTT,sample,87274,86434,10457,75977,8343,67634,15457,1009,26804,2630,42261,21734,7047,1070,3132,4856
TTGGTACCTTCTGGTT,sample,52917,52574,2089,50485,12291,38194,23313,1159,9547,759,32860,3416,1877,841,9502,8246
ACGTATTATTCTGGTT,sample,59885,59393,5752,53641,11294,42347,16349,887,14830,1438,31179,8843,4214,897,3666,6728
AAGAGCGCTTCTGGTT,sample,35860,35570,918,34652,10206,24446,17900,823,4575,489,22475,659,1199,910,5699,6832
GTCTTAGCTTCTGGTT,sample,64470,63843,9209,54634,7672,46962,8428,586,19742,2134,28170,16072,6023,803,2067,4456
TCAATATATTCTGGTT,sample,76987,76532,3722,72810,19134,53676,30806,2038,14042,1117,44848,5673,2718,879,13814,12753
GGAGAGTTGTTCGGTT,sample,109808,109389,4067,105322,33944,71378,38077,2628,18651,2397,56728,9625,3578,1123,18536,21391
TATCAGTTGTTCGGTT,sample,78475,77934,8197,69737,12252,57485,16947,1087,21618,2456,38565,15377,6422,1281,2785,7794
ATTCTCTTGTTCGGTT,sample,85595,85055,4432,80623,21173,59450,31783,1917,17063,1789,48846,6898,3369,1041,12820,13887
GGTTGCGTGTTCGGTT,sample,44747,44339,4421,39918,5308,34610,15948,1113,9740,980,25688,6829,4164,1525,939,3464
TTCGTAATGTTCGGTT,sample,95567,95094,3400,91694,24107,67587,41971,2179,16435,2154,58406,4848,2547,1161,21053,16051
ACGTTATGGTTCGGTT,sample,106212,105575,7013,98562,28484,70078,38433,1541,18121,1849,56554,10134,4510,1143,19090,18304
TAGTACGGGTTCGGTT,sample,63236,62795,1847,60948,18219,42729,29025,1031,9415,881,38440,2377,1965,1049,10870,11412
TTCCGTCTGTTCGGTT,sample,73294,72555,5632,66923,14986,51937,23229,1605,16605,1637,39834,8861,4372,1325,5963,10013
GCCTTGCTGTTCGGTT,sample,27525,27264,3085,24179,5006,19173,6005,370,7465,744,13470,4589,2827,637,1798,3058
GACGATAAGTTCGGTT,sample,56343,55891,4709,51182,7737,43445,15128,1153,17752,1963,32880,7449,3977,1038,3049,5209
GGCCAGAGGTTCGGTT,sample,68760,68145,6610,61535,9963,51572,17266,703,18707,2044,35973,12852,5832,1032,6953,6853
CATTGCAGGTTCGGTT,sample,72761,72344,1983,70361,19815,50546,36893,2127,8789,997,45682,1740,1405,1011,14395,13692
CCATGAAGGTTCGGTT,sample,51913,51412,5034,46378,6197,40181,13171,993,16763,1578,29934,7676,4024,1043,3065,4134
ACGACTTCGTTCGGTT,sample,51288,51035,1848,49187,13802,35385,24354,1616,6767,492,31121,2156,2114,1287,7997,9097
GTCCTGCCGTTCGGTT,sample,31001,30701,3556,27145,4888,22257,6899,516,8235,933,15134,5674,3404,812,943,3026
TTGGTACCGTTCGGTT,sample,75595,74979,6642,68337,12287,56050,21108,1076,19390,2423,40498,12053,4729,1071,5137,8059
CGTATGAAGTTCGGTT,sample,90668,89881,7473,82408,15821,66587,29989,1902,20508,2384,50497,11804,5181,1306,8923,10141
ACCAATGCGTTCGGTT,sample,72577,72199,2535,69664,18184,51480,32881,1588,11104,1484,43985,4423,2170,890,13858,12123
TTGGTTAAGTTCGGTT,sample,49567,49082,5012,44070,4948,39122,11190,707,16976,1633,28166,8616,4263,1076,1389,3121
GTACCGTAGTTCGGTT,sample,163155,161855,17379,144476,14030,130446,39647,2087,55335,7321,94982,26056,8801,1684,6192,8283
TCAATATAGTTCGGTT,sample,84785,84155,7023,77132,15068,62064,27614,2006,18320,2147,45934,11977,4616,1098,10717,10010
TTATTCGAGTTCGGTT,Neg_Ctrl,265,218,59,159,46,113,64,0,33,0,97,16,56,33,11,20
GGAGAGTTTGGCGGTT,sample,107284,106657,3610,103047,27140,75907,52870,4525,11752,2232,64622,4528,2252,1094,15437,17891
ATTCTCTTTGGCGGTT,sample,149478,148762,8179,140583,40335,100248,64866,2706,23009,2086,87875,7581,2941,1120,31310,27768
TCCAACTTTGGCGGTT,sample,181025,179929,11432,168497,22683,145814,55748,3205,56502,6663,112250,23696,6986,1817,11795,16214
TGAGCGCGTGGCGGTT,sample,37151,36824,2905,33919,8754,25165,9958,892,9254,815,19212,4246,2857,783,2966,5762
TTAGAAGTTGGCGGTT,sample,102237,101675,4986,96689,23101,73588,35243,2534,23921,2748,59164,9142,4272,1374,9753,15563
GCCTTGCTTGGCGGTT,sample,82846,82272,4016,78256,20664,57592,31543,1839,15133,1757,46676,7320,3998,1335,9898,14069
CAAGGCCTTGGCGGTT,sample,56532,56098,2481,53617,9143,44474,22570,1593,14127,1803,36697,4381,2603,1161,4619,6617
CATAACCTTGGCGGTT,sample,75661,75025,5819,69206,16144,53062,24191,1239,16536,1912,40727,9184,4598,1315,7125,10575
ACTATACTTGGCGGTT,sample,81990,81206,6500,74706,15672,59034,21696,1272,20818,2335,42514,12913,4746,987,5467,10100
GACGGAGATGGCGGTT,sample,61003,60472,4084,56388,6255,50133,19926,1566,18711,2071,38637,7859,3589,1250,1556,4145
GACGATAATGGCGGTT,sample,90649,90209,2760,87449,20637,66812,42975,2846,15157,2323,58132,3511,2256,1412,13954,14230
GGCCAGAGTGGCGGTT,sample,40676,40327,3155,37172,8444,28728,12023,966,9311,1106,21334,5322,3365,911,4151,5518
AATCCGTCTGGCGGTT,sample,36528,36270,2015,34255,12160,22095,11770,1057,6308,745,18078,2215,2295,1117,3525,7174
CGTACGTCTGGCGGTT,sample,103743,103187,2497,100690,30160,70530,49359,2056,13749,2394,63108,2972,1593,881,23856,19741
TTGGTACCTGGCGGTT,sample,108241,107636,3013,104623,28103,76520,48730,3251,18057,2093,66787,4389,2306,1088,21598,20071
GCCTGAACTGGCGGTT,sample,110683,110085,3900,106185,30873,75312,47993,3153,16687,1678,64680,5801,1939,921,22787,20567
ACGTATTATGGCGGTT,sample,102393,101582,7940,93642,22007,71635,28878,2067,23308,2401,52186,14981,5357,1282,7902,13940
ACCAATGCTGGCGGTT,sample,97325,96523,7946,88577,11112,77465,30980,2180,27834,3263,58814,13208,5551,1476,6689,7692
AAGAGCGCTGGCGGTT,sample,116041,114926,12365,102561,10561,92000,20506,1462,37769,4147,58275,28116,9100,1556,2734,6854
GTCTTAGCTGGCGGTT,sample,91174,90323,9088,81235,13432,67803,19845,1038,25324,3003,45169,18593,6666,1105,4830,8753
GTACCGTATGGCGGTT,sample,86216,85667,5152,80515,14013,66502,34563,2611,19777,2551,54340,7000,4044,1833,5834,10454
GACCGGAATGGCGGTT,sample,73791,73409,3690,69719,22355,47364,22206,1089,15191,1529,37397,7349,3368,949,6630,13726
TATCAGTTTCCTTATT,sample,49248,48922,2804,46118,5662,40456,15560,1074,13735,1679,29295,8408,3636,951,1577,3895
AGTACCATTCCTTATT,sample,52301,51959,4717,47242,9377,37865,16713,911,11669,1318,28382,7254,3893,1240,3974,6028
TTCGTAATTCCTTATT,sample,43604,43284,6117,37167,6511,30656,8475,519,12334,1358,20809,7970,4247,917,2105,4068
AATGGTAATCCTTATT,sample,62268,61789,7070,54719,10887,43832,14518,960,15680,1510,30198,11164,4809,981,2826,7131
CATAACCTTCCTTATT,sample,5670,5625,394,5231,1062,4169,2181,141,1117,89,3298,641,896,465,526,710
ACCTCGAGTCCTTATT,sample,43456,43259,1611,41648,11411,30237,20183,1279,6034,768,26217,1973,1970,969,8796,7432
ACGACTTCTCCTTATT,sample,65640,65224,5973,59251,11616,47635,19713,1104,15741,1850,35454,9227,4450,1050,8611,7897
AATCCGTCTCCTTATT,sample,66489,66180,3097,63083,16032,47051,27681,1500,11262,1607,38943,5001,2610,881,11956,11024
CGTACGTCTCCTTATT,sample,53430,53174,1979,51195,15041,36154,25244,1409,6883,959,32127,1659,1575,926,9982,10155
GTCCTGCCTCCTTATT,sample,34220,33995,2344,31651,6823,24828,11135,840,7684,944,18819,4225,2567,577,3783,4687
CGGATTACTCCTTATT,sample,34050,33875,2511,31364,6827,24537,9012,800,8029,871,17041,5825,3418,843,2147,4470
GCCTGAACTCCTTATT,sample,25078,24941,1552,23389,5617,17772,8647,649,4770,582,13417,3124,2122,698,2497,3579
AATATATCTCCTTATT,sample,35707,35533,1388,34145,9073,25072,14354,1181,6139,944,20493,2454,1997,821,3876,5977
GTACCGTATCCTTATT,sample,59170,58770,7134,51636,6659,44977,8384,613,19062,1917,27446,15001,5680,792,2090,4245
GGCATATATCCTTATT,sample,42847,42618,3416,39202,8756,30446,12744,858,9920,922,22664,6002,3104,709,5084,5818
TCAATATATCCTTATT,sample,24697,24554,3561,20993,3253,17740,4090,248,7231,793,11321,5378,2966,513,1160,1866
CTTCATGATCCTTATT,sample,34393,34182,3349,30833,5707,25126,8698,508,9171,947,17869,5802,3394,756,1933,3600
GACCGGAATCCTTATT,sample,2094,2088,113,1975,707,1268,612,32,447,47,1059,130,362,151,213,412
GGAGAGTTAATAAGGT,sample,187088,185657,20321,165336,21085,144251,25900,1491,61986,7068,87886,47806,10607,1775,4622,12722
TATCAGTTAATAAGGT,sample,127445,126538,7720,118818,22695,96123,44506,2833,27065,3719,71571,18000,5571,1080,12701,16033
ACGTAAGTAATAAGGT,sample,125346,124405,7811,116594,22420,94174,42145,2382,30363,3703,72508,15581,5415,1353,15829,15576
ACGTTATGAATAAGGT,sample,83085,82489,6949,75540,15066,60474,16564,967,23731,2507,40295,16705,6568,1301,3368,9833
TTCTAATGAATAAGGT,sample,67056,66584,4812,61772,13395,48377,22560,1857,14660,1767,37220,7533,3904,1344,6263,8901
TCGCATCTAATAAGGT,sample,39541,39278,2161,37117,8423,28694,16911,798,6978,800,23889,3207,2094,797,8253,5870
CATAACCTAATAAGGT,sample,31906,31691,1219,30472,6566,23906,16382,777,4830,524,21212,1393,1698,1029,4872,4735
GACGGAGAAATAAGGT,sample,70968,70361,5828,64533,11857,52676,20993,1116,17126,1872,38119,11569,4586,990,3416,7859
CCGCAACGAATAAGGT,Pos_Ctrl,58145,57246,3440,53806,2346,51460,42913,4067,3087,368,46000,1025,5211,5934,2907,1317
GGACGTAGAATAAGGT,sample,91256,90474,10619,79855,7550,72305,17377,1345,28624,3126,46001,21833,6550,1209,1411,4027
CTTGATAGAATAAGGT,sample,45789,45430,3106,42324,7786,34538,17016,1028,9893,1226,26909,5375,3392,1197,2552,5222
ACCTCGAGAATAAGGT,sample,80981,80381,5578,74803,11049,63754,26191,1313,22939,2243,49130,11068,4653,1100,5179,7644
AATCCGTCAATAAGGT,Pos_Ctrl,50618,50075,3033,47042,2362,44680,37132,3524,2894,299,40026,831,5063,5347,3202,1108
AGTCCGCAAATAAGGT,sample,75673,75109,5605,69504,15284,54220,28241,1501,14569,1426,42810,8483,4439,1318,7781,10046
CTAGGACCAATAAGGT,sample,115152,114013,12962,101051,8930,92121,31252,1689,36285,4422,67537,18473,6669,1421,4440,5140
TGCTTCGCAATAAGGT,sample,65723,65258,5789,59469,12007,47462,17266,1012,16871,1677,34137,10636,4901,955,4649,7541
GAAGGCGCAATAAGGT,sample,84252,83666,3734,79932,18093,61839,27644,2756,19168,2688,46812,9583,4026,1111,7869,12485
AAGAGCGCAATAAGGT,sample,61581,61147,3947,57200,12475,44725,20109,1266,13583,1556,33692,8211,4117,1149,3786,8403
TTGGTTAAAATAAGGT,sample,79138,78568,5940,72628,13371,59257,26880,1872,19521,1896,46401,9088,4172,1305,5750,9267
TCAATATAAATAAGGT,sample,106741,105949,9645,96304,18436,77868,30281,1860,25784,3382,56065,16561,5236,1085,8630,12155
AGGTCGGAAATAAGGT,sample,103209,102734,2951,99783,30684,69099,42365,2197,15700,2273,58065,6564,2942,948,20013,20073
AAGTTCGTCAGGACCA,sample,59607,59181,5899,53282,8780,44502,11892,896,17725,1896,29617,12093,5214,958,3279,6110
ACGTAAGTCAGGACCA,sample,59045,58648,3275,55373,14094,41279,22887,1486,10494,918,33381,5494,3053,962,9497,9481
CCTCTAGACAGGACCA,sample,46573,46180,4193,41987,7353,34634,13577,914,12427,1353,26004,6363,3659,1050,4679,4869
AGTACCATCAGGACCA,sample,88254,87711,5834,81877,21494,60383,26364,1785,19227,2849,45591,10158,4085,1093,10751,13670
ACGTTATGCAGGACCA,sample,131234,130524,5078,125446,37382,88064,52500,3165,20559,2013,73059,9827,3346,1075,26111,25080
TTCTAATGCAGGACCA,sample,83331,82735,6954,75781,21246,54535,19104,1295,20430,1795,39534,11911,5036,955,7099,12897
TTCCGTCTCAGGACCA,sample,60973,60501,4863,55638,10514,45124,20045,1133,13927,1516,33972,8503,4145,916,9897,7517
CATAACCTCAGGACCA,sample,95890,95234,6937,88297,15728,72569,31679,2148,22638,2313,54317,13791,4048,900,13136,10856
CCAGAGCGCAGGACCA,sample,67974,67450,3101,64349,14523,49826,26156,1927,13952,1233,40108,6558,2588,791,9880,10089
GTTAGCCGCAGGACCA,sample,92511,91683,12143,79540,9269,70271,12798,662,29464,2886,42262,24461,8206,1081,2779,5291
GGACGTAGCAGGACCA,sample,40686,40334,4466,35868,6007,29861,6447,327,12348,1349,18795,9390,4054,593,1278,3589
CTTGATAGCAGGACCA,sample,65215,64753,4340,60413,7367,53046,21222,1499,19335,2188,40557,8802,3620,936,2017,4991
GGCCAGAGCAGGACCA,sample,88217,87622,6055,81567,15321,66246,32186,1936,20079,2229,52265,9816,4441,1425,9467,11036
CATTGCAGCAGGACCA,sample,76661,76244,2355,73889,22663,51226,35464,2272,10944,821,46408,1725,1893,1327,12758,14901
CGGATTACCAGGACCA,sample,46249,45857,2724,43133,12174,30959,15005,1284,9756,917,24761,3997,2552,758,4038,7482
ACGTATTACAGGACCA,sample,123853,122895,12192,110703,17697,93006,29989,2289,35056,2866,65045,22806,6720,1221,8944,11644
TTGGCCTCCAGGACCA,sample,75894,75328,4993,70335,14091,56244,24765,1492,17840,2302,42605,9845,4040,976,7395,9589
AATATATCCAGGACCA,Neg_Ctrl,555,449,160,289,53,236,74,6,91,8,165,57,71,32,24,28
ACCAATGCCAGGACCA,sample,80666,80137,3693,76444,18614,57830,32691,1587,15000,1856,47691,6696,2669,941,12764,12716
GAAGGCGCCAGGACCA,sample,53468,53093,4081,49012,11278,37734,15510,1129,12246,1656,27756,7193,3783,824,4246,7633
GTCTTAGCCAGGACCA,sample,73142,72673,5792,66881,13290,53591,23370,1534,17005,1866,40375,9816,4010,829,9518,8933
CCAATTCCCAGGACCA,sample,61583,61069,5928,55141,9236,45905,13071,703,17857,1714,30928,12560,5707,1093,3065,5701
TTGGTTAACAGGACCA,sample,48362,48004,2733,45271,10462,34809,18151,1458,9216,1019,27367,4965,3280,1256,2497,7014
TCAATATACAGGACCA,sample,96398,95927,3329,92598,27751,64847,37316,2433,17027,1448,54343,6623,2622,861,14278,17995
TTATTCGACAGGACCA,sample,82532,81813,7956,73857,12745,61112,17386,997,22975,2490,40361,17264,6565,1084,5845,8146
TCCAACTTCCTCGTTG,sample,24271,24003,1180,22823,1873,20950,9492,950,6701,752,16193,3055,2251,1029,431,1248
TCCTCCGTCCTCGTTG,sample,132953,131601,14831,116770,15773,100997,21674,1705,41443,4291,63117,31884,8818,1426,3040,10937
CCTCTAGACCTCGTTG,sample,99834,99102,6168,92934,15706,77228,37155,2937,22748,2812,59903,11576,3834,981,10417,10587
ATGCCTGGCCTCGTTG,sample,26934,26747,1797,24950,8322,16628,8450,529,4605,437,13055,2607,1779,629,3289,4818
TAGTACGGCCTCGTTG,sample,42736,42437,2638,39799,9743,30056,16026,963,8359,723,24385,3985,3085,1062,5303,6519
ACTATACTCCTCGTTG,sample,101946,101233,5105,96128,15811,80317,32391,2873,24703,3152,57094,17198,5002,1188,10236,11421
CCAGAGCGCCTCGTTG,sample,56797,56507,2491,54016,14756,39260,28474,1414,7700,887,36174,785,883,623,9441,10054
GTTAGCCGCCTCGTTG,sample,81245,80700,6916,73784,11455,62329,22406,2117,20894,2635,43300,14277,5369,972,7395,7984
GGACGTAGCCTCGTTG,Neg_Ctrl,318,230,149,81,6,75,29,2,33,6,62,5,31,10,10,7
CTTGATAGCCTCGTTG,sample,65978,65463,4918,60545,10922,49623,23804,1483,14917,1488,38721,7931,4518,1245,7137,7666
GACGATAACCTCGTTG,sample,43433,42999,6002,36997,4288,32709,7185,479,13504,1471,20689,10070,4599,687,1252,2610
GGCCAGAGCCTCGTTG,sample,83876,83240,5314,77926,12060,65866,27507,1939,20864,2408,48371,13148,5181,938,9752,8444
CGTACGTCCCTCGTTG,Neg_Ctrl,486,371,80,291,53,238,109,6,69,14,178,40,91,41,40,25
GTCCTGCCCCTCGTTG,sample,50720,50318,3850,46468,8024,38444,17255,1350,11832,998,29087,7009,3428,1093,2587,4951
AACTCGTACCTCGTTG,sample,123445,122400,13691,108709,12779,95930,22772,1631,37912,4423,60684,29192,8662,1445,5272,8048
CGTATGAACCTCGTTG,sample,70899,70367,3812,66555,14751,51804,24985,2082,14791,1475,39776,8471,4430,1437,4272,10055
ACCAATGCCCTCGTTG,sample,58852,58295,5950,52345,6920,45425,14971,1030,18019,1975,32990,9430,4555,999,2096,4419
CCAATTCCCCTCGTTG,sample,89520,88693,11522,77171,8472,68699,11684,727,29334,3017,41018,23937,7880,993,3391,4925
TTGGTTAACCTCGTTG,sample,68620,68125,4422,63703,10635,53068,26825,2177,14821,1766,41646,7479,3613,1262,6079,7721
GTACCGTACCTCGTTG,Pos_Ctrl,34845,34489,3489,31000,1589,29411,24315,2185,2029,225,26344,657,4415,4107,2018,835
TCAATATACCTCGTTG,sample,86731,85966,7115,78851,14672,64179,27979,2090,19456,2287,47435,12367,4643,991,11598,9761
CTTCATGACCTCGTTG,sample,63518,62958,8529,54429,6176,48253,9906,539,19999,2147,29905,15662,6428,894,2588,3966
AAGTTCGTTTGCGGAC,sample,78638,78114,3306,74808,16334,58474,34383,2955,12792,1508,47175,6836,3462,1198,6418,11092
TCCTCCGTTTGCGGAC,sample,123492,122521,11545,110976,18185,92791,28800,2173,35407,3761,64207,22650,6847,1176,8280,11097
TTCGTAATTTGCGGAC,sample,167805,166472,16530,149942,20280,129662,24851,2292,53584,5929,78435,43006,9708,1575,6091,13873
AATGGTAATTGCGGAC,sample,127585,126730,7379,119351,25895,93456,50262,3970,23946,2642,74208,12636,5084,1417,11298,18167
GCCTTGCTTTGCGGAC,sample,109322,108383,9728,98655,12547,86108,22798,1116,33450,3573,56248,25171,7088,1288,2693,7715
ACTATACTTTGCGGAC,sample,94809,94102,6634,87468,13115,74353,34876,2299,22698,2391,57574,12089,5274,1279,7797,9137
ACCTCGAGTTGCGGAC,sample,73501,73023,2631,70392,15404,54988,34043,3025,12943,1094,46986,3883,2316,962,10469,10876
TGGACGAGTTGCGGAC,sample,115412,114379,13040,101339,17205,84134,28943,1497,28576,3058,57519,22060,7980,1352,7976,11181
GGCCAGAGTTGCGGAC,sample,68788,68472,2893,65579,15524,50055,32149,1902,11050,969,43199,3985,2387,950,9792,10766
CATTGCAGTTGCGGAC,sample,45388,45106,1815,43291,10862,32429,20190,1305,6963,815,27153,3156,2435,1023,3700,7144
CATGATTCTTGCGGAC,sample,75621,75155,2008,73147,20736,52411,35163,2491,11196,1834,46359,1727,1001,785,13374,14171
CGTACGTCTTGCGGAC,sample,151505,150077,18721,131356,13923,117433,29524,1849,46672,4596,76196,34792,11094,1709,10186,8948
AGTCCGCATTGCGGAC,sample,93011,92372,5340,87032,16278,70754,30914,1936,23057,3025,53971,11822,5221,1142,10565,11617
AACTCGTATTGCGGAC,sample,100504,99939,4648,95291,26278,69013,39237,2937,17227,1827,56464,7785,2500,995,14820,17515
CGTATGAATTGCGGAC,sample,73180,72665,4167,68498,15141,53357,25025,1983,17635,1994,42660,6720,3585,1021,5816,10207
ACCAATGCTTGCGGAC,sample,50980,50612,3224,47388,7615,39773,17582,1127,13678,1678,31260,5708,3117,959,3633,5055
TTGGTTAATTGCGGAC,sample,26034,25805,1578,24227,6922,17305,7607,547,5700,769,13307,2682,2079,690,1542,4186
GTACCGTATTGCGGAC,sample,113002,112164,10718,101446,17188,84258,28819,1800,30740,3113,59559,19786,6965,1329,7247,11577
TCAATATATTGCGGAC,sample,82895,82360,3373,78987,20051,58936,31741,1951,16804,1777,48545,6663,3126,836,11388,13661
AGGTCGGATTGCGGAC,sample,88895,88347,4236,84111,21574,62537,33806,2120,18153,1900,51959,6558,2948,1015,13577,14471
TTATTCGATTGCGGAC,sample,38441,38122,5047,33075,3958,29117,8478,519,11750,1248,20228,7122,3839,929,939,2332
AGTACCATTCCATTGG,sample,92215,91458,8743,82715,16880,65835,22922,1825,23899,2582,46821,14607,6067,1315,4635,10882
TTCGTAATTCCATTGG,sample,51680,51327,4807,46520,5606,40914,11624,776,18081,1792,29705,8641,4206,1050,1708,3669
TGAGCGCGTCCATTGG,sample,7278,7210,729,6481,1672,4809,1647,118,1699,211,3346,1134,1102,364,578,1022
TTAGAAGTTCCATTGG,sample,48787,48531,2705,45826,6907,38919,16345,1106,14390,1962,30735,5116,2969,1130,3059,4639
GCCTTGCTTCCATTGG,sample,50390,50080,3011,47069,9810,37259,17569,1041,11469,1388,29038,5792,3315,1050,3424,6792
CATAACCTTCCATTGG,sample,73854,73407,3559,69848,19206,50642,28034,1351,13851,1386,41885,6020,3262,941,11024,12569
GTTAGCCGTCCATTGG,sample,72493,72181,1516,70665,24080,46585,33327,2378,8330,1225,41657,1325,914,725,16704,15032
CCGCAACGTCCATTGG,sample,41086,40817,2159,38658,10650,28008,14676,1023,7841,873,22517,3595,2667,932,4424,6752
GGACGTAGTCCATTGG,sample,99564,98883,8801,90082,14674,75408,26807,1099,25748,2904,52555,18850,6753,1293,8479,9674
TGGACGAGTCCATTGG,sample,56412,56086,3036,53050,13665,39385,19267,1453,11495,1151,30762,6019,3142,973,6662,9338
CCATGAAGTCCATTGG,sample,36602,36328,2528,33800,7303,26497,12160,787,8646,1051,20806,3853,2749,1015,3341,5045
CGTACGTCTCCATTGG,sample,78341,77666,9069,68597,11206,57391,16948,891,21717,2522,38665,15313,6111,1140,4606,7414
GTCCTGCCTCCATTGG,sample,52090,51759,3546,48213,12102,36111,16445,1157,11097,1442,27542,5970,3241,842,4630,8002
ACGTATTATCCATTGG,sample,48981,48640,2653,45987,11971,34016,17491,1217,9755,1016,27246,4537,2878,1020,5831,7922
CGTATGAATCCATTGG,sample,54537,54095,4384,49711,12114,37597,15524,968,12159,1281,27683,7665,4159,1066,3930,7474
TTGGCCTCTCCATTGG,sample,68130,67803,2754,65049,18421,46628,28748,1744,11213,1075,39961,3848,2283,922,13253,12179
TGCTTCGCTCCATTGG,sample,53018,52602,5559,47043,9182,37861,13169,845,13667,1521,26836,8659,4339,829,4578,6084
AAGAGCGCTCCATTGG,sample,61751,61458,2103,59355,18198,41157,26650,1421,8913,721,35563,3452,2405,1061,8996,11795
CCAATTCCTCCATTGG,sample,43450,43122,3099,40023,7132,32891,13834,782,12005,1319,25839,4951,2978,949,3450,4690
GTACCGTATCCATTGG,sample,59470,59166,2621,56545,17579,38966,22584,1667,9477,771,32061,4467,2613,983,6618,11163
GGCATATATCCATTGG,Neg_Ctrl,219,189,34,155,36,119,54,1,29,17,83,18,43,18,14,24
TCGCCTGATCCATTGG,sample,53260,52648,9217,43431,5168,38263,6684,395,16571,1757,23255,12856,5203,790,759,3160
AGGTCGGATCCATTGG,sample,84410,83645,9682,73963,12414,61549,13156,807,25398,2807,38554,19381,6877,1087,2477,7687
GGAGAGTTCATAGGCG,sample,39641,39455,2307,37148,10396,26752,8768,580,10102,1212,18870,6090,3771,769,3149,6535
CCTCTAGACATAGGCG,sample,51512,51139,3093,48046,9617,38429,18563,1313,12176,1144,30739,5233,3736,1402,4678,6552
AATGGTAACATAGGCG,sample,89228,88471,7131,81340,18190,63150,26024,1862,21118,2456,47142,11690,4484,1014,7893,11903
TTAGAAGTCATAGGCG,sample,101391,100912,3831,97081,25709,71372,43930,2819,17473,1786,61403,5364,3095,1023,21371,17821
CATAACCTCATAGGCG,sample,18322,18080,2614,15466,1893,13573,3521,246,5633,588,9154,3585,2221,510,540,1130
TGGACGAGCATAGGCG,sample,38944,38674,2248,36426,6451,29975,12931,728,11308,1501,24239,3507,2719,1112,2388,4361
CATTGCAGCATAGGCG,sample,79777,79094,6122,72972,14754,58218,27762,1013,18017,1818,45779,9608,4440,1052,9799,9972
ACGACTTCCATAGGCG,sample,108944,107717,19438,88279,6648,81631,13745,732,35317,4113,49062,27724,8422,1250,750,3395
CGTACGTCCATAGGCG,sample,71565,70788,10811,59977,6987,52990,8729,614,22477,2371,31206,18799,6593,939,1347,4127
AGTCCGCACATAGGCG,sample,173217,171582,25988,145594,14407,131187,23075,1407,56244,5817,79319,44644,10870,1711,6275,8054
CTAGGACCCATAGGCG,sample,208379,206621,22215,184406,21529,162877,55356,3498,63294,7808,118650,32921,9362,1997,9547,12704
CGGATTACCATAGGCG,sample,50064,49587,6088,43499,7970,35529,10513,475,13329,1626,23842,9586,4206,738,4052,5052
ACGTATTACATAGGCG,sample,95141,94268,9697,84571,17395,67176,19271,1387,27062,2535,46333,16921,5757,1062,3847,10929
ACCAATGCCATAGGCG,sample,49628,49304,2620,46684,14030,32654,16773,1517,9103,937,25876,4324,2869,974,5030,9084
AAGAGCGCCATAGGCG,sample,54078,53422,8203,45219,3339,41880,10639,609,17880,1836,28519,10916,4961,1072,422,1516
GTCTTAGCCATAGGCG,sample,83013,82346,5919,76427,16675,59752,27990,2003,18217,1651,46207,9891,4653,1196,9011,10910
CCAATTCCCATAGGCG,sample,37274,37021,1701,35320,7305,28015,14160,1406,8362,970,22522,3117,2677,1214,2674,4983
CTTCATGACATAGGCG,sample,118589,117902,9977,107925,27010,80915,32544,1065,26404,3208,58948,17694,5410,1208,12909,16425
TTATTCGACATAGGCG,sample,86158,85627,4602,81025,20403,60622,33126,1834,16367,1694,49493,7601,3666,1073,9779,13761
ATGACCGACATAGGCG,sample,58401,57913,6048,51865,5513,46352,15288,1153,17898,2062,33186,9951,4706,1233,1642,3462
TATCAGTTTTGGAGAG,sample,97774,97192,6885,90307,20555,69752,27351,1225,24561,2461,51912,14154,5075,1136,10979,13803
ATTCTCTTTTGGAGAG,Pos_Ctrl,60972,60479,3762,56717,2695,54022,44783,4798,3111,349,47894,981,5253,5957,3404,1210
GGTTGCGTTTGGAGAG,sample,103938,103477,2728,100749,32528,68221,48261,2358,13429,1675,61690,2498,1937,1061,22894,20807
CCTCTAGATTGGAGAG,sample,112758,112321,2571,109750,36841,72909,52966,3323,13122,1534,66088,1964,1375,1098,24864,23039
AGTACCATTTGGAGAG,sample,101448,100966,3506,97460,28704,68756,44580,3014,14233,1441,58813,5488,3156,1470,18895,18220
TTCGTAATTTGGAGAG,sample,38820,38614,1714,36900,11331,25569,15636,1168,5451,628,21087,2686,2607,1574,1584,7289
TTCCGTCTTTGGAGAG,Pos_Ctrl,61340,60550,3997,56553,2491,54062,44889,4130,3429,459,48318,1155,5281,6110,2657,1205
TCGCATCTTTGGAGAG,sample,48958,48611,3688,44923,10337,34586,14603,963,11695,1239,26298,6086,3472,998,2815,6685
GCCTTGCTTTGGAGAG,sample,57922,57517,2666,54851,10560,44291,23869,1393,12539,1755,36408,4735,2794,1161,7653,7538
ACTATACTTTGGAGAG,sample,88678,87920,8109,79811,9324,70487,23743,1114,28803,3779,52546,13048,5020,1254,3047,6132
GACGGAGATTGGAGAG,sample,70975,70466,4875,65591,17117,48474,21372,816,15648,1417,37020,9221,4019,813,9457,10926
GGAGGACGTTGGAGAG,sample,12034,11885,665,11220,1530,9690,4600,424,2923,267,7523,1476,1529,756,290,1001
GGACGTAGTTGGAGAG,sample,63858,63315,5891,57424,7521,49903,16173,970,19764,2790,35937,10206,4471,1027,2373,4880
CTTGATAGTTGGAGAG,sample,67416,66985,4349,62636,9853,52783,23237,1489,18213,2319,41450,7525,3371,1114,3797,6465
GACGATAATTGGAGAG,sample,68753,68187,4612,63575,11972,51603,22625,1931,16152,2137,38777,8758,3934,1138,6440,8029
AACTCGTATTGGAGAG,sample,83946,83551,2339,81212,27965,53247,36906,2217,11555,1380,48461,1189,1102,774,17665,17582
CGTATGAATTGGAGAG,sample,39887,39552,2941,36611,8271,28340,13708,905,8588,1188,22296,3951,3048,1143,4354,5534
AATATATCTTGGAGAG,sample,79452,78857,6807,72050,12199,59851,29000,1793,17961,1998,46961,9099,4978,1665,6892,8337
ACCAATGCTTGGAGAG,sample,56520,56222,2178,54044,12275,41769,24338,1461,11107,1523,35445,3340,2404,1130,6519,8679
GTCTTAGCTTGGAGAG,sample,93239,92379,10790,81589,13137,68452,13527,1052,28847,3177,42374,21849,7567,1215,3073,8515
TCGCCTGATTGGAGAG,sample,40126,39843,2988,36855,8784,28071,12935,1156,8090,859,21025,5031,3555,1414,2484,5597
ATGACCGATTGGAGAG,sample,111419,110607,11245,99362,14639,84723,28261,2177,30965,4115,59226,19205,6658,1314,6901,9709
ATTCTCTTTTCAAGCC,sample,91269,90728,5785,84943,19612,65331,30142,1591,21250,2438,51392,9910,4380,1157,11546,13824
CCTCTAGATTCAAGCC,sample,46191,45699,6749,38950,2409,36541,9571,661,15418,1617,24989,9274,4472,1102,343,1176
TTCGTAATTTCAAGCC,sample,80866,80351,4205,76146,19861,56285,31398,2219,14418,1779,45816,6471,3368,1053,11636,13136
TTCTAATGTTCAAGCC,sample,67998,67519,2402,65117,16316,48801,29672,2062,11994,1899,41666,3174,2548,1219,9459,11375
ATGCCTGGTTCAAGCC,sample,36051,35757,3333,32424,7175,25249,9183,661,9109,1125,18292,5171,3278,979,2057,4552
CAACCGCGTTCAAGCC,sample,45772,45304,5268,40036,6076,33960,8699,530,13469,1605,22168,9657,5187,1085,1856,4031
TTCCGTCTTTCAAGCC,sample,103102,101704,22396,79308,6342,72966,10167,718,32738,3643,42905,25700,8880,1359,1060,3006
CAAGGCCTTTCAAGCC,sample,52560,52256,2829,49427,14217,35210,21225,1550,7150,1182,28375,4103,2923,1511,5860,9291
ACTATACTTTCAAGCC,sample,86721,85912,10244,75668,12811,62857,18197,1398,23517,2874,41714,16871,6283,1096,4595,8234
CCAGAGCGTTCAAGCC,sample,76889,76356,3372,72984,18210,54774,32870,2358,13672,1239,46542,4635,2180,807,17220,12751
GTTAGCCGTTCAAGCC,sample,89044,88334,10511,77823,14784,63039,23204,1561,21602,2452,44806,14220,5924,1139,9199,9418
CCGCAACGTTCAAGCC,sample,63363,62720,6550,56170,13115,43055,15429,1050,14829,1611,30258,10136,4349,875,4512,8146
GGACGTAGTTCAAGCC,sample,72709,72086,6705,65381,13206,52175,20685,1232,17299,2568,37984,10391,4229,904,7831,8890
CTTGATAGTTCAAGCC,sample,64089,63613,3399,60214,14040,46174,23151,1543,13717,1583,36868,6180,3438,1100,7209,9271
GACGATAATTCAAGCC,sample,79357,78810,4422,74388,17818,56570,30823,1239,16995,1288,47818,6225,3239,996,12090,11879
CGAGGCAGTTCAAGCC,sample,69166,68366,12203,56163,6610,49553,9250,647,21540,2287,30790,15829,6895,1102,1031,3587
CCATGAAGTTCAAGCC,sample,41698,41350,2838,38512,7505,31007,15052,1054,8610,1106,23662,5185,2928,1071,2063,4976
AATCCGTCTTCAAGCC,sample,30591,30296,1900,28396,6548,21848,11778,742,5451,744,17229,3133,2495,1238,1637,4570
CGGATTACTTCAAGCC,sample,47318,46982,3734,43248,6407,36841,16158,951,12458,1389,28616,5885,3353,1145,2420,4303
GTTAGGACTTCAAGCC,sample,57869,57513,3307,54206,13508,40698,20021,1604,11692,1144,31713,6237,3562,1074,5812,9401
CGTATGAATTCAAGCC,sample,84888,84252,6554,77698,18747,58951,18908,1299,20669,2640,39577,15435,5120,1062,6249,12143
TTGGCCTCTTCAAGCC,Pos_Ctrl,28060,27793,2144,25649,1269,24380,20048,2029,1569,195,21617,539,4099,3971,1134,658
ACCAATGCTTCAAGCC,sample,67885,67375,6114,61261,9189,52072,21608,1410,17796,2062,39404,9196,4588,1279,5283,6029
GTACCGTATTCAAGCC,sample,76004,75364,7565,67799,7962,59837,17856,1480,24589,3102,42445,12810,5121,1101,2546,5235
CTTCATGATTCAAGCC,sample,76495,75941,7107,68834,11259,57575,21955,1363,20833,2364,42788,11060,4854,1086,4619,7196
AGGTCGGATTCAAGCC,sample,97066,96188,13703,82485,10634,71851,16477,938,30280,3489,46757,20667,7437,1211,4261,6459
TTATTCGATTCAAGCC,sample,83545,83138,5580,77558,20202,57356,25041,2169,17451,1753,42492,10942,3635,871,9494,12916
TCCAACTTAACTTAAC,Neg_Ctrl,248,163,46,117,33,84,40,0,27,1,67,16,38,22,13,12
TTCTAATGAACTTAAC,sample,91473,90943,8680,82263,17028,65235,25868,1622,22105,2442,47973,13198,5550,1152,9568,11044
TAGTACGGAACTTAAC,sample,80442,80067,6155,73912,17747,56165,24174,1532,17263,2118,41437,11078,5004,1098,10958,11474
CAACCGCGAACTTAAC,sample,75262,74868,4750,70118,18265,51853,25630,1110,15244,1613,40874,8256,3799,851,13078,11651
GGACCTCTAACTTAAC,Neg_Ctrl,289,215,54,161,27,134,78,5,31,6,109,14,40,22,26,12
CAAGGCCTAACTTAAC,sample,19059,18953,830,18123,5308,12815,6833,555,3573,387,10406,1467,1714,938,1419,3394
GTTAGCCGAACTTAAC,sample,15267,15192,1253,13939,2604,11335,4109,205,4285,460,8394,2276,1826,409,1118,1695
ACCTCGAGAACTTAAC,sample,27056,26880,1106,25774,6646,19128,9842,739,6004,506,15846,2037,1951,932,2023,4516
TGGACGAGAACTTAAC,sample,60029,59435,9624,49811,6830,42981,6926,483,18892,1928,25818,14752,6178,812,2047,4031
GACGATAAAACTTAAC,sample,81194,80671,6933,73738,13427,60311,19976,1214,21797,2145,41773,15179,5674,1359,3167,8310
ACGACTTCAACTTAAC,sample,29482,29280,1927,27353,8109,19244,7825,504,6697,960,14522,3258,2289,727,2014,4812
CATGATTCAACTTAAC,sample,74487,74127,1444,72683,22901,49782,37292,2249,8362,743,45654,1136,1232,962,14706,14690
AATCCGTCAACTTAAC,sample,94376,93929,3779,90150,25326,64824,40203,2211,15882,1819,56085,4709,2572,984,14725,17003
TTGGCCTCAACTTAAC,sample,51249,50876,2540,48336,12197,36139,19531,1716,9073,1122,28604,4697,2807,1035,4454,7683
ACCAATGCAACTTAAC,sample,74570,74177,2387,71790,22583,49207,28156,2188,12994,1721,41150,4148,2641,834,10968,14087
TGCTTCGCAACTTAAC,sample,73194,72736,3356,69380,16419,52961,30084,1858,12714,1348,42798,6957,3741,1231,7425,11413
GGCATATAAACTTAAC,sample,70340,69915,3551,66364,14696,51668,26895,1488,13204,1497,40099,8584,3967,1225,9122,10080
TCGCCTGAAACTTAAC,sample,74828,74205,7026,67179,10113,57066,21188,1913,18551,1924,39739,13490,5681,1292,3202,6534
AGGTCGGAAACTTAAC,sample,68679,68052,6599,61453,10414,51039,18526,1578,17818,1951,36344,11166,4729,1077,2926,6180
TCCTCCGTATACTTGA,sample,46450,46038,7225,38813,6028,32785,8701,678,12940,1421,21641,9045,4456,773,2752,3822
TTCGTAATATACTTGA,sample,46822,46575,2056,44519,11500,33019,19684,1004,8623,763,28307,2945,1986,1037,7248,7960
TTCTAATGATACTTGA,sample,40534,40220,5005,35215,9838,25377,6242,477,10200,1137,16442,7321,3740,650,2048,5522
ATGCCTGGATACTTGA,sample,59483,58834,8007,50827,7327,43500,13515,954,16262,1807,29777,10962,4851,1168,3176,4611
TGAGCGCGATACTTGA,sample,74046,73591,6684,66907,15801,51106,21710,1451,16261,1592,37971,10092,4077,971,6772,9623
GGACCTCTATACTTGA,sample,20888,20696,2808,17888,2350,15538,4865,331,5990,751,10855,3601,2698,798,830,1483
GACGGAGAATACTTGA,sample,58217,57942,1740,56202,17956,38246,24628,1838,7620,869,32248,3291,2166,752,7220,11186
GGAGGACGATACTTGA,sample,96926,96199,7854,88345,13016,75329,29125,2454,25426,2867,54551,15457,5287,946,9646,8926
AATCCGTCATACTTGA,sample,64465,63846,7215,56631,4899,51732,13775,938,20289,1932,34064,14798,4925,836,1099,2560
AGTCCGCAATACTTGA,sample,90368,89937,2421,87516,24210,63306,44397,2563,11735,1990,56132,2621,1381,838,15924,16497
TTGGTACCATACTTGA,sample,113453,112734,5018,107716,26890,80826,45352,3205,20606,2135,65958,9528,3484,983,15800,19632
CTAGGACCATACTTGA,sample,88175,87466,7709,79757,11781,67976,24878,1600,24354,2832,49232,14312,4923,1141,2868,7715
CGGATTACATACTTGA,sample,86584,85707,12022,73685,11103,62582,13457,703,25131,2517,38588,20774,6824,1020,2526,6902
AACTCGTAATACTTGA,sample,90615,90166,2029,88137,26049,62088,46157,2523,10445,1455,56602,1508,900,677,22782,17570
CGTATGAAATACTTGA,sample,117234,116415,10130,106285,21831,84454,35306,2030,27932,2652,63238,16534,6045,1112,12384,15091
AATATATCATACTTGA,Neg_Ctrl,303,253,82,171,25,146,50,1,54,5,104,36,50,19,17,14
ACCAATGCATACTTGA,sample,74994,74135,11333,62802,5233,57569,10547,788,24477,2580,35024,19177,6331,1037,536,2308
TGCTTCGCATACTTGA,sample,55503,55101,3739,51362,11346,40016,20027,920,11046,1378,31073,6645,3620,1010,5513,7559
AAGTTCGTATCCGCGA,sample,94693,94326,2323,92003,33268,58735,42454,2594,9174,1327,51628,3186,2430,1419,15423,20240
GGTTGCGTATCCGCGA,sample,66263,65620,9823,55797,8241,47556,10853,592,20116,2054,30969,13941,5836,1133,1833,5117
AGTACCATATCCGCGA,sample,66222,65711,7563,58148,9426,48722,14017,1352,19295,2003,33312,12055,4549,991,2668,5744
TGAGCGCGATCCGCGA,sample,74998,74354,8979,65375,7810,57565,17649,1153,23885,2596,41534,12282,5449,1245,2638,5249
CAACCGCGATCCGCGA,sample,63689,63203,6296,56907,12867,44040,18218,1114,13765,1368,31983,9575,4672,1141,5814,8160
AATGGTAAATCCGCGA,sample,120125,119569,4015,115554,37605,77949,48302,2374,21036,2758,69338,3479,1925,799,22755,24101
TCGCATCTATCCGCGA,sample,98313,97723,3601,94122,21653,72469,41366,3458,18449,2541,59815,6655,2514,814,10943,15240
CTTGATAGATCCGCGA,sample,87788,87336,2418,84918,24302,60616,41808,2954,11682,1368,53490,2804,1127,732,13226,16057
CATTGCAGATCCGCGA,sample,2203,2152,448,1704,273,1431,328,13,620,37,948,433,432,100,102,151
AATCCGTCATCCGCGA,sample,100432,99775,6664,93111,22468,70643,35210,2050,20379,2431,55589,10573,3819,812,16607,15202
CGTACGTCATCCGCGA,sample,94423,93685,6681,87004,17990,69014,34127,1547,19784,1858,53911,11698,4605,1112,8982,12284
TTGGTACCATCCGCGA,sample,89166,88430,8321,80109,12115,67994,22476,1690,25919,2934,48395,14975,5287,1057,3339,7921
GTTAGGACATCCGCGA,sample,112372,111584,5972,105612,26092,79520,41106,3087,20498,3856,61604,10973,4048,1004,13142,18090
ACGTATTAATCCGCGA,sample,117504,116769,6141,110628,27683,82945,41442,2104,24896,2904,66338,11599,4072,1018,11231,18604
GGCATATAATCCGCGA,sample,56506,56199,2218,53981,14100,39881,23045,2219,9244,1256,32289,4117,2722,1095,5424,9132
TCAATATAATCCGCGA,sample,101442,100505,13770,86735,11640,75095,13514,1241,32668,3610,46182,24062,7628,1115,1490,6871
TCGCCTGAATCCGCGA,sample,102626,101863,8683,93180,17114,76066,27535,2047,25783,2508,53318,18193,4998,1026,7214,11181
AGGTCGGAATCCGCGA,sample,57985,57379,8294,49085,7195,41890,9538,540,17564,1938,27102,12310,4992,873,975,3895
ATGACCGAATCCGCGA,sample,49583,49277,3010,46267,16402,29865,13784,916,9121,1051,22905,4993,3145,1044,3761,9637
ATTCTCTTAGGACTCA,sample,70223,69716,2581,67135,17593,49542,29356,2088,12030,1330,41386,4738,2674,951,5459,11632
TCCAACTTAGGACTCA,sample,177039,175564,18031,157533,20431,137102,31490,1859,53886,5346,85376,44521,9328,1465,7207,11955
CCTCTAGAAGGACTCA,sample,95781,95172,2700,92472,23890,68582,46107,3530,12538,2259,58645,4148,2213,1138,11973,16144
TGAGCGCGAGGACTCA,sample,94559,93803,8328,85475,19216,66259,19651,1124,24693,2673,44344,18118,6138,901,7339,11714
AATGGTAAAGGACTCA,sample,93002,92142,15066,77076,6107,70969,12268,689,31694,3249,43962,23069,7411,1109,842,3356
CAAGGCCTAGGACTCA,sample,87147,86763,2568,84195,22430,61765,49473,3227,7218,655,56691,1192,1113,990,14032,14978
GACGGAGAAGGACTCA,sample,59684,59227,3727,55500,10959,44541,21201,1320,12378,1635,33579,8007,3703,959,6922,6952
CATTGCAGAGGACTCA,sample,101813,101035,9061,91974,16552,75422,29780,2533,24927,2440,54707,15742,5866,1437,4770,11290
ACGACTTCAGGACTCA,sample,94862,94058,7805,86253,13408,72845,32887,2474,21499,2289,54386,13696,5421,1393,3163,9010
AATCCGTCAGGACTCA,sample,44195,43920,1119,42801,10915,31886,22909,1861,4833,579,27742,1704,2005,1349,3747,7525
AACTCGTAAGGACTCA,sample,46418,46049,4363,41686,7171,34515,11966,805,13045,1418,25011,7281,3574,797,3424,4656
CGTATGAAAGGACTCA,sample,77807,77268,3096,74172,17846,56326,35976,2413,11906,1033,47882,4998,2549,1091,10951,12374
AATATATCAGGACTCA,sample,84051,83340,9292,74048,8083,65965,18414,1397,27874,3365,46288,14915,5566,1092,2600,5019
ACCAATGCAGGACTCA,sample,84926,84389,4359,80030,21184,58846,33144,1873,15163,1586,48307,7080,2683,785,13833,14146
AAGAGCGCAGGACTCA,sample,59260,58852,2431,56421,12724,43697,23536,1182,12965,1744,36501,4270,2207,854,7780,8883
CCAATTCCAGGACTCA,sample,117858,116800,13092,103708,13285,90423,19425,1331,35839,4110,55264,29718,9051,1427,4404,8228
TTGGTTAAAGGACTCA,sample,82808,82219,4312,77907,13220,64687,34805,2970,16974,2249,51779,7689,3576,1264,5734,9211
TCGCCTGAAGGACTCA,sample,104133,103068,13207,89861,7125,82736,12012,716,35895,3696,47907,30417,8576,1225,1027,3681
AGGTCGGAAGGACTCA,Pos_Ctrl,56821,56204,3865,52339,2518,49821,41578,3907,3036,307,44614,993,5390,5922,3323,1200
ATGACCGAAGGACTCA,sample,42849,42616,1571,41045,11432,29613,15681,781,8474,840,24155,3837,2573,878,3154,7237
TCCAACTTTATTGAAC,sample,88784,88249,3156,85093,15954,69139,33560,2800,21495,2511,55055,8773,3635,1057,6452,10868
TCCTCCGTTATTGAAC,sample,121771,120945,8555,112390,21826,90564,32401,2464,30478,3183,62879,22038,7100,1420,6894,13801
ACGTAAGTTATTGAAC,sample,123994,123215,5402,117813,33543,84270,43408,3950,22768,2487,66176,11657,3953,1028,13639,22272
TGAGCGCGTATTGAAC,sample,76322,75957,4139,71818,11566,60252,25570,2446,21115,2308,46685,8813,4583,1342,3254,7917
CAAGGCCTTATTGAAC,sample,76095,75545,5585,69960,8746,61214,23922,2046,22690,2693,46612,9863,3872,1066,3530,5931
CATAACCTTATTGAAC,sample,99002,98258,8228,90030,13490,76540,31008,2583,25062,2570,56070,15317,5668,1153,5329,9161
ACTATACTTATTGAAC,sample,130433,129322,14449,114873,17136,97737,27723,1957,37359,4016,65082,26682,7770,1506,3703,10897
GACGATAATATTGAAC,sample,98350,97772,5961,91811,15998,75813,38554,2757,21205,2434,59759,10863,4704,1216,9291,11576
CCATGAAGTATTGAAC,sample,81899,81099,7856,73243,16076,57167,18443,1427,22153,2367,40596,12777,5655,1067,4761,10444
ACGACTTCTATTGAAC,sample,102352,101892,2672,99220,28123,71097,50185,3043,13887,1641,64072,2341,1720,893,27102,19089
AATATATCTATTGAAC,sample,139184,138187,11865,126322,18385,107937,39244,2891,37994,4177,77238,23631,7534,1457,10451,12412
TGCTTCGCTATTGAAC,sample,66430,65928,3749,62179,10438,51741,22199,1362,17624,2420,39823,8136,3568,1018,3473,6959
GAAGGCGCTATTGAAC,sample,77118,76540,3848,72692,16855,55837,26667,1774,15201,1704,41868,10491,4336,1278,6048,11373
GTCTTAGCTATTGAAC,sample,136835,135786,10249,125537,17416,108121,39124,2850,38231,4729,77355,23187,7837,1599,8386,11212
GTACCGTATATTGAAC,sample,76655,75942,6756,69186,10930,58256,19856,1752,21710,2699,41566,12239,5427,1081,3218,7194
TCGCCTGATATTGAAC,sample,41846,41460,4895,36565,4471,32094,7778,472,12210,1322,19988,10312,4659,846,1118,2673
TTATTCGATATTGAAC,sample,77170,76668,3674,72994,16217,56777,28884,2527,15568,2646,44452,7152,3704,1020,7959,10997
GACCGGAATATTGAAC,sample,106402,105786,6339,99447,23080,76367,41665,3603,17439,2031,59104,11629,5037,1534,8158,14463
GGAGAGTTGTTCAACT,sample,27398,27238,2418,24820,4436,20384,6783,391,7779,822,14562,4609,2803,718,1802,2802
ACGTAAGTGTTCAACT,sample,32506,32322,1741,30581,5536,25045,13518,718,7386,857,20904,2566,1985,776,6037,3874
TAGTACGGGTTCAACT,sample,33576,33398,1997,31401,7046,24355,13503,695,6552,691,20055,2914,2489,807,5839,5000
CAACCGCGGTTCAACT,sample,23172,22971,2194,20777,4185,16592,5903,396,5559,525,11462,4209,2695,591,2174,2674
GGAGGACGGTTCAACT,sample,20258,20115,1909,18206,3670,14536,6887,405,4073,512,10960,2659,1965,560,3233,2398
GGCCAGAGGTTCAACT,sample,22705,22530,1783,20747,4242,16505,9158,633,4086,487,13244,2141,2043,880,2830,3145
CCATGAAGGTTCAACT,sample,21367,21194,1907,19287,2536,16751,7163,454,5310,550,12473,3274,2174,590,1580,1742
CATGATTCGTTCAACT,sample,31961,31754,1890,29864,6312,23552,12628,800,6733,921,19361,2470,2414,1071,5041,4178
GTCCTGCCGTTCAACT,sample,31992,31774,1510,30264,8243,22021,13163,882,4912,533,18075,2531,2119,973,5314,5586
TTGGTACCGTTCAACT,sample,34137,33954,3497,30457,4836,25621,11408,799,7931,901,19339,4582,3268,786,5598,3348
GCCTGAACGTTCAACT,sample,9082,9014,440,8574,1834,6740,3930,234,1653,167,5583,756,1035,538,1694,1253
CGTATGAAGTTCAACT,sample,16071,15946,1605,14341,2025,12316,4005,331,4810,431,8815,2739,2257,561,596,1271
TGCTTCGCGTTCAACT,sample,17128,17013,1388,15625,2700,12925,5952,418,3926,399,9878,2230,1762,602,1708,1837
GTCTTAGCGTTCAACT,sample,23008,22851,1439,21412,4617,16795,8640,510,4829,529,13469,2287,1887,584,3344,3152
GGCATATAGTTCAACT,sample,24433,24253,2241,22012,1919,20093,6074,361,8121,881,14195,4656,2644,674,503,1089
TCAATATAGTTCAACT,sample,31065,30855,3783,27072,3974,23098,6151,426,8821,912,14972,6788,3382,569,1548,2446
TCGCCTGAGTTCAACT,sample,20260,20145,955,19190,2803,16387,8688,714,4646,588,13334,1751,1573,837,1285,1964
TTATTCGAGTTCAACT,Neg_Ctrl,101,98,18,80,18,62,18,2,21,0,39,21,21,17,5,11
ATTCTCTTCTGAGGTT,sample,182616,181502,11747,169755,35229,134526,67926,4458,36994,3562,104920,21586,7072,1849,23624,24725
TCCTCCGTCTGAGGTT,sample,131651,131016,5661,125355,35143,90212,58260,3682,18564,1533,76824,8173,2459,1134,26754,24023
CCTCTAGACTGAGGTT,sample,51546,51162,2174,48988,10937,38051,23515,1145,8312,1084,31827,3995,2361,892,10755,7800
ATGCCTGGCTGAGGTT,sample,126423,125568,6582,118986,27288,91698,52140,3663,22783,2806,74923,10306,4871,1495,18435,18706
TGAGCGCGCTGAGGTT,sample,120234,119226,13279,105947,13124,92823,24058,1657,38760,3989,62818,24359,7646,1516,3536,8205
TTAGAAGTCTGAGGTT,sample,124184,123332,4507,118825,22553,96272,63172,4438,18525,2243,81697,7894,3640,1742,10586,15143
TCGCATCTCTGAGGTT,sample,137821,136695,14606,122089,21901,100188,27868,1688,37977,4811,65845,27844,8093,1352,8508,14006
CATAACCTCTGAGGTT,sample,93846,93197,5262,87935,16165,71770,36305,1957,20005,2347,56310,11156,4497,1362,12599,11339
ACTATACTCTGAGGTT,sample,68275,67973,2095,65878,17705,48173,34172,2656,8391,1329,42563,1625,1402,903,15004,12332
CCGCAACGCTGAGGTT,sample,70504,69956,3428,66528,15248,51280,27319,1677,13839,1429,41158,7016,4080,1654,8063,10409
CTTGATAGCTGAGGTT,sample,144132,143355,5273,138082,32704,105378,67404,4450,20537,2429,87941,10558,4312,1631,25330,22434
ACCTCGAGCTGAGGTT,sample,123414,122841,3587,119254,31848,87406,65218,3202,14196,1287,79414,3503,1958,1103,33590,22839
GGCCAGAGCTGAGGTT,sample,121586,120814,6915,113899,23505,90394,47200,2939,24536,2527,71736,13192,5442,1643,20024,16261
CATTGCAGCTGAGGTT,sample,158603,157979,4205,153774,44883,108891,79239,3480,19721,1715,98960,4736,2248,1173,36939,31023
CGAGGCAGCTGAGGTT,sample,93479,92729,7632,85097,16583,68514,23123,1396,26492,2680,49615,14823,5832,1359,6407,10701
CCATGAAGCTGAGGTT,sample,133748,133014,5142,127872,32354,95518,60564,2844,21780,2554,82344,7776,3720,1326,26944,22504
CGTACGTCCTGAGGTT,sample,131886,131252,4238,127014,37560,89454,65542,3192,14863,1717,80405,4140,2313,1173,31906,25038
TTGGTACCCTGAGGTT,sample,121740,120736,10514,110222,20037,90185,27806,1539,32310,3595,60116,24935,8190,1423,11493,13266
GTTAGGACCTGAGGTT,sample,169994,169247,5052,164195,46413,117782,84362,5309,23493,2482,107855,2136,1430,1086,42953,32390
ACGTATTACTGAGGTT,sample,197106,195659,14149,181510,25271,156239,69476,5804,45442,5831,114918,29686,8070,1984,11214,16326
AGGTCGGACTGAGGTT,sample,166214,164847,18615,146232,15179,131053,22487,1313,56945,6877,79432,43431,10743,1931,3908,9619
CCTCTAGAAGACCGTT,sample,48606,48268,2783,45485,11303,34182,18790,1480,8853,987,27643,4072,2988,1433,5530,7513
ATGCCTGGAGACCGTT,sample,60875,60497,2505,57992,14987,43005,24705,1510,11436,1655,36141,3699,2365,912,10185,10437
TAGTACGGAGACCGTT,sample,100216,99626,6324,93302,14766,78536,37518,3135,24033,2289,61551,11561,5716,1891,9132,10445
GGACCTCTAGACCGTT,sample,179702,178966,5210,173756,46177,127579,92723,4586,22589,2118,115312,5563,2381,1106,46354,31690
TCGCATCTAGACCGTT,sample,138315,137670,3548,134122,36887,97235,72075,4317,16362,1851,88437,2630,1193,948,37407,25319
GCCTTGCTAGACCGTT,sample,152421,151529,6041,145488,31975,113513,69261,3083,25329,3505,94590,12335,3864,1214,30015,23156
CAAGGCCTAGACCGTT,sample,118495,117636,4262,113374,23393,89981,52465,3175,23341,3179,75806,7821,3261,1244,16314,15926
CATAACCTAGACCGTT,sample,150676,149511,10420,139091,22359,116732,46383,3070,38792,4486,85175,24001,7297,1558,9365,14824
CGAGGCAGAGACCGTT,sample,126424,125294,12653,112641,11705,100936,19684,1735,43006,4414,62690,32097,8169,1309,3070,5894
GTCCTGCCAGACCGTT,sample,128381,127457,9080,118377,20937,97440,46497,2569,27969,2849,74466,17556,5322,1106,15962,14031
CGGATTACAGACCGTT,sample,129021,128246,5693,122553,29472,93081,60123,4561,19288,1875,79411,7234,2832,997,25800,20384
GTTAGGACAGACCGTT,sample,121548,120724,8743,111981,20077,91904,41715,2595,26811,3461,68526,17322,6216,1375,11623,13509
CGTATGAAAGACCGTT,sample,135144,134264,6497,127767,26303,101464,60550,3463,23984,2764,84534,10703,3747,1102,24297,18892
AAGAGCGCAGACCGTT,sample,148395,147039,16696,130343,13082,117261,29538,2580,47948,5081,77486,32114,8895,1665,3744,7786
GTCTTAGCAGACCGTT,sample,121013,120354,3132,117222,28104,89118,61886,3780,16694,1421,78580,5337,1972,1044,18010,20078
ATGACCGAAGACCGTT,sample,136864,135951,11408,124543,13913,110630,30279,2552,45693,5386,75972,26720,7720,1427,4425,8673
GGAGAGTTCTTGAGTT,sample,149875,149005,10172,138833,25854,112979,35342,2531,42542,4638,77884,27926,7967,1589,7688,16506
ATTCTCTTCTTGAGTT,sample,169596,168658,7413,161245,41561,119684,62848,4132,31559,3895,94407,17250,5985,1681,20120,26940
ACGTAAGTCTTGAGTT,sample,200529,199126,15338,183788,21619,162169,50623,3469,64178,7365,114801,36534,8677,1704,7677,13654
ATGCCTGGCTTGAGTT,sample,80001,79513,4494,75019,11092,63927,28073,2055,22735,2983,50808,8081,4329,1605,4151,8086
AATGGTAACTTGAGTT,sample,187458,186027,15751,170276,27514,142762,43871,3585,53619,5888,97490,35799,8527,1712,14281,18673
TTAGAAGTCTTGAGTT,sample,79274,78793,1856,76937,19757,57180,39224,4008,10947,1048,50171,1953,1748,1273,10568,13294
TTCCGTCTCTTGAGTT,sample,127136,126325,8838,117487,23138,94349,45387,2857,28227,3077,73614,14801,5532,1303,21098,16897
TCGCATCTCTTGAGTT,sample,131692,130713,8711,122002,17027,104975,41469,3353,38796,4224,80265,17133,5912,1525,10546,11977
GCCTTGCTCTTGAGTT,sample,135084,134144,9413,124731,31118,93613,38494,3060,29999,3912,68493,18148,6446,1593,9082,20267
GTTAGCCGCTTGAGTT,sample,138389,137391,7215,130176,17186,112990,53436,3996,35922,4539,89358,15097,5566,1823,8687,11683
GACGATAACTTGAGTT,sample,109217,108278,10225,98053,11510,86543,27508,1845,34482,4005,61990,18703,6386,1534,3934,6828
CATTGCAGCTTGAGTT,sample,120761,119964,5291,114673,19801,94872,49732,2431,29400,3688,79132,9621,3846,1327,18576,14069
CCATGAAGCTTGAGTT,sample,82070,81418,5083,76335,13599,62736,26627,2007,20746,2769,47373,10587,4537,1395,6119,9322
AGTCCGCACTTGAGTT,sample,197585,196309,10968,185341,35044,150297,80667,6158,35395,4877,116062,23200,6818,1834,24405,25294
GTCCTGCCCTTGAGTT,sample,76209,75644,2302,73342,9296,64046,47516,3357,8696,948,56212,3529,3283,2308,3598,6244
GCCTGAACCTTGAGTT,sample,98286,97655,7346,90309,13891,76418,29692,1915,23677,2839,53369,18295,6302,1659,8493,9101
AATATATCCTTGAGTT,sample,186202,184477,19710,164767,22083,142684,34922,2160,56087,5879,91009,43636,9724,1734,6355,13683
ACCAATGCCTTGAGTT,sample,133210,132100,10644,121456,18351,103105,40603,3029,33446,3730,74049,22297,6958,1515,7050,12743
AAGAGCGCCTTGAGTT,sample,162372,161283,9673,151610,30758,120852,65084,4421,32969,2765,98053,15613,4417,1312,23904,22079
GGCATATACTTGAGTT,sample,121919,121187,7222,113965,27059,86906,46938,2464,23133,1916,70071,12455,3694,1008,16353,18215
CTTCATGACTTGAGTT,sample,241956,240242,19386,220856,32202,188654,64384,3792,66073,6831,130457,47574,11387,2257,20147,21336
ATGACCGACTTGAGTT,sample,112194,111225,10410,100815,14031,86784,27504,1156,32606,3679,60110,21839,6504,1145,3529,8747
GGAGAGTTTCGGAGTT,sample,69835,69314,4327,64987,14521,50466,23624,1509,15722,1980,39346,7631,4204,1341,4473,9775
TCCAACTTTCGGAGTT,sample,115225,114609,4289,110320,24146,86174,47608,3752,23941,2452,71549,8421,3165,1021,19096,17389
AAGTTCGTTCGGAGTT,sample,87118,86625,2366,84259,25118,59141,40726,3066,10384,1240,51110,3725,2282,1263,14299,16429
ACGTAAGTTCGGAGTT,sample,112701,112017,4950,107067,19458,87609,49558,3128,24273,2588,73831,8062,3334,1336,15920,14289
TTCGTAATTCGGAGTT,sample,79402,78808,5843,72965,9071,63894,23272,1596,24702,2642,47974,11682,4887,1291,4023,6018
ACGTTATGTCGGAGTT,sample,81794,81139,7559,73580,12799,60781,22347,1655,19973,2304,42320,14502,6183,1352,5223,8795
ATGCCTGGTCGGAGTT,sample,82832,82372,5194,77178,17885,59293,28776,1856,17257,2117,46033,9287,4218,1129,11101,11710
GCCTTGCTTCGGAGTT,sample,103024,102446,5395,97051,19894,77157,38506,2894,22553,2235,61059,10969,4907,1168,15570,13679
GACGGAGATCGGAGTT,sample,83144,82421,7496,74925,12195,62730,20795,1228,22434,2728,43229,15545,5611,1036,6390,8286
CCAGAGCGTCGGAGTT,sample,64927,64305,5327,58978,7458,51520,17793,1248,20127,2084,37920,10268,4656,1047,3639,5012
GTTAGCCGTCGGAGTT,sample,70692,70209,2986,67223,17872,49351,28042,2260,11476,1081,39518,6492,3731,1217,9893,12061
CCGCAACGTCGGAGTT,sample,112291,111094,14195,96899,7858,89041,15178,1138,38673,4144,53851,29908,8895,1356,1961,3980
GGCCAGAGTCGGAGTT,sample,25574,25406,1409,23997,3912,20085,8956,504,6789,789,15745,3047,2218,726,1733,2711
CGAGGCAGTCGGAGTT,sample,41839,41607,1464,40143,11880,28263,20630,1077,5155,492,25785,909,965,721,10251,7933
ACGACTTCTCGGAGTT,sample,55661,55366,1416,53950,14726,39224,29910,1627,5912,730,35822,1045,922,744,14221,10327
AATCCGTCTCGGAGTT,sample,52425,51999,3131,48868,8595,40273,16555,1105,13037,1483,29592,8093,4237,917,5642,6024
CGTACGTCTCGGAGTT,sample,60417,60115,2096,58019,13697,44322,29531,2059,9148,1220,38679,2364,1687,835,11906,9990
TTGGTACCTCGGAGTT,sample,37842,37568,1802,35766,6407,29359,15253,909,8176,1146,23429,3875,2597,917,4180,4274
AACTCGTATCGGAGTT,sample,58910,58666,1576,57090,13465,43625,33277,2046,6634,342,39911,1326,1054,853,12496,9933
TTGGCCTCTCGGAGTT,Pos_Ctrl,4904,4846,431,4415,260,4155,3398,293,302,55,3700,107,1349,988,408,105
TGCTTCGCTCGGAGTT,sample,62927,62526,1990,60536,12565,47971,31719,3040,9168,802,40887,3242,2492,1203,7696,9080
GAAGGCGCTCGGAGTT,sample,33991,33674,3505,30169,3834,26335,8420,610,9365,1278,17785,6662,3851,944,1102,2407
GTACCGTATCGGAGTT,sample,47727,47445,2793,44652,9494,35158,16590,1170,10336,1143,26926,5919,3241,823,4954,6135
CTTCATGATCGGAGTT,sample,102064,101360,6605,94755,7672,87083,35271,2227,33412,3404,68683,12769,5185,1657,3359,4798
TTATTCGATCGGAGTT,sample,59221,58775,4007,54768,5287,49481,18624,1741,18003,1936,36627,9177,4053,1083,1287,3478
ATTCTCTTTGAACCTT,Pos_Ctrl,174260,172663,9912,162751,6737,156014,130610,12380,8878,1162,139488,2984,6793,9612,8404,2855
AAGTTCGTTGAACCTT,sample,230424,229123,8155,220968,43735,177233,104291,6806,46547,7639,150838,11950,3806,1599,35071,29899
GGTTGCGTTGAACCTT,sample,169822,168358,14638,153720,23422,130298,43188,1814,46979,5174,90167,33143,8139,1421,16483,14867
ACGTAAGTTGAACCTT,sample,113701,112925,8125,104800,16231,88569,36753,3163,28402,3772,65155,16479,6749,2305,5669,10796
AGTACCATTGAACCTT,sample,177736,176966,5399,171567,54770,116797,85354,3900,21048,3385,106402,3110,1474,872,49130,37094
TTCGTAATTGAACCTT,sample,160309,158955,16310,142645,23353,119292,43710,2469,41133,4004,84843,27976,7886,1609,12441,14708
TTCTAATGTGAACCTT,sample,104668,103697,11190,92507,11353,81154,20334,1944,32367,3599,52701,22910,6914,1295,2995,6898
ATGCCTGGTGAACCTT,sample,125439,124491,9745,114746,20426,94320,41203,2576,28976,2749,70179,18816,6128,1379,16495,14242
TAGTACGGTGAACCTT,Pos_Ctrl,79716,78653,5467,73186,3571,69615,57809,5319,4243,648,62052,1596,6161,6938,5186,1691
TTAGAAGTTGAACCTT,sample,239621,238376,17037,221339,47017,174322,92531,7385,44638,5340,137169,24428,7081,1851,38926,32232
TTCCGTCTTGAACCTT,sample,162646,161614,11744,149870,23575,126295,39325,2931,47221,5094,86546,31724,8621,1900,6000,16077
GGACCTCTTGAACCTT,sample,55404,54660,14615,40045,2668,37377,3241,164,17627,1890,20868,14455,6491,603,186,983
GCCTTGCTTGAACCTT,sample,86846,86196,2972,83224,18496,64728,39735,2308,15064,1391,54799,6230,3501,1355,9045,13139
CATAACCTTGAACCTT,sample,177986,177017,7694,169323,43385,125938,74445,4198,31063,3689,105508,12543,4152,1336,27811,29721
ACTATACTTGAACCTT,sample,79569,78969,7400,71569,10069,61500,22427,1447,23050,2885,45477,11691,5187,1294,5993,6691
GACGGAGATGAACCTT,sample,48706,48387,2094,46293,14100,32193,17486,928,8519,1084,26005,4176,2477,893,6413,9004
CCGCAACGTGAACCTT,Pos_Ctrl,34743,34355,1772,32583,1558,31025,26137,2549,1597,196,27734,546,4407,4582,2483,710
TGGACGAGTGAACCTT,sample,48849,48308,7576,40732,4123,36609,8371,626,14949,1658,23320,11005,5337,1087,1085,2134
CATTGCAGTGAACCTT,sample,78223,77481,7339,70142,9884,60258,19083,1462,22462,2720,41545,14531,5572,1079,6386,6513
CCATGAAGTGAACCTT,sample,96136,95695,2890,92805,26056,66749,46848,2392,14163,932,61011,2414,1198,733,24495,17948
AATCCGTCTGAACCTT,Pos_Ctrl,62359,61753,3267,58486,2437,56049,46544,4525,3410,459,49954,1111,5445,6398,2718,1081
CGTACGTCTGAACCTT,sample,70556,69928,4923,65005,10441,54564,21121,1882,18091,1830,39212,11640,5051,928,3433,6918
AGTCCGCATGAACCTT,sample,69804,69225,8038,61187,4875,56312,13669,834,22217,2381,35886,17211,5827,1026,1347,2359
AACTCGTATGAACCTT,sample,113598,112833,9114,103719,15155,88564,31922,2233,30364,3817,62286,20228,6933,1372,7477,9901
CGTATGAATGAACCTT,sample,177257,175795,15029,160766,13907,146859,50930,3058,54582,5721,105512,32568,8039,1955,3122,8694
TTGGCCTCTGAACCTT,sample,111757,110953,7226,103727,15559,88168,41747,3888,27789,2871,69536,11873,4872,1204,10099,11232
GAAGGCGCTGAACCTT,sample,170270,168965,13101,155864,14504,141360,53249,2941,47428,5818,100677,31924,8483,1854,5394,8764
CCAATTCCTGAACCTT,sample,83600,82850,5624,77226,11600,65626,21383,1447,24362,2369,45745,16065,5123,1049,3147,7304
GTACCGTATGAACCTT,Pos_Ctrl,21294,21095,1498,19597,1117,18480,15314,1256,1258,192,16572,460,3536,3110,1781,537
GGCATATATGAACCTT,sample,96728,96240,2910,93330,20685,72645,46984,2575,14614,1681,61598,6791,2355,903,17854,15306
TCGCCTGATGAACCTT,sample,78390,77800,5336,72464,9513,62951,25349,2022,21022,2247,46371,12311,5408,1485,2800,6024
CTTCATGATGAACCTT,sample,227355,225879,17839,208040,13528,194512,73977,6601,75190,9481,149167,29263,9362,2881,5505,7449
TTATTCGATGAACCTT,sample,81548,81038,5261,75777,11030,64747,38526,1753,14199,1773,52725,8496,3778,1266,7636,7413
ACGTAAGTACCGAATT,sample,127591,126628,10194,116434,23944,92490,31366,2175,34481,4032,65847,20436,6854,1283,9149,15889
AGTACCATACCGAATT,sample,188163,186922,11091,175831,23051,152780,63415,3764,55485,7697,118900,22419,5985,1625,15876,16286
TTCGTAATACCGAATT,sample,144540,143696,4774,138922,32264,106658,68502,4052,23827,2889,92329,7388,2859,1409,26998,23208
ACGTTATGACCGAATT,sample,155458,154420,9752,144668,30887,113781,59365,3150,32524,4255,91889,14487,5065,1530,23117,20173
ATGCCTGGACCGAATT,sample,170294,169185,7902,161283,30345,130938,68562,4125,33472,3806,102034,20973,6878,1663,22921,20792
TTAGAAGTACCGAATT,sample,123166,122416,5824,116592,28664,87928,49542,3703,20010,2334,69552,12339,5132,1743,11252,19080
GCCTTGCTACCGAATT,sample,115157,114119,12622,101497,16544,84953,23060,1875,31743,3675,54803,24600,7638,1264,6429,10253
CTTGATAGACCGAATT,sample,60926,60408,5783,54625,5385,49240,16392,1195,18863,1865,35255,10925,4941,1187,4741,3308
ACGACTTCACCGAATT,sample,60026,59583,3736,55847,10087,45760,18163,1286,15596,1557,33759,9158,4477,1081,4042,6603
CGTACGTCACCGAATT,sample,132386,131501,9171,122330,17373,104957,33680,2957,37868,3977,71548,26475,7321,1367,8519,11755
AGTCCGCAACCGAATT,sample,103232,102606,3871,98735,11200,87535,39399,3149,30088,4311,69487,10588,3504,1192,3679,7492
CTAGGACCACCGAATT,sample,114958,114217,4910,109307,21506,87801,50169,3732,21366,2709,71535,9825,4280,1250,8818,14864
AATATATCACCGAATT,Neg_Ctrl,478,352,112,240,48,192,90,3,57,8,147,34,75,38,22,22
GTACCGTAACCGAATT,sample,163689,162424,16162,146262,15499,130763,30033,1916,53274,5359,83307,40181,9164,1586,4668,8394
TCGCCTGAACCGAATT,sample,122238,121624,5124,116500,30173,86327,48526,3882,18716,2480,67242,12723,3455,1139,13935,20476
CTTCATGAACCGAATT,sample,173864,172784,9740,163044,24547,138497,49517,3562,49950,5143,99467,30325,8793,2100,9187,17132
TTATTCGAACCGAATT,sample,110985,110314,3478,106836,26498,80338,47260,3697,19096,2210,66356,8075,2381,782,19180,18694
ATGACCGAACCGAATT,sample,120992,120149,12843,107306,11858,95448,15875,1225,40582,4468,56457,33298,9108,1363,2663,7063
TCCAACTTGGTCTGGT,Neg_Ctrl,322,209,74,135,15,120,66,3,36,2,102,13,51,19,19,16
GGTTGCGTGGTCTGGT,sample,124880,124074,7378,116696,26335,90361,41010,1540,27385,3065,68395,17361,6634,1161,18545,17855
TCCTCCGTGGTCTGGT,sample,163391,162673,5661,157012,45171,111841,67782,3987,24752,2816,92534,12504,4780,1370,28375,29951
ACGTAAGTGGTCTGGT,sample,127535,126791,7719,119072,25914,93158,42338,2309,29462,3017,71800,16032,5870,1245,12921,17513
CCTCTAGAGGTCTGGT,sample,71569,71034,5249,65785,12364,53421,20238,1953,17267,2059,37505,11904,5200,1091,6356,7778
AGTACCATGGTCTGGT,sample,126551,125716,7954,117762,25611,92151,38803,3022,30006,3923,68809,16397,5771,1398,11824,15693
TGAGCGCGGGTCTGGT,Neg_Ctrl,209,173,52,121,40,81,36,4,23,1,59,17,35,17,9,21
CAACCGCGGGTCTGGT,sample,74819,74356,2943,71413,19118,52295,32119,2507,12705,1376,44824,3588,2654,983,11962,12712
GCCTTGCTGGTCTGGT,sample,109440,108811,5343,103468,25975,77493,45003,2653,19378,2477,64381,7982,3982,1190,16356,16668
GGAGGACGGGTCTGGT,sample,73309,72835,4413,68422,17733,50689,27536,2119,12450,1379,39986,7205,3599,973,11537,12175
GGACGTAGGGTCTGGT,Neg_Ctrl,176,127,46,81,29,52,18,1,20,1,38,12,27,11,8,10
ACGACTTCGGTCTGGT,sample,77711,77182,4618,72564,7361,65203,28051,1584,22516,3475,50567,9577,4394,1276,2425,5151
CGTACGTCGGTCTGGT,Neg_Ctrl,282,216,58,158,29,129,56,2,54,1,110,16,62,19,15,20
TTGGCCTCGGTCTGGT,sample,61601,61069,4810,56259,8303,47956,19316,1234,15863,2263,35179,9280,4022,754,4969,5601
AATATATCGGTCTGGT,sample,97072,96164,11751,84413,8335,76078,16419,1635,30982,3055,47401,23987,7494,1107,2641,4480
TGCTTCGCGGTCTGGT,sample,79397,78774,6674,72100,11049,61051,21670,2105,21781,2113,43451,13382,5284,996,4638,7991
GTCTTAGCGGTCTGGT,sample,112844,111982,8118,103864,12173,91691,32272,2023,33145,3779,65417,20472,6880,1527,5078,7674
GGCATATAGGTCTGGT,Neg_Ctrl,213,160,36,124,26,98,45,5,35,1,80,12,46,21,15,11
TATCAGTTCGACGTTA,sample,129420,128657,9758,118899,16970,101929,32762,2633,36358,3551,69120,26625,8367,1568,7555,10916
AAGTTCGTCGACGTTA,sample,195248,194167,13378,180789,38742,142047,58480,3324,47214,4053,105694,28976,8327,1595,27293,25398
ACGTAAGTCGACGTTA,sample,155310,154287,10452,143835,30569,113266,43329,2888,39255,4479,82584,23315,6947,1369,12968,20954
ATGCCTGGCGACGTTA,sample,126799,126195,3356,122839,31002,91837,66360,4647,14693,2181,81053,3956,2623,1443,21661,20929
TCGCATCTCGACGTTA,sample,97451,96912,4778,92134,16640,75494,37428,2779,22696,3125,60124,9466,4025,1203,10160,11550
ACTATACTCGACGTTA,sample,169124,167770,17926,149844,12524,137320,30499,2318,59477,7067,89976,37959,9718,1825,1901,7085
CTTGATAGCGACGTTA,sample,185131,183869,16561,167308,33009,134299,51805,2501,45313,5835,97118,28845,8982,1750,15971,21407
CATTGCAGCGACGTTA,sample,138998,138336,6318,132018,35510,96508,54397,3068,22850,3465,77247,12728,5218,1500,23908,22669
CCATGAAGCGACGTTA,sample,152707,152005,6062,145943,35334,110609,77108,4322,19838,2201,96946,7140,3211,1486,32109,23670
AATCCGTCCGACGTTA,sample,101872,101177,6176,95001,13367,81634,32039,1883,30960,3575,62999,13177,5241,1525,3838,9338
AGTCCGCACGACGTTA,sample,29122,28988,1078,27910,7486,20424,13094,606,4759,499,17853,1466,1480,818,5703,4991
CGGATTACCGACGTTA,sample,66484,66213,4889,61324,15073,46251,30092,1698,10583,1368,40675,2510,2126,1152,15060,11016
ACCAATGCCGACGTTA,sample,95437,94907,5043,89864,15526,74338,31333,2110,26145,3103,57478,11647,5210,1237,6556,10600
CCAATTCCCGACGTTA,sample,75057,74491,5883,68608,12414,56194,16706,1047,22539,2271,39245,13631,5492,989,3138,8097
TCGCCTGACGACGTTA,sample,80263,79955,2039,77916,23381,54535,35307,3226,10277,1540,45584,4185,2226,914,13468,15389
TTATTCGACGACGTTA,sample,89034,88499,5733,82766,10978,71788,23029,1738,28660,3988,51689,14373,5370,1169,2665,7121
ACGTTATGTACTAAGT,sample,78083,77490,8493,68997,11507,57490,17376,1109,20141,2451,37517,16413,6509,1233,5087,7019
ATGCCTGGTACTAAGT,sample,45707,45363,3363,42000,5602,36398,15582,1078,12356,1443,27938,5939,3589,1410,2451,3607
TTAGAAGTTACTAAGT,sample,115582,114786,6946,107840,19231,88609,42125,2785,27042,2119,69167,14538,5468,1280,19072,13947
GGACCTCTTACTAAGT,sample,47038,46672,3600,43072,6080,36992,16343,717,12411,1538,28754,5983,3260,939,5921,4102
CAAGGCCTTACTAAGT,sample,49906,49693,1732,47961,13372,34589,24533,1300,6360,872,30893,1524,1225,813,11433,9245
GACGGAGATACTAAGT,sample,35989,35712,3870,31842,4778,27064,10435,939,8554,840,18989,6296,3660,1010,2022,3028
CCAGAGCGTACTAAGT,sample,16637,16459,2390,14069,1754,12315,3374,248,4511,463,7885,3719,2512,528,1167,1006
GTTAGCCGTACTAAGT,sample,11802,11734,748,10986,2351,8635,4485,278,2415,271,6900,1186,1424,624,1225,1586
CTTGATAGTACTAAGT,sample,16575,16448,1008,15440,3848,11592,5811,363,3399,320,9210,1699,1405,535,1766,2334
GGCCAGAGTACTAAGT,sample,46175,45786,3487,42299,7050,35249,18427,925,9641,991,28068,5265,3172,964,6956,5008
AGTCCGCATACTAAGT,sample,35579,35293,2942,32351,5894,26457,12538,679,7571,812,20109,4857,3290,1082,4691,4100
TTGGTACCTACTAAGT,sample,37252,37038,1629,35409,9657,25752,16423,888,5607,607,22030,2227,2029,1017,7634,6404
TTGGCCTCTACTAAGT,sample,83250,82833,5737,77096,12934,64162,30643,2099,20376,2141,51019,8903,4302,1274,6984,8745
AATATATCTACTAAGT,sample,146418,145337,15629,129708,15324,114384,32577,1632,43390,4442,75967,32343,9519,1575,11089,9814
TGCTTCGCTACTAAGT,sample,63821,63374,4323,59051,16170,42881,24012,1226,11846,1264,35858,4533,2184,900,8628,10222
GAAGGCGCTACTAAGT,sample,53265,53088,1382,51706,15395,36311,27366,1772,5143,887,32509,1143,912,783,9868,9985
CCAATTCCTACTAAGT,sample,67011,66682,2105,64577,19492,45085,31207,2331,9036,1586,40243,925,916,746,10774,13448
TCAATATATACTAAGT,sample,62984,62608,3142,59466,13399,46067,23082,1603,13106,1878,36188,6398,3450,1042,4873,8900
TCGCCTGATACTAAGT,sample,64522,64183,2153,62030,19479,42551,31621,2280,6405,840,38026,1405,1202,790,9741,12561
CTTCATGATACTAAGT,sample,70213,69841,2902,66939,17050,49889,31432,2169,9683,1137,41115,5468,3046,1058,10371,11384
GACCGGAATACTAAGT,sample,62484,62056,4003,58053,4941,53112,18946,1690,20662,2881,39608,8933,4037,1092,1572,3096
ATTCTCTTTTGCCGCT,sample,206948,206089,5676,200413,65898,134515,83911,6247,29477,3003,113388,11877,3971,1268,37076,40758
TCCAACTTTTGCCGCT,sample,176099,175473,5565,169908,50966,118942,71787,6065,26656,3726,98443,10708,4642,1592,25084,32827
AATGGTAATTGCCGCT,sample,162151,161049,14580,146469,24309,122160,35425,2559,47412,5190,82837,31574,8433,1454,10463,16149
CCAGAGCGTTGCCGCT,sample,44431,44070,3162,40908,4409,36499,12941,673,15093,1848,28034,5944,3379,1113,1422,2985
GGACGTAGTTGCCGCT,sample,61847,61546,1517,60029,15702,44327,29955,2447,8846,904,38801,2175,1928,1308,9256,10811
GGCCAGAGTTGCCGCT,sample,87384,86804,4645,82159,12730,69429,35697,1777,20976,2658,56673,8321,3631,1330,12896,9699
CCATGAAGTTGCCGCT,sample,110250,109379,9392,99987,17294,82693,30329,1511,28830,3397,59159,18626,6488,1273,12054,11692
CATGATTCTTGCCGCT,sample,81199,80560,5662,74898,14657,60241,28974,2532,16803,1779,45777,10153,4890,1271,11468,9710
AATCCGTCTTGCCGCT,sample,115320,114336,9105,105231,16328,88903,31056,2281,30648,4650,61704,20268,7458,1671,5159,10606
TTGGTACCTTGCCGCT,sample,83312,82765,4420,78345,18072,60273,31948,1666,16731,1720,48679,8208,4008,1194,14159,12175
CGGATTACTTGCCGCT,sample,49766,49399,3939,45460,6842,38618,14557,934,14620,1821,29177,6686,3921,1265,2456,4699
CGTATGAATTGCCGCT,sample,50762,50287,1724,48563,9242,39321,24603,2122,8643,1022,33246,2931,2346,1136,4426,6558
TTGGCCTCTTGCCGCT,sample,188974,187858,16505,171353,25765,145588,46178,2966,51839,5061,98017,39544,10724,1858,16384,17048
AATATATCTTGCCGCT,sample,124715,124043,6454,117589,18050,99539,47332,3106,33070,4026,80402,12005,4906,1466,8212,12173
GAAGGCGCTTGCCGCT,sample,110121,109366,6731,102635,19781,82854,34233,2035,26768,3351,61001,16467,6794,1732,7093,13455
GTACCGTATTGCCGCT,sample,102420,101811,7646,94165,16940,77225,28605,1703,26399,2702,55004,17816,5834,1067,9300,10873
TCGCCTGATTGCCGCT,sample,93022,92367,5967,86400,14925,71475,33333,2618,19354,2198,52687,13972,4973,1252,4407,9599
GACCGGAATTGCCGCT,sample,103171,102421,9706,92715,14490,78225,19264,1984,29516,3723,48780,23738,7094,1153,3281,9394
TATCAGTTTTCGACCT,sample,126295,125568,5644,119924,27064,92860,50459,3336,25020,3049,75479,10996,4299,1208,19911,19036
GGTTGCGTTTCGACCT,sample,135486,134642,6514,128128,27355,100773,58346,4635,23409,2948,81755,11435,4622,1505,15499,18784
ACGTTATGTTCGACCT,sample,54642,54291,3157,51134,11842,39292,25186,1392,7910,1065,33096,3739,3430,1694,7699,7838
GTTAGCCGTTCGACCT,sample,37527,37286,2976,34310,9440,24870,10870,917,7761,945,18631,4377,3433,1229,2753,5794
TGGACGAGTTCGACCT,sample,99927,99273,5808,93465,18948,74517,37918,1943,21149,3560,59067,9947,4187,1211,13159,13055
GGCCAGAGTTCGACCT,sample,156146,154532,17997,136535,8032,128503,25653,1180,54470,5779,80123,41421,9766,1624,2083,4124
ACGACTTCTTCGACCT,sample,137140,136113,10343,125770,15052,110718,51570,4155,32659,3873,84229,18461,7242,2367,7587,9776
AATCCGTCTTCGACCT,sample,107467,106569,12469,94100,11827,82273,18526,1220,33581,3992,52107,24954,7838,1357,3978,7708
CGTACGTCTTCGACCT,sample,83168,82617,3550,79067,15868,63199,38874,3053,15117,1653,53991,4502,3066,1268,9337,11230
GTCCTGCCTTCGACCT,sample,121479,120689,3580,117109,29435,87674,57762,5261,16410,3599,74172,4642,2019,932,23416,20173
CTAGGACCTTCGACCT,sample,72304,71657,6148,65509,11352,54157,17301,2076,19903,2308,37204,12569,5251,1146,3193,7381
GTTAGGACTTCGACCT,sample,129565,128688,9244,119444,20276,99168,49738,4231,25401,3104,75139,16694,6430,1744,10121,13586
GCCTGAACTTCGACCT,sample,191133,189256,20825,168431,17890,150541,26870,1741,64550,7145,91420,50235,11488,1919,4887,10643
ACGTATTATTCGACCT,sample,101771,101082,4046,97036,24775,72261,45547,3433,14609,2603,60156,6069,3130,1316,14385,16829
TTGGCCTCTTCGACCT,sample,114695,114046,7215,106831,23754,83077,39873,3010,24455,2196,64328,13543,4398,1046,14697,15460
ACCAATGCTTCGACCT,sample,150120,148860,18368,130492,11099,119393,24638,1900,51624,5126,76262,36105,9972,1763,1760,6196
AAGAGCGCTTCGACCT,sample,89968,89189,11104,78085,9577,68508,12364,809,28827,2835,41191,23673,7745,1259,2212,5343
CCAATTCCTTCGACCT,sample,127845,126917,7823,119094,21442,97652,45662,3452,29473,3986,75135,15079,4621,1225,13693,14823
TTGGTTAATTCGACCT,sample,97119,96455,4574,91881,11864,80017,45149,2970,21517,2717,66666,7664,3679,1553,5678,8297
GTACCGTATTCGACCT,sample,116052,115280,6301,108979,23903,85076,40125,2975,23366,2638,63491,15972,5722,1396,10754,15849
TTATTCGATTCGACCT,sample,152501,151454,16089,135365,18148,117217,27860,2542,47484,5323,75344,34008,9351,1609,4919,11416
GGAGAGTTTCCAGACT,sample,67128,66822,4136,62686,10537,52149,20103,1268,19864,2021,39967,8893,4091,1012,6360,6914
GGTTGCGTTCCAGACT,sample,41425,41143,1756,39387,8887,30500,15429,1204,8943,1156,24372,3768,2574,1084,3583,5859
AGTACCATTCCAGACT,sample,124249,123699,3190,120509,36931,83578,57752,3546,16226,2056,73978,3998,1855,959,28157,24421
TGAGCGCGTCCAGACT,sample,41749,41582,838,40744,14981,25763,18697,1435,3792,624,22489,1215,1386,994,7464,9009
CAACCGCGTCCAGACT,sample,42152,41874,1735,40139,8189,31950,15152,1025,9910,988,25062,4875,3033,995,4846,5850
TCGCATCTTCCAGACT,sample,77111,76643,8103,68540,10662,57878,20414,1276,19751,2124,40165,14313,6243,1321,3654,6580
GCCTTGCTTCCAGACT,sample,74685,74035,9329,64706,9600,55106,12235,665,22451,2561,34686,17194,6780,1040,2983,5808
CAAGGCCTTCCAGACT,sample,59055,58635,2737,55898,15025,40873,22385,1369,10303,1165,32688,5651,3014,1019,7323,10050
CCAGAGCGTCCAGACT,sample,41102,40751,3092,37659,5840,31819,13944,943,10423,1078,24367,5431,3220,1003,2306,3964
GTTAGCCGTCCAGACT,sample,64920,64422,3524,60898,11535,49363,27457,2439,11668,1284,39125,6515,3734,1429,5145,7858
GGAGGACGTCCAGACT,sample,63927,63440,5636,57804,9855,47949,17601,1070,15617,1959,33218,11702,5022,1002,5546,6482
GGCCAGAGTCCAGACT,sample,64525,63937,7709,56228,7758,48470,8985,449,19920,2036,28905,17080,6214,888,2307,4924
CATTGCAGTCCAGACT,sample,65647,65392,1905,63487,15519,47968,33735,2183,8027,1390,41762,2633,1541,840,19605,11334
CGAGGCAGTCCAGACT,sample,52718,52430,2454,49976,12565,37411,24629,1200,7719,857,32348,3006,2325,1146,9426,8597
CCATGAAGTCCAGACT,sample,48048,47643,5768,41875,5206,36669,9790,621,15487,1547,25277,9224,4517,934,2546,3373
CATGATTCTCCAGACT,sample,118158,117192,7874,109318,16730,92588,36136,1983,30234,3241,66370,20994,5269,1194,13317,11425
AATCCGTCTCCAGACT,sample,87032,86343,5259,81084,16381,64703,32106,2173,17923,2120,50029,10381,4526,1318,6569,11310
CGTACGTCTCCAGACT,sample,70294,69683,6762,62921,11665,51256,19908,1293,17044,1999,36952,11012,5142,1076,5308,7057
CGGATTACTCCAGACT,sample,89098,88530,3608,84922,18232,66690,42016,3712,13649,1415,55665,5898,2680,1144,13212,12551
GTTAGGACTCCAGACT,Pos_Ctrl,53068,52651,2653,49998,2153,47845,39635,4122,2865,358,42500,865,5168,5872,2751,875
CGTATGAATCCAGACT,sample,65650,65174,3641,61533,10561,50972,29861,2500,11800,1545,41661,5266,3156,1257,9332,7543
TTGGCCTCTCCAGACT,Pos_Ctrl,51765,51287,3360,47927,2094,45833,38032,3600,2873,420,40905,908,5141,5629,3080,788
TGCTTCGCTCCAGACT,sample,102200,101363,11172,90191,10924,79267,20222,1757,31887,3628,52109,21773,7167,1216,4215,7141
GAAGGCGCTCCAGACT,sample,71093,70491,4899,65592,9998,55594,28029,1979,14413,1897,42442,9276,4319,1083,5077,6599
GTCTTAGCTCCAGACT,sample,121738,120920,10590,110330,15720,94610,26823,3161,35056,4147,61879,25423,7339,1289,7011,10643
GGCATATATCCAGACT,sample,201265,199675,19593,180082,15971,164111,27906,1451,68925,7101,96831,58728,12655,2152,5921,9321
TCGCCTGATCCAGACT,sample,102287,101490,8150,93340,13152,80188,41475,3254,20695,2431,62170,12333,5223,1365,5047,8411
AGGTCGGATCCAGACT,sample,58558,58092,4251,53841,6877,46964,21121,1159,15610,1406,36731,7668,3583,1013,4313,4931
TTATTCGATCCAGACT,sample,71711,71355,3640,67715,18304,49411,25203,2351,12614,1952,37817,7291,3572,1130,7877,11838
ATTCTCTTACCATTAT,sample,188615,187922,6705,181217,50808,130409,78921,5647,29474,3841,108395,12526,4509,1419,34070,33397
TCCAACTTACCATTAT,sample,47443,47147,2245,44902,10157,34745,19066,1425,9585,1229,28651,3440,2708,1403,3306,6893
GGTTGCGTACCATTAT,sample,169052,167576,13330,154246,29690,124556,47765,2835,42088,4963,89853,26905,8122,1728,15184,20676
TCCTCCGTACCATTAT,sample,133469,132560,9346,123214,27287,95927,47467,2331,27659,3054,75126,15416,5470,1263,20237,18389
CCTCTAGAACCATTAT,sample,124128,123286,7570,115716,25911,89805,45753,3394,24874,3069,70627,12715,5813,1899,10708,16739
TAGTACGGACCATTAT,sample,181358,179854,17037,162817,23939,138878,41440,2664,52849,6541,94289,35384,9115,1665,9362,15276
TTCCGTCTACCATTAT,sample,135108,134351,3732,130619,33647,96972,67698,5551,15256,2177,82954,6290,3387,1845,20370,23282
GGACCTCTACCATTAT,sample,161475,160062,17166,142896,17236,125660,29015,2259,52943,5897,81958,35546,9152,1549,6034,10731
GACGGAGAACCATTAT,sample,97769,97104,5503,91601,19341,72260,34187,1965,20259,2053,54446,13796,5332,1390,8007,12876
GTTAGCCGACCATTAT,sample,141577,140658,7346,133312,31138,102174,60398,3727,25081,2161,85479,10807,4613,1104,28356,21272
CTTGATAGACCATTAT,sample,98758,97917,10315,87602,13437,74165,19394,1570,30117,3207,49511,19877,7008,1206,3022,8499
GACGATAAACCATTAT,sample,51646,51164,5589,45575,3872,41703,14031,919,16267,1706,30298,8780,4599,1343,1086,2247
GGCCAGAGACCATTAT,sample,67672,67218,2908,64310,14492,49818,29925,2482,11955,1142,41880,4314,2898,1179,8389,9863
AGTCCGCAACCATTAT,sample,130600,129979,3368,126611,29873,96738,65651,3334,18048,2777,83699,6928,2774,1183,23993,21069
GTTAGGACACCATTAT,sample,154147,153269,3638,149631,42070,107561,79157,4793,19724,1407,98881,2480,1212,898,30906,28234
GCCTGAACACCATTAT,sample,148271,147055,14545,132510,20706,111804,35172,2338,41136,3994,76308,29164,7897,1310,11839,14344
CGTATGAAACCATTAT,sample,154481,153351,11969,141382,22892,118490,43082,3152,39423,4950,82505,27883,8009,1507,11529,14811
TGCTTCGCACCATTAT,sample,110976,110087,10258,99829,12414,87415,26627,1936,32621,3813,59248,22418,7150,1241,4057,8295
GAAGGCGCACCATTAT,sample,165431,164336,9672,154664,31223,123441,58229,6272,35369,3418,93598,20153,6805,1404,18889,21256
TCAATATAACCATTAT,sample,306435,304318,27991,276327,44730,231597,67474,5815,85623,8824,153097,63861,13827,2824,18065,28092
TCGCCTGAACCATTAT,sample,147122,146318,9353,136965,26368,110597,45652,2737,34626,3295,80278,24287,5897,1233,16379,18270
AGGTCGGAACCATTAT,sample,183400,182182,12568,169614,30421,139193,56008,5445,46925,4953,102933,25862,7110,1552,15564,21018
TATCAGTTCAATGGAT,sample,156059,154958,12496,142462,20585,121877,39189,2869,45808,5016,84997,28995,8171,1737,6874,13662
AGTACCATCAATGGAT,sample,143545,142452,13061,129391,24682,104709,33396,2582,40264,4569,73660,23898,7066,1193,9872,16271
TTCGTAATCAATGGAT,sample,110976,110125,12653,97472,9864,87608,20662,1452,36902,3831,57564,24761,7364,1464,1878,5081
ACGTTATGCAATGGAT,sample,150931,150328,3325,147003,45914,101089,77399,4675,14091,1729,91490,3195,1469,1037,38484,29497
CAACCGCGCAATGGAT,sample,36572,36281,2800,33481,6005,27476,10043,680,9938,1156,19981,5659,2912,654,3115,3920
TTCCGTCTCAATGGAT,sample,85480,85022,2744,82278,14626,67652,35080,2908,20917,2422,55997,6325,2655,1251,7081,10634
GGACCTCTCAATGGAT,sample,175281,173932,17030,156902,23438,133464,37868,1770,53325,5416,91193,35085,9348,1547,12307,15428
TCGCATCTCAATGGAT,sample,107437,106963,2756,104207,28501,75706,56693,4060,11043,1037,67736,2873,1947,1409,20311,19100
CAAGGCCTCAATGGAT,sample,116625,115667,9594,106073,17567,88506,33525,2611,32026,3673,65551,16671,5502,1215,8317,11417
CGAGGCAGCAATGGAT,sample,85911,85278,6209,79069,13522,65547,30916,1391,19745,2585,50661,10910,4879,1124,8315,9425
GTCCTGCCCAATGGAT,sample,89751,89042,6717,82325,9236,73089,26633,2391,26914,2973,53547,14178,5196,1079,3507,5978
CGGATTACCAATGGAT,sample,125179,124163,6851,117312,16891,100421,43148,2931,32606,4287,75754,17449,4977,1157,8881,12311
GCCTGAACCAATGGAT,Neg_Ctrl,548,482,205,277,29,248,115,5,64,2,179,62,82,33,43,38
ACGTATTACAATGGAT,sample,94610,93888,7023,86865,14630,72235,26547,1889,24753,3175,51300,15871,5367,1075,6764,9982
CGTATGAACAATGGAT,sample,112049,111361,3808,107553,19771,87782,53970,3941,20987,2343,74957,6541,2910,1255,14542,13667
TTGGCCTCCAATGGAT,sample,108292,107388,13346,94042,9001,85041,21703,1774,34504,3594,56207,23466,7606,1395,3079,5468
AATATATCCAATGGAT,Neg_Ctrl,505,422,91,331,49,282,135,8,80,6,215,53,112,39,25,17
TGCTTCGCCAATGGAT,sample,101052,100379,5839,94540,20177,74363,36789,1576,21470,2242,58259,12286,4826,978,9493,13080
AAGAGCGCCAATGGAT,sample,94343,93579,5743,87836,13702,74134,40959,2443,17719,2242,58678,10771,4683,1318,5187,9281
TTGGTTAACAATGGAT,sample,171226,170104,13336,156768,25597,131171,52630,4431,42305,4694,94935,27111,7254,1328,12713,17327
TCGCCTGACAATGGAT,sample,28533,28360,1593,26767,5596,21171,9375,860,6582,703,15957,3651,2461,928,1070,3577
AGGTCGGACAATGGAT,Pos_Ctrl,92637,91842,4884,86958,3938,83020,69338,6941,4637,587,73975,1517,6249,7822,5131,1693
AAGTTCGTAGATTCAT,sample,72308,71824,5094,66730,16796,49934,24849,1089,14198,1892,39047,7906,3743,822,10772,10960
TCCTCCGTAGATTCAT,sample,125220,124321,13699,110622,16970,93652,20017,1400,38121,4066,58138,30048,8617,1251,6134,10695
AGTACCATAGATTCAT,sample,26338,25998,4424,21574,2524,19050,3996,292,8011,994,12007,5757,3275,701,260,1438
GCCTTGCTAGATTCAT,sample,64139,63729,3015,60714,14222,46492,27519,2822,9935,1162,37454,5054,2816,1163,6142,9484
GACGGAGAAGATTCAT,sample,110085,109452,5120,104332,19853,84479,42023,2403,26718,2622,68741,10713,4623,1398,13575,14505
CCAGAGCGAGATTCAT,sample,145049,144304,5688,138616,40583,98033,66373,3445,17115,1900,83488,9200,3996,1442,23742,26890
GGAGGACGAGATTCAT,sample,62050,61631,4068,57563,4446,53117,18900,1262,21859,2628,40759,8468,3886,1131,1621,2788
TGGACGAGAGATTCAT,sample,84824,84404,3010,81394,22263,59131,39410,2999,11282,1885,50692,3555,2149,925,14572,15220
CCATGAAGAGATTCAT,sample,112026,111395,6095,105300,21325,83975,49289,1922,20929,2948,70218,8887,3373,1036,17000,15241
CGTACGTCAGATTCAT,sample,92119,91594,2410,89184,23538,65646,45868,2970,13230,1011,59098,2567,932,648,17505,16135
GCCTGAACAGATTCAT,sample,89023,88240,7548,80692,11645,69047,25102,1949,23989,2181,49091,15826,5092,958,6722,7698
ACCAATGCAGATTCAT,sample,72778,72196,5140,67056,10685,56371,23242,2281,18544,2646,41786,9658,4125,891,5314,7649
GAAGGCGCAGATTCAT,sample,55348,54997,2360,52637,10117,42520,18147,1351,13591,1327,31738,8104,3696,876,4191,7011
GTACCGTAAGATTCAT,sample,133864,132818,10191,122627,16602,106025,37929,3233,37379,4504,75308,22980,6796,1328,8086,10644
ATGACCGAAGATTCAT,sample,79557,79028,5293,73735,11901,61834,20260,1718,21504,2485,41764,15867,5823,1139,3711,8242
GACCGGAAAGATTCAT,sample,102104,101630,4631,96999,15450,81549,42354,3106,20521,2388,62875,13180,5690,1443,17451,10267
GGAGAGTTCAATCTTG,sample,87458,86989,7146,79843,10816,69027,22181,1533,27539,3073,49720,14701,6548,1675,4220,7427
TATCAGTTCAATCTTG,sample,138746,137971,11126,126845,25909,100936,37071,2536,35111,3633,72182,22585,7347,1348,12994,17300
AAGTTCGTCAATCTTG,sample,173457,172828,3744,169084,60105,108979,84710,4884,14803,1930,99513,2652,1304,1128,40669,36202
GGTTGCGTCAATCTTG,sample,166909,165915,8317,157598,38559,119039,60793,3636,33171,3843,93964,17596,6175,1587,22140,25664
TCCTCCGTCAATCTTG,sample,142074,141426,4327,137099,34302,102797,68828,3511,21555,2237,90383,6666,3503,1283,30401,23201
TTCGTAATCAATCTTG,sample,168691,167819,7913,159906,33729,126177,67259,3774,35640,3854,102899,15650,5445,1420,29029,24049
ACGTTATGCAATCTTG,sample,120148,119597,3496,116101,31927,84174,60727,4356,14855,1290,75582,2946,2245,1109,31618,22171
ATGCCTGGCAATCTTG,sample,108777,108187,5562,102625,24579,78046,34280,2332,22842,2201,57122,16391,6247,1295,10022,16506
GGACCTCTCAATCTTG,sample,155081,154334,6227,148107,40290,107817,62367,3437,26835,2870,89202,12308,4414,1170,27601,27223
TCGCATCTCAATCTTG,sample,148021,147375,3546,143829,38684,105145,77575,5737,18185,1096,95760,2552,1432,1061,30338,26896
CAAGGCCTCAATCTTG,sample,189509,188374,13315,175059,30296,144763,66143,5421,42742,4742,108885,25715,7591,1868,21762,20324
GACGGAGACAATCTTG,sample,70128,69712,3515,66197,13912,52285,26505,1556,14846,2088,41351,7290,3610,1056,10145,9803
CCAGAGCGCAATCTTG,sample,56641,56283,3721,52562,13020,39542,21578,1251,10008,1078,31586,5627,3430,1193,7361,8390
GGAGGACGCAATCTTG,sample,91097,90549,4037,86512,19937,66575,37019,2453,16759,1840,53778,8504,3750,1078,15477,13401
CTTGATAGCAATCTTG,sample,68282,67803,5019,62784,13172,49612,24422,2057,14830,1173,39252,7130,3811,1056,7349,8607
GACGATAACAATCTTG,sample,61007,60610,3525,57085,13784,43301,22271,1397,12744,1393,35015,5496,3120,1007,7438,8733
CATTGCAGCAATCTTG,sample,49370,48853,6060,42793,5210,37583,10286,530,14896,1522,25182,10349,4842,759,3020,3273
CGAGGCAGCAATCTTG,sample,129520,128567,10284,118283,18453,99830,43054,2301,30675,3864,73729,19936,6371,1251,14341,12848
AATCCGTCCAATCTTG,sample,50755,50294,4346,45948,3951,41997,11918,794,18173,2107,30091,9005,3922,984,919,2020
CGTACGTCCAATCTTG,sample,80616,80092,2729,77363,12980,64383,44450,3440,10725,1238,55175,4530,2914,1475,10942,10005
TTGGTACCCAATCTTG,sample,102843,101976,10316,91660,11359,80301,21392,1995,31058,3046,52450,22810,6930,1213,2734,7331
ACCAATGCCAATCTTG,sample,52339,51825,3908,47917,6559,41358,20480,1106,11692,858,32172,7222,3543,816,6533,4483
AAGAGCGCCAATCTTG,sample,123743,122706,10668,112038,12734,99304,36200,2063,34447,4982,70647,21612,6348,1207,10332,7755
TTATTCGACAATCTTG,Neg_Ctrl,417,320,85,235,53,182,106,6,51,5,157,14,76,40,36,26
ATGACCGACAATCTTG,sample,46387,45944,4097,41847,5120,36727,11301,689,14208,1429,25509,9100,4383,938,995,3125
TCCTCCGTCGTTCCGA,sample,126147,125529,4648,120881,31686,89195,55894,3316,19491,2095,75385,8399,2921,1200,25221,21674
AGTACCATCGTTCCGA,sample,142547,141630,11932,129698,24835,104863,38480,2108,37548,4086,76028,22641,7588,1582,8730,16631
TCGCATCTCGTTCCGA,sample,39226,38986,3087,35899,6892,29007,10925,675,10704,1154,21629,5549,3513,944,1977,4556
CCGCAACGCGTTCCGA,sample,38465,38172,3421,34751,5341,29410,11897,1170,9908,1053,21805,5382,3488,1236,1516,3726
CATTGCAGCGTTCCGA,sample,57963,57435,7140,50295,8265,42030,17856,1390,12389,1282,30245,9113,4701,1187,4300,5127
ACGACTTCCGTTCCGA,sample,80048,79466,8338,71128,9358,61770,19592,1226,24912,2449,44504,13591,5624,1148,7128,5954
GTTAGGACCGTTCCGA,sample,14754,14664,1185,13479,2948,10531,4955,346,3308,366,8263,1556,1838,864,1225,1873
ACGTATTACGTTCCGA,sample,41570,41282,1963,39319,7907,31412,19407,2373,6212,791,25619,2629,1824,740,4854,5330
TTGGCCTCCGTTCCGA,sample,108171,107666,3252,104414,29467,74947,51423,3917,16595,782,68018,2230,1404,776,23417,20025
GTACCGTACGTTCCGA,sample,72549,72079,4322,67757,8239,59518,27814,1959,19001,2213,46815,8531,3821,1291,3872,5303
TCGCCTGACGTTCCGA,sample,75429,74841,3271,71570,14020,57550,29066,2287,16181,1765,45247,8251,3798,1182,5842,9789
TTATTCGACGTTCCGA,sample,98081,97601,4208,93393,22749,70644,39248,2021,18212,1786,57460,9377,3737,1131,12099,15160
ATGACCGACGTTCCGA,sample,81418,81043,2832,78211,22361,55850,36712,2242,11434,1849,48146,3613,2288,926,12943,14811
GACCGGAACGTTCCGA,sample,1907,1895,118,1777,440,1337,680,36,360,41,1040,220,322,182,172,287
ATTCTCTTCAATTCGG,Pos_Ctrl,270263,268360,11196,257164,9002,248162,206227,21916,13490,1892,219717,4637,7161,11511,9522,2754
TCCAACTTCAATTCGG,sample,169606,168954,4107,164847,55787,109060,78275,5416,18938,1737,97213,4694,2267,1264,32969,35520
AAGTTCGTCAATTCGG,sample,72973,72555,2064,70491,23132,47359,30145,1537,10858,1661,41003,3158,2534,1099,9716,14311
ACGTTATGCAATTCGG,Pos_Ctrl,44760,44478,1873,42605,2229,40376,33831,3671,1978,304,35809,592,4920,5616,3047,1106
ATGCCTGGCAATTCGG,sample,76562,76136,4543,71593,15725,55868,26315,1778,17641,2261,43956,7873,4207,1267,8849,10184
TAGTACGGCAATTCGG,sample,81887,81542,2158,79384,17330,62054,38018,2371,15309,2212,53327,4144,2500,1313,12256,11802
TGAGCGCGCAATTCGG,sample,55340,55023,2661,52362,10913,41449,20308,1140,12231,1958,32539,5812,3290,1146,6495,7506
TTCCGTCTCAATTCGG,sample,125433,124702,8531,116171,21610,94561,41024,3205,28359,3600,69383,18373,5822,1156,22025,14742
GGACCTCTCAATTCGG,sample,67625,67228,3646,63582,9565,54017,24288,1581,19181,2158,43469,6809,3934,1400,7049,6811
TCGCATCTCAATTCGG,sample,110446,109923,3952,105971,26339,79632,47320,2571,20146,2600,67466,6995,2988,1086,23825,18777
GCCTTGCTCAATTCGG,Pos_Ctrl,53815,53397,2744,50653,2389,48264,40300,4043,2645,307,42945,969,5282,5924,3869,844
ACTATACTCAATTCGG,sample,43533,43283,2274,41009,10316,30693,17067,1051,7940,697,25007,3938,2464,856,7613,6976
GGAGGACGCAATTCGG,sample,15519,15452,1029,14423,2841,11582,6555,463,2808,282,9363,1474,1941,1006,2046,1957
CCGCAACGCAATTCGG,Pos_Ctrl,23823,23543,1320,22223,1213,21010,17784,1642,1144,125,18928,315,3747,3599,2004,560
CCATGAAGCAATTCGG,Pos_Ctrl,77810,77239,2771,74468,3361,71107,59344,6857,3360,476,62704,1070,5495,7085,4811,1215
CATGATTCCAATTCGG,sample,75281,74782,3984,70798,17232,53566,29240,1686,13350,2020,42590,7270,3789,1199,12974,12100
AATCCGTCCAATTCGG,sample,63915,63228,8776,54452,5218,49234,8830,557,21367,2477,30197,16003,6148,995,835,2747
CGTACGTCCAATTCGG,sample,98030,97551,4334,93217,22945,70272,45536,2137,14919,1428,60455,6252,3718,1244,23468,16331
AGTCCGCACAATTCGG,sample,45911,45487,4702,40785,2695,38090,10949,648,17693,2089,28642,6711,4328,1338,529,1409
CGGATTACCAATTCGG,Pos_Ctrl,105097,103965,5534,98431,3963,94468,78595,8041,5373,736,83968,1723,6250,8285,5335,1643
TTGGCCTCCAATTCGG,Pos_Ctrl,82447,81730,3962,77768,2901,74867,62521,6412,4139,539,66660,1256,5860,7345,3618,1167
AAGAGCGCCAATTCGG,sample,82630,81933,8042,73891,12396,61495,20855,1871,20614,2337,41469,15818,5580,988,4970,8400
GGCATATACAATTCGG,sample,105479,104957,3225,101732,29515,72217,49745,2814,13170,2142,62915,4346,1942,832,19746,19411
TCAATATACAATTCGG,sample,116774,115836,12558,103278,12133,91145,19967,1347,38792,4219,58759,26820,7763,1272,2679,7820
ATTCTCTTAACTCCGG,sample,140082,138967,12313,126654,17996,108658,37374,1918,39498,4808,76872,25060,6914,1442,8760,11713
AAGTTCGTAACTCCGG,sample,127826,127228,3869,123359,34493,88866,59996,2998,18311,2109,78307,5452,2240,1073,30293,23220
GGTTGCGTAACTCCGG,sample,97311,96540,7061,89479,10665,78814,32449,2459,26208,3386,58657,14312,5048,1466,6072,6896
TCCTCCGTAACTCCGG,sample,62794,62407,4180,58227,14270,43957,19362,1002,13525,1269,32887,8799,4301,922,7023,8967
ACGTAAGTAACTCCGG,sample,106303,105757,3232,102525,29480,73045,48447,3040,15209,1236,63656,5113,2462,1046,22592,19904
CCTCTAGAAACTCCGG,sample,110966,110232,9598,100634,18947,81687,31319,1859,26607,2459,57926,19443,6502,1317,12633,12522
AGTACCATAACTCCGG,sample,44209,43975,1205,42770,17681,25089,17398,1023,4996,369,22394,1303,1277,698,8977,9799
TTCTAATGAACTCCGG,sample,87401,86675,7902,78773,10690,68083,14377,922,27568,2929,41945,22287,8110,1399,2664,6590
ATGCCTGGAACTCCGG,sample,73516,73102,3682,69420,18587,50833,27979,1439,12681,1323,40660,7411,3742,1250,10516,12133
TGAGCGCGAACTCCGG,sample,58598,58130,4492,53638,6867,46771,15846,1040,18641,2480,34487,8764,4024,971,2679,4733
TTCCGTCTAACTCCGG,sample,50857,50456,4796,45660,2867,42793,10521,671,19617,2245,30138,9739,4129,957,465,1544
GGACCTCTAACTCCGG,sample,90641,89866,9228,80638,8709,71929,14299,1074,31794,3111,46093,21651,6952,1242,1237,5236
CAAGGCCTAACTCCGG,sample,20312,20081,2035,18046,2861,15185,6978,375,4832,488,11810,2512,2261,785,2274,1922
ACTATACTAACTCCGG,sample,34978,34801,1403,33398,9175,24223,15819,981,4850,607,20669,1966,1793,893,6974,6072
CCAGAGCGAACTCCGG,sample,8428,8393,306,8087,2309,5778,3805,232,1194,102,4999,445,827,499,1605,1484
GGCCAGAGAACTCCGG,sample,63767,63358,2463,60895,17073,43822,30256,1388,8385,1056,38641,2737,2074,984,15068,11533
AGTCCGCAAACTCCGG,sample,75252,74497,8681,65816,8979,56837,14276,787,22318,2572,36594,16884,6411,1077,4157,5763
TTGGTACCAACTCCGG,sample,55323,55024,2256,52768,13121,39647,27589,1295,7636,811,35225,2316,1991,945,15269,9202
CTAGGACCAACTCCGG,sample,36127,35884,1557,34327,6677,27650,14603,925,8838,1212,23441,2072,1992,1000,5054,4993
CGTATGAAAACTCCGG,sample,101754,100960,6984,93976,12651,81325,37770,2414,25568,3076,63338,12497,4507,1226,12054,9531
GAAGGCGCAACTCCGG,sample,91981,91272,8449,82823,11796,71027,23684,1777,25306,2731,48990,17529,6533,1152,4594,6854
AAGAGCGCAACTCCGG,sample,164639,163283,17274,146009,14658,131351,27435,1266,52429,5274,79864,44947,11409,1822,8229,9470
CTTCATGAAACTCCGG,sample,280572,278339,38716,239623,15113,224510,24569,1432,102946,10674,127515,84889,15773,2848,1780,6151
ATGACCGAAACTCCGG,sample,96887,96384,3452,92932,20958,71974,43826,3213,15635,2558,59461,6742,2783,953,17013,14661
TCCAACTTCCTGAAGG,Neg_Ctrl,246,171,70,101,34,67,39,0,18,2,57,8,34,18,8,9
TCCTCCGTCCTGAAGG,sample,126024,124943,13487,111456,17259,94197,26269,1338,36005,4204,62274,26381,8420,1266,9877,11313
CCTCTAGACCTGAAGG,sample,88265,87747,3932,83815,18011,65804,39071,3166,15321,2001,54392,6245,3492,1230,13475,13147
TTCTAATGCCTGAAGG,Neg_Ctrl,317,253,105,148,27,121,46,1,43,10,89,21,41,12,18,12
ATGCCTGGCCTGAAGG,sample,81405,81013,2544,78469,24129,54340,37824,2167,10414,1357,48238,2578,1769,887,19035,15807
TAGTACGGCCTGAAGG,sample,24411,24156,4485,19671,1669,18002,3776,226,7587,839,11363,5574,3313,687,281,799
AATGGTAACCTGAAGG,sample,84652,84220,4063,80157,20456,59701,32713,2290,15412,1521,48125,7765,3976,1277,9695,13689
GGACCTCTCCTGAAGG,sample,86797,86080,9376,76704,10724,65980,17171,1128,26436,3153,43607,18092,6814,1172,3871,6696
CAAGGCCTCCTGAAGG,Neg_Ctrl,218,162,79,83,26,57,21,2,17,1,38,16,24,12,8,6
ACTATACTCCTGAAGG,sample,47038,46670,5589,41081,6321,34760,8195,642,13739,1440,21934,10744,4587,703,3231,3952
GTTAGCCGCCTGAAGG,sample,65857,65335,3771,61564,6872,54692,26143,1599,18329,2076,44472,6545,3813,1338,5126,4730
GGACGTAGCCTGAAGG,Neg_Ctrl,225,152,88,64,8,56,27,1,11,5,38,12,14,9,15,7
TGGACGAGCCTGAAGG,sample,8233,8161,658,7503,2797,4706,1836,138,1640,186,3476,906,1016,359,460,1462
ACGACTTCCCTGAAGG,Neg_Ctrl,318,222,93,129,30,99,37,1,31,2,68,28,38,16,8,13
AATCCGTCCCTGAAGG,sample,81461,80920,6837,74083,13980,60103,29783,1265,17539,2234,47322,9282,3918,1032,14504,9135
CGTACGTCCCTGAAGG,sample,34546,34299,1308,32991,8531,24460,15984,1147,5055,572,21039,1702,1720,1052,4174,5699
AGTCCGCACCTGAAGG,sample,69028,68441,5634,62807,4565,58242,20782,1379,21550,3179,42332,11352,4427,1190,846,2772
TTGGTACCCCTGAAGG,sample,49814,49375,3817,45558,7812,37746,18167,1342,11517,1306,29684,5414,3887,1424,2358,5118
GTTAGGACCCTGAAGG,Neg_Ctrl,238,173,89,84,17,67,31,1,25,0,56,10,29,11,11,5
TTGGCCTCCCTGAAGG,sample,78123,77512,8465,69047,6458,62589,16705,1361,25658,3168,42363,15697,5836,1063,1961,4243
AATATATCCCTGAAGG,Neg_Ctrl,302,246,85,161,22,139,57,3,51,3,108,25,52,18,19,14
GTCTTAGCCCTGAAGG,sample,114935,114023,12867,101156,12091,89065,22210,1347,34224,3618,56434,27666,8240,1340,6070,7053
GGAGAGTTAATATTCG,sample,119679,118965,7608,111357,23468,87889,39861,2876,27240,3046,67101,14866,4991,1298,13915,15116
ATGCCTGGAATATTCG,sample,31938,31648,3869,27779,2802,24977,5971,447,10736,1212,16707,6611,4053,953,330,1675
TAGTACGGAATATTCG,sample,116910,116402,3831,112571,35497,77074,55962,2481,13404,1446,69366,3781,2121,896,26889,23014
CATAACCTAATATTCG,sample,62884,62528,2816,59712,16375,43337,27582,1988,9500,985,37082,3282,2576,1339,6881,10920
CTTGATAGAATATTCG,sample,25091,24938,1599,23339,5357,17982,9995,687,4807,580,14802,1913,1889,713,4514,3551
TGGACGAGAATATTCG,sample,96499,95671,6698,88973,17820,71153,32531,2510,22488,2102,55019,11522,5399,1284,11962,11768
GGCCAGAGAATATTCG,sample,71625,71021,4708,66313,15163,51150,24634,1634,14508,1520,39142,8854,4949,1129,10575,10235
CCATGAAGAATATTCG,sample,46045,45749,1807,43942,8426,35516,19772,1201,10099,1312,29871,3132,2431,1316,5774,6059
AATCCGTCAATATTCG,sample,74185,73590,3041,70549,9955,60594,34762,2528,15661,1709,50423,5934,3600,1792,4106,6925
GTCCTGCCAATATTCG,sample,139647,138489,14843,123646,15170,108476,31137,2283,41836,4356,72973,28864,9006,1621,6795,9524
GTTAGGACAATATTCG,sample,98567,97839,5940,91899,10065,81834,34240,2341,28941,3487,63181,12825,5070,1458,3875,6383
GAAGGCGCAATATTCG,sample,42383,42022,3039,38983,8884,30099,15373,762,8803,971,24176,4190,2818,717,5252,5757
AAGAGCGCAATATTCG,sample,61833,61304,5044,56260,7852,48408,17003,1331,17636,1728,34639,10710,4680,939,4077,5315
GTACCGTAAATATTCG,Pos_Ctrl,65384,64694,3591,61103,2532,58571,48928,4585,3577,470,52505,1011,5640,6414,4002,907
GGCATATAAATATTCG,sample,87387,86862,3728,83134,18406,64728,39689,3070,14299,2314,53988,5356,2089,791,15465,13366
GACCGGAAAATATTCG,sample,76672,76350,1892,74458,24067,50391,35000,3000,9135,973,44135,2283,1577,776,12660,16064
GGAGAGTTAGTCTCCG,sample,106043,105599,3385,102214,22156,80058,44346,2303,22852,3437,67198,7120,3307,1296,14752,15707
TATCAGTTAGTCTCCG,sample,100520,100026,3554,96472,26589,69883,44300,3046,15814,1373,60114,5350,2715,1123,21125,17799
TCCAACTTAGTCTCCG,sample,89172,88561,4794,83767,17885,65882,34075,1862,18796,2084,52871,9065,4862,1475,8474,12201
AAGTTCGTAGTCTCCG,sample,76985,76543,3126,73417,17027,56390,32183,2853,13471,1782,45654,6101,3240,1119,9387,11808
ACGTAAGTAGTCTCCG,sample,104066,103415,7166,96249,21076,75173,35200,2180,22676,2346,57876,12771,5151,1165,14198,14320
ACGTTATGAGTCTCCG,sample,84763,84356,3091,81265,23163,58102,37370,2239,11542,1377,48912,5574,3360,1245,14257,15803
TTCTAATGAGTCTCCG,sample,118881,118350,3219,115131,33708,81423,58378,2950,13689,2619,72067,3787,2077,1040,27911,22774
AATGGTAAAGTCTCCG,sample,84616,83990,6948,77042,13990,63052,18208,1386,25146,2403,43354,15909,5422,935,4216,8650
TTAGAAGTAGTCTCCG,sample,79931,79410,5179,74231,9213,65018,26278,1713,25171,2620,51449,9236,4200,1272,5447,6430
GTTAGCCGAGTCTCCG,sample,66764,66331,1874,64457,11839,52618,38366,2341,8109,1023,46475,2779,2469,1557,6031,8902
GGAGGACGAGTCTCCG,sample,93432,92853,5350,87503,14658,72845,29185,2371,27422,3260,56607,10607,4752,1346,6023,10496
ACCTCGAGAGTCTCCG,sample,68141,67799,3468,64331,12297,52034,23513,1448,16585,1845,40098,8643,4567,1025,9458,8596
GGCCAGAGAGTCTCCG,sample,49852,49513,3057,46456,5785,40671,16892,1245,14147,1696,31039,6691,4058,1258,4271,3977
CATTGCAGAGTCTCCG,sample,70414,70058,2107,67951,16071,51880,31384,2553,11511,1206,42895,5226,2986,1116,12110,11382
CGAGGCAGAGTCTCCG,sample,49014,48684,3050,45634,8170,37464,13833,1382,13256,1653,27089,7340,3975,858,4871,5668
CCATGAAGAGTCTCCG,sample,73915,73559,2507,71052,20336,50716,31480,1747,12397,1035,43877,4057,2424,841,15829,13723
AATCCGTCAGTCTCCG,sample,49430,49157,3848,45309,6481,38828,16446,1493,12332,1201,28778,7356,4348,1480,3588,4146
AGTCCGCAAGTCTCCG,sample,76940,76507,2182,74325,11376,62949,46752,3179,9214,752,55966,3052,2767,1821,6885,7698
GTCCTGCCAGTCTCCG,sample,78738,78320,3423,74897,16752,58145,30318,2601,15793,1926,46111,7507,3655,1031,10052,11634
TTGGTACCAGTCTCCG,sample,52063,51840,1296,50544,14057,36487,25593,1710,6558,829,32151,1797,1668,1019,8580,9464
ACGTATTAAGTCTCCG,sample,87170,86759,2158,84601,25863,58738,44407,3695,8782,785,53189,1069,1240,1110,13632,16846
AACTCGTAAGTCTCCG,sample,27595,27453,1933,25520,2922,22598,8983,687,8298,1106,17281,3524,2678,1017,1494,1717
AATATATCAGTCTCCG,sample,85712,85200,6988,78212,7193,71019,21170,1743,29587,2914,50757,15605,5963,1076,1707,4154
TGCTTCGCAGTCTCCG,sample,76375,76030,3288,72742,17274,55468,35345,2764,11916,1103,47261,4340,1905,891,13459,11964
GTCTTAGCAGTCTCCG,sample,79464,79068,2748,76320,17271,59049,32004,2759,16161,1381,48165,6744,2880,964,9572,11355
TCGCCTGAAGTCTCCG,sample,58098,57765,2198,55567,8478,47089,20285,1554,16955,1736,37240,6559,2965,962,2358,5645
ATGACCGAAGTCTCCG,sample,101499,101072,4317,96755,27534,69221,42706,3045,15320,1391,58026,6759,2585,879,16771,17865
AAGTTCGTTGCCTACG,sample,42858,42594,3152,39442,9146,30296,11015,579,10864,1590,21879,6248,3842,859,3328,6068
CCTCTAGATGCCTACG,sample,41675,41354,2979,38375,10305,28070,12478,998,8712,931,21190,4951,3283,1170,2372,6467
CATAACCTTGCCTACG,sample,43434,43007,4227,38780,5871,32909,11994,868,11631,1337,23625,7079,4189,1282,1708,3649
ACTATACTTGCCTACG,sample,112397,111452,12701,98751,10688,88063,23877,1358,34867,4179,58744,23782,9048,1723,6204,6314
CCAGAGCGTGCCTACG,sample,53597,53221,3081,50140,9943,40197,21403,1744,10718,1416,32121,4916,2685,882,7606,6588
GACGATAATGCCTACG,sample,32768,32559,2903,29656,2353,27303,10132,631,10146,1103,20278,5291,3265,1017,853,1324
ACGACTTCTGCCTACG,sample,13102,13018,655,12363,3290,9073,6214,477,1470,176,7684,736,1151,761,2001,2201
CTAGGACCTGCCTACG,sample,103322,102491,10885,91606,7871,83735,21887,1244,33996,3937,55883,22671,6993,1094,2384,4772
GCCTGAACTGCCTACG,sample,68456,67884,6378,61506,9882,51624,16764,1371,18595,2277,35359,12617,5624,1062,4066,6267
AATATATCTGCCTACG,sample,35082,34840,1971,32869,7585,25284,13535,973,6833,576,20368,3367,2122,793,3034,4862
GGCATATATGCCTACG,Neg_Ctrl,119,71,25,46,8,38,16,2,12,3,28,5,18,4,6,3
TTATTCGATGCCTACG,sample,71796,71296,6740,64556,4471,60085,17877,1789,24891,2713,42768,12815,5316,1140,1154,2385
ATGACCGATGCCTACG,sample,1884,1857,71,1786,588,1198,713,68,256,37,969,124,335,213,139,363
TCCTCCGTCTTAGTTC,sample,103218,102671,4124,98547,24328,74219,47463,2972,15439,1769,62902,6576,3316,1131,23378,17248
AGTACCATCTTAGTTC,sample,68909,68382,3650,64732,14204,50528,26671,1897,13524,1577,40195,6859,3723,1345,4343,9479
TTCGTAATCTTAGTTC,sample,134103,133453,3841,129612,36613,92999,66871,3446,16991,1912,83862,3779,2107,972,32106,25491
ATGCCTGGCTTAGTTC,sample,65641,65144,7345,57799,7112,50687,16353,1167,17894,1973,34247,13300,5605,1515,1129,4318
CTTGATAGCTTAGTTC,sample,63504,63036,5227,57809,5698,52111,16789,1441,21528,2512,38317,9841,4487,1086,1889,3475
CATTGCAGCTTAGTTC,sample,3882,3851,261,3590,883,2707,1283,116,767,71,2050,470,703,356,271,578
AATCCGTCCTTAGTTC,sample,79960,79176,7250,71926,5673,66253,13460,1447,27127,3100,40587,21119,7094,1233,891,3491
GTCCTGCCCTTAGTTC,sample,233903,231899,27787,204112,15706,188406,34507,2940,79066,8233,113573,63660,14727,2721,7310,9194
GCCTGAACCTTAGTTC,sample,115065,114437,4056,110381,24045,86336,60208,4719,14332,2486,74540,4591,1988,864,23090,17206
AACTCGTACTTAGTTC,sample,104969,104402,5135,99267,25945,73322,50490,3107,13291,1872,63781,4562,1821,880,17840,16959
CGTATGAACTTAGTTC,sample,87672,86877,9429,77448,9918,67530,20065,1322,25653,2847,45718,17643,6396,1079,5159,6145
CCAATTCCCTTAGTTC,sample,64393,63918,3121,60797,12549,48248,24993,2412,13171,1719,38164,5953,3229,910,7342,8983
TCAATATACTTAGTTC,sample,133399,132569,7134,125435,20127,105308,49237,5085,29643,2956,78880,18387,6412,1253,11822,15206
GACCGGAACTTAGTTC,sample,123563,122961,10214,112747,19534,93213,32964,2706,29689,2999,62653,24855,7163,1486,8460,11642
ATTCTCTTCGAGCTTC,sample,126452,125640,10031,115609,19976,95633,39670,1774,30989,3763,70659,19437,6248,1476,9242,13465
TCCAACTTCGAGCTTC,sample,82789,82177,5511,76666,16287,60379,25203,1777,19292,2865,44495,11242,5080,1070,7977,10681
AAGTTCGTCGAGCTTC,sample,143650,143026,5937,137089,38890,98199,53350,1754,24561,2594,77911,15940,4456,1190,28607,25482
CAACCGCGCGAGCTTC,sample,67565,67153,2912,64241,17314,46927,27959,1770,11536,1106,39495,4556,3134,1048,7992,11755
GCCTTGCTCGAGCTTC,sample,70598,70148,4396,65752,13461,52291,22117,1720,17325,1712,39442,9417,4997,1615,2777,8763
GTTAGCCGCGAGCTTC,sample,58750,58272,5120,53152,10911,42241,17449,905,13720,1498,31169,8669,4293,873,5143,7130
CCGCAACGCGAGCTTC,sample,37695,37281,3913,33368,5072,28296,8303,563,11007,1217,19310,7206,4085,804,1440,3268
GACGATAACGAGCTTC,sample,53475,52913,6020,46893,7493,39400,12220,1077,14120,1648,26340,10335,4729,896,4127,4672
CATTGCAGCGAGCTTC,sample,67239,66742,3856,62886,5626,57260,29402,2456,16259,1653,45661,7490,4498,1986,1606,3412
CGTACGTCCGAGCTTC,sample,98852,98306,6454,91852,20214,71638,36252,2594,19022,2606,55274,11164,4264,1151,11468,14241
AACTCGTACGAGCTTC,sample,78542,77998,2671,75327,15735,59592,37114,3272,12410,1647,49524,5149,2712,1019,9905,10833
CGTATGAACGAGCTTC,sample,95171,94589,3881,90708,21903,68805,36904,3614,16749,2292,53653,9246,4281,1277,9938,14559
AAGAGCGCCGAGCTTC,sample,82995,82523,2534,79989,19008,60981,39639,3222,12386,1285,52025,4449,1943,819,14989,13653
GTCTTAGCCGAGCTTC,sample,94688,94070,4927,89143,16132,73011,36696,3039,20897,2541,57593,9838,4436,1195,11579,11236
TCGCCTGACGAGCTTC,sample,72691,72100,7232,64868,7606,57262,17992,1297,21352,2141,39344,14480,5803,1030,3604,4512
CTTCATGACGAGCTTC,sample,67145,66749,2085,64664,20088,44576,30787,2684,8507,1171,39294,1427,880,679,10313,12927
ATTCTCTTGTAGAATG,Pos_Ctrl,111108,110396,4874,105522,5692,99830,84314,7944,5142,794,89456,1636,6519,8229,9855,2944
GGTTGCGTGTAGAATG,sample,259431,257513,23490,234023,34384,199639,59782,2627,73242,7752,133024,56236,13207,2625,23958,22499
AGTACCATGTAGAATG,sample,154440,153329,11769,141560,30221,111339,45314,2608,34280,4262,79594,24875,7014,1160,19412,19963
TTCGTAATGTAGAATG,sample,161826,160906,8662,152244,30529,121715,64411,4682,34148,4733,98559,13741,4723,1423,21474,21872
ACGTTATGGTAGAATG,sample,127832,127234,3791,123443,41583,81860,59599,3907,14654,2340,74253,1360,1031,815,21038,26956
TTCTAATGGTAGAATG,sample,98471,97677,8051,89626,9199,80427,23601,1610,31888,3546,55489,19782,7353,1600,2726,6015
CAACCGCGGTAGAATG,sample,72361,71950,3626,68324,18736,49588,32549,2042,9141,1390,41690,4466,2454,856,17264,12129
AATGGTAAGTAGAATG,sample,112186,111560,4148,107412,18218,89194,51705,2420,24236,3002,75941,7831,3349,1191,17769,13325
TTAGAAGTGTAGAATG,sample,150419,149425,9456,139969,13766,126203,45466,3386,49156,6021,94622,22174,6310,1558,7689,8897
GGACCTCTGTAGAATG,Pos_Ctrl,66462,65818,3146,62672,2917,59755,50088,4562,3477,418,53565,1210,5703,6560,4835,1368
GCCTTGCTGTAGAATG,sample,54884,54609,2330,52279,12084,40195,25512,1349,9488,843,35000,3003,2151,841,10907,8653
CCGCAACGGTAGAATG,sample,39536,39164,2164,37000,7445,29555,17017,1008,6779,1424,23796,3327,2565,850,5841,4873
CTTGATAGGTAGAATG,sample,53310,52851,4761,48090,6450,41640,13505,732,16265,1654,29770,9484,4327,862,2207,3801
GGCCAGAGGTAGAATG,sample,51532,51111,5361,45750,7401,38349,9703,699,15810,1657,25513,10480,4537,708,2652,4502
CGAGGCAGGTAGAATG,Pos_Ctrl,57303,56782,2713,54069,2266,51803,43794,4079,2804,326,46598,800,5342,6117,4248,1015
CTAGGACCGTAGAATG,sample,70685,70084,6375,63709,8074,55635,18575,1706,19163,1979,37738,14212,5359,1013,2382,4940
ACCAATGCGTAGAATG,Pos_Ctrl,75201,74608,3353,71255,3001,68254,57077,5864,3598,468,60675,1247,5848,7137,4088,1262
TGCTTCGCGTAGAATG,sample,71176,70675,5277,65398,12921,52477,17150,1765,18598,1798,35748,13166,5999,1164,3873,7997
GAAGGCGCGTAGAATG,sample,67305,66820,6265,60555,5420,55135,15532,1807,22505,2487,38037,12804,5053,1004,1211,3230
CCAATTCCGTAGAATG,sample,67625,66980,6863,60117,5943,54174,13364,1088,20839,2578,34203,16305,6211,1050,813,3364
GTACCGTAGTAGAATG,sample,87233,86553,8608,77945,9285,68660,19179,981,27002,2769,46181,18729,6214,1189,2881,5451
TTATTCGAGTAGAATG,sample,137499,136670,9112,127558,25136,102422,43771,3126,31212,3112,74983,21201,5115,1406,13342,16100
AAGTTCGTCAATAGTC,sample,26259,26152,1060,25092,5355,19737,10588,954,4917,538,15505,2740,2387,1057,2220,3525
TTCTAATGCAATAGTC,sample,65722,65330,4286,61044,12549,48495,18710,1170,16681,1839,35391,10095,4623,897,5670,8685
AATGGTAACAATAGTC,sample,77633,77256,4565,72691,17337,55354,22428,1463,18006,2787,40434,10670,4915,1016,8647,11275
TTAGAAGTCAATAGTC,sample,81103,80765,2833,77932,23442,54490,33818,1608,13260,1499,47078,4305,2668,1024,13149,14799
TCGCATCTCAATAGTC,sample,36779,36603,3091,33512,7018,26494,10294,712,9121,976,19415,5391,3486,841,4366,4654
GGACGTAGCAATAGTC,sample,46444,46278,1034,45244,14071,31173,22405,1510,5556,468,27961,1234,1517,1005,6339,9108
ACCTCGAGCAATAGTC,sample,33324,33151,2459,30692,6793,23899,8617,544,8544,967,17161,5227,3095,650,2477,4261
AATCCGTCCAATAGTC,sample,55218,55014,4787,50227,13980,36247,19826,1205,8941,989,28767,5286,3362,1175,7488,9435
AGTCCGCACAATAGTC,sample,54206,53967,1558,52409,10716,41693,25492,1909,10405,1348,35897,2539,2124,1234,9324,7750
GTCCTGCCCAATAGTC,sample,41835,41621,2537,39084,5839,33245,14061,1010,12509,1255,26570,4410,3201,1191,2303,4168
GTTAGGACCAATAGTC,sample,39494,39264,2429,36835,9708,27127,14717,1009,6466,710,21183,4225,2674,906,7102,6285
CGTATGAACAATAGTC,sample,105301,104520,11401,93119,6951,86168,21604,1327,36117,3431,57721,23689,7603,1371,1707,3403
TTGGCCTCCAATAGTC,sample,116368,115736,6703,109033,22412,86621,41339,3438,24847,3294,66186,13703,5710,1139,16586,15305
AAGAGCGCCAATAGTC,sample,145090,144069,11474,132595,18392,114203,34826,2971,40832,4975,75658,30599,9529,1832,8071,12219
TCGCCTGACAATAGTC,sample,83993,83594,3124,80470,19684,60786,39313,3331,11851,1752,51164,4539,2493,857,12147,13731
CTTCATGACAATAGTC,sample,93514,93061,2054,91007,27651,63356,47076,3452,9286,1984,56362,1558,986,751,17420,18012
ATGACCGACAATAGTC,sample,105879,105288,4346,100942,21649,79293,40567,4079,20529,2492,61096,11626,4748,1269,9545,14114
GGAGAGTTCGTTACTC,sample,105570,105129,6406,98723,21124,77599,27593,1478,26004,2846,53597,19678,7761,1466,12578,14014
ATTCTCTTCGTTACTC,sample,148245,147343,8099,139244,34825,104419,53508,4692,29864,3326,83372,13029,5210,1596,19512,23525
TCCAACTTCGTTACTC,Neg_Ctrl,488,403,90,313,61,252,109,6,89,8,198,40,93,39,35,32
AAGTTCGTCGTTACTC,sample,118336,117526,8229,109297,21769,87528,38664,2645,25989,2686,64653,17544,5804,1414,9942,14993
ACGTAAGTCGTTACTC,sample,67693,67214,5829,61385,16358,45027,19762,1159,13534,1598,33296,8974,5220,1408,7001,10032
CCTCTAGACGTTACTC,sample,99133,98444,6418,92026,21657,70369,34377,2733,20232,2085,54609,10942,4520,1137,13715,14228
AGTACCATCGTTACTC,sample,94461,93900,3490,90410,22168,68242,39171,2506,18206,2101,57377,6258,3169,1238,14101,15320
TAGTACGGCGTTACTC,sample,149064,148376,4059,144317,46202,98115,65199,3738,21038,2561,86237,5579,2351,1081,28081,29522
TTAGAAGTCGTTACTC,sample,151414,150191,15121,135070,17479,117591,34708,2169,45958,5694,80666,29062,8772,1623,6020,10665
GGACCTCTCGTTACTC,sample,145262,144449,6233,138216,36918,101298,55690,3567,26528,3403,82218,12110,4070,1178,26505,24888
TCGCATCTCGTTACTC,Neg_Ctrl,516,423,160,263,50,213,111,0,56,17,167,29,75,35,54,32
CATAACCTCGTTACTC,sample,95951,95230,7956,87274,15829,71445,24392,1290,25370,3072,49762,17321,6563,1124,10165,10273
GTTAGCCGCGTTACTC,sample,114093,113476,5127,108349,24227,84122,48062,2378,20600,3095,68662,9987,3299,1192,19900,16883
TGGACGAGCGTTACTC,sample,121604,121109,3349,117760,35804,81956,63064,3104,11555,2322,74619,1911,1524,1038,32332,22841
CGAGGCAGCGTTACTC,sample,95994,95493,4033,91460,22245,69215,46808,3066,12370,1399,59178,5572,3943,1723,17898,15075
CCATGAAGCGTTACTC,Neg_Ctrl,547,427,137,290,55,235,97,6,82,12,179,38,83,37,25,54
ACGACTTCCGTTACTC,sample,53012,52657,4288,48369,9829,38540,17292,1085,12563,1360,29855,6240,3682,1165,6596,6401
CATGATTCCGTTACTC,sample,84591,83946,6439,77507,15614,61893,25135,1522,20321,2692,45456,12223,5261,1284,8193,10076
CGGATTACCGTTACTC,sample,61409,60773,8554,52219,5256,46963,12335,952,18718,1991,31053,12967,5446,1223,974,2705
GTTAGGACCGTTACTC,sample,26238,26065,794,25271,6803,18468,12476,995,3281,468,15757,1248,1991,1446,2234,4393
GCCTGAACCGTTACTC,sample,11594,11505,860,10645,5415,5230,2119,146,1694,195,3813,1076,975,276,1064,2386
TTGGCCTCCGTTACTC,sample,104837,104080,8463,95617,12265,83352,30092,1657,30384,3613,60476,17606,6285,1415,3659,8235
TGCTTCGCCGTTACTC,Neg_Ctrl,396,273,56,217,41,176,84,4,46,9,130,33,59,23,22,19
GTCTTAGCCGTTACTC,sample,97761,97087,8876,88211,17332,70879,30094,2400,22183,2021,52277,14181,5857,1514,5758,11050
GTACCGTACGTTACTC,sample,62562,62097,3967,58130,14277,43853,19088,1907,13306,1520,32394,8032,3989,960,4766,8836
TCAATATACGTTACTC,sample,99041,98390,6052,92338,14500,77838,33232,2881,24571,2958,57803,14196,4935,1374,6629,10048
TCGCCTGACGTTACTC,sample,127054,126137,12886,113251,15204,98047,19679,1326,41265,4185,60944,31592,9041,1374,6054,9530
AGGTCGGACGTTACTC,sample,104306,103701,2919,100782,24715,76067,49157,4689,15542,2099,64699,4580,2722,1141,14740,17366
TTATTCGACGTTACTC,sample,153894,153011,7346,145665,29035,116630,57836,5521,29926,4568,87762,18779,6084,1569,19482,20223
GGAGAGTTTGGACTGC,sample,81799,81199,7553,73646,7050,66596,20097,1733,25364,2275,45461,17127,6322,1460,1677,4315
TATCAGTTTGGACTGC,sample,80033,79654,3735,75919,18697,57222,34585,2397,12374,1293,46959,6573,4146,2012,8565,12388
ATGCCTGGTGGACTGC,sample,60466,59985,5537,54448,4411,50037,16160,1135,20439,2222,36599,10081,4848,1247,1254,2762
TAGTACGGTGGACTGC,sample,61798,61404,4276,57128,11930,45198,23355,1197,12224,1782,35579,6640,3655,1105,9001,8284
GCCTTGCTTGGACTGC,sample,104122,103312,9308,94004,16857,77147,21109,1683,30342,3219,51451,20794,7181,1143,5844,11016
ACTATACTTGGACTGC,sample,44869,44644,2212,42432,8979,33453,17692,1207,10040,999,27732,3515,2512,1047,6384,6185
GGAGGACGTGGACTGC,sample,83501,83113,3494,79619,20924,58695,39089,2112,12567,1219,51656,3708,2686,1198,14073,14403
CCGCAACGTGGACTGC,sample,42563,42295,2015,40280,11207,29073,16425,1070,7418,607,23843,3553,2435,981,4447,7134
CTTGATAGTGGACTGC,sample,70164,69746,4910,64836,15157,49679,18790,1569,17341,1740,36131,10239,4574,996,6939,9876
ACCTCGAGTGGACTGC,sample,89677,89116,5719,83397,19256,64141,31238,2384,16549,2424,47787,11546,5707,1640,9480,12661
CATTGCAGTGGACTGC,sample,35540,35316,1670,33646,4707,28939,12471,1149,10426,707,22897,4186,2565,927,1101,3414
ACGACTTCTGGACTGC,sample,99390,98949,5278,93671,25184,68487,43876,2185,15903,1435,59779,5088,2992,1144,22878,16703
CATGATTCTGGACTGC,sample,92097,91504,6587,84917,17448,67469,31671,1697,21344,2216,53015,10541,5161,1226,13245,11435
GTCCTGCCTGGACTGC,sample,100955,100386,3339,97047,14259,82788,50071,4052,18561,2669,68632,7435,3233,1581,10676,9702
GTTAGGACTGGACTGC,sample,55903,55421,6139,49282,9893,39389,10226,849,15140,1793,25366,11381,5522,1092,1563,5900
GCCTGAACTGGACTGC,sample,105079,104583,2868,101715,30253,71462,53376,3892,11834,898,65210,1462,1649,1315,15615,19673
CGTATGAATGGACTGC,sample,47259,46967,4201,42766,9022,33744,11354,930,11941,1217,23295,8302,4394,840,3669,5577
TTGGCCTCTGGACTGC,sample,72649,72201,5228,66973,10225,56748,20854,1381,20537,2586,41391,11390,4755,1078,5233,6894
TGCTTCGCTGGACTGC,sample,55552,55159,4747,50412,8703,41709,11619,834,16484,1976,28103,10796,4707,799,2509,5351
AGGTCGGATGGACTGC,sample,149524,148440,9288,139152,21285,117867,53288,3657,37310,5252,90598,18360,7282,1711,9636,15028
TTATTCGATGGACTGC,sample,60524,60156,5049,55107,8253,46854,15181,759,17335,1859,32516,11720,5352,1007,2208,5191
GGAGAGTTCCTTGAGC,sample,44403,44170,2135,42035,13133,28902,16746,1192,7379,760,24125,2825,2189,941,6545,7919
TCCAACTTCCTTGAGC,sample,62912,62415,7439,54976,7995,46981,10746,788,21033,2325,31779,12089,5206,938,1605,5125
TTCGTAATCCTTGAGC,Pos_Ctrl,76284,75732,4961,70771,3633,67138,56638,5427,3539,472,60177,1062,6053,6937,5696,1738
TAGTACGGCCTTGAGC,sample,95542,94869,10728,84141,15338,68803,19913,1266,26590,2961,46503,18073,6726,1183,4935,9570
AATGGTAACCTTGAGC,sample,92024,91455,4803,86652,19888,66764,32504,1951,19353,2079,51857,10877,4869,1501,5699,13399
TTAGAAGTCCTTGAGC,sample,131044,130443,5400,125043,28754,96289,48866,2697,26498,2985,75364,15243,4775,1279,22803,20220
TTCCGTCTCCTTGAGC,sample,100334,99761,3587,96174,19474,76700,42136,2707,22224,2764,64360,6869,3159,1341,14011,14005
GGACCTCTCCTTGAGC,sample,93979,93123,10724,82399,8616,73783,15104,1356,31389,3317,46493,22617,7026,1130,3597,5135
CAAGGCCTCCTTGAGC,sample,13815,13669,1557,12112,3319,8793,3753,252,2639,350,6392,1799,2069,944,499,1980
GTTAGCCGCCTTGAGC,Pos_Ctrl,57206,56411,3653,52758,2422,50336,42360,3881,2803,311,45163,981,5496,6170,3751,1223
GGAGGACGCCTTGAGC,sample,95547,95018,2912,92106,22684,69422,45240,3409,14589,1703,59829,4481,2085,1060,18067,16314
ACCTCGAGCCTTGAGC,sample,68972,68645,2210,66435,22822,43613,34535,1646,5755,707,40290,970,1136,873,19588,14374
TGGACGAGCCTTGAGC,sample,19202,19002,1514,17488,2787,14701,6221,518,5079,557,11300,2326,2118,832,753,1712
GGCCAGAGCCTTGAGC,sample,61915,61267,8020,53247,7889,45358,9342,601,19067,2059,28409,14289,5826,983,2750,4826
CGAGGCAGCCTTGAGC,sample,142787,141899,8487,133412,33041,100371,53061,2834,26600,2607,79661,15269,6253,1373,26189,21549
ACGACTTCCCTTGAGC,sample,16328,16170,1862,14308,1869,12439,4466,431,4424,488,8890,2630,2596,951,622,1099
AATCCGTCCCTTGAGC,sample,158697,157837,7037,150800,36987,113813,61864,3703,31900,2751,93764,13595,5040,1202,26728,25926
CGTACGTCCCTTGAGC,sample,123072,122150,11225,110925,12924,98001,31633,1875,38525,3915,70158,22053,7283,1379,7655,8477
TTGGTACCCCTTGAGC,Pos_Ctrl,145164,143828,6649,137179,5166,132013,110717,11023,6944,901,117661,2428,6556,9358,6321,1795
CGGATTACCCTTGAGC,sample,116598,115899,5384,110515,20427,90088,51261,3771,22244,3103,73505,9709,4091,1422,9869,13783
GCCTGAACCCTTGAGC,sample,86553,85775,10905,74870,5941,68929,15823,1203,28293,3099,44116,20511,7200,1292,1053,3074
AATATATCCCTTGAGC,sample,108006,107138,11535,95603,14000,81603,20849,1258,32720,3626,53569,23150,6945,1085,4951,9221
TCAATATACCTTGAGC,sample,211434,209985,20692,189293,28674,160619,50399,4303,55456,5809,105855,44652,10310,2209,12138,18133
AGGTCGGACCTTGAGC,Pos_Ctrl,98552,97987,4354,93633,4410,89223,74699,8135,4323,561,79022,1505,6197,8251,5606,2025
GACCGGAACCTTGAGC,sample,31393,31247,865,30382,10573,19809,11302,1182,5101,480,16403,1744,1370,569,3694,6568
TCCAACTTCGATATCC,sample,102587,102191,2341,99850,26613,73237,52089,3714,12354,1653,64443,3427,2057,1540,17582,17606
GGTTGCGTCGATATCC,sample,175904,174603,19542,155061,11776,143285,25539,2307,64904,7136,90443,43399,10798,2014,1124,6218
CAAGGCCTCGATATCC,sample,168481,167195,14717,152478,23807,128671,40967,2694,48145,4617,89112,32248,9719,1846,13328,15852
CATAACCTCGATATCC,sample,61095,60768,2283,58485,17076,41409,23985,1665,10421,1307,34406,4031,2833,1014,6084,10691
GACGGAGACGATATCC,sample,98236,97578,7226,90352,17147,73205,23539,2400,28713,2913,52252,15640,6367,1193,5943,11895
CCGCAACGCGATATCC,sample,66820,66480,1669,64811,19575,45236,31274,3059,7708,720,38982,2475,2010,1204,11777,12390
CTTGATAGCGATATCC,sample,127768,126898,10957,115941,16170,99771,25550,2019,39991,4403,65541,27808,9184,1678,5994,10885
TGGACGAGCGATATCC,sample,80555,80222,4064,76158,19841,56317,33772,2922,11955,1483,45727,6185,3764,1291,11803,12885
CGAGGCAGCGATATCC,sample,46737,46456,3685,42771,9350,33421,12081,716,12189,1446,24270,6989,4034,878,2022,5721
CGGATTACCGATATCC,sample,110368,109757,3600,106157,24768,81389,46368,4316,20425,2082,66793,8198,3825,1313,13159,18198
GCCTGAACCGATATCC,sample,90939,90390,5516,84874,12648,72226,30547,2511,24231,3290,54778,11647,5079,1277,4360,8219
CGTATGAACGATATCC,sample,74242,73876,1946,71930,12603,59327,34000,3172,15930,2356,49930,3869,2120,1164,7766,9225
AATATATCCGATATCC,sample,57041,56784,1769,55015,16346,38669,24913,1884,8472,776,33385,2624,2073,821,7583,10394
TGCTTCGCCGATATCC,sample,65562,65266,2641,62625,18879,43746,27100,2077,9393,1702,36493,3474,2024,747,12176,12021
AAGAGCGCCGATATCC,sample,76714,76417,2672,73745,20088,53657,31942,1471,13157,1434,45099,5653,3220,1038,9775,12850
GTCTTAGCCGATATCC,sample,71532,71267,1746,69521,27316,42205,31555,1684,7735,680,39290,551,864,666,12576,15468
GTACCGTACGATATCC,sample,28431,28275,1066,27209,11041,16168,8333,939,4466,676,12799,1754,1572,624,2109,6069
GGCATATACGATATCC,sample,42930,42737,1380,41357,15183,26174,16250,1180,6195,653,22445,1896,1619,706,5589,8794
TCAATATACGATATCC,sample,109301,108851,2850,106001,27757,78244,46622,2609,18227,2207,64849,8579,3100,1053,14464,19068
TATCAGTTATCTGACC,sample,136316,135573,7927,127646,28135,99511,51122,3100,29096,3816,80218,12377,5032,1398,20374,19474
CCTCTAGAATCTGACC,sample,76339,75988,1827,74161,29003,45158,34112,2555,5930,928,40042,1633,1284,1074,14055,17182
ACGTTATGATCTGACC,Neg_Ctrl,273,224,51,173,25,148,73,6,48,1,121,20,65,32,14,15
ATGCCTGGATCTGACC,sample,12873,12813,391,12422,4617,7805,4660,457,1836,190,6496,662,949,535,1698,2641
TAGTACGGATCTGACC,sample,141175,140069,15243,124826,10853,113973,24641,1769,48735,5464,73376,33364,9466,1638,3059,6165
CAACCGCGATCTGACC,sample,12161,12083,762,11321,2850,8471,4827,333,2152,171,6979,988,1289,623,1771,1873
GGACCTCTATCTGACC,sample,86008,85624,3120,82504,17677,64827,36491,2402,17643,2115,54134,6176,3125,1384,10190,12407
GTTAGCCGATCTGACC,sample,48913,48561,4205,44356,8158,36198,11628,771,13715,1792,25343,8292,4141,822,2960,5295
GGAGGACGATCTGACC,Neg_Ctrl,235,193,55,138,37,101,46,1,36,0,82,18,49,24,17,17
GGACGTAGATCTGACC,sample,62318,61842,5479,56363,9422,46941,14620,997,17924,1913,32544,11487,4849,895,3910,6360
CATTGCAGATCTGACC,sample,69793,69234,6571,62663,9380,53283,17993,1069,19849,2437,37842,11935,5112,992,5185,5925
CGAGGCAGATCTGACC,sample,45658,45242,4710,40532,5486,35046,10488,819,14296,1414,24784,8029,3973,918,2104,3581
CATGATTCATCTGACC,sample,65060,64594,5692,58902,10817,48085,16593,1412,16877,2108,33470,11095,4746,818,6013,7217
CTAGGACCATCTGACC,Neg_Ctrl,234,151,54,97,22,75,32,2,21,1,53,19,31,16,5,8
AACTCGTAATCTGACC,sample,59872,59563,2579,56984,15577,41407,22454,1388,11435,1077,33889,5053,2922,839,5597,10037
AATATATCATCTGACC,sample,73416,73007,4403,68604,12986,55618,27649,2125,17204,2034,44853,6606,3211,1043,6606,9471
GAAGGCGCATCTGACC,sample,82999,82486,3824,78662,16688,61974,33296,2162,16196,1815,49492,8505,3757,990,10537,11341
TTGGTTAAATCTGACC,sample,121585,120868,5571,115297,24777,90520,48334,3272,21895,2419,70229,14600,3446,1076,18786,16628
GTACCGTAATCTGACC,sample,114160,113468,6804,106664,16939,89725,39292,3443,30202,2993,69494,13795,4944,1137,11948,11502
TCGCCTGAATCTGACC,sample,84395,83733,6509,77224,9884,67340,27124,2096,22679,2420,49803,13021,5324,1181,3117,6868
CTTCATGAATCTGACC,sample,73975,73458,5501,67957,11185,56772,23518,2067,17771,2251,41289,11165,4233,991,2850,7266
TTATTCGAATCTGACC,Neg_Ctrl,472,379,45,334,38,296,96,4,125,15,221,56,113,43,11,27
GACCGGAAATCTGACC,sample,89460,88780,6982,81798,12905,68893,21118,1325,25971,2671,47089,17808,6157,1094,4860,8832
TATCAGTTCTTCTTAC,sample,89830,89271,5567,83704,14789,68915,30323,1389,21024,1842,51347,14337,5471,1356,11587,10178
ACGTAAGTCTTCTTAC,sample,133617,132726,5531,127195,26912,100283,56759,3949,24201,2844,80960,12530,4619,1390,22918,18913
TAGTACGGCTTCTTAC,sample,139651,139030,4057,134973,42771,92202,61426,4669,18791,1996,80217,5320,2385,1078,22278,27374
TGAGCGCGCTTCTTAC,sample,58852,58574,3121,55453,11164,44289,21386,1666,13101,1716,34487,6420,3623,986,6993,7573
TTCCGTCTCTTCTTAC,sample,85455,85044,2323,82721,24732,57989,39375,3016,11296,1188,50671,3114,2336,1334,13307,16300
GGACCTCTCTTCTTAC,sample,123885,123297,4524,118773,26923,91850,56383,3710,20987,2381,77370,8389,3910,1325,20633,17727
TCGCATCTCTTCTTAC,sample,89790,89117,8272,80845,15759,65086,17755,667,26523,3012,44278,17129,6292,1002,4037,10192
ACTATACTCTTCTTAC,sample,114465,113965,4504,109461,24006,85455,47478,2933,23881,3220,71359,7943,3549,1208,18176,17526
GGCCAGAGCTTCTTAC,sample,130035,129196,10265,118931,23024,95907,43474,2591,28883,2967,72357,17992,6542,1403,18264,16035
ACGACTTCCTTCTTAC,sample,87248,86767,5562,81205,19024,62181,31054,2158,16677,2003,47731,10289,3878,989,12180,12809
CGGATTACCTTCTTAC,sample,75857,75175,6199,68976,9523,59453,14830,1368,23860,2684,38690,16711,6035,998,2741,6195
CGTATGAACTTCTTAC,sample,150735,149832,6972,142860,36806,106054,60754,3643,29165,2898,89919,9594,3093,1044,21890,25993
TTGGCCTCCTTCTTAC,sample,74282,73806,5755,68051,7100,60951,21297,1514,23420,3057,44717,11663,4630,1131,713,4589
AATATATCCTTCTTAC,sample,122304,121664,4863,116801,30154,86647,47625,3423,23558,3204,71183,8837,3780,1029,15905,20821
TGCTTCGCCTTCTTAC,sample,147924,146950,13650,133300,18961,114339,34838,1787,41240,4841,76078,31633,8281,1527,10469,11285
GTCTTAGCCTTCTTAC,sample,117458,116766,3880,112886,26689,86197,50545,2806,22009,1836,72554,9001,3666,1113,15341,18144
CCAATTCCCTTCTTAC,sample,100287,99686,2992,96694,29074,67620,41260,4943,16031,1132,57291,4254,1735,784,13146,19258
TCGCCTGACTTCTTAC,sample,95507,95092,2401,92691,30282,62409,44638,4107,10164,1504,54802,1996,1422,955,15045,18991
TATCAGTTACTTCTAC,sample,64842,64509,2225,62284,15019,47265,32422,2308,8340,1104,40762,3091,2468,1368,9823,10029
ACGTAAGTACTTCTAC,sample,51653,51280,4270,47010,9395,37615,13667,932,13273,1686,26940,8057,3877,946,4064,6383
ATGCCTGGACTTCTAC,sample,109676,109214,2634,106580,32441,74139,52637,3450,14989,829,67626,2234,1396,909,22692,21974
TGAGCGCGACTTCTAC,sample,88970,88351,7701,80650,11101,69549,21431,1917,27756,2690,49187,15755,5865,1157,4920,7441
GCCTTGCTACTTCTAC,sample,88553,87742,8562,79180,10999,68181,18140,1279,26179,2877,44319,19706,6787,1304,3687,6736
CATAACCTACTTCTAC,sample,85218,84682,7743,76939,15183,61756,17967,1294,24138,2478,42105,15879,5179,975,4219,9356
GACGGAGAACTTCTAC,sample,86397,85905,4522,81383,19562,61821,30158,2793,16932,2180,47090,9758,3986,973,11615,13353
GGACGTAGACTTCTAC,sample,55292,54963,3483,51480,7030,44450,19837,1332,15266,1877,35103,6138,3450,1118,3854,4693
GACGATAAACTTCTAC,sample,33186,32951,2754,30197,5277,24920,10345,773,8006,806,18351,4990,3067,924,2268,3491
GGCCAGAGACTTCTAC,sample,56400,56006,6550,49456,6219,43237,11035,819,18851,1759,29886,10773,5538,1137,2245,3649
CATTGCAGACTTCTAC,sample,89276,88512,9248,79264,12102,67162,17586,889,26299,2848,43885,19540,6830,1083,4046,7790
CCATGAAGACTTCTAC,sample,87553,87184,2311,84873,24796,60077,42597,2338,12955,1065,55552,1122,1108,721,20610,16593
CATGATTCACTTCTAC,sample,81078,80565,4506,76059,16577,59482,28435,1690,18148,2141,46583,9068,4168,1022,10725,10712
CGTACGTCACTTCTAC,sample,114122,113024,13505,99519,10463,89056,13019,986,38241,3977,51260,32833,9138,1316,1953,6483
TTGGTACCACTTCTAC,sample,75816,75070,6941,68129,5058,63071,17289,1343,26868,2670,44157,14901,5570,1023,1649,2516
CTAGGACCACTTCTAC,sample,108911,108067,10162,97905,12025,85880,24633,2287,32059,3205,56692,23696,7793,1308,4462,7488
CTTCATGAACTTCTAC,sample,147372,146355,9318,137037,21508,115529,45270,4168,37044,3508,82314,25539,7606,1571,15724,14244
ATTCTCTTAGAAGTAA,sample,50666,50408,2115,48293,13700,34593,19071,1856,8332,1081,27403,4253,2744,1105,4830,8848
AAGTTCGTAGAAGTAA,sample,138375,137534,7598,129936,23162,106774,52261,3272,31498,4098,83759,15645,6312,1966,7380,15653
ACGTAAGTAGAAGTAA,sample,138431,137532,9796,127736,14930,112806,41250,2132,43515,6544,84765,19365,6824,1709,5432,9554
AGTACCATAGAAGTAA,sample,205709,204558,9769,194789,49566,145223,75714,4189,41656,3879,117370,19785,5920,1400,31971,33314
ACGTTATGAGAAGTAA,sample,155401,154566,9425,145141,26693,118448,51170,4032,37039,4372,88209,21835,7055,1695,15721,18394
TAGTACGGAGAAGTAA,sample,127535,126961,3782,123179,31751,91428,61284,4212,16700,2686,77984,6546,2796,973,29248,21467
CAACCGCGAGAAGTAA,sample,113435,112354,13579,98775,10020,88755,14512,1340,38904,4183,53416,29816,8684,1271,1871,5369
TTCCGTCTAGAAGTAA,sample,167818,166834,9638,157196,19829,137367,50941,3157,53165,6523,104106,23581,6918,1750,8763,12802
GCCTTGCTAGAAGTAA,sample,26928,26739,2296,24443,6317,18126,6533,619,6218,720,12751,4036,2867,855,1660,3697
CCAGAGCGAGAAGTAA,sample,79014,78515,3171,75344,16629,58715,34828,2669,13487,1737,48315,5994,3641,1273,10102,11690
CCGCAACGAGAAGTAA,sample,56054,55720,3267,52453,6113,46340,18359,1342,16694,2347,35053,7598,3793,1271,3028,4124
CATGATTCAGAAGTAA,sample,84463,83994,2699,81295,16158,65137,40635,2926,15538,1655,56173,4383,2622,1323,9931,11346
AATCCGTCAGAAGTAA,sample,49148,48774,3861,44913,6064,38849,13214,999,14012,1818,27226,8806,4584,1274,1545,4129
CGTACGTCAGAAGTAA,sample,42039,41788,1095,40693,10504,30189,19022,1497,6708,734,25730,2228,1831,1010,3209,6789
ACGTATTAAGAAGTAA,sample,213021,211476,21718,189758,21844,167914,47766,2825,63106,6656,110872,47561,8385,1796,8764,11586
GTCTTAGCAGAAGTAA,sample,126305,125252,13194,112058,10214,101844,17601,1327,43819,5611,61420,33486,9139,1371,1652,5550
GGCATATAAGAAGTAA,sample,88510,87937,8289,79648,13235,66413,27940,1673,20720,2146,48660,13934,5410,1283,9323,8567
TCGCCTGAAGAAGTAA,sample,148126,146858,18652,128206,10705,117501,24731,1353,49745,4982,74476,36690,8905,1382,3434,5322
CTTCATGAAGAAGTAA,sample,100808,100125,6885,93240,10275,82965,27718,2759,33633,3376,61351,15479,5451,1224,3112,6736
Short,Non_sample,0,NA,NA,NA,NA,NA,NA,NA,NA,NA,NA,NA,NA,NA,NA,NA
Unselected,Non_sample,0,NA,NA,NA,NA,NA,NA,NA,NA,NA,NA,NA,NA,NA,NA,NA
Undetermined,Non_sample,196048676,NA,NA,NA,NA,NA,NA,NA,NA,NA,NA,NA,NA,NA,NA,NA
