Barcode,Sample,Barcoded_Reads,Trimmed_Reads,Unmapped_Reads,Mapped_Reads,Multimapped_Reads,Uniquely_Mapped_Reads,Exon_Reads,Ambiguous_Exon_Reads,Intron_Reads,Ambiguous_Intron_Reads,Gene_Reads,Intergenic_Reads,No_of_Genes,No_of_Transcripts,Mitochondrial_Reads,Ribosomal_Reads
TATCAGTTCGTTGGTT,sample,171224,170363,3503,166860,60186,106674,84002,5256,12671,2055,96673,2690,2058,1755,22772,35703
CAAGGCCTCGTTGGTT,sample,115821,115052,7339,107713,23209,84504,42059,2975,24602,2546,66661,12322,5347,1410,12408,15996
ACTATACTCGTTGGTT,sample,76417,75934,4708,71226,18183,53043,29402,2129,13130,1270,42532,7112,4457,1902,9126,11860
GGACGTAGCGTTGGTT,sample,43061,42752,2877,39875,8810,31065,15445,811,9905,912,25350,3992,3010,1201,5196,6122
CTTGATAGCGTTGGTT,sample,60117,59565,4100,55465,10593,44872,18454,1469,16168,2038,34622,6743,3878,1261,5558,7013
ACCTCGAGCGTTGGTT,sample,56217,55807,3017,52790,17050,35740,21156,1264,8505,1220,29661,3595,2316,997,6787,10493
TGGACGAGCGTTGGTT,sample,65752,65312,4656,60656,13859,46797,21993,1778,14447,1671,36440,6908,4046,1379,5717,9204
GACGATAACGTTGGTT,sample,69680,69300,3733,65567,20170,45397,23532,1638,12093,1200,35625,6934,3622,1125,8536,12438
CATTGCAGCGTTGGTT,sample,865,795,57,738,270,468,228,18,153,11,381,58,187,105,49,138
CGTACGTCCGTTGGTT,sample,177,176,19,157,43,114,50,13,32,3,82,16,37,14,21,27
AGTCCGCACGTTGGTT,sample,206,206,19,187,43,144,62,8,58,4,120,12,63,36,23,27
GTCCTGCCCGTTGGTT,sample,249,244,39,205,26,179,77,5,65,6,142,26,74,29,29,19
GCCTGAACCGTTGGTT,sample,194,188,21,167,18,149,60,2,55,1,115,31,59,23,11,13
TTGGCCTCCGTTGGTT,sample,174,169,22,147,23,124,60,9,39,4,99,12,57,31,12,15
AATATATCCGTTGGTT,sample,111,111,17,94,19,75,32,1,18,2,50,22,25,11,6,12
AAGAGCGCCGTTGGTT,sample,130,128,10,118,24,94,57,5,22,0,79,10,45,35,11,13
GTCTTAGCCGTTGGTT,sample,125,123,11,112,13,99,37,1,41,1,78,19,40,13,12,9
TCGCCTGACGTTGGTT,sample,90,89,9,80,23,57,25,0,20,1,45,11,29,10,2,13
TATCAGTTCTATCGTT,sample,96829,96203,4931,91272,25435,65837,39262,2811,15173,1961,54435,6630,3928,1652,9545,16630
TCCAACTTCTATCGTT,sample,92884,92344,4354,87990,23601,64389,41837,3903,12039,1507,53876,5103,3258,1717,11303,15929
GGTTGCGTCTATCGTT,sample,87112,86497,5955,80542,19044,61498,28267,2029,19044,2157,47311,10001,4808,1755,6296,12293
CCTCTAGACTATCGTT,sample,72410,71941,3638,68303,14365,53938,30527,2450,13076,1561,43603,6324,3643,1218,6545,9223
GCCTTGCTCTATCGTT,sample,13942,13826,581,13245,4477,8768,5525,455,1673,311,7198,804,1184,704,1350,2660
ACTATACTCTATCGTT,sample,34083,33829,1967,31862,9373,22489,13207,639,5356,619,18563,2668,2106,802,4469,5948
GTTAGCCGCTATCGTT,sample,48194,47588,7057,40531,6122,34409,14113,816,10927,1400,25040,7153,4351,1183,4359,4146
GGACGTAGCTATCGTT,sample,28972,28669,2814,25855,4869,20986,8185,651,7948,778,16133,3424,2624,932,2018,3076
CATTGCAGCTATCGTT,sample,59102,58525,7826,50699,4408,46291,13022,938,19473,2005,32495,10853,5435,1286,2491,2643
CGAGGCAGCTATCGTT,sample,63709,63175,4810,58365,15990,42375,22614,1902,11202,1304,33816,5353,3312,1144,6339,10165
CCATGAAGCTATCGTT,sample,68961,68397,5867,62530,12462,50068,23237,1630,14239,1521,37476,9441,4694,1397,5206,8476
ACGACTTCCTATCGTT,sample,52353,51925,2684,49241,15725,33516,19343,1596,8797,959,28140,2821,2194,1018,5857,9696
CGTACGTCCTATCGTT,sample,73130,72418,6349,66069,10120,55949,24317,1511,15913,1883,40230,12325,4603,1238,5674,7278
GTTAGGACCTATCGTT,sample,171,168,19,149,9,140,74,5,29,5,103,27,51,29,15,8
AACTCGTACTATCGTT,sample,141,140,18,122,30,92,42,2,34,0,76,14,33,16,11,20
AATATATCCTATCGTT,sample,100,100,15,85,15,70,27,0,23,1,50,19,29,12,8,9
GAAGGCGCCTATCGTT,sample,1059,993,83,910,195,715,387,29,200,27,587,72,259,146,102,118
TTGGTTAACTATCGTT,sample,278,265,20,245,28,217,97,8,62,10,159,40,69,28,32,28
GGCATATACTATCGTT,sample,123,122,19,103,14,89,50,3,22,4,72,10,41,26,12,10
TCAATATACTATCGTT,sample,171,168,21,147,23,124,49,16,32,8,81,19,58,37,7,13
TCGCCTGACTATCGTT,sample,89,85,11,74,10,64,24,5,20,0,44,15,34,14,5,10
CTTCATGACTATCGTT,sample,129,125,13,112,12,100,54,1,38,1,92,6,33,14,8,10
AGGTCGGACTATCGTT,sample,160,157,19,138,24,114,61,5,34,5,95,9,46,22,16,24
ATGACCGACTATCGTT,sample,119,119,10,109,8,101,47,2,30,8,77,14,48,25,10,11
GGAGAGTTGTCTTCTT,sample,3686,3600,182,3418,955,2463,1245,88,760,78,2005,292,617,289,356,557
ATTCTCTTGTCTTCTT,Pos_Ctrl,37691,37489,1767,35722,2032,33690,28354,3034,1632,185,29986,485,4509,5007,2355,912
TCCAACTTGTCTTCTT,sample,62613,62260,2135,60125,18717,41408,27451,2376,8515,888,35966,2178,2085,1159,8190,11958
AAGTTCGTGTCTTCTT,sample,44629,44309,3370,40939,9356,31583,15164,1039,8688,926,23852,5766,3336,864,4665,6079
GGTTGCGTGTCTTCTT,sample,76012,75584,3403,72181,19025,53156,26933,1572,14658,2188,41591,7805,4146,1338,7715,12358
TCCTCCGTGTCTTCTT,sample,73578,73166,1902,71264,23034,48230,36907,2874,6345,838,43252,1266,1179,1000,13534,14430
CCTCTAGAGTCTTCTT,Pos_Ctrl,27128,26871,1256,25615,1627,23988,20348,2157,1013,154,21361,316,3819,4084,1825,817
CAACCGCGGTCTTCTT,sample,42492,42117,2952,39165,10152,29013,14918,1057,7466,998,22384,4574,2668,783,5203,6417
AATGGTAAGTCTTCTT,sample,67150,66717,4272,62445,10170,52275,23727,1636,17902,2065,41629,6945,3845,1374,5792,7376
TTCCGTCTGTCTTCTT,sample,53848,53404,5292,48112,7382,40730,16071,951,13887,1644,29958,8177,4255,991,5473,5119
TCGCATCTGTCTTCTT,sample,46947,46564,2051,44513,13467,31046,20896,1448,6320,608,27216,1774,1359,768,6180,8633
ACCTCGAGGTCTTCTT,sample,37286,36944,3486,33458,4228,29230,10862,718,11262,1327,22124,5061,3300,1145,2247,2876
GGCCAGAGGTCTTCTT,sample,26506,26195,2074,24121,6214,17907,9132,595,5161,592,14293,2427,1920,708,2856,3959
CATTGCAGGTCTTCTT,sample,23385,23147,2098,21049,2857,18192,5556,571,7854,862,13410,3349,2572,818,920,1879
CATGATTCGTCTTCTT,sample,38164,37827,2418,35409,7012,28397,14212,853,9073,1124,23285,3135,2605,1193,3628,4742
CGTACGTCGTCTTCTT,sample,38479,38082,2676,35406,6800,28606,17881,1020,5754,737,23635,3214,2509,1254,3549,4679
CTAGGACCGTCTTCTT,sample,40937,40663,1963,38700,8060,30640,18300,1326,6343,895,24643,3776,2072,951,5818,5456
CGGATTACGTCTTCTT,sample,41772,41398,1594,39804,9536,30268,20952,1584,5126,772,26078,1834,1696,1136,5100,6661
CGTATGAAGTCTTCTT,sample,43470,43050,3153,39897,7848,32049,13941,1280,9690,1025,23631,6113,3687,917,3247,5275
TTGGCCTCGTCTTCTT,sample,11212,11065,858,10207,2540,7667,2629,236,2861,244,5490,1697,1554,467,481,1553
GTCTTAGCGTCTTCTT,sample,45764,45297,4982,40315,7507,32808,13132,684,11255,1285,24387,6452,4126,1123,2725,4891
CCAATTCCGTCTTCTT,sample,32513,32166,2143,30023,5652,24371,12740,907,6520,824,19260,3380,2705,1115,2957,3999
TTGGTTAAGTCTTCTT,sample,46367,45969,2895,43074,8070,35004,20709,1565,7693,845,28402,4192,2194,974,4601,5779
AGGTCGGAGTCTTCTT,Pos_Ctrl,162,161,26,135,22,113,59,1,35,2,94,16,58,27,16,15
ATGACCGAGTCTTCTT,sample,209,205,27,178,27,151,72,4,41,5,113,29,52,29,18,17
GGAGAGTTTAGGCTCT,sample,81720,81106,2804,78302,9732,68570,36556,2402,22659,2618,59215,4335,2562,1302,9924,6918
TCCAACTTTAGGCTCT,sample,186164,185075,5712,179363,45218,134145,95609,7540,20469,1942,116078,8585,3883,1853,21767,31215
ACGTAAGTTAGGCTCT,sample,219598,218279,16642,201637,31202,170435,62317,4038,59707,6585,122024,37788,10188,2247,19110,21798
CCTCTAGATAGGCTCT,sample,113645,112920,5042,107878,32844,75034,44590,3167,17684,2136,62274,7457,3987,1291,14694,20019
AGTACCATTAGGCTCT,sample,181927,180941,7258,173683,44959,128724,72491,4927,35514,3089,108005,12703,4727,1420,22984,29606
TAGTACGGTAGGCTCT,sample,103001,102461,4586,97875,26528,71347,36739,3559,20332,2147,57071,8570,4313,1405,10569,17001
CAAGGCCTTAGGCTCT,sample,156416,154875,11977,142898,27707,115191,56234,3078,32817,3748,89051,19314,6510,1812,13921,19225
ACTATACTTAGGCTCT,sample,127974,126690,9942,116748,22915,93833,51044,3159,24107,2269,75151,13254,5152,1317,17005,17030
GACGGAGATAGGCTCT,sample,147959,146434,11891,134543,20448,114095,51010,2795,37419,3989,88429,18882,5712,1564,12242,14957
GTTAGCCGTAGGCTCT,sample,73952,73065,5633,67432,13718,53714,23614,1613,17586,2031,41200,8870,4248,1143,5039,9007
GGAGGACGTAGGCTCT,sample,76559,75416,15197,60219,7167,53052,12520,993,21123,2358,33643,16058,7092,1443,2053,3750
ACCTCGAGTAGGCTCT,sample,110406,109731,4543,105188,33871,71317,43661,2902,16270,1470,59931,7014,2656,1168,14350,20710
GACGATAATAGGCTCT,sample,107906,107018,8533,98485,23777,74708,35927,2728,22732,2702,58659,10619,4280,1341,13090,15763
GGCCAGAGTAGGCTCT,sample,116445,115626,6447,109179,32011,77168,47841,3967,16329,2403,64170,6628,3553,1659,14330,20750
CATTGCAGTAGGCTCT,sample,141068,139801,12454,127347,21795,105552,38303,3263,35704,4264,74007,24018,7417,1755,10947,15030
CGAGGCAGTAGGCTCT,sample,110700,109745,6244,103501,20542,82959,51112,3470,17944,2398,69056,8035,4404,1818,12190,14210
AATCCGTCTAGGCTCT,sample,123515,122361,10314,112047,23560,88487,36381,2787,26611,2894,62992,19814,5866,1389,11116,15494
CTAGGACCTAGGCTCT,sample,149486,147655,14770,132885,13283,119602,36604,2684,44043,4666,80647,31605,9234,1975,7909,8288
GCCTGAACTAGGCTCT,sample,100662,99364,8276,91088,19501,71587,37551,2345,19905,2292,57456,9494,3827,1117,10445,13472
TTGGCCTCTAGGCTCT,sample,65005,64317,4607,59710,7288,52422,20985,1202,19703,2603,40688,7929,3747,1117,4433,4938
AATATATCTAGGCTCT,sample,118640,117333,13555,103778,10707,93071,31933,2623,31783,3845,63716,22887,8028,1545,6415,6887
GGCATATATAGGCTCT,sample,85242,84572,4036,80536,13813,66723,37187,3080,16061,2592,53248,7803,4060,1225,13522,10081
ATTCTCTTTTGACTAT,sample,100287,99568,6405,93163,14930,78233,41935,2863,21845,2477,63780,9113,4202,1674,10550,10757
TCCAACTTTTGACTAT,Neg_Ctrl,1271,648,353,295,90,205,89,5,60,10,149,41,81,41,25,18
ACGTAAGTTTGACTAT,sample,75844,75262,5801,69461,12666,56795,24289,1299,18228,1715,42517,11264,4784,1174,8029,9013
AGTACCATTTGACTAT,Neg_Ctrl,1789,1144,837,307,38,269,124,10,63,26,187,46,91,46,32,9
ACGTTATGTTGACTAT,sample,22697,22416,3599,18817,2982,15835,5322,297,5337,555,10659,4324,2636,612,1741,1710
TTCTAATGTTGACTAT,sample,84562,83868,5553,78315,15980,62335,31367,1829,17534,1526,48901,10079,3812,1236,9470,10877
TGAGCGCGTTGACTAT,sample,39138,38767,3357,35410,9011,26399,14192,935,6456,729,20648,4087,2780,957,4208,5686
CAACCGCGTTGACTAT,sample,61550,60958,4858,56100,12071,44029,22126,1561,11621,1291,33747,7430,4363,1432,5989,8268
AATGGTAATTGACTAT,sample,42718,42326,2903,39423,9508,29915,17134,712,7906,788,25040,3375,2822,1051,7328,6075
TTAGAAGTTTGACTAT,sample,14122,13997,1604,12393,2971,9422,4137,258,2844,270,6981,1913,2012,863,1244,1812
TTCCGTCTTTGACTAT,Pos_Ctrl,30428,30043,2485,27558,1633,25925,21769,2082,1419,188,23188,467,4113,4023,1800,863
TCGCATCTTTGACTAT,sample,71821,71156,4837,66319,16357,49962,24941,1618,13843,1634,38784,7926,3894,1143,7218,11221
GACGGAGATTGACTAT,sample,51302,50766,5292,45474,7617,37857,17731,953,11000,1250,28731,6923,3752,1094,4848,4754
CCGCAACGTTGACTAT,Pos_Ctrl,21130,20690,2013,18677,963,17714,14986,1304,1038,105,16024,281,3427,3165,1148,497
GACGATAATTGACTAT,sample,48541,48057,4020,44037,10908,33129,17138,1205,8470,1241,25608,5075,3113,984,5118,6725
GGCCAGAGTTGACTAT,sample,91929,91034,10693,80341,11382,68959,20386,1411,24104,2985,44490,20073,7369,1264,6027,7488
CCATGAAGTTGACTAT,sample,85002,84221,6521,77700,13748,63952,33346,2036,16791,1784,50137,9995,4856,1461,7416,8978
ACGACTTCTTGACTAT,sample,32921,32552,4930,27622,2940,24682,6804,464,9579,1001,16383,6834,3464,775,2208,1930
AATCCGTCTTGACTAT,Pos_Ctrl,26494,26119,2368,23751,1305,22446,18743,1794,1269,177,20012,463,3868,3755,1404,668
TTGGTACCTTGACTAT,sample,68607,67835,7310,60525,9005,51520,21756,1580,15944,1767,37700,10473,4387,1291,5844,5924
CGTATGAATTGACTAT,sample,108660,107186,14516,92670,10342,82328,21789,1396,30803,3410,52592,24930,7747,1207,4642,6306
TTGGCCTCTTGACTAT,Pos_Ctrl,23709,23316,2134,21182,1007,20175,16893,1542,1231,152,18124,357,3699,3554,949,486
ACCAATGCTTGACTAT,sample,54185,53534,6518,47016,4480,42536,14732,842,15221,1819,29953,9922,4535,969,2057,2756
GTACCGTATTGACTAT,sample,65607,64798,7662,57136,7468,49668,18794,1133,16115,1798,34909,11828,5137,1020,4713,5001
AGGTCGGATTGACTAT,sample,5261,5078,826,4252,558,3694,1189,76,1329,104,2518,996,898,277,261,300
TTATTCGATTGACTAT,Neg_Ctrl,267,236,33,203,11,192,92,0,53,3,145,44,73,31,14,6
TTCTAATGTGCAGTTG,sample,604,597,30,567,147,420,241,13,92,16,333,58,157,101,48,93
ATGCCTGGTGCAGTTG,sample,63582,63163,2462,60701,17922,42779,26470,2208,8871,1257,35341,3973,2209,996,7286,11901
CAACCGCGTGCAGTTG,sample,10859,10741,419,10322,3248,7074,3570,271,2215,286,5785,732,1156,623,765,1979
TTAGAAGTTGCAGTTG,sample,69123,68622,4564,64058,15891,48167,24039,1631,12720,1365,36759,8412,4324,959,10308,10394
CAAGGCCTTGCAGTTG,sample,77272,76486,8451,68035,11718,56317,16127,834,20769,2086,36896,16501,6326,1096,4418,7698
ACTATACTTGCAGTTG,sample,54718,54164,7294,46870,6721,40149,13440,896,14906,1485,28346,9422,5006,1165,2623,4332
CCAGAGCGTGCAGTTG,sample,102551,101665,6814,94851,17246,77605,33817,1881,29649,3040,63466,9218,4444,1351,9383,12440
GGACGTAGTGCAGTTG,sample,40140,39684,3044,36640,6998,29642,13154,966,9457,1260,22611,4805,3066,917,3493,4754
GGCCAGAGTGCAGTTG,sample,144655,143014,13826,129188,7149,122039,42138,3237,54055,8449,96193,14160,6458,2161,2426,4027
ACGACTTCTGCAGTTG,sample,55062,54537,3910,50627,9337,41290,19039,1165,11579,1277,30618,8230,3650,938,5854,6499
AATCCGTCTGCAGTTG,sample,48344,47886,4192,43694,6952,36742,17347,1292,11438,1247,28785,5418,3442,1209,3718,4772
CGTACGTCTGCAGTTG,sample,53327,52862,3240,49622,8745,40877,24132,1870,9157,1136,33289,4582,3004,1108,5445,6172
TTGGTACCTGCAGTTG,sample,60049,59365,4739,54626,8911,45715,19378,1225,13575,1423,32953,10114,4668,1114,5072,6029
CGGATTACTGCAGTTG,sample,51106,50500,4371,46129,8973,37156,17168,1377,10500,1093,27668,7018,3819,943,5361,5970
GTTAGGACTGCAGTTG,sample,46316,45731,4365,41366,6204,35162,14292,806,11302,1418,25594,7344,3490,816,3965,4360
ACGTATTATGCAGTTG,sample,71406,70594,7679,62915,9643,53272,18896,1526,18506,2042,37402,12302,5604,1119,4662,6792
GAAGGCGCTGCAGTTG,sample,63731,62979,6210,56769,10219,46550,19690,1705,14175,1996,33865,8984,4135,1036,4888,6521
GTCTTAGCTGCAGTTG,sample,73396,72575,6649,65926,12290,53636,23068,1336,18295,1486,41363,9451,4265,984,5692,8345
GGCATATATGCAGTTG,sample,47935,47472,3323,44149,5736,38413,17918,1211,11889,1725,29807,5670,3557,1392,2312,3948
TTATTCGATGCAGTTG,sample,863,834,96,738,89,649,247,10,227,26,474,139,208,79,47,57
GGAGAGTTTCATGCTG,sample,30507,30281,2637,27644,5978,21666,7844,647,7943,832,15787,4400,3126,775,1813,3722
ATTCTCTTTCATGCTG,sample,3546,3491,258,3233,913,2320,1163,127,704,58,1867,268,547,299,277,554
TTCGTAATTCATGCTG,sample,10847,10747,802,9945,2485,7460,3949,230,1920,200,5869,1161,1270,554,1063,1626
ATGCCTGGTCATGCTG,sample,25534,25331,1246,24085,6548,17537,10843,783,3839,373,14682,1699,1599,767,3144,4315
TAGTACGGTCATGCTG,sample,11983,11848,776,11072,1781,9291,4174,289,3158,417,7332,1253,1445,593,1454,1274
CAACCGCGTCATGCTG,sample,21056,20861,1516,19345,4678,14667,7447,470,4103,551,11550,2096,1833,595,2869,3006
AATGGTAATCATGCTG,sample,40853,40564,2889,37675,6380,31295,14964,1445,9749,990,24713,4147,3075,1390,3661,4421
GGACCTCTTCATGCTG,Neg_Ctrl,590,297,166,131,13,118,28,5,59,6,87,20,38,12,15,7
TCGCATCTTCATGCTG,sample,30246,29982,2079,27903,4274,23629,11700,714,7551,1016,19251,2648,2618,1302,1680,3036
CAAGGCCTTCATGCTG,sample,78166,77340,4914,72426,10215,62211,29559,2468,18230,2237,47789,9717,3924,1032,4494,7036
CCGCAACGTCATGCTG,sample,4593,4526,370,4156,884,3272,1561,135,983,80,2544,513,844,426,340,582
GGACGTAGTCATGCTG,Neg_Ctrl,256,160,74,86,20,66,33,2,17,2,50,12,29,13,13,6
GGCCAGAGTCATGCTG,sample,3631,3586,545,3041,450,2591,901,53,853,78,1754,706,686,222,255,294
CCATGAAGTCATGCTG,sample,26309,25844,5194,20650,846,19804,2677,139,9071,900,11748,7017,3605,563,78,342
CGTACGTCTCATGCTG,Neg_Ctrl,474,257,120,137,17,120,54,6,27,2,81,31,47,21,7,8
GTCCTGCCTCATGCTG,sample,24521,24120,2830,21290,3381,17909,7832,532,5140,596,12972,3809,2562,816,1804,2297
CGGATTACTCATGCTG,sample,16987,16756,2072,14684,1732,12952,5391,391,3920,477,9311,2773,2090,550,1623,1097
TTGGCCTCTCATGCTG,sample,19322,19044,2545,16499,2336,14163,5342,367,4626,443,9968,3385,2549,816,1319,1540
AATATATCTCATGCTG,Neg_Ctrl,488,320,224,96,18,78,17,1,29,6,46,25,27,9,8,6
ACCAATGCTCATGCTG,sample,16142,15901,1709,14192,2082,12110,5028,344,3732,419,8760,2587,2078,649,1327,1373
CCAATTCCTCATGCTG,sample,32502,31909,4174,27735,3566,24169,9219,519,7952,867,17171,5612,3350,763,2476,2315
TTGGTTAATCATGCTG,sample,40047,39404,5004,34400,2187,32213,11759,668,12121,1063,23880,6602,3883,1195,874,1253
GGCATATATCATGCTG,sample,22935,22617,2265,20352,2122,18230,8752,562,5096,521,13848,3299,2579,866,1947,1456
TCAATATATCATGCTG,sample,8495,8388,1278,7110,959,6151,2045,182,2165,244,4210,1515,1340,427,429,645
AGGTCGGATCATGCTG,sample,19542,19307,2112,17195,1873,15322,6047,584,5149,510,11196,3032,2088,714,831,1083
TTATTCGATCATGCTG,sample,5590,5545,964,4581,423,4158,700,51,1828,177,2528,1402,1180,189,177,198
ATGACCGATCATGCTG,sample,222,204,34,170,24,146,51,5,37,7,88,46,54,23,7,13
ATTCTCTTTTAGGCGG,Pos_Ctrl,52845,52552,2401,50151,3011,47140,40024,4763,1526,197,41550,630,4856,5729,3327,1390
CCTCTAGATTAGGCGG,Pos_Ctrl,40902,40533,2031,38502,2005,36497,31143,3050,1548,219,32691,537,4671,5293,2503,934
ACGTTATGTTAGGCGG,sample,100926,100219,5820,94399,23082,71317,36976,3094,19016,2213,55992,10018,4628,1102,12812,15425
TTCTAATGTTAGGCGG,sample,66040,65717,3302,62415,14138,48277,22076,1204,17282,1954,39358,5761,3692,1271,4068,9862
CAACCGCGTTAGGCGG,sample,29810,29487,3046,26441,4461,21980,7793,492,8135,917,15928,4643,3147,951,1753,2993
CCAGAGCGTTAGGCGG,sample,59053,58296,5325,52971,7134,45837,19930,1165,15297,1629,35227,7816,4015,1043,4175,4959
GGACGTAGTTAGGCGG,sample,117897,116906,11509,105397,16134,89263,35954,2475,31389,3694,67343,15751,6896,1970,7051,11050
CATTGCAGTTAGGCGG,sample,44941,44241,5155,39086,7967,31119,10280,862,11503,1159,21783,7315,3742,825,2378,5296
AATCCGTCTTAGGCGG,sample,94846,93918,7568,86350,14017,72333,35493,1977,20435,2048,55928,12380,5189,1265,8611,9858
TTGGTACCTTAGGCGG,sample,24741,24367,2494,21873,4464,17409,8679,388,4843,631,13522,2868,2055,625,2819,3008
CTAGGACCTTAGGCGG,sample,69444,68649,6531,62118,9893,52225,22999,1320,15613,1735,38612,10558,4777,957,7137,6324
GCCTGAACTTAGGCGG,sample,71982,71112,3873,67239,14363,52876,31380,2590,11983,1715,43363,5208,2423,944,9834,9713
CGTATGAATTAGGCGG,sample,88873,87796,6061,81735,18658,63077,34670,3029,14741,1309,49411,9328,2846,970,10142,13094
TCAATATATTAGGCGG,sample,108040,107149,6716,100433,13594,86839,44450,3104,24593,2595,69043,12097,4420,1103,11535,9526
TTATTCGATTAGGCGG,sample,6266,6177,658,5519,481,5038,2145,156,1660,167,3805,910,1163,476,340,270
GACCGGAATTAGGCGG,sample,153,151,27,124,14,110,47,7,35,1,82,20,45,24,5,14
ACGTAAGTTCAGATAC,sample,50620,50203,4157,46046,10678,35368,14499,907,11415,1142,25914,7405,3789,760,5429,6882
TTCTAATGTCAGATAC,sample,9754,9668,1344,8324,1230,7094,2323,170,2615,305,4938,1681,1513,409,694,797
TTAGAAGTTCAGATAC,sample,60367,59813,7661,52152,6912,45240,13576,1095,17200,1902,30776,11467,5601,1109,3509,4238
CATAACCTTCAGATAC,sample,41397,40785,8213,32572,3381,29191,5462,316,12125,1250,17587,10038,4879,656,1517,1935
ACTATACTTCAGATAC,sample,12780,12624,2409,10215,1314,8901,2520,156,3358,362,5878,2505,1952,504,574,802
GTTAGCCGTCAGATAC,sample,42858,42525,4102,38423,7645,30778,15243,1115,8770,1067,24013,4583,3172,1145,3052,5204
GGACGTAGTCAGATAC,sample,44409,43860,5982,37878,5072,32806,12104,816,11181,1337,23285,7368,4231,940,3185,3346
ACGACTTCTCAGATAC,sample,13507,13337,1828,11509,1381,10128,3600,195,3511,384,7111,2438,2037,536,979,842
AATCCGTCTCAGATAC,sample,13818,13618,2247,11371,1120,10251,2922,222,3948,382,6870,2777,2245,484,697,673
AGTCCGCATCAGATAC,sample,32597,32197,2308,29889,3839,26050,13643,1016,6777,761,20420,3853,1984,678,2245,2826
CTAGGACCTCAGATAC,sample,28031,27566,3988,23578,2991,20587,5809,404,7742,740,13551,5892,2870,512,993,1719
GTTAGGACTCAGATAC,sample,31267,30934,2086,28848,5479,23369,13597,1487,5606,671,19203,2008,1522,626,3801,4133
AACTCGTATCAGATAC,sample,42318,41829,4168,37661,3132,34529,13217,940,12568,1567,25785,6237,3421,927,1160,2137
CGTATGAATCAGATAC,sample,12896,12693,1592,11101,1105,9996,3832,340,3367,429,7199,2028,1619,509,821,750
TGCTTCGCTCAGATAC,sample,38079,37623,5177,32446,4033,28413,8794,262,10437,999,19231,7921,3755,574,2750,2488
GTCTTAGCTCAGATAC,sample,27395,26908,4240,22668,2549,20119,5856,445,7890,862,13746,5066,3061,688,1108,1531
TTGGTTAATCAGATAC,sample,33045,32715,1792,30923,5815,25108,17280,742,4490,320,21770,2276,1475,747,3878,4225
TCGCCTGATCAGATAC,sample,26997,26675,1793,24882,4970,19912,12930,744,4014,538,16944,1686,1428,585,4056,3544
GACCGGAATCAGATAC,sample,143,137,21,116,23,93,41,3,30,3,71,16,42,18,2,13
TCCAACTTTCGCTAGG,Neg_Ctrl,870,509,268,241,53,188,96,5,63,5,159,19,71,31,25,17
ACGTAAGTTCGCTAGG,sample,46731,46412,3330,43082,10205,32877,19865,1686,6953,630,26818,3743,2947,1354,4115,6700
CCTCTAGATCGCTAGG,sample,29723,29390,2543,26847,5108,21739,10308,704,6341,850,16649,3536,2388,820,3352,3473
AGTACCATTCGCTAGG,Neg_Ctrl,889,583,355,228,34,194,99,2,57,6,156,30,64,34,27,12
TAGTACGGTCGCTAGG,sample,78975,78330,6510,71820,10114,61706,26845,2202,19164,2186,46009,11309,4903,974,6276,7139
AATGGTAATCGCTAGG,sample,18086,17894,1134,16760,4007,12753,7567,554,2632,268,10199,1732,1533,699,2379,2692
TTAGAAGTTCGCTAGG,sample,40385,40045,2644,37401,8016,29385,17584,1386,6521,805,24105,3089,2500,1199,3801,5359
TCGCATCTTCGCTAGG,sample,31611,31214,2919,28295,5275,23020,11238,733,6014,516,17252,4519,2401,713,3991,3623
CATAACCTTCGCTAGG,sample,32501,32059,3854,28205,2965,25240,7731,601,9417,1065,17148,6426,3453,619,1608,1940
ACTATACTTCGCTAGG,sample,39086,38625,5529,33096,3041,30055,7662,412,11583,1280,19245,9118,4480,652,1652,1866
GACGGAGATCGCTAGG,sample,31934,31593,1725,29868,4537,25331,16397,1496,5348,576,21745,1514,1307,633,3614,3376
CCAGAGCGTCGCTAGG,sample,82463,81371,11759,69612,6356,63256,15165,916,24214,2557,39379,20404,7874,1135,2780,3839
GGACGTAGTCGCTAGG,sample,25983,25596,2292,23304,3219,20085,8977,612,6145,598,15122,3753,2356,603,2156,2211
CGAGGCAGTCGCTAGG,sample,26444,26068,4052,22016,3375,18641,6364,534,6500,657,12864,4586,3242,988,1619,2123
ACGACTTCTCGCTAGG,sample,15192,14964,1375,13589,2469,11120,5536,403,3199,319,8735,1663,1623,701,1799,1754
CGTACGTCTCGCTAGG,sample,13335,13087,1556,11531,2098,9433,4010,301,2932,424,6942,1766,1596,497,1251,1398
GTCCTGCCTCGCTAGG,sample,37944,37454,4847,32607,4897,27710,9863,819,9546,1013,19409,6469,3676,873,2299,3183
TTGGTACCTCGCTAGG,sample,61217,60539,7721,52818,2914,49904,13717,894,22824,2393,36541,10076,4952,1283,1473,1542
CGGATTACTCGCTAGG,sample,39404,38898,4097,34801,4014,30787,14090,892,9293,1101,23383,5411,3334,1067,2878,2669
GTTAGGACTCGCTAGG,sample,21680,21435,1900,19535,3770,15765,7340,612,4461,568,11801,2784,2064,695,2272,2604
GCCTGAACTCGCTAGG,sample,23830,23451,1988,21463,2221,19242,8110,712,6500,633,14610,3287,2249,754,1276,1560
ACGTATTATCGCTAGG,sample,29010,28539,1720,26819,5383,21436,13745,1019,4144,403,17889,2125,1873,949,3376,3858
TTGGCCTCTCGCTAGG,sample,23341,23016,2624,20392,2365,18027,8331,568,5194,640,13525,3294,2419,707,2617,1703
ACCAATGCTCGCTAGG,sample,30593,30162,3891,26271,5187,21084,9643,565,6363,655,16006,3858,2080,663,2267,3493
TGCTTCGCTCGCTAGG,sample,10567,10428,651,9777,1855,7922,4505,483,1898,228,6403,808,1193,694,1147,1325
GAAGGCGCTCGCTAGG,sample,23726,23399,2107,21292,3231,18061,9340,645,4735,505,14075,2836,1799,650,2485,2367
AAGAGCGCTCGCTAGG,sample,14941,14696,1488,13208,1493,11715,4434,295,4286,448,8720,2252,1662,563,776,934
TTGGTTAATCGCTAGG,sample,18990,18660,1929,16731,3278,13453,6086,323,4220,359,10306,2465,1927,623,1949,2168
GTACCGTATCGCTAGG,Pos_Ctrl,18587,18213,1672,16541,746,15795,13218,1169,963,132,14181,313,3249,2925,815,366
GGCATATATCGCTAGG,sample,23889,23502,2822,20680,3217,17463,7588,484,5094,628,12682,3669,2154,639,1625,2216
TCAATATATCGCTAGG,sample,35564,34978,5257,29721,3124,26597,6625,281,10465,980,17090,8246,3938,609,1293,1907
TTATTCGATCGCTAGG,sample,26319,25950,2402,23548,2660,20888,10065,595,6260,658,16325,3310,2504,931,2155,1760
GACCGGAATCGCTAGG,sample,3413,3294,395,2899,429,2470,754,53,900,94,1654,669,655,221,177,258
TATCAGTTCCGTTGCG,sample,191764,189941,21817,168124,26306,141818,51120,3257,49371,5490,100491,32580,9274,1929,15394,17188
GGTTGCGTCCGTTGCG,sample,93626,92549,8559,83990,17139,66851,31395,2627,19596,2157,50991,11076,4815,1337,7413,11110
TTCGTAATCCGTTGCG,sample,96352,95632,5686,89946,26164,63782,39216,2456,13944,1430,53160,6736,2897,1084,13843,16423
TTCTAATGCCGTTGCG,sample,89837,89047,8338,80709,11750,68959,25432,2022,26582,2797,52014,12126,5244,1498,4771,8102
TAGTACGGCCGTTGCG,sample,91596,90825,6117,84708,19974,64734,34417,2241,17153,1657,51570,9266,3474,1271,11085,14157
AATGGTAACCGTTGCG,sample,94342,93584,8421,85163,21147,64016,34781,1806,15121,1709,49902,10599,3445,959,13159,13680
TTCCGTCTCCGTTGCG,sample,89429,88581,10455,78126,13001,65125,22701,1236,22067,2550,44768,16571,6754,1378,7220,8629
GGACCTCTCCGTTGCG,sample,69715,69068,6365,62703,11198,51505,22411,1420,16579,1716,38990,9379,4821,1471,7195,7736
TCGCATCTCCGTTGCG,sample,101073,100286,8365,91921,23264,68657,33881,2232,18046,1995,51927,12503,4987,1250,10593,15104
CAAGGCCTCCGTTGCG,sample,82612,81692,11264,70428,12174,58254,18741,1383,21548,2317,40289,14265,5172,1093,5021,7672
GGACGTAGCCGTTGCG,sample,48847,48331,4350,43981,10868,33113,17780,1284,8627,921,26407,4501,3311,1280,4953,7162
CTTGATAGCCGTTGCG,sample,41995,41625,2417,39208,14340,24868,17035,930,4545,661,21580,1697,1453,894,7249,8457
ACCTCGAGCCGTTGCG,sample,36145,35769,2898,32871,8710,24161,13632,1024,5723,783,19355,2999,2024,973,4429,5803
TGGACGAGCCGTTGCG,sample,24955,24658,4541,20117,3251,16866,4569,273,6698,583,11267,4743,3238,709,1350,1963
GACGATAACCGTTGCG,sample,33528,33131,5224,27907,4762,23145,7408,537,8770,856,16178,5574,3708,1014,1941,2981
CGAGGCAGCCGTTGCG,sample,60648,60068,3731,56337,14798,41539,23415,1456,11144,1039,34559,4485,2587,1137,7208,10048
CCATGAAGCCGTTGCG,sample,49578,49082,5463,43619,5435,38184,12936,949,14435,1522,27371,8342,4510,1175,2752,3367
ACGACTTCCCGTTGCG,sample,74235,73725,4202,69523,18047,51476,35951,2354,8491,882,44442,3798,2682,1381,11497,11685
CGTACGTCCCGTTGCG,sample,98147,97326,7915,89411,14927,74484,34434,2496,21251,2809,55685,13494,5638,1280,9810,9995
AGTCCGCACCGTTGCG,sample,138473,137552,9716,127836,21302,106534,57311,5093,24469,3086,81780,16575,6799,1614,17498,15319
GTCCTGCCCCGTTGCG,sample,70798,70332,2976,67356,16217,51139,28797,1885,14188,1626,42985,4643,2732,1059,7745,11168
CGGATTACCCGTTGCG,sample,82957,81890,9029,72861,11334,61527,28927,1642,17509,2179,46436,11270,4565,1217,7252,7414
GTTAGGACCCGTTGCG,sample,85851,84923,9329,75594,9451,66143,26776,2134,21356,2595,48132,13282,5993,1709,5597,6482
TTGGCCTCCCGTTGCG,sample,75775,74969,4831,70138,9418,60720,37895,2536,12364,1287,50259,6638,3812,1435,7568,6861
ACCAATGCCCGTTGCG,sample,101146,99291,13937,85354,11960,73394,29297,1611,23239,2289,52536,16958,6322,1239,6606,8051
CCAATTCCCCGTTGCG,sample,49952,49045,6172,42873,6343,36530,14256,650,12377,1408,26633,7839,4298,874,3880,4442
TCAATATACCGTTGCG,sample,84980,84197,5861,78336,13056,65280,34417,2467,16390,1930,50807,10076,4302,1421,8815,8734
TATCAGTTAGGCCAAG,sample,44333,44064,3093,40971,14663,26308,8871,575,9108,1044,17979,6710,3519,664,2989,8066
GGTTGCGTAGGCCAAG,sample,206899,205432,13490,191942,44546,147396,72463,4029,42613,4263,115076,24028,7706,1813,22636,30481
TCCTCCGTAGGCCAAG,sample,86792,86169,9511,76658,11663,64995,21918,1559,23344,2715,45262,15459,6448,1393,6554,7292
ATGCCTGGAGGCCAAG,sample,97543,96910,3442,93468,33528,59940,45931,2557,8228,690,54159,2534,1089,909,13551,19989
TAGTACGGAGGCCAAG,sample,16099,15961,2363,13598,2337,11261,3859,248,4091,427,7950,2636,2179,550,1234,1403
TGAGCGCGAGGCCAAG,sample,79047,78361,10930,67431,11210,56221,19462,1340,19521,2084,38983,13814,6797,1733,4171,7022
GCCTTGCTAGGCCAAG,sample,161204,159409,25952,133457,14945,118512,20544,1525,49936,5414,70480,41093,10705,1583,5272,8651
GTTAGCCGAGGCCAAG,sample,73210,72673,3760,68913,14114,54799,36710,2769,10125,895,46835,4300,3983,2389,5089,9918
CCGCAACGAGGCCAAG,sample,7048,6895,1313,5582,650,4932,985,56,2155,224,3140,1512,1262,249,251,382
CGAGGCAGAGGCCAAG,sample,45074,44599,3152,41447,8776,32671,17618,1230,8688,1264,26306,3871,2967,1229,5707,6151
CCATGAAGAGGCCAAG,sample,55321,54778,3928,50850,7426,43424,21822,1359,13143,1792,34965,5308,3340,1430,4579,5558
AATCCGTCAGGCCAAG,sample,66408,65587,7653,57934,8571,49363,15663,1147,17696,1947,33359,12910,5540,1091,5495,5656
GTCCTGCCAGGCCAAG,sample,77099,76154,7795,68359,7967,60392,24186,1865,20476,2884,44662,10981,4828,1231,5027,5030
TGCTTCGCAGGCCAAG,sample,55813,55106,4024,51082,7077,44005,23223,1710,12039,1558,35262,5475,2742,856,5167,4985
TTGGTTAAAGGCCAAG,sample,177089,174462,29515,144947,13188,131759,31153,1869,51040,5245,82193,42452,11685,1809,7130,7707
GGCATATAAGGCCAAG,Neg_Ctrl,1284,730,512,218,42,176,77,3,51,0,128,45,66,33,24,16
TCAATATAAGGCCAAG,sample,134692,132967,19428,113539,9149,104390,17660,1918,44213,4418,61873,36181,9558,1284,2649,5146
CTTCATGAAGGCCAAG,sample,62953,62068,5382,56686,7210,49476,21277,1764,15589,1735,36866,9111,3882,967,3414,4873
TCCAACTTAGAACCGC,sample,26105,25894,4018,21876,2681,19195,4353,289,8299,814,12652,5440,3295,602,1226,1514
AGTACCATAGAACCGC,sample,158421,157497,11359,146138,26819,119319,51870,4423,39180,4443,91050,19403,6875,1876,13161,19293
TTCTAATGAGAACCGC,sample,112634,112012,7821,104191,22629,81562,37734,2768,27015,2852,64749,11193,5536,1677,9865,14648
TAGTACGGAGAACCGC,sample,19641,19498,1062,18436,4040,14396,7215,592,4254,569,11469,1766,1899,899,1731,2693
GGACCTCTAGAACCGC,sample,41403,41044,3633,37411,10749,26662,13668,803,7483,847,21151,3861,3160,1346,2195,6590
CAAGGCCTAGAACCGC,sample,118706,117326,14189,103137,14527,88610,31793,2221,30758,3766,62551,20072,6848,1282,8070,10030
CATAACCTAGAACCGC,sample,205991,203766,29775,173991,23871,150120,43114,1799,55154,5543,98268,44510,11880,1992,12345,15312
ACTATACTAGAACCGC,sample,92597,91944,5403,86541,17115,69426,39241,3316,17176,2407,56417,7286,3913,1617,11009,12274
GACGGAGAAGAACCGC,sample,170333,168839,21438,147401,16157,131244,33269,2116,48504,5422,81773,41933,10159,1869,9941,9856
GACGATAAAGAACCGC,sample,61272,60639,4141,56498,10177,46321,25889,2008,11366,1336,37255,5722,3320,1304,7352,7110
ACGACTTCAGAACCGC,sample,68611,67995,4218,63777,7323,56454,26767,1758,19373,2654,46140,5902,3411,1529,4483,4956
AGTCCGCAAGAACCGC,sample,116376,115127,12014,103113,17206,85907,40815,2669,24477,2429,65292,15517,5983,1606,7351,10781
TTGGTACCAGAACCGC,sample,96148,95231,7161,88070,19164,68906,39909,2660,14378,1380,54287,10579,3715,1051,9771,13436
CTAGGACCAGAACCGC,sample,101457,100627,4429,96198,14243,81955,52589,5140,16726,1805,69315,5695,3505,2172,6647,10211
GCCTGAACAGAACCGC,sample,81651,80839,6476,74363,15459,58904,34647,1914,14805,1660,49452,5878,2769,1067,9613,10879
AACTCGTAAGAACCGC,sample,146605,145046,13255,131791,13809,117982,51222,3081,37768,4016,88990,21895,6197,1555,13834,9273
ACCAATGCAGAACCGC,sample,82572,81375,8516,72859,10033,62826,26563,1444,20314,1863,46877,12642,4644,986,5223,7042
GTCTTAGCAGAACCGC,sample,92796,91690,10450,81240,12530,68710,24580,2137,23467,2295,48047,16231,6095,1038,5964,8554
GGCATATAAGAACCGC,sample,54211,53471,3610,49861,6989,42872,20746,1936,12221,1220,32967,6749,3477,1050,2398,4647
TCAATATAAGAACCGC,sample,84384,83490,7520,75970,11974,63996,30763,2265,18449,2010,49212,10509,4901,1630,4948,8364
ATTCTCTTCATCAAGC,sample,158783,157726,8532,149194,35881,113313,63029,4843,30203,2919,93232,12319,4138,1535,18084,24056
TCCAACTTCATCAAGC,sample,112135,111051,13496,97555,13347,84208,25130,1319,31601,3411,56731,22747,7821,1374,7758,8353
ATGCCTGGCATCAAGC,sample,71706,71163,2691,68472,22028,46444,35415,1849,6597,683,42012,1900,1279,978,12032,14183
TAGTACGGCATCAAGC,sample,68281,67790,4403,63387,12705,50682,27272,2119,13421,1634,40693,6236,3561,1176,10434,8767
CAACCGCGCATCAAGC,sample,71874,71193,6803,64390,12783,51607,23827,1726,15030,1705,38857,9319,4335,1128,7470,8267
AATGGTAACATCAAGC,sample,69369,68803,7676,61127,8696,52431,18466,1315,19204,2256,37670,11190,4819,1158,5688,5804
TTCCGTCTCATCAAGC,sample,76673,75938,6479,69459,15774,53685,28365,1912,13822,1654,42187,7932,3472,921,9876,11123
GGACCTCTCATCAAGC,sample,90705,89947,5972,83975,21137,62838,36836,2751,14352,2093,51188,6806,3814,1358,11503,14038
GACGGAGACATCAAGC,sample,77055,76107,6615,69492,11801,57691,25051,1807,17636,2039,42687,11158,4214,1073,7244,8538
GGACGTAGCATCAAGC,sample,15729,15519,2210,13309,2467,10842,4665,230,3400,376,8065,2171,1715,562,1728,1564
ACCTCGAGCATCAAGC,sample,16468,16247,2191,14056,2859,11197,5059,300,3508,340,8567,1990,1849,585,1883,1834
GGCCAGAGCATCAAGC,sample,77500,76616,9432,67184,8931,58253,22619,1662,19686,1944,42305,12342,5233,1012,7682,6035
CGAGGCAGCATCAAGC,sample,82605,81775,7721,74054,12747,61307,29789,2310,16759,2146,46548,10303,5051,1532,6755,8656
CGTACGTCCATCAAGC,sample,65727,65020,4720,60300,12590,47710,26716,1795,13048,1386,39764,4765,2882,1007,8845,8358
CGGATTACCATCAAGC,sample,53823,52990,8731,44259,4597,39662,10518,686,14972,1474,25490,12012,5024,803,2619,2585
ACGTATTACATCAAGC,sample,61399,60690,4664,56026,10710,45316,26392,1405,10586,1007,36978,5926,2178,780,7382,7776
TTGGCCTCCATCAAGC,Pos_Ctrl,34952,34414,2759,31655,1519,30136,25150,2543,1610,252,26760,581,4453,4637,1713,729
ACCAATGCCATCAAGC,sample,38451,37993,1802,36191,5028,31163,18322,1309,7653,1076,25975,2803,1966,945,2666,3839
TTATTCGACATCAAGC,sample,59876,59136,6072,53064,8465,44599,19901,2166,12753,1063,32654,8716,3811,905,5525,6217
ATGACCGACATCAAGC,sample,107803,106260,16775,89485,10031,79454,19762,1065,30532,3209,50294,24886,8383,1206,3717,6110
TATCAGTTAGAGAGCC,sample,50322,49772,6767,43005,8034,34971,11436,937,12799,1548,24235,8251,4167,817,3590,5049
AAGTTCGTAGAGAGCC,sample,84092,83288,5474,77814,15595,62219,32490,1859,16973,1619,49463,9278,4160,1255,8802,10602
TCCTCCGTAGAGAGCC,sample,78332,77775,4054,73721,17616,56105,34545,2632,12410,1115,46955,5403,2872,1210,10132,11860
TTCTAATGAGAGAGCC,sample,47980,47539,3795,43744,10517,33227,17337,1137,8354,1121,25691,5278,3588,1288,4401,6771
TGAGCGCGAGAGAGCC,sample,51302,50788,4571,46217,8676,37541,17266,799,11684,1296,28950,6496,3587,913,6162,5867
AATGGTAAAGAGAGCC,sample,21678,21452,2917,18535,2999,15536,6106,366,5280,662,11386,3122,2404,711,2261,1945
GCCTTGCTAGAGAGCC,sample,47143,46666,3656,43010,8794,34216,17025,1114,9531,1150,26556,5396,3198,1028,5232,5779
CATAACCTAGAGAGCC,sample,71876,71245,6043,65202,14348,50854,24410,1560,15259,2111,39669,7514,3843,1042,7933,9631
GTTAGCCGAGAGAGCC,sample,65448,64961,6186,58775,12146,46629,23306,1125,12167,1346,35473,8685,4207,1067,8391,8090
ACCTCGAGAGAGAGCC,sample,43035,42618,4046,38572,7306,31266,14286,1036,9641,1087,23927,5216,3252,893,4578,4965
TGGACGAGAGAGAGCC,sample,68907,68266,6168,62098,11753,50345,22064,1336,15533,1863,37597,9549,4260,1041,5695,7858
CATGATTCAGAGAGCC,sample,26035,25759,2037,23722,4832,18890,8681,631,5574,579,14255,3425,2097,558,2897,3126
CGTACGTCAGAGAGCC,sample,77558,76907,4217,72690,16910,55780,35317,1936,11980,1713,47297,4834,2605,1074,9267,11083
GTCCTGCCAGAGAGCC,sample,54624,54195,3035,51160,12307,38853,25833,2022,7058,719,32891,3221,2812,1442,5052,8236
TTGGTACCAGAGAGCC,sample,76372,75880,4604,71276,9823,61453,38460,2594,11711,1292,50171,7396,3964,1553,8003,6895
CTAGGACCAGAGAGCC,sample,74512,73772,5987,67785,11635,56150,26933,2064,17072,1683,44005,8398,4240,1202,5734,8304
TTGGCCTCAGAGAGCC,sample,54869,54247,5857,48390,7177,41213,19747,1324,11089,1123,30836,7930,4356,1487,4792,4735
TGCTTCGCAGAGAGCC,sample,47255,46736,6574,40162,4978,35184,13053,699,11362,1234,24415,8836,4581,1191,2446,2920
AAGAGCGCAGAGAGCC,sample,70626,69607,9054,60553,7568,52985,17681,1370,19243,1938,36924,12753,5569,1105,4142,5028
TCGCCTGAAGAGAGCC,sample,29536,29063,2920,26143,4061,22082,9736,1004,6540,595,16276,4207,2524,728,2419,2678
CTTCATGAAGAGAGCC,sample,63764,62877,7422,55455,7621,47834,19572,1697,14483,1325,34055,10757,4315,953,5024,5496
GGAGAGTTAGCATTGA,sample,122659,121768,8083,113685,25487,88198,45080,2890,24886,2441,69966,12901,4616,1342,12952,16316
TATCAGTTAGCATTGA,sample,103372,102657,4782,97875,27583,70292,47575,3239,11930,1387,59505,6161,3065,1262,12604,18367
AAGTTCGTAGCATTGA,sample,165881,164591,8670,155921,27598,128323,65313,5610,39908,4240,105221,13252,5027,1624,19130,19248
GGTTGCGTAGCATTGA,sample,145220,144029,12368,131661,24933,106728,46067,2989,33617,4294,79684,19761,6555,1660,12341,16895
AGTACCATAGCATTGA,sample,116541,115451,8392,107059,24236,82823,41154,2844,24314,3104,65468,11407,4853,1416,12814,16763
TTCGTAATAGCATTGA,sample,180156,178762,15012,163750,29847,133903,59132,3994,45440,5536,104572,19801,6211,1683,14026,19737
ATGCCTGGAGCATTGA,sample,102165,101346,6240,95106,23469,71637,36933,1862,19132,2442,56065,11268,4083,1140,12381,15251
TAGTACGGAGCATTGA,sample,103312,102590,4916,97674,25035,72639,41662,3107,18420,2077,60082,7373,3219,1188,12871,17346
TGAGCGCGAGCATTGA,sample,18274,18061,1038,17023,9171,7852,4922,349,1571,179,6493,831,616,398,1379,4036
AATGGTAAAGCATTGA,sample,112084,111066,9106,101960,22987,78973,38893,1923,23248,2591,62141,12318,4721,1240,11999,15107
TTAGAAGTAGCATTGA,sample,126263,125291,8637,116654,23974,92680,48066,2909,25696,2465,73762,13544,5491,1509,14151,16636
CAAGGCCTAGCATTGA,sample,231895,229905,12797,217108,28279,188829,110219,7507,43334,4652,153553,23117,6212,1932,18968,18920
GACGGAGAAGCATTGA,sample,12679,12482,1980,10502,1278,9224,2757,208,3611,406,6368,2242,1970,521,821,709
GGAGGACGAGCATTGA,sample,29819,29504,1199,28305,7520,20785,14940,776,3632,521,18572,916,913,632,6114,5160
CCGCAACGAGCATTGA,sample,42054,41568,4238,37330,6372,30958,14174,1036,8903,842,23077,6003,3111,797,5243,4371
GGACGTAGAGCATTGA,sample,39388,38975,3692,35283,4342,30941,10726,745,10928,1359,21654,7183,3865,1056,2055,2855
CTTGATAGAGCATTGA,sample,21273,20951,2268,18683,3379,15304,5570,407,5428,516,10998,3383,2257,675,1378,2108
CATGATTCAGCATTGA,sample,80028,79296,3690,75606,11276,64330,35851,2835,18144,1915,53995,5585,2926,1321,7226,7700
AGTCCGCAAGCATTGA,sample,125512,124200,11231,112969,16079,96890,43929,3391,28635,3420,72564,17515,6647,1590,9615,11258
TTGGTACCAGCATTGA,sample,89699,88779,7554,81225,8914,72311,30462,2631,24522,2589,54984,12107,5556,1142,8152,6500
CGGATTACAGCATTGA,sample,96344,95300,11128,84172,9789,74383,22294,1222,27414,2732,49708,20721,7871,1423,4044,5563
GCCTGAACAGCATTGA,sample,96862,95995,7950,88045,12889,75156,36318,3799,19512,2064,55830,13463,5765,1557,5569,8710
AACTCGTAAGCATTGA,sample,118235,117441,6363,111078,11189,99889,51188,4233,27309,3286,78497,13873,4750,1607,5394,7571
AATATATCAGCATTGA,Neg_Ctrl,1581,988,580,408,58,350,142,8,142,12,284,46,117,54,51,43
ACCAATGCAGCATTGA,sample,94387,93210,8529,84681,11917,72764,31762,1827,21812,2126,53574,15237,5548,1094,8198,7873
AAGAGCGCAGCATTGA,sample,39088,38647,3431,35216,4700,30516,12988,1292,10178,1188,23166,4870,3149,853,3211,3155
TTGGTTAAAGCATTGA,sample,135740,134690,7367,127323,15899,111424,53702,3718,36603,3846,90305,13555,4777,1477,10770,11298
GTACCGTAAGCATTGA,sample,153967,152733,10596,142137,21573,120564,52594,2887,36664,3603,89258,24816,6975,1459,12606,15564
ATGACCGAAGCATTGA,sample,66431,65692,4077,61615,11195,50420,26809,3019,12069,1291,38878,7232,3650,1199,5109,8546
GACCGGAAAGCATTGA,sample,129207,127749,14805,112944,13839,99105,32340,1910,35105,3942,67445,25808,7805,1464,7592,8790
GGTTGCGTAATTACCA,sample,43223,42532,6229,36303,3134,33169,10838,886,13131,1446,23969,6868,4023,1121,1703,1890
TCCTCCGTAATTACCA,sample,78114,77470,6771,70699,13455,57244,32860,2425,13500,1581,46360,6878,4777,2309,6864,9273
CCTCTAGAAATTACCA,sample,70360,69681,3523,66158,17723,48435,32180,2035,9259,748,41439,4213,1945,837,14503,12142
ACGTTATGAATTACCA,sample,66125,65505,3394,62111,17184,44927,28931,1864,9574,991,38505,3567,1886,944,9880,11353
TTCTAATGAATTACCA,sample,59123,58497,7601,50896,7138,43758,15535,959,16004,1442,31539,9818,4633,1095,4693,4397
TGAGCGCGAATTACCA,sample,11971,11874,888,10986,2667,8319,3968,306,2452,271,6420,1322,1408,558,1080,1746
CAACCGCGAATTACCA,sample,22886,22727,1186,21541,6729,14812,7952,559,3846,321,11798,2134,1790,644,2494,4147
AATGGTAAAATTACCA,sample,30517,30244,3138,27106,4886,22220,8525,591,8088,829,16613,4187,2838,818,2649,3215
TTCCGTCTAATTACCA,sample,38487,38145,3464,34681,7439,27242,10289,644,9306,820,19595,6183,3438,893,3169,4911
TCGCATCTAATTACCA,sample,68115,67589,3356,64233,12981,51252,30858,1999,12178,1822,43036,4395,2565,991,9728,9168
CAAGGCCTAATTACCA,sample,69568,69024,6197,62827,11055,51772,25292,1922,14633,1877,39925,8048,3851,1110,6260,7372
CATAACCTAATTACCA,sample,76325,75733,5502,70231,11431,58800,31186,2353,15705,1436,46891,8120,4521,1704,6270,7479
CTTGATAGAATTACCA,sample,64175,63642,4118,59524,11327,48197,29139,2051,10389,1007,39528,5611,3020,1337,9186,8072
ACCTCGAGAATTACCA,sample,67262,66690,4347,62343,7220,55123,25628,2332,18036,2461,43664,6666,3415,1256,5028,5209
GACGATAAAATTACCA,sample,54236,53747,4153,49594,10765,38829,22246,933,9550,1167,31796,4933,2764,829,8499,7629
GGCCAGAGAATTACCA,sample,57331,56796,5626,51170,4963,46207,22148,1405,12707,1353,34855,8594,4977,1875,2539,3331
GTCCTGCCAATTACCA,sample,51749,51211,4484,46727,11763,34964,20530,1541,6834,932,27364,5127,2762,1167,4514,7583
CGGATTACAATTACCA,sample,13586,13341,2811,10530,1020,9510,2007,129,3764,432,5771,3178,2001,397,470,552
GTTAGGACAATTACCA,sample,46785,46223,2669,43554,5409,38145,19496,1844,11097,1204,30593,4504,2438,1015,3980,3478
GCCTGAACAATTACCA,sample,43520,42885,3289,39596,6053,33543,19204,1983,7160,1213,26364,3983,2713,1109,4377,4041
AACTCGTAAATTACCA,sample,45627,45094,3455,41639,5369,36270,18702,1225,9667,955,28369,5721,2737,1045,3355,3565
AAGAGCGCAATTACCA,sample,53225,52543,6557,45986,6637,39349,17131,1465,11854,1308,28985,7591,3852,977,3805,4647
GTACCGTAAATTACCA,sample,38011,37396,6601,30795,2860,27935,6223,370,11010,1170,17233,9162,4035,523,1630,1709
TCAATATAAATTACCA,sample,105246,103824,16615,87209,7132,80077,22592,1780,30025,3424,52617,22256,7168,1207,4301,4043
ATTCTCTTTAGATGAC,Pos_Ctrl,5410,5373,275,5098,356,4742,3773,518,294,23,4067,134,1311,1188,277,191
TCCAACTTTAGATGAC,sample,59219,58860,3215,55645,14801,40844,23744,2398,9310,1100,33054,4292,2764,1051,5830,9557
GGTTGCGTTAGATGAC,sample,65411,64968,4449,60519,15941,44578,21133,1340,12391,1424,33524,8290,4633,1009,6464,10137
ACGTTATGTAGATGAC,Pos_Ctrl,14678,14588,934,13654,894,12760,10781,1151,538,72,11319,218,2714,2675,972,431
ATGCCTGGTAGATGAC,sample,57372,56960,2950,54010,12624,41386,26156,1975,9062,826,35218,3367,2148,893,10217,8840
TGAGCGCGTAGATGAC,sample,57142,56748,4660,52088,9718,42370,19586,1534,12076,1325,31662,7849,4183,1051,5960,6520
CAACCGCGTAGATGAC,sample,51603,51080,4538,46542,7094,39448,14306,817,15138,1572,29444,7615,4287,956,3139,4477
AATGGTAATAGATGAC,sample,56455,55979,2782,53197,11747,41450,26533,1504,8311,1165,34844,3937,2753,1107,6030,8186
TTCCGTCTTAGATGAC,Pos_Ctrl,34403,34132,2211,31921,1704,30217,25503,2538,1469,200,26972,507,4378,4645,2032,927
CAAGGCCTTAGATGAC,sample,24655,24336,2156,22180,3785,18395,9041,622,5280,612,14321,2840,2232,859,2538,2536
ACTATACTTAGATGAC,sample,111047,109913,12868,97045,10962,86083,25046,1257,31013,3144,56059,25623,7890,1328,6880,7024
CCAGAGCGTAGATGAC,sample,8896,8726,1406,7320,1225,6095,1653,115,2471,233,4124,1623,1353,321,418,695
GTTAGCCGTAGATGAC,sample,76220,75603,3411,72192,15244,56948,38706,1823,11235,1191,49941,3993,2185,1081,12284,11190
CTTGATAGTAGATGAC,sample,39611,39114,3968,35146,6352,28794,14019,786,8418,767,22437,4804,3089,815,5177,4048
ACCTCGAGTAGATGAC,sample,53089,52585,5301,47284,7811,39473,17821,1277,11408,1543,29229,7424,4532,1475,3714,5245
CGAGGCAGTAGATGAC,sample,16219,15959,2843,13116,1081,12035,3092,238,5032,630,8124,3043,2499,640,449,611
CCATGAAGTAGATGAC,sample,45902,45405,4253,41152,5707,35445,15485,972,11031,1392,26516,6565,3698,1018,4678,4008
AGTCCGCATAGATGAC,sample,63076,62450,3814,58636,5288,53348,27483,1623,15967,1913,43450,6362,2934,1065,4264,3174
CTAGGACCTAGATGAC,sample,105386,104067,15594,88473,8680,79793,24425,1937,28108,3359,52533,21964,7978,1368,3911,5066
GTTAGGACTAGATGAC,sample,83244,82349,9668,72681,10038,62643,21351,1248,22379,2428,43730,15237,6373,1351,3272,6145
CGTATGAATAGATGAC,sample,54088,53453,1833,51620,10443,41177,31311,2189,6283,421,37594,973,999,780,7589,7663
AATATATCTAGATGAC,sample,73788,72804,10091,62713,7009,55704,18272,1607,18502,1968,36774,15355,5637,882,3134,4177
CCAATTCCTAGATGAC,sample,63240,62351,7310,55041,6820,48221,20210,1726,14400,1487,34610,10398,4283,1007,4250,4349
TCAATATATAGATGAC,sample,83562,82588,10095,72493,6134,66359,27180,2287,21917,2300,49097,12675,5413,1480,3246,3981
CTTCATGATAGATGAC,sample,42823,42243,3118,39125,6885,32240,18228,1265,7801,725,26029,4221,2537,1013,2978,5045
AGGTCGGATAGATGAC,sample,100857,99306,15208,84098,5750,78348,24101,1699,30708,3142,54809,18698,7040,1431,2423,3658
GGAGAGTTGTTCAGAA,sample,47191,46877,2691,44186,10100,34086,19390,1614,8564,986,27954,3532,2622,1102,6036,6926
ATTCTCTTGTTCAGAA,sample,119813,118813,15100,103713,17867,85846,26737,1387,31544,2976,58281,23202,8483,1452,6969,11228
GGTTGCGTGTTCAGAA,sample,54645,54176,2979,51197,16259,34938,20591,1731,8038,869,28629,3709,2804,1218,6059,10086
ACGTAAGTGTTCAGAA,sample,65423,64942,2500,62442,18257,44185,30804,2095,8667,1165,39471,1454,1440,957,10117,12075
AATGGTAAGTTCAGAA,sample,81053,80546,5226,75320,18602,56718,34094,2243,13287,1304,47381,5790,3122,1277,9813,12614
GGACCTCTGTTCAGAA,sample,16885,16675,2049,14626,2764,11862,5477,266,3447,357,8924,2315,1844,511,1990,1702
ACTATACTGTTCAGAA,sample,21375,21194,1705,19489,4371,15118,7981,486,4290,449,12271,1912,1773,740,2634,2893
CTTGATAGGTTCAGAA,sample,8687,8573,918,7655,1805,5850,2722,155,1843,177,4565,953,1533,656,672,1117
ACGACTTCGTTCAGAA,sample,57806,57273,3909,53364,7962,45402,20002,1604,15041,1896,35043,6859,3999,1364,5697,5707
ACGTATTAGTTCAGAA,sample,44482,44093,3771,40322,7792,32530,13523,960,10305,1031,23828,6711,4064,1251,3640,4876
TGCTTCGCGTTCAGAA,sample,39531,39161,975,38186,7868,30318,23547,2104,3499,316,27046,852,1005,833,5354,5733
TTGGTTAAGTTCAGAA,sample,65671,65016,2893,62123,7903,54220,30970,2247,15101,1758,46071,4144,2714,1160,6755,5573
GTACCGTAGTTCAGAA,sample,103046,102095,8277,93818,16432,77386,37614,3354,21089,2395,58703,12934,5321,1226,9241,10687
AGGTCGGAGTTCAGAA,Pos_Ctrl,59543,59028,2363,56665,2098,54567,45972,4523,2845,308,48817,919,5228,6523,2329,638
TTATTCGAGTTCAGAA,sample,73139,72754,3575,69179,12161,57018,36052,3150,10840,1205,46892,5771,3696,1390,5293,8153
ATGACCGAGTTCAGAA,sample,42322,42115,2574,39541,7152,32389,15476,1348,8471,920,23947,6174,3918,1044,3939,4709
GGAGAGTTTTCTGGTT,sample,130852,129482,11722,117760,20882,96878,42720,2528,29257,3070,71977,19303,6295,1548,13361,14270
ATTCTCTTTTCTGGTT,sample,24358,24121,2222,21899,4035,17864,8982,578,5376,601,14358,2327,2061,928,3366,2754
TCCAACTTTTCTGGTT,Neg_Ctrl,1356,712,433,279,50,229,107,12,61,16,168,33,79,33,39,23
AAGTTCGTTTCTGGTT,sample,112241,111232,5964,105268,24904,80364,50469,3660,17942,2358,68411,5935,2838,1308,13146,17438
TCCTCCGTTTCTGGTT,sample,114355,113242,10076,103166,22381,80785,36857,2497,24517,3038,61374,13876,5376,1380,10821,14807
TTCGTAATTTCTGGTT,sample,48088,47546,4371,43175,7784,35391,15280,842,12409,1700,27689,5160,3301,1005,3689,5474
ACGTTATGTTCTGGTT,sample,108965,108170,3836,104334,27170,77164,57411,2710,11726,1325,69137,3992,2005,1296,14107,18735
TTCTAATGTTCTGGTT,Neg_Ctrl,999,554,281,273,48,225,97,9,76,3,173,40,74,35,23,18
TTAGAAGTTTCTGGTT,sample,66035,65521,2541,62980,16851,46129,32841,1444,8020,1120,40861,2704,1501,935,11690,11767
GGACCTCTTTCTGGTT,Neg_Ctrl,1021,525,307,218,50,168,73,1,54,2,127,38,59,25,12,8
ACTATACTTTCTGGTT,sample,21121,20877,4247,16630,1923,14707,3868,243,5705,641,9573,4250,2769,604,1292,1041
CCAGAGCGTTCTGGTT,sample,58849,58117,7820,50297,6503,43794,14695,1192,15188,1819,29883,10900,5099,975,3761,4335
GTTAGCCGTTCTGGTT,sample,53810,53251,4319,48932,7111,41821,23837,1568,9302,1291,33139,5823,3472,1213,5595,5001
CCGCAACGTTCTGGTT,sample,7601,7431,811,6620,948,5672,2187,133,2086,246,4273,1020,1282,460,549,626
GGCCAGAGTTCTGGTT,sample,888,868,76,792,140,652,321,23,192,15,513,101,228,117,90,94
CATTGCAGTTCTGGTT,sample,39408,39096,1875,37221,9657,27564,16217,1222,6573,870,22790,2682,2002,974,4282,6747
ACGACTTCTTCTGGTT,sample,24626,24415,3452,20963,3117,17846,5670,348,6937,773,12607,4118,2997,774,1599,1914
GTCCTGCCTTCTGGTT,sample,61462,60824,5454,55370,7945,47425,20182,887,14857,1774,35039,9725,4143,956,4167,5543
GTTAGGACTTCTGGTT,sample,104602,103692,10939,92753,12682,80071,28458,2417,27776,2576,56234,18844,6503,1351,5162,8767
GCCTGAACTTCTGGTT,sample,62196,61624,3838,57786,9331,48455,27561,1528,12789,1632,40350,4945,2845,1043,6238,6754
ACCAATGCTTCTGGTT,sample,61729,61116,3219,57897,10768,47129,30507,2930,8526,800,39033,4366,2327,1182,6376,7422
TGCTTCGCTTCTGGTT,sample,94744,93731,14157,79574,7918,71656,18492,1251,27435,2770,45927,21708,8586,1349,3767,4671
GTCTTAGCTTCTGGTT,sample,42760,42144,3828,38316,6156,32160,16159,858,9316,766,25475,5061,2442,730,4377,4306
TTGGTTAATTCTGGTT,sample,99233,98202,10573,87629,8256,79373,29894,1720,29197,3145,59091,15417,6000,1301,6503,5389
CTTCATGATTCTGGTT,sample,112552,110861,18336,92525,7872,84653,21358,1880,31237,3376,52595,26802,8550,1429,3063,4139
ATGACCGATTCTGGTT,sample,27413,26992,2707,24285,4198,20087,10252,655,5240,681,15492,3259,2038,628,2389,2880
TCCAACTTGTTCGGTT,sample,63816,63191,3953,59238,15354,43884,17584,1718,15883,1878,33467,6821,3543,957,3966,9654
TGAGCGCGGTTCGGTT,sample,73470,72988,4699,68289,15018,53271,26170,1910,16113,1480,42283,7598,4145,1141,8723,10206
CAACCGCGGTTCGGTT,sample,50927,50533,2970,47563,12754,34809,18862,1274,8873,1188,27735,4612,3154,962,6049,8496
CAAGGCCTGTTCGGTT,sample,136209,135282,5402,129880,27605,102275,64973,3636,24934,2401,89907,6331,2573,1286,18430,20066
GACGGAGAGTTCGGTT,sample,108526,107655,5105,102550,21535,81015,46552,2908,21929,2318,68481,7308,2877,1301,14664,15295
GGACGTAGGTTCGGTT,sample,47936,47489,3625,43864,10994,32870,18593,974,8327,1084,26920,3892,2518,983,6811,7310
ACCTCGAGGTTCGGTT,sample,19161,18829,3211,15618,2396,13222,4036,306,4874,559,8910,3447,2643,625,1381,1446
GGCCAGAGGTTCGGTT,sample,59720,59127,4396,54731,12068,42663,20475,1254,12672,1600,33147,6662,3758,1314,6104,7824
CATTGCAGGTTCGGTT,sample,41635,41218,2775,38443,8599,29844,18370,1487,6432,838,24802,2717,2509,1276,4952,5631
CCATGAAGGTTCGGTT,sample,41360,41014,2590,38424,11019,27405,16250,1290,6553,733,22803,2579,3002,1652,4860,7108
ACGACTTCGTTCGGTT,sample,26591,26288,2853,23435,5872,17563,8012,555,5250,599,13262,3147,2677,850,3570,3644
AATCCGTCGTTCGGTT,sample,56582,56084,3538,52546,10932,41614,25759,1654,8485,928,34244,4788,3371,1877,5279,7756
CGTACGTCGTTCGGTT,sample,110981,109583,15858,93725,9586,84139,22854,1264,32907,3685,55761,23429,8474,1506,4605,6217
CGGATTACGTTCGGTT,sample,88283,87352,8130,79222,11403,67819,31100,1779,19864,2499,50964,12577,4919,1211,6858,7724
GCCTGAACGTTCGGTT,sample,74272,73517,5890,67627,9662,57965,28194,2349,16810,1762,45004,8850,4725,1407,7781,6781
TTGGCCTCGTTCGGTT,sample,88868,87931,9421,78510,9879,68631,30250,2166,20610,2019,50860,13586,5048,1119,6928,7199
ACCAATGCGTTCGGTT,sample,87415,86380,9828,76552,9593,66959,28308,2061,21241,1977,49549,13372,5859,1340,5850,5939
TGCTTCGCGTTCGGTT,sample,69337,68544,7143,61401,7012,54389,22182,1216,19306,2156,41488,9529,4771,1181,3878,4829
GAAGGCGCGTTCGGTT,sample,50577,49777,5135,44642,6106,38536,14918,854,13244,1222,28162,8298,3932,887,2755,4096
GTACCGTAGTTCGGTT,sample,61679,61044,3291,57753,10205,47548,29984,2718,10273,881,40257,3692,2541,1289,5641,7412
TCAATATAGTTCGGTT,sample,144242,142630,12012,130618,16007,114611,47212,2452,36881,3633,84093,24433,6575,1283,11556,10773
CTTCATGAGTTCGGTT,sample,114012,112938,4885,108053,17119,90934,57743,5552,17243,1767,74986,8629,2725,980,10265,12712
TTATTCGAGTTCGGTT,Neg_Ctrl,560,415,194,221,28,193,93,4,56,0,149,40,85,41,19,11
GGAGAGTTTGGCGGTT,sample,186547,185196,10164,175032,26849,148183,74775,5567,44906,5050,119681,17885,5783,1828,19760,19737
ATTCTCTTTGGCGGTT,sample,279545,277572,19236,258336,41521,216815,99372,7434,69614,7630,168986,32765,8553,2407,19602,28727
GGTTGCGTTGGCGGTT,sample,98356,97288,4188,93100,26328,66772,48188,3242,10977,1339,59165,3026,1689,964,18971,17260
TCCTCCGTTGGCGGTT,sample,168177,166662,11351,155311,30287,125024,58788,3618,35453,4715,94241,22450,7115,1634,22984,21004
ACGTTATGTGGCGGTT,sample,227589,226186,15428,210758,44858,165900,75101,4334,52305,6425,127406,27735,8487,1827,24229,31023
TTCTAATGTGGCGGTT,sample,205439,203901,11123,192778,30730,162048,80552,5104,49980,5592,130532,20820,6919,1902,16388,23399
ATGCCTGGTGGCGGTT,sample,191280,189563,22019,167544,31211,136333,54337,3035,41922,4477,96259,32562,10516,1950,17544,20749
TTAGAAGTTGGCGGTT,sample,154335,153185,10755,142430,16286,126144,52863,3058,46354,5052,99217,18817,6061,2036,8448,11024
TCGCATCTTGGCGGTT,sample,117794,116977,6381,110596,23927,86669,49825,3937,21185,2717,71010,9005,4272,1405,14217,16536
GTTAGCCGTGGCGGTT,sample,168436,167206,10197,157009,24399,132610,70328,4859,34842,3660,105170,18921,6365,1868,16222,18194
CTTGATAGTGGCGGTT,sample,72939,72352,3350,69002,22228,46774,30366,2458,9590,996,39956,3364,2547,1400,9262,13887
ACCTCGAGTGGCGGTT,sample,61474,60848,4523,56325,13569,42756,20939,1244,11625,1638,32564,7310,3147,960,7560,8786
TGGACGAGTGGCGGTT,sample,30962,30658,2121,28537,7131,21406,10859,648,5549,597,16408,3753,2585,1068,3232,4767
GGCCAGAGTGGCGGTT,sample,23326,22929,2903,20026,3639,16387,6873,381,5268,498,12141,3367,2498,816,2195,2394
CATTGCAGTGGCGGTT,sample,81342,80535,4891,75644,19015,56629,36941,2451,10806,1154,47747,5277,2479,1127,15199,13194
ACGACTTCTGGCGGTT,sample,71171,70348,5352,64996,11331,53665,27646,2082,13617,1635,41263,8685,4439,1818,5159,7368
CATGATTCTGGCGGTT,sample,99472,98158,10206,87952,10164,77788,33419,1944,25052,2396,58471,14977,6342,1889,7032,6230
CTAGGACCTGGCGGTT,sample,73893,72970,6913,66057,11300,54757,24793,2143,17175,2218,41968,8428,3950,1117,6613,7430
CGTATGAATGGCGGTT,sample,107566,106196,13471,92725,11495,81230,25168,2377,28188,2858,53356,22639,7352,1335,6967,6937
AAGAGCGCTGGCGGTT,sample,132454,130742,12363,118379,18522,99857,45970,4331,30287,4343,76257,14926,6871,1766,10416,11932
GGCATATATGGCGGTT,sample,62387,61686,2147,59539,12924,46615,31500,2271,9028,1163,40528,2653,2459,1582,5994,8744
TCGCCTGATGGCGGTT,sample,54747,53826,5502,48324,6819,41505,18815,1733,11821,1167,30636,7969,3812,888,5003,4768
ATGACCGATGGCGGTT,sample,118308,117088,8597,108491,14596,93895,45366,3552,27107,3286,72473,14584,6129,1696,8276,10290
GGTTGCGTTCCTTATT,sample,32915,32614,2162,30452,8021,22431,13524,845,5271,510,18795,2281,2016,819,4157,5311
TCCTCCGTTCCTTATT,sample,8621,8555,937,7618,1206,6412,2179,175,2300,233,4479,1525,1257,382,784,748
ACGTAAGTTCCTTATT,sample,30677,30494,1766,28728,7258,21470,10883,1036,6019,603,16902,2929,2313,947,3044,4804
AGTACCATTCCTTATT,sample,15929,15797,965,14832,4124,10708,5860,329,2845,309,8705,1365,1384,584,1909,2557
ACGTTATGTCCTTATT,sample,25051,24891,1346,23545,5812,17733,12499,991,2589,337,15088,1317,1719,1133,2715,3778
TTAGAAGTTCCTTATT,sample,23044,22842,2321,20521,4263,16258,7348,586,4639,536,11987,3149,2533,924,1917,2780
GGACCTCTTCCTTATT,sample,42322,41946,4525,37421,3041,34380,11237,945,13718,1558,24955,6922,3855,1129,1264,1863
TCGCATCTTCCTTATT,sample,42895,42524,4592,37932,5853,32079,11345,497,10806,1432,22151,7999,3908,803,3860,3766
CAAGGCCTTCCTTATT,sample,20681,20382,1494,18888,2663,16225,8418,606,4199,417,12617,2585,1447,521,1523,1929
CCAGAGCGTCCTTATT,sample,24402,24155,1817,22338,2798,19540,8867,490,6437,768,15304,2978,2150,785,1907,1811
GTTAGCCGTCCTTATT,sample,10297,10182,427,9755,2029,7726,5533,509,1094,213,6627,377,896,744,1677,1426
CCGCAACGTCCTTATT,sample,5692,5617,467,5150,1385,3765,2006,194,914,86,2920,565,963,550,503,888
GGACGTAGTCCTTATT,sample,5017,4925,454,4471,1132,3339,1984,85,788,72,2772,410,552,330,741,740
GACGATAATCCTTATT,sample,29803,29429,2556,26873,3796,23077,9911,542,7660,739,17571,4225,2649,746,3087,2577
CCATGAAGTCCTTATT,sample,64543,63986,4204,59782,5803,53979,36084,2538,8697,856,44781,5804,4036,2081,3721,3665
CATGATTCTCCTTATT,sample,59836,59123,7631,51492,5227,46265,15812,823,16061,2083,31873,11486,4928,1115,2829,3289
AATCCGTCTCCTTATT,sample,37703,37199,5610,31589,3287,28302,9277,532,9852,1030,19129,7611,3889,774,2685,2173
GCCTGAACTCCTTATT,sample,25081,24716,2404,22312,3548,18764,8184,373,5631,613,13815,3963,2355,658,2390,2403
ACGTATTATCCTTATT,sample,87364,86387,13962,72425,5746,66679,15613,1007,25356,2600,40969,22103,7791,1222,4452,3180
TTGGCCTCTCCTTATT,Pos_Ctrl,14162,13949,1258,12691,609,12082,10323,848,641,86,10964,184,2775,2494,520,262
ACCAATGCTCCTTATT,sample,17488,17195,3000,14195,1458,12737,4163,320,4430,531,8593,3293,2335,592,827,863
CCAATTCCTCCTTATT,sample,14290,14081,1275,12806,1983,10823,5691,404,2769,255,8460,1704,1740,744,1414,1429
GTACCGTATCCTTATT,sample,23132,22762,2633,20129,2360,17769,8625,457,4672,520,13297,3495,1813,600,2380,1688
GACCGGAATCCTTATT,sample,17966,17778,1521,16257,1476,14781,6390,493,4409,537,10799,2952,2340,845,1152,969
GGAGAGTTAATAAGGT,sample,202935,201598,18814,182784,33180,149604,52025,3386,50464,5329,102489,38400,11391,2160,17278,21857
TATCAGTTAATAAGGT,sample,105691,104992,7981,97011,22435,74576,38652,2413,19675,2132,58327,11704,4985,1344,13031,15220
TCCAACTTAATAAGGT,sample,956,928,66,862,207,655,326,23,186,20,512,100,221,133,106,141
TCCTCCGTAATAAGGT,sample,161841,160858,6479,154379,36817,117562,72922,6148,22275,2716,95197,13501,3576,1240,24170,25275
ACGTAAGTAATAAGGT,sample,88885,88234,7713,80521,15632,64889,30042,2286,17819,2168,47861,12574,5905,1430,9181,10401
CCTCTAGAAATAAGGT,sample,124686,123943,5296,118647,33504,85143,56415,4060,16417,2067,72832,6184,3579,1698,15771,21992
AGTACCATAATAAGGT,sample,159516,158316,11680,146636,22135,124501,52730,3493,45117,4446,97847,18715,6415,1746,12941,15674
TTCGTAATAATAAGGT,sample,70655,69987,3854,66133,14809,51324,27104,2157,13524,2414,40628,6125,3466,1318,4011,9674
ACTATACTAATAAGGT,sample,71842,71042,6761,64281,13871,50410,23401,1929,14132,1611,37533,9337,4294,1264,7511,9300
CCAGAGCGAATAAGGT,sample,24685,24268,3292,20976,2418,18558,6024,362,7342,908,13366,3922,2680,840,1159,1510
GGAGGACGAATAAGGT,sample,111483,110258,11189,99069,15102,83967,34171,1914,28350,3422,62521,16110,6192,1385,10349,10294
CCGCAACGAATAAGGT,Pos_Ctrl,27212,26684,2028,24656,1389,23267,19477,1788,1356,180,20833,466,3984,3803,1822,691
TGGACGAGAATAAGGT,sample,131699,130349,10004,120345,19201,101144,48210,2843,30792,3440,79002,15859,5475,1258,9982,13148
CATTGCAGAATAAGGT,sample,156104,154521,13407,141114,17780,123334,52040,3361,39224,4263,91264,24446,6938,1616,10972,11013
CCATGAAGAATAAGGT,sample,169106,167044,22817,144227,19486,124741,36215,2851,44894,5263,81109,35518,11068,1951,8915,12224
CATGATTCAATAAGGT,sample,73588,72795,2601,70194,14763,55431,42152,2646,8068,735,50220,1830,1317,882,13013,10847
AATCCGTCAATAAGGT,Pos_Ctrl,53677,53073,3171,49902,2304,47598,40072,3640,2715,303,42787,868,5288,6035,2802,1128
GCCTGAACAATAAGGT,sample,150845,149216,16044,133172,18675,114497,44348,3967,35334,3871,79682,26977,8180,1633,11447,11930
ACGTATTAAATAAGGT,sample,164346,162716,15483,147233,16442,130791,54838,4175,39342,4704,94180,27732,6884,1633,13626,10698
CGTATGAAAATAAGGT,sample,147833,145914,21674,124240,11990,112250,26824,1885,43501,4838,70325,35202,9868,1493,7006,7060
CCAATTCCAATAAGGT,sample,141633,139737,14950,124787,10450,114337,33915,3076,41312,4630,75227,31404,9323,1754,7169,5248
TTGGTTAAAATAAGGT,sample,196543,194136,25605,168531,12140,156391,34384,2375,68064,7307,102448,44261,11390,2131,3401,7068
TCAATATAAATAAGGT,sample,173233,171547,13323,158224,19222,139002,67594,5245,39679,4839,107273,21645,6123,1193,11090,12802
TCGCCTGAAATAAGGT,sample,151449,148850,23317,125533,12030,113503,28042,1437,45160,5050,73202,33814,10619,1624,7040,6844
TATCAGTTCAGGACCA,sample,125856,125033,4957,120076,16555,103521,51224,4086,34835,4117,86059,9259,3572,1594,9665,12391
TCCAACTTCAGGACCA,sample,144950,144004,7430,136574,16371,120203,57855,4908,39370,3919,97225,14151,4806,2089,7980,10866
ACGTAAGTCAGGACCA,sample,113629,112718,6729,105989,24585,81404,44662,2768,21705,2227,66367,10042,4315,1373,13355,16394
AGTACCATCAGGACCA,sample,47676,47323,4976,42347,6201,36146,14150,790,12913,1599,27063,6694,3774,1192,3171,4207
TTCGTAATCAGGACCA,sample,100612,100007,5239,94768,19909,74859,39349,2704,22875,2164,62224,7767,3889,1374,10743,13347
TGAGCGCGCAGGACCA,sample,58664,58236,3392,54844,15942,38902,20512,1855,9833,980,30345,5722,3071,961,7084,10060
GCCTTGCTCAGGACCA,sample,27292,26819,5291,21528,1989,19539,4219,256,8257,940,12476,5867,3532,635,1089,1238
CAAGGCCTCAGGACCA,sample,330524,328047,25527,302520,22909,279611,109134,6375,103785,12288,212919,48029,10760,2399,8856,14036
GGAGGACGCAGGACCA,sample,32482,32159,2104,30055,6121,23934,14348,916,5619,587,19967,2464,1871,880,4865,4104
TGGACGAGCAGGACCA,sample,86161,85265,4624,80641,16009,64632,42193,2586,13301,1180,55494,5372,2350,1034,12907,11691
CCATGAAGCAGGACCA,sample,173787,171645,23459,148186,20305,127881,37339,2070,47379,5031,84718,36062,10984,1917,9923,12455
ACGACTTCCAGGACCA,sample,87500,86518,5741,80777,12980,67797,35961,2199,18962,2147,54923,8528,3846,1171,7887,9139
CGTACGTCCAGGACCA,sample,99606,98329,10747,87582,11229,76353,25371,1761,27772,2469,53143,18980,6039,1175,6290,7055
AGTCCGCACAGGACCA,sample,88333,87271,9726,77545,11675,65870,22238,1461,22720,2475,44958,16976,5834,1330,4671,7061
GTCCTGCCCAGGACCA,sample,112542,111262,9488,101774,15033,86741,39066,2814,26422,3388,65488,15051,5143,1284,10843,11111
TTGGTACCCAGGACCA,sample,57551,56898,3866,53032,9643,43389,24213,1428,10899,1354,35112,5495,2707,889,5529,7016
GTTAGGACCAGGACCA,sample,116367,114676,19414,95262,8001,87261,16955,999,35340,3618,52295,30349,9119,1179,3620,4040
GCCTGAACCAGGACCA,sample,107757,106633,10969,95664,9046,86618,36538,2590,27093,2759,63631,17638,6721,1250,6966,5647
TTGGCCTCCAGGACCA,sample,83404,82546,8434,74112,12171,61941,24890,2112,20399,2098,45289,12442,6226,2019,3849,7847
AATATATCCAGGACCA,Neg_Ctrl,1409,979,644,335,54,281,131,4,81,11,212,54,111,50,24,13
TGCTTCGCCAGGACCA,sample,65952,65074,6430,58644,12480,46164,21400,1658,13596,1465,34996,8045,3548,1000,4564,8226
GAAGGCGCCAGGACCA,sample,90605,88899,8597,80302,11911,68391,39339,2399,15721,1422,55060,9510,3912,1107,9743,8699
AAGAGCGCCAGGACCA,sample,68730,67842,6622,61220,7954,53266,25925,2003,15570,1526,41495,8242,4232,1552,4089,5566
TTGGTTAACAGGACCA,sample,126117,124422,6377,118045,21037,97008,69023,3893,14825,1958,83848,7309,3464,1544,10892,15695
GGCATATACAGGACCA,sample,58228,57422,3418,54004,11072,42932,29575,2467,7402,1022,36977,2466,1655,845,7498,8268
ATGACCGACAGGACCA,sample,107846,106856,7558,99298,12857,86441,43480,3994,23220,3103,66700,12644,4921,1138,5641,8566
GACCGGAACAGGACCA,sample,2274,2083,128,1955,352,1603,806,86,480,40,1286,191,429,250,154,196
TATCAGTTCCTCGTTG,sample,96599,95940,6093,89847,12102,77745,37629,2811,25414,3168,63043,8723,4358,1681,7178,8761
TCCAACTTCCTCGTTG,sample,98931,97979,8742,89237,18220,71017,30966,1705,21851,2418,52817,14077,5499,1073,9700,12293
TTAGAAGTCCTCGTTG,sample,26428,26179,4306,21873,2741,19132,5971,298,7350,854,13321,4659,3098,701,1761,1668
GCCTTGCTCCTCGTTG,sample,91846,90987,5809,85178,22788,62390,35809,2895,14862,1981,50671,6843,2625,982,11470,15266
ACTATACTCCTCGTTG,sample,96490,95670,7140,88530,18653,69877,36267,2326,18661,2377,54928,10246,3525,1315,13276,12507
CCAGAGCGCCTCGTTG,sample,87538,86924,6972,79952,12202,67750,28462,2228,21013,2511,49475,13536,5893,1479,6901,8008
GGAGGACGCCTCGTTG,sample,67972,67334,3815,63519,13181,50338,33587,1943,9859,1031,43446,3918,2234,1065,10387,9564
GGACGTAGCCTCGTTG,Neg_Ctrl,1636,831,501,330,51,279,129,7,98,14,227,31,111,48,20,15
CTTGATAGCCTCGTTG,sample,90935,90124,5864,84260,17263,66997,41261,2510,14407,1518,55668,7301,3464,1481,9353,12066
TGGACGAGCCTCGTTG,sample,65082,64593,3194,61399,15988,45411,31599,2509,7451,672,39050,3180,3018,1852,8121,10212
GGCCAGAGCCTCGTTG,sample,87429,86357,9220,77137,11255,65882,28192,1774,20294,1994,48486,13628,5248,1496,3920,7273
CGAGGCAGCCTCGTTG,sample,107438,106401,7111,99290,22370,76920,39206,3580,19764,2215,58970,12155,3789,1295,10870,14968
CCATGAAGCCTCGTTG,sample,81797,80897,4804,76093,12585,63508,33320,2160,18552,1889,51872,7587,3399,1090,9454,9380
CATGATTCCCTCGTTG,sample,69753,68750,9335,59415,7015,52400,15516,1232,19469,2050,34985,14133,5694,927,4680,4464
CGTACGTCCCTCGTTG,Neg_Ctrl,1771,889,494,395,50,345,150,16,127,5,277,47,140,57,26,20
AGTCCGCACCTCGTTG,sample,90546,89712,5206,84506,15283,69223,46165,3263,12329,1231,58494,6235,3204,1545,10212,10757
GTCCTGCCCCTCGTTG,sample,82025,81092,5524,75568,16234,59334,34106,2526,13988,1894,48094,6820,2679,935,10520,11083
CTAGGACCCCTCGTTG,sample,89645,88836,3582,85254,18166,67088,47260,3585,10622,1252,57882,4369,2515,1410,7199,13236
GAAGGCGCCCTCGTTG,sample,78206,77204,8679,68525,6995,61530,22482,1497,22037,2420,44519,13094,5405,1225,4186,4362
TTGGTTAACCTCGTTG,sample,86831,85778,5599,80179,12978,67201,41797,3310,14336,1569,56133,6189,2656,1094,8413,9475
GTACCGTACCTCGTTG,Pos_Ctrl,48217,47326,3951,43375,2103,41272,34783,3011,2370,306,37153,802,4899,5432,1923,1040
ATGACCGACCTCGTTG,sample,74432,73622,4949,68673,10801,57872,34270,2415,13970,1214,48240,6003,2223,854,6614,7708
GACCGGAACCTCGTTG,sample,1307,1217,116,1101,172,929,507,26,220,33,727,143,310,186,100,103
ATTCTCTTTTGCGGAC,sample,25581,25374,1152,24222,5645,18577,9925,1016,5090,602,15015,1944,1669,935,2358,3791
AAGTTCGTTTGCGGAC,sample,98116,97615,6435,91180,17058,74122,31835,2055,24836,2669,56671,12727,5334,1541,8860,11829
CCTCTAGATTGCGGAC,sample,82343,81888,3112,78776,25333,53443,35382,3063,9905,1471,45287,3622,2403,1242,9150,16166
AGTACCATTTGCGGAC,sample,56424,55920,4394,51526,13473,38053,14045,963,13960,1534,28005,7551,3362,753,2581,8493
TGAGCGCGTTGCGGAC,sample,49442,49134,2226,46908,11991,34917,19903,1471,9128,1352,29031,3063,2141,996,6117,7828
AATGGTAATTGCGGAC,sample,97281,96608,4430,92178,24405,67773,38304,3125,17082,2045,55386,7217,3219,1161,11634,16800
TTAGAAGTTTGCGGAC,sample,97597,96796,8993,87803,16458,71345,29129,2100,22072,2573,51201,15471,5661,1113,11220,11236
GGACCTCTTTGCGGAC,sample,102423,101649,6494,95155,18399,76756,41517,3204,20781,2061,62298,9193,4186,1325,11558,12611
TCGCATCTTTGCGGAC,sample,98336,97568,10652,86916,14548,72368,27072,1639,25363,2797,52435,15497,6278,1341,7333,9154
GCCTTGCTTTGCGGAC,sample,77340,76832,4596,72236,19539,52697,38094,3205,6940,759,45034,3699,1916,1178,10120,12352
GACGGAGATTGCGGAC,sample,107994,107172,4667,102505,21489,81016,54424,3941,15318,2095,69742,5238,3085,1840,10124,15474
GGAGGACGTTGCGGAC,sample,63504,62934,3668,59266,6517,52749,24905,1485,18410,1826,43315,6123,3405,1299,4270,4378
CCGCAACGTTGCGGAC,sample,45691,45242,3251,41991,9248,32743,18031,1307,7973,1040,26004,4392,3453,1466,4149,6240
GACGATAATTGCGGAC,sample,117800,116567,12857,103710,14400,89310,31116,2203,28923,3589,60039,23479,7480,1408,8125,9761
CCATGAAGTTGCGGAC,sample,52412,51883,3732,48151,8015,40136,20970,1165,11443,1090,32413,5468,3132,991,5350,5747
CATGATTCTTGCGGAC,sample,40727,40299,3955,36344,6112,30232,10881,693,10825,1042,21706,6791,3837,942,1822,4138
AGTCCGCATTGCGGAC,sample,102249,101222,10236,90986,11483,79503,34426,2489,22734,2370,57160,17484,6245,1204,7124,7926
TTGGTACCTTGCGGAC,sample,95016,94179,5841,88338,13228,75110,35885,3133,22678,2492,58563,10922,3890,1099,5951,8757
GCCTGAACTTGCGGAC,sample,78126,77228,5419,71809,9091,62718,35273,3101,13978,1723,49251,8643,4334,1629,5295,6597
ACCAATGCTTGCGGAC,sample,75139,74412,4477,69935,8472,61463,34889,2920,15755,2001,50644,5898,2885,1046,7089,6158
TGCTTCGCTTGCGGAC,sample,45431,44885,4242,40643,4886,35757,18355,788,9664,927,28019,6023,3419,806,2496,3407
TTGGTTAATTGCGGAC,sample,62221,61173,8320,52853,4401,48452,10359,974,19861,2381,30220,14877,4994,800,1034,2301
TCAATATATTGCGGAC,sample,88742,87731,6469,81262,10474,70788,36528,2346,19214,2018,55742,10682,4302,1083,6960,7284
AGGTCGGATTGCGGAC,sample,47660,46815,5834,40981,3726,37255,14999,1035,13945,1211,28944,6065,3552,995,2804,3073
ATGACCGATTGCGGAC,sample,67823,67197,4140,63057,9740,53317,30201,2420,13306,1106,43507,6284,3223,919,6492,7107
TATCAGTTTCCATTGG,sample,13535,13448,366,13082,5130,7952,5935,600,971,101,6906,345,1021,939,1105,2819
AAGTTCGTTCCATTGG,sample,21338,21154,739,20415,4589,15826,9058,594,4520,632,13578,1022,1169,616,2574,3269
AGTACCATTCCATTGG,sample,35177,34963,1437,33526,10149,23377,15601,1097,4312,645,19913,1722,1683,990,4614,6379
ATGCCTGGTCCATTGG,sample,15928,15808,991,14817,2986,11831,5195,374,3921,428,9116,1913,1956,715,1576,1941
TAGTACGGTCCATTGG,sample,26131,25900,1780,24120,4088,20032,12849,707,3636,308,16485,2532,2033,1130,2633,2852
CAACCGCGTCCATTGG,sample,17211,17048,1857,15191,2803,12388,5068,321,3884,449,8952,2666,1945,491,1522,1816
CTTGATAGTCCATTGG,sample,13803,13647,2512,11135,1223,9912,2297,167,3994,452,6291,3002,2195,432,540,678
ACCTCGAGTCCATTGG,sample,7093,7017,856,6161,1407,4754,2039,115,1403,191,3442,1006,1021,400,722,900
TGGACGAGTCCATTGG,sample,10380,10212,1549,8663,1460,7203,2884,100,2342,302,5226,1575,1369,422,797,904
CGAGGCAGTCCATTGG,sample,14489,14292,1181,13111,2482,10629,6194,407,2536,283,8730,1209,1201,584,2035,1734
AATCCGTCTCCATTGG,sample,30504,30064,4523,25541,2981,22560,7834,417,7552,716,15386,6041,3411,664,2064,1836
AGTCCGCATCCATTGG,sample,14670,14443,1337,13106,2225,10881,5477,393,3163,270,8640,1578,1492,621,1335,1533
TTGGTACCTCCATTGG,sample,32789,32372,4031,28341,2959,25382,9621,636,8482,972,18103,5671,3055,735,2366,1964
ACGTATTATCCATTGG,sample,48472,47737,9553,38184,3476,34708,6110,503,14488,1469,20598,12138,5768,756,774,1686
TTGGCCTCTCCATTGG,sample,29961,29601,2665,26936,2966,23970,12142,717,6606,843,18748,3662,2433,1022,1572,2267
ACCAATGCTCCATTGG,sample,11974,11817,951,10866,1712,9154,5694,434,1895,212,7589,919,1362,867,1137,1208
GAAGGCGCTCCATTGG,sample,12409,12223,910,11313,1223,10090,5273,374,2680,340,7953,1423,1334,668,1220,859
AAGAGCGCTCCATTGG,sample,23047,22687,3685,19002,2530,16472,5409,515,5889,724,11298,3935,3091,857,1010,1568
GTCTTAGCTCCATTGG,sample,39646,39110,5607,33503,3418,30085,8859,499,11648,1187,20507,7892,4491,988,1326,2283
GGCATATATCCATTGG,Neg_Ctrl,494,271,180,91,15,76,44,4,10,1,54,17,31,17,9,3
TATCAGTTCATAGGCG,sample,196478,194926,14868,180058,36148,143910,69777,4217,41231,4808,111008,23877,7509,2167,16978,24910
TCCAACTTCATAGGCG,sample,116597,115622,6721,108901,23603,85298,48579,3449,21054,2647,69633,9569,4624,1433,13988,16351
AAGTTCGTCATAGGCG,sample,100193,99151,9804,89347,17588,71759,32430,2120,20730,2258,53160,14221,5496,1241,9470,11725
CCTCTAGACATAGGCG,sample,90532,89677,3380,86297,22989,63308,46121,4543,9396,912,55517,2336,1747,1125,17030,15333
TTCGTAATCATAGGCG,sample,39838,39356,6755,32601,3605,28996,7511,487,12210,1280,19721,7508,4213,941,1679,2131
AATGGTAACATAGGCG,sample,81083,80151,11292,68859,10027,58832,15151,872,22035,2512,37186,18262,6575,1039,5014,6118
TTCCGTCTCATAGGCG,sample,88375,87612,7158,80454,11008,69446,30765,1955,22478,2820,53243,11428,4706,1373,7433,7861
CATAACCTCATAGGCG,sample,68748,68134,3587,64547,19092,45455,33065,2307,7444,674,40509,1965,1498,1082,9979,12759
ACTATACTCATAGGCG,sample,91541,90750,6343,84407,19938,64469,33759,2912,17996,1856,51755,7946,3230,1081,10618,13080
GTTAGCCGCATAGGCG,sample,94691,93421,15021,78400,7749,70651,19041,1099,27434,3018,46475,20059,8013,1512,3989,4366
CTTGATAGCATAGGCG,sample,43052,42439,6782,35657,2651,33006,7764,462,14134,1534,21898,9112,5074,1072,1496,1468
ACCTCGAGCATAGGCG,sample,31116,30759,2549,28210,4398,23812,11556,596,7553,738,19109,3369,2358,928,3066,3055
GGCCAGAGCATAGGCG,sample,78219,77123,12942,64181,9208,54973,16727,1125,19727,2207,36454,15187,6485,1172,5451,5535
CATTGCAGCATAGGCG,sample,58667,57987,7777,50210,6402,43808,15142,995,15399,1711,30541,10561,5199,1278,3831,4074
CCATGAAGCATAGGCG,sample,54279,53560,5563,47997,9529,38468,16577,919,11925,1104,28502,7943,3939,945,5181,6193
AATCCGTCCATAGGCG,sample,70410,69787,5026,64761,9066,55695,26852,2001,17933,2071,44785,6838,3667,1243,3787,6973
CGTACGTCCATAGGCG,sample,49156,48503,5124,43379,6348,37031,14219,863,12664,1286,26883,7999,4003,920,3374,4358
GTCCTGCCCATAGGCG,sample,95830,94805,9644,85161,10680,74481,30532,2570,23247,2344,53779,15788,5704,1120,8987,6785
GTTAGGACCATAGGCG,sample,78726,77937,8084,69853,6790,63063,24341,1634,22063,2726,46404,12299,5115,1467,4761,4590
GCCTGAACCATAGGCG,sample,30887,30433,5479,24954,2602,22352,6364,395,8287,997,14651,6309,3652,697,1822,1593
ACGTATTACATAGGCG,sample,134452,133133,11533,121600,17528,104072,45520,3009,34482,3316,80002,17745,5878,1323,10520,12447
CGTATGAACATAGGCG,sample,40630,40043,5005,35038,4537,30501,10422,994,11062,1425,21484,6598,3571,831,2556,2900
AATATATCCATAGGCG,sample,59522,59174,2632,56542,9672,46870,28450,2509,11003,1541,39453,3367,2174,1179,6240,6974
TGCTTCGCCATAGGCG,sample,49539,48897,6913,41984,5770,36214,11033,835,12914,1394,23947,10038,4822,940,2821,3451
AAGAGCGCCATAGGCG,sample,74996,74120,7327,66793,7842,58951,26624,1982,18840,2239,45464,9266,4210,1317,5718,5618
TTGGTTAACATAGGCG,sample,111724,110436,10673,99763,13503,86260,38895,3078,26761,2813,65656,14713,5823,1523,7355,9635
GGAGAGTTTTGGAGAG,sample,94292,93427,8429,84998,15440,69558,33486,1924,19660,1920,53146,12568,5250,1530,11808,11108
TATCAGTTTTGGAGAG,sample,129626,128636,7082,121554,32009,89545,53373,3720,19859,2910,73232,9683,3348,1224,17367,22296
ATTCTCTTTTGGAGAG,Pos_Ctrl,66263,65531,4932,60599,3111,57488,48589,4344,3125,393,51714,1037,5621,6425,3953,1816
TCCAACTTTTGGAGAG,sample,44250,43965,2713,41252,11689,29563,18358,1504,6214,677,24572,2810,3302,1979,4924,7225
GGTTGCGTTTGGAGAG,sample,128286,127353,8175,119178,20120,99058,55275,3461,25424,3010,80699,11888,4500,1650,15206,13154
AGTACCATTTGGAGAG,sample,75111,74620,5788,68832,13769,55063,29652,1760,14643,1717,44295,7291,4311,1782,8094,9338
TTCCGTCTTTGGAGAG,Pos_Ctrl,34420,34172,2270,31902,1747,30155,25476,2561,1503,174,26979,441,4299,4471,2096,934
GGACCTCTTTGGAGAG,sample,88310,87598,5045,82553,12092,70461,35196,2363,21706,2570,56902,8626,3710,1373,9037,8011
CAAGGCCTTTGGAGAG,sample,73686,73064,4314,68750,15000,53750,28178,1817,15095,1911,43273,6749,3669,1185,8081,10131
CCAGAGCGTTGGAGAG,sample,64565,63909,6129,57780,7925,49855,21175,1382,16637,2012,37812,8649,4851,1505,5187,5369
GTTAGCCGTTGGAGAG,sample,40118,39739,3273,36466,7326,29140,15536,1102,7144,970,22680,4388,3587,1645,3667,4630
CCGCAACGTTGGAGAG,sample,50364,49526,9900,39626,5323,34303,10104,562,12608,1106,22712,9923,5575,1115,2755,2939
GACGATAATTGGAGAG,sample,45732,45226,3459,41767,5194,36573,16354,1000,12832,1443,29186,4944,2877,1087,3812,3836
CGAGGCAGTTGGAGAG,sample,55506,54734,7651,47083,6627,40456,13471,739,15625,1521,29096,9100,4716,1056,4130,4239
ACGACTTCTTGGAGAG,sample,31648,31317,2643,28674,6844,21830,11510,973,5580,595,17090,3172,2598,1298,3072,4540
CATGATTCTTGGAGAG,sample,27632,27326,2378,24948,3605,21343,9692,791,6505,850,16197,3505,2768,1105,2376,2584
AATCCGTCTTGGAGAG,sample,19985,19695,3316,16379,2039,14340,4767,372,5140,657,9907,3404,3068,990,933,1299
AGTCCGCATTGGAGAG,sample,114399,112961,14457,98504,12257,86247,30402,1941,28081,2982,58483,22841,6953,1238,8979,8038
TTGGTACCTTGGAGAG,sample,58326,57611,6676,50935,6809,44126,17073,1037,14020,1679,31093,10317,4615,1071,4565,4650
CTAGGACCTTGGAGAG,sample,62834,61972,5186,56786,8408,48378,25524,1637,13076,1300,38600,6841,3487,1081,6289,5931
ACCAATGCTTGGAGAG,sample,77012,76042,7357,68685,9651,59034,27092,1766,17455,2324,44547,10397,4969,1240,4886,7278
TATCAGTTTTCAAGCC,sample,123979,123022,14026,108996,14127,94869,29681,1912,35342,4219,65023,23715,8202,1660,7099,8898
ATTCTCTTTTCAAGCC,sample,40823,40380,3825,36555,7238,29317,15404,845,7376,883,22780,4809,2549,694,5689,4995
TTCGTAATTTCAAGCC,sample,86368,85612,8161,77451,9569,67882,26345,1403,23932,2731,50277,13471,5270,1513,5318,6408
TTCCGTCTTTCAAGCC,sample,56732,56085,6553,49532,7394,42138,16224,814,14486,1697,30710,8917,4435,942,5931,4786
GGACCTCTTTCAAGCC,sample,82491,81767,9026,72741,8161,64580,23624,1679,25062,2985,48686,11230,5672,1716,4299,5256
TCGCATCTTTCAAGCC,sample,73757,73124,8061,65063,8899,56164,22427,1997,20292,2698,42719,8750,4621,1443,5017,5582
CAAGGCCTTTCAAGCC,sample,32974,32585,1414,31171,7321,23850,15440,1015,5025,483,20465,1887,1986,1172,3753,5163
GACGGAGATTCAAGCC,sample,68714,68016,4958,63058,10836,52222,27970,2142,12954,1934,40924,7222,3707,1177,7354,7593
GGACGTAGTTCAAGCC,sample,10715,10553,2260,8293,754,7539,1415,83,3225,348,4640,2468,1775,314,379,431
TGGACGAGTTCAAGCC,sample,25893,25532,4408,21124,2566,18558,5825,454,6842,708,12667,4729,3242,729,1990,1566
GACGATAATTCAAGCC,sample,13562,13363,794,12569,3073,9496,6125,420,1990,236,8115,725,1077,690,2031,2116
CGAGGCAGTTCAAGCC,sample,18575,18284,1737,16547,2530,14017,5590,409,5001,518,10591,2499,2038,714,1077,1625
CCATGAAGTTCAAGCC,sample,26504,26284,2075,24209,4829,19380,9717,626,5165,743,14882,3129,2604,1075,2575,3188
GCCTGAACTTCAAGCC,sample,63507,62704,4787,57917,6363,51554,25880,2029,14545,1487,40425,7613,3534,1115,5713,4227
TTGGCCTCTTCAAGCC,Pos_Ctrl,20089,19737,1832,17905,894,17011,14066,1279,1171,150,15237,345,3359,3061,953,411
AATATATCTTCAAGCC,sample,58516,57830,7716,50114,5023,45091,10819,577,17913,2164,28732,13618,5514,920,2906,3106
CCAATTCCTTCAAGCC,sample,28148,27540,3717,23823,3099,20724,6426,590,7245,742,13671,5721,2985,591,1536,1904
GGCATATATTCAAGCC,sample,21080,20758,2259,18499,2204,16295,7408,465,4900,634,12308,2888,2126,634,1728,1404
TCAATATATTCAAGCC,sample,76926,76060,8813,67247,6646,60601,25905,2919,18101,1975,44006,11701,5119,1362,5448,4114
TCGCCTGATTCAAGCC,sample,32323,31857,5035,26822,3520,23302,7245,415,8768,1015,16013,5859,3479,718,1586,2036
TTATTCGATTCAAGCC,sample,73186,72051,10704,61347,4933,56414,12792,903,21928,2457,34720,18334,7175,1113,2619,2690
GACCGGAATTCAAGCC,sample,32211,31787,2891,28896,4620,24276,9561,843,7654,870,17215,5348,2529,697,2170,2983
TATCAGTTAACTTAAC,sample,19913,19769,1377,18392,3640,14752,8051,790,4030,423,12081,1458,1794,898,1869,2512
ATTCTCTTAACTTAAC,sample,28937,28718,2003,26715,6094,20621,9368,827,5962,707,15330,3757,2626,849,2373,4010
TCCAACTTAACTTAAC,Neg_Ctrl,728,334,135,199,34,165,54,24,55,4,109,28,56,28,23,7
CCTCTAGAAACTTAAC,sample,61686,61250,3471,57779,9581,48198,23845,2183,14106,2103,37951,5961,3364,1134,5841,6569
AGTACCATAACTTAAC,sample,75390,74817,9909,64908,8512,56396,12687,914,22463,2365,35150,17967,6956,1133,3737,5385
TTCTAATGAACTTAAC,sample,14602,14522,1286,13236,2683,10553,5412,354,2761,315,8173,1711,1687,700,2007,1839
ATGCCTGGAACTTAAC,sample,80571,79990,8366,71624,13558,58066,23249,1293,18184,2080,41433,13260,6266,1225,6456,8646
TGAGCGCGAACTTAAC,sample,16966,16852,1673,15179,2149,13030,5747,458,4107,479,9854,2239,2105,926,1115,1412
CAACCGCGAACTTAAC,sample,15465,15367,1222,14145,3686,10459,6463,500,2135,245,8598,1116,1309,756,2360,2630
AATGGTAAAACTTAAC,sample,87065,86507,7454,79053,18623,60430,31028,1625,15272,1517,46300,10988,3388,986,10423,12593
GGACCTCTAACTTAAC,Neg_Ctrl,880,397,218,179,22,157,54,5,58,9,112,31,52,25,11,10
CCAGAGCGAACTTAAC,sample,18412,18168,2214,15954,2396,13558,5223,329,4636,498,9859,2872,2089,597,1435,1545
GTTAGCCGAACTTAAC,sample,55756,55120,6282,48838,5606,43232,14143,944,15640,2001,29783,10504,5053,1060,3659,3748
CTTGATAGAACTTAAC,sample,47167,46576,7378,39198,4565,34633,9942,570,13383,1551,23325,9187,4615,912,2570,2587
CATGATTCAACTTAAC,sample,62517,61761,6951,54810,7526,47284,19697,1171,14718,1897,34415,9801,4585,981,5029,5035
AGTCCGCAAACTTAAC,sample,43066,42539,3966,38573,7307,31266,15454,1892,8284,1143,23738,4493,3157,1079,3840,5008
TTGGTACCAACTTAAC,sample,23134,22849,2292,20557,3359,17198,9308,538,4414,478,13722,2460,2082,796,2304,2431
GTTAGGACAACTTAAC,sample,41871,41365,3417,37948,6424,31524,17796,1353,7314,547,25110,4514,2263,713,6129,4325
ACGTATTAAACTTAAC,sample,67755,67049,5478,61571,6812,54759,24001,1824,18830,2202,42831,7902,3460,1098,5466,5054
TTGGCCTCAACTTAAC,sample,34243,33827,3448,30379,3835,26544,9847,611,9383,1072,19230,5631,3036,735,2625,2699
ACCAATGCAACTTAAC,sample,44154,43577,4293,39284,3447,35837,16885,905,10639,1438,27524,5970,3239,952,2235,2236
AAGAGCGCAACTTAAC,sample,13689,13403,2648,10755,1212,9543,2646,226,3683,383,6329,2605,1984,432,687,689
GTACCGTAAACTTAAC,sample,50920,50344,5139,45205,4677,40528,17884,1452,11920,1346,29804,7926,3853,1039,2713,3153
GGCATATAAACTTAAC,sample,28196,27868,1824,26044,3428,22616,13785,971,5088,551,18873,2221,1981,914,2721,2650
GACCGGAAAACTTAAC,sample,36875,36511,2428,34083,3124,30959,15457,1264,9647,1088,25104,3503,2348,1060,2055,2034
TATCAGTTATACTTGA,sample,122615,121840,5776,116064,29957,86107,56216,3810,16946,1329,73162,7806,2778,1179,19177,20536
ATTCTCTTATACTTGA,sample,111443,110574,7048,103526,20951,82575,46327,3352,19902,2025,66229,10969,4663,1437,12652,14698
TCCAACTTATACTTGA,sample,37617,37193,4785,32408,6705,25703,10610,807,8011,805,18621,5470,3244,865,3101,4330
AGTACCATATACTTGA,sample,92602,91838,6489,85349,25439,59910,30135,2079,16762,1529,46897,9405,4109,1299,10386,15876
TAGTACGGATACTTGA,sample,52894,52331,5209,47122,9683,37439,14280,968,12929,1638,27209,7624,3887,1032,2364,6417
TGAGCGCGATACTTGA,sample,42637,42334,1778,40556,9443,31113,20665,1362,6155,602,26820,2329,1947,1184,4209,6673
AATGGTAAATACTTGA,sample,74739,73988,10621,63367,9238,54129,14616,767,20501,2347,35117,15898,6444,1127,4243,5596
GCCTTGCTATACTTGA,sample,11520,11352,2448,8904,1007,7897,1725,132,3227,320,4952,2493,1836,362,562,572
ACTATACTATACTTGA,sample,1148,1133,90,1043,294,749,482,37,129,16,611,85,205,147,152,191
GACGGAGAATACTTGA,sample,60237,59641,4446,55195,10445,44750,22566,1558,12532,1455,35098,6639,3647,1250,6215,6810
CCAGAGCGATACTTGA,sample,58801,58366,3536,54830,11477,43353,23025,1839,11465,1113,34490,5911,3335,1243,7034,7898
GTTAGCCGATACTTGA,sample,63605,63048,7579,55469,11311,44158,17592,1216,14261,1347,31853,9742,5041,1162,4892,7263
GGAGGACGATACTTGA,sample,46284,45890,4790,41100,5686,35414,14486,1035,11787,1238,26273,6868,4259,1235,4125,3821
CATTGCAGATACTTGA,sample,74109,73248,5730,67518,12706,54812,29220,2061,13754,1619,42974,8158,3990,1275,7271,8874
ACGACTTCATACTTGA,sample,34232,33839,1687,32152,6353,25799,17611,1367,4943,361,22554,1517,1442,789,5881,4749
CATGATTCATACTTGA,sample,63594,62910,5117,57793,11039,46754,28078,2275,10368,968,38446,5065,2335,952,8311,7433
CGGATTACATACTTGA,sample,52377,51762,5006,46756,7677,39079,18906,1328,11122,1382,30028,6341,3627,1167,5274,4998
GTTAGGACATACTTGA,sample,16178,15864,3988,11876,970,10906,2019,143,4604,449,6623,3691,2508,432,409,485
AACTCGTAATACTTGA,sample,65309,64696,3403,61293,12328,48965,33982,2075,8125,1081,42107,3702,2038,996,7648,8862
TTGGCCTCATACTTGA,sample,12855,12664,1408,11256,1575,9681,3889,363,3231,344,7120,1854,1816,685,931,995
AATATATCATACTTGA,Neg_Ctrl,996,625,379,246,22,224,83,4,67,8,150,62,73,33,30,5
ACCAATGCATACTTGA,sample,28405,27979,3358,24621,3715,20906,9551,465,6305,687,15856,3898,2796,915,2343,2600
TTGGTTAAATACTTGA,sample,86863,85699,12857,72842,8787,64055,22206,1207,22406,2402,44612,15834,5948,1179,5845,5540
TCAATATAATACTTGA,sample,94526,93648,9037,84611,8256,76355,31997,2226,25675,3102,57672,13355,5311,1335,5523,5528
TCGCCTGAATACTTGA,sample,38688,38308,1630,36678,5619,31059,21360,1688,5705,693,27065,1613,2056,1379,3250,4295
CTTCATGAATACTTGA,sample,49614,48746,7832,40914,3174,37740,8686,562,15503,1817,24189,11172,4763,867,1425,1671
AGGTCGGAATACTTGA,sample,82522,81490,8559,72931,7899,65032,27267,2135,18877,2045,46144,14708,5275,1100,6049,5215
TTATTCGAATACTTGA,sample,96758,95890,6477,89413,11858,77555,38839,3679,19262,2500,58101,13275,5409,1213,8739,8422
ACGTAAGTATCCGCGA,sample,162800,161811,10567,151244,40290,110954,59436,3927,26622,2991,86058,17978,5402,1446,22672,25741
TTCTAATGATCCGCGA,sample,49340,48956,6051,42905,5679,37226,13698,970,13274,1271,26972,8013,4430,1419,2930,3454
ATGCCTGGATCCGCGA,sample,106063,105400,4327,101073,29485,71588,51747,3129,10731,1144,62478,4837,2544,1575,14911,19536
AATGGTAAATCCGCGA,sample,167827,166582,15477,151105,19674,131431,60613,3808,37622,3678,98235,25710,7559,2035,8837,13064
TTCCGTCTATCCGCGA,sample,103279,102494,8205,94289,12643,81646,35162,2198,28422,3114,63584,12750,4854,1526,7342,8809
CATAACCTATCCGCGA,sample,247568,245429,23429,222000,28721,193279,75563,6767,61314,5824,136877,43811,8974,1953,10412,19927
CCAGAGCGATCCGCGA,sample,40002,39619,2664,36955,8033,28922,15674,1335,6883,872,22557,4158,2670,1136,4298,5674
GTTAGCCGATCCGCGA,sample,45546,45160,5218,39942,5401,34541,13959,941,11651,1020,25610,6970,4007,994,3895,3423
TGGACGAGATCCGCGA,sample,93180,92132,12071,80061,10018,70043,25576,1623,22266,2393,47842,18185,6349,1144,6768,6387
CGAGGCAGATCCGCGA,sample,102107,100825,16215,84610,9934,74676,21296,2044,29140,2994,50436,19202,7075,1508,3911,6466
CCATGAAGATCCGCGA,sample,136588,134954,17761,117193,15973,101220,33054,1813,35849,4079,68903,26425,8140,1602,8645,10800
GTCCTGCCATCCGCGA,sample,105880,104522,15748,88774,6117,82657,24411,1745,31949,3713,56360,20839,6823,1766,2621,3397
TTGGTACCATCCGCGA,sample,117319,116245,9334,106911,8314,98597,43398,3172,32981,3527,76379,15519,4795,1193,5151,5955
CGGATTACATCCGCGA,sample,77145,76300,6678,69622,5405,64217,22308,1617,24093,2928,46401,13271,4601,960,1893,3474
GCCTGAACATCCGCGA,sample,143494,141831,17443,124388,11579,112809,37753,2929,39326,4236,77079,28565,8814,1546,9190,7659
AACTCGTAATCCGCGA,sample,37697,37263,5683,31580,3026,28554,9053,676,10053,1184,19106,7588,3459,749,1495,1830
GAAGGCGCATCCGCGA,sample,80598,79526,7341,72185,9073,63112,27396,2313,20518,1854,47914,11031,4223,1150,5514,6096
AAGAGCGCATCCGCGA,sample,170453,168479,23466,145013,12500,132513,45696,2702,45963,5058,91659,33094,9367,1854,7316,7314
TTGGTTAAATCCGCGA,sample,122601,121138,17457,103681,8972,94709,29082,2024,35643,4314,64725,23646,7871,1600,5242,5417
TCGCCTGAATCCGCGA,sample,49366,48550,11799,36751,2814,33937,5255,341,15017,1553,20272,11771,5686,764,955,1187
ATGACCGAATCCGCGA,sample,110121,109008,12460,96548,10235,86313,33358,2039,30670,3407,64028,16839,6800,1721,5946,6723
GACCGGAAATCCGCGA,sample,72483,71880,4373,67507,10101,57406,29439,2545,15411,1369,44850,8642,3201,937,6165,7147
TATCAGTTAGGACTCA,sample,132707,131673,10133,121540,18551,102989,48897,3000,32680,3682,81577,14730,5074,1627,12759,12471
TCCAACTTAGGACTCA,sample,98828,97904,5155,92749,23309,69440,39975,3314,16194,1446,56169,8511,3961,1099,13886,15790
AAGTTCGTAGGACTCA,sample,93798,92968,6546,86422,18301,68121,36492,2629,17641,2244,54133,9115,3675,1086,10906,12404
TGAGCGCGAGGACTCA,sample,24609,24366,3309,21057,2772,18285,5463,507,7431,807,12894,4077,3120,871,1146,1839
TTAGAAGTAGGACTCA,sample,47829,47407,4389,43018,7659,35359,15580,1417,11232,1444,26812,5686,3291,1038,4359,4812
TTCCGTCTAGGACTCA,sample,33912,33525,3823,29702,4462,25240,10870,867,7977,927,18847,4599,3108,1081,2752,2842
TCGCATCTAGGACTCA,sample,86588,85832,5540,80292,13652,66640,37825,2857,16180,1775,54005,8003,3993,1432,8356,8816
GCCTTGCTAGGACTCA,sample,53998,53405,4536,48869,7302,41567,19757,1060,13290,1149,33047,6311,3553,1095,5324,5021
CAAGGCCTAGGACTCA,sample,35469,35000,4486,30514,5785,24729,10033,744,8319,832,18352,4801,3103,885,2503,3828
GACGGAGAAGGACTCA,sample,52552,51948,5860,46088,8125,37963,16170,1083,12036,1135,28206,7539,3965,917,4520,5405
CCAGAGCGAGGACTCA,sample,41190,40764,2719,38045,6130,31915,14914,1270,10501,1169,25415,4061,2659,908,4284,4212
GTTAGCCGAGGACTCA,sample,65632,65065,6534,58531,6225,52306,19511,1109,19406,2308,38917,9972,4655,1282,4456,3828
GGAGGACGAGGACTCA,sample,60703,60014,5787,54227,6057,48170,19995,1476,16133,1625,36128,8941,4558,1467,3306,4084
CCGCAACGAGGACTCA,sample,59902,59294,3610,55684,12022,43662,25859,1997,10119,1093,35978,4594,3110,1210,7089,8295
ACCTCGAGAGGACTCA,sample,107260,105879,17013,88866,9796,79070,20136,1203,30234,3415,50370,24082,8582,1353,5809,5574
CGAGGCAGAGGACTCA,sample,45869,45346,2177,43169,12184,30985,22568,1469,5103,769,27671,1076,1006,781,7705,8654
CATGATTCAGGACTCA,sample,58919,58376,4034,54342,10211,44131,24795,1860,11472,932,36267,5072,2392,865,9534,7193
GTTAGGACAGGACTCA,sample,35994,35557,3698,31859,4783,27076,9248,721,9647,1134,18895,6326,3448,692,2194,3078
ACGTATTAAGGACTCA,sample,83553,82727,5531,77196,12285,64911,33591,2553,17954,2032,51545,8781,4207,1445,7538,8775
AACTCGTAAGGACTCA,sample,46969,46336,3240,43096,4824,38272,17168,1211,12516,1307,29684,6070,2762,900,1906,3333
TTGGCCTCAGGACTCA,sample,54236,53693,5019,48674,8112,40562,20174,1617,10920,1334,31094,6517,3644,1196,4319,5873
AATATATCAGGACTCA,sample,66491,65860,4687,61173,10463,50710,21811,1487,15687,2003,37498,9722,3764,1051,4928,7241
GTCTTAGCAGGACTCA,sample,62452,61734,7154,54580,6813,47767,17226,1295,16238,2115,33464,10893,4914,1030,4541,4614
TTGGTTAAAGGACTCA,sample,45495,44732,6497,38235,3532,34703,9502,456,13502,1346,23004,9897,4179,713,1143,2203
AGGTCGGAAGGACTCA,Pos_Ctrl,30398,29864,2158,27706,1320,26386,22011,2047,1561,236,23572,531,4095,4153,1246,641
TTATTCGAAGGACTCA,sample,69438,68597,5398,63199,6875,56324,27222,1828,16569,1532,43791,9173,3552,932,6844,5373
GACCGGAAAGGACTCA,sample,46632,46146,3877,42269,5000,37269,13197,814,13085,1270,26282,8903,3870,849,1576,2892
GGAGAGTTTATTGAAC,sample,651,644,101,543,109,434,136,7,178,9,314,104,162,60,26,61
TATCAGTTTATTGAAC,sample,26507,26348,1838,24510,6220,18290,8865,586,5096,748,13961,2995,2420,744,2786,3882
ATTCTCTTTATTGAAC,sample,85675,85264,4436,80828,16905,63923,34326,2437,17115,2078,51441,7967,4192,1545,7720,11749
TCCAACTTTATTGAAC,sample,102217,101622,6231,95391,22288,73103,39865,2811,18217,2278,58082,9932,4686,1462,9154,14532
AAGTTCGTTATTGAAC,sample,132392,131566,7087,124479,16796,107683,72524,4939,17419,2007,89943,10794,5527,2379,12899,10757
TCCTCCGTTATTGAAC,sample,21553,21347,2314,19033,3815,15218,6905,523,4491,398,11396,2901,1995,648,2673,2448
CCTCTAGATATTGAAC,sample,57018,56494,4346,52148,11921,40227,17902,1301,12267,1368,30169,7389,4510,1310,6073,7985
TAGTACGGTATTGAAC,sample,80855,80272,9460,70812,12698,58114,21616,1408,19043,2669,40659,13378,5041,1058,7589,8467
TGAGCGCGTATTGAAC,sample,23480,23243,2577,20666,4247,16419,6521,351,5320,611,11841,3616,2559,626,2303,2612
AATGGTAATATTGAAC,sample,60908,60361,4416,55945,5904,50041,23249,1525,16617,2270,39866,6380,3650,1518,4113,4043
GGACCTCTTATTGAAC,sample,80013,79337,6721,72616,14712,57904,32232,2668,14042,1299,46274,7663,4557,1532,6611,10052
ACCTCGAGTATTGAAC,sample,62289,61531,6166,55365,7971,47394,19921,1040,15330,1731,35251,9372,4269,1046,5216,5189
CATTGCAGTATTGAAC,sample,20108,19811,2121,17690,2710,14980,6405,490,4639,469,11044,2977,2176,670,1709,1827
CATGATTCTATTGAAC,sample,40303,39743,5371,34372,4507,29865,11247,629,10223,1157,21470,6609,3469,808,2843,2998
AGTCCGCATATTGAAC,sample,38070,37498,4926,32572,4173,28399,10205,985,9323,908,19528,6978,3522,792,1868,2527
GTCCTGCCTATTGAAC,sample,87918,86863,9154,77709,9007,68702,32148,2615,18898,2135,51046,12906,5300,1241,7059,6196
CTAGGACCTATTGAAC,sample,27173,26661,4478,22183,2474,19709,4003,366,8076,768,12079,6496,3255,489,832,1428
CGGATTACTATTGAAC,sample,54079,53518,4412,49106,3781,45325,22756,2070,12989,1249,35745,6261,3958,1499,3056,2415
CGTATGAATATTGAAC,sample,68744,67816,7016,60800,7355,53445,19700,1708,16587,1576,36287,13874,4993,1010,3653,4826
AATATATCTATTGAAC,sample,44907,44486,2472,42014,7339,34675,25125,1617,5040,706,30165,2187,2031,1309,4375,5423
GTCTTAGCTATTGAAC,sample,14368,14119,2366,11753,1370,10383,3312,344,3903,436,7215,2388,1965,551,702,779
TTGGTTAATATTGAAC,sample,54009,53360,6587,46773,4239,42534,14068,1281,15918,1709,29986,9558,4798,1382,2032,2679
TCGCCTGATATTGAAC,sample,102099,100713,10580,90133,9942,80191,30814,2709,24864,3600,55678,18204,6048,1103,5929,6671
GGAGAGTTGTTCAACT,sample,86892,86140,11416,74724,7298,67426,16311,1244,26691,2827,43002,20353,8136,1214,2778,4268
TATCAGTTGTTCAACT,sample,41776,41460,1579,39881,7072,32809,23140,1398,4691,644,27831,2936,1751,923,4653,5124
GGTTGCGTGTTCAACT,sample,48918,48571,3312,45259,5929,39330,16062,1572,13487,1789,29549,6420,3399,1169,4247,3866
CCTCTAGAGTTCAACT,sample,16678,16530,864,15666,2436,13230,7217,488,3953,503,11170,1069,1544,807,1873,1635
TTCTAATGGTTCAACT,sample,32643,32325,3195,29130,4165,24965,8790,418,8969,887,17759,5901,3333,798,2605,2858
TAGTACGGGTTCAACT,sample,27348,27073,3267,23806,4671,19135,7906,564,6225,675,14131,3765,2661,693,2654,2914
CAACCGCGGTTCAACT,sample,14755,14601,1617,12984,2299,10685,5048,427,2983,330,8031,1897,1779,723,1328,1563
AATGGTAAGTTCAACT,sample,25041,24726,4656,20070,2387,17683,4371,299,6870,654,11241,5489,3653,822,1053,1251
GGACCTCTGTTCAACT,sample,14144,13994,1222,12772,1626,11146,4783,196,3859,451,8642,1857,1583,541,1900,1045
GGCCAGAGGTTCAACT,sample,26242,25850,3161,22689,2533,20156,6826,658,7862,776,14688,4034,2716,844,1401,1556
CGAGGCAGGTTCAACT,sample,21698,21419,2094,19325,3788,15537,9152,608,3545,397,12697,1835,1586,652,3508,2576
ACGACTTCGTTCAACT,sample,20397,20222,1196,19026,3628,15398,11453,885,2158,249,13611,653,1547,1277,1913,2779
AATCCGTCGTTCAACT,sample,24627,24266,3919,20347,2407,17940,4530,228,6885,726,11415,5571,3189,518,1491,1375
CGTACGTCGTTCAACT,sample,17414,17194,1597,15597,2697,12900,6521,387,3382,359,9903,2251,1696,534,2444,1844
TTGGTACCGTTCAACT,sample,23232,22992,1840,21152,3550,17602,10558,761,3942,349,14500,1992,1421,650,2569,2661
CTAGGACCGTTCAACT,sample,20665,20468,1359,19109,3520,15589,9254,631,3744,429,12998,1531,1317,653,2301,2544
AACTCGTAGTTCAACT,sample,24285,23924,2721,21203,2994,18209,7559,379,5973,600,13532,3698,2189,599,1271,1901
ACCAATGCGTTCAACT,sample,21590,21180,1717,19463,2635,16828,9555,850,3890,381,13445,2152,1649,629,2466,1967
GTCTTAGCGTTCAACT,sample,13374,13123,1380,11743,1386,10357,4390,505,3224,431,7614,1807,1426,487,1069,876
CCAATTCCGTTCAACT,sample,30472,29757,5532,24225,1950,22275,5244,353,8657,885,13901,7136,3949,490,1069,1058
TCAATATAGTTCAACT,sample,33292,32831,3807,29024,2211,26813,10765,1157,8605,1102,19370,5184,2781,774,1609,1340
CTTCATGAGTTCAACT,sample,32623,32057,5427,26630,2566,24064,7271,457,8716,946,15987,6674,3875,594,1715,1431
AGGTCGGAGTTCAACT,sample,38294,37606,6879,30727,2656,28071,6662,476,10690,1249,17352,8994,4393,636,1594,1470
TTATTCGAGTTCAACT,Neg_Ctrl,342,188,91,97,15,82,33,5,23,3,56,18,36,24,5,10
ATTCTCTTCTGAGGTT,sample,188326,187221,16991,170230,38129,132101,57901,4155,39573,4066,97474,26406,9363,2230,15650,24650
TCCAACTTCTGAGGTT,sample,161577,160433,11947,148486,23465,125021,53096,3721,38955,4370,92051,24879,7895,1773,18179,16865
CCTCTAGACTGAGGTT,sample,137756,136769,8401,128368,27479,100889,52484,3575,27630,2892,80114,14308,5151,1637,13314,18987
AGTACCATCTGAGGTT,sample,87109,86437,6209,80228,16483,63745,28837,2330,20287,2103,49124,10188,4247,1120,9277,10568
GGACCTCTCTGAGGTT,sample,83338,82670,6961,75709,14114,61595,26567,2349,18578,2501,45145,11600,5682,1699,7018,9270
GCCTTGCTCTGAGGTT,sample,92133,91377,5494,85883,17169,68714,36881,2818,18506,1780,55387,8729,4272,1318,13091,11860
CCAGAGCGCTGAGGTT,sample,60725,59830,6133,53697,8640,45057,17165,933,15074,1738,32239,10147,4681,979,5428,6091
GGACGTAGCTGAGGTT,sample,63302,62681,3120,59561,17680,41881,23493,2157,10553,1306,34046,4372,2937,1365,5576,10633
CGAGGCAGCTGAGGTT,sample,121658,120262,11554,108708,19074,89634,40515,3326,25501,2650,66016,17642,5659,1363,13052,13570
CCATGAAGCTGAGGTT,sample,136053,134756,10534,124222,25683,98539,55033,4255,21558,2192,76591,15501,6354,1669,17845,17086
CATGATTCCTGAGGTT,sample,320340,317474,29072,288402,26291,262111,102495,7046,87904,12290,190399,52376,11573,2623,16922,16617
AATCCGTCCTGAGGTT,sample,91045,90017,11659,78358,8159,70199,22451,1554,24882,2838,47333,18474,6708,1113,4553,5103
CGTACGTCCTGAGGTT,sample,218624,216560,13264,203296,16002,187294,94815,7735,53929,5015,148744,25800,6890,1796,11542,10132
TTGGTACCCTGAGGTT,sample,217081,214665,25918,188747,18795,169952,46359,2553,61739,6259,108098,53042,11630,1966,14659,12236
GCCTGAACCTGAGGTT,sample,165639,163706,18401,145305,12023,133282,37088,3371,52033,5754,89121,35036,8899,1747,8627,7357
CGTATGAACTGAGGTT,sample,125127,123641,11849,111792,15265,96527,42020,2601,28934,3250,70954,19722,6603,1404,10000,10569
AATATATCCTGAGGTT,sample,132941,131559,11912,119647,11664,107983,34477,2249,37318,3900,71795,30039,8120,1334,9706,6748
TGCTTCGCCTGAGGTT,sample,61684,60987,2841,58146,8157,49989,35347,2837,7588,1382,42935,2835,1840,806,9602,6283
GAAGGCGCCTGAGGTT,sample,89417,88487,5752,82735,8863,73872,45514,3787,14776,2026,60290,7769,4236,1885,7143,6005
TCGCCTGACTGAGGTT,sample,124088,122642,7202,115440,18150,97290,68863,4930,15185,1705,84048,6607,3558,1711,10085,12608
ATGACCGACTGAGGTT,sample,171746,169985,14515,155470,15450,140020,53474,5560,46901,5238,100375,28847,6938,1639,12187,11649
GACCGGAACTGAGGTT,sample,114141,113155,8028,105127,10925,94202,39448,2223,29968,3072,69416,19491,6987,1518,8681,7093
ATTCTCTTAGACCGTT,sample,121477,120493,11729,108764,20398,88366,33723,2440,30593,3377,64316,18233,6220,1335,9687,13952
AAGTTCGTAGACCGTT,sample,96471,95891,4639,91252,21594,69658,43763,3469,13742,1731,57505,6953,3966,1659,12879,14098
GGTTGCGTAGACCGTT,sample,47093,46705,2290,44415,12755,31660,22444,1383,5296,858,27740,1679,1403,899,6578,7921
CCTCTAGAAGACCGTT,sample,124027,123334,3440,119894,33511,86383,64508,5244,10299,1663,74807,4669,2914,1867,14988,21431
AGTACCATAGACCGTT,sample,121351,120630,6211,114419,24904,89515,49409,3544,24608,2491,74017,9463,4242,1980,12668,16998
TTCGTAATAGACCGTT,sample,108248,107382,9896,97486,13436,84050,33159,2256,28100,3486,61259,17049,6035,1421,7493,8833
ACGTTATGAGACCGTT,sample,74797,74268,6010,68258,9691,58567,24505,1850,19989,2100,44494,10123,4959,1414,6546,6442
TTCTAATGAGACCGTT,sample,56494,55986,3674,52312,12784,39528,17682,1328,13091,1232,30773,6195,3487,1116,2953,8289
ATGCCTGGAGACCGTT,sample,187792,186227,22051,164176,23419,140757,41501,2901,51299,6582,92800,38474,11236,2024,11498,15131
TGAGCGCGAGACCGTT,sample,91069,90446,3408,87038,17756,69282,47263,3336,12570,1365,59833,4748,2996,1384,14396,12740
AATGGTAAAGACCGTT,sample,164627,163381,9922,153459,21693,131766,74554,5462,30347,3202,104901,18201,6437,2135,14163,14507
TTAGAAGTAGACCGTT,sample,76827,76133,4100,72033,12167,59866,34287,2721,13914,1935,48201,7009,3670,1511,4137,8488
GGACCTCTAGACCGTT,sample,35307,34910,2903,32007,5051,26956,13557,991,7305,703,20862,4400,2766,760,4866,3442
GCCTTGCTAGACCGTT,sample,103367,102371,8407,93964,14477,79487,36112,2702,24010,2923,60122,13740,5678,1631,9429,9339
CAAGGCCTAGACCGTT,sample,15026,14703,2016,12687,1585,11102,4314,259,3815,496,8129,2218,1833,567,1613,1053
CCAGAGCGAGACCGTT,sample,128666,127076,15575,111501,11766,99735,30984,2181,39227,4881,70211,22462,7975,1842,6171,7918
GGACGTAGAGACCGTT,sample,98926,97982,8464,89518,14327,75191,39700,2488,19872,2403,59572,10728,4084,1336,10595,9774
GACGATAAAGACCGTT,sample,154520,153227,17406,135821,19167,116654,51732,4023,34671,3857,86403,22371,6758,2210,9006,12528
CGAGGCAGAGACCGTT,sample,72750,72049,3397,68652,11975,56677,39762,3889,8025,1250,47787,3751,3400,2445,6471,8456
AATCCGTCAGACCGTT,sample,194274,192064,25433,166631,17332,149299,43033,2771,54344,5447,97377,43704,11607,1971,12547,11092
TTGGTACCAGACCGTT,sample,71846,70901,5302,65599,6419,59180,22983,1577,21902,2547,44885,10171,4199,1127,3818,4012
GTTAGGACAGACCGTT,sample,110056,108904,6843,102061,15085,86976,52455,5220,17445,1714,69900,10142,3069,1261,12643,11506
AACTCGTAAGACCGTT,sample,114888,113420,10937,102483,10276,92207,39588,2621,27882,2867,67470,19249,7154,2028,4926,6592
TTGGCCTCAGACCGTT,sample,105490,104292,8719,95573,13834,81739,39642,3270,21819,2521,61461,14487,4036,1089,13093,9645
GTCTTAGCAGACCGTT,sample,111594,110032,11338,98694,6919,91775,30579,2397,32903,3094,63482,22802,5794,1347,5686,4671
CTTCATGAAGACCGTT,sample,85452,84011,7974,76037,9658,66379,35699,2891,16260,2110,51959,9419,3965,1097,8281,7387
TTATTCGAAGACCGTT,sample,82381,81021,11350,69671,4099,65572,14105,912,27211,3062,41316,20282,6316,1127,708,1901
TATCAGTTCTTGAGTT,sample,27922,27683,1452,26231,5835,20396,10760,898,6246,722,17006,1770,1920,1017,1836,3781
GGTTGCGTCTTGAGTT,sample,28449,28204,2334,25870,3964,21906,7855,631,8537,999,16392,3884,2967,860,2255,2552
TCCTCCGTCTTGAGTT,sample,78433,77914,4611,73303,12400,60903,26183,2157,20406,2278,46589,9879,4872,1281,8736,8301
GCCTTGCTCTTGAGTT,sample,123875,122497,9066,113431,19450,93981,49022,3460,25318,2747,74340,13434,5179,1449,13515,13100
CAAGGCCTCTTGAGTT,sample,149255,148018,10297,137721,28107,109614,68675,5437,22862,2311,91537,10329,3894,1428,20954,19818
GTTAGCCGCTTGAGTT,sample,84914,84170,4919,79251,9521,69730,34276,2605,22657,3049,56933,7143,3664,1571,5696,6463
GGAGGACGCTTGAGTT,sample,120477,119156,6610,112546,22413,90133,52829,5433,18448,1997,71277,11426,3475,1094,14944,16359
TGGACGAGCTTGAGTT,sample,24455,24123,2807,21316,2827,18489,6741,376,6525,714,13266,4133,2644,634,2503,1882
CATTGCAGCTTGAGTT,sample,143881,142687,9331,133356,24226,109130,64676,5024,24584,2531,89260,12315,5562,1954,14731,16751
CGAGGCAGCTTGAGTT,sample,173346,171935,10946,160989,21188,139801,69442,5079,40212,5192,109654,19876,6188,1938,12185,15182
CATGATTCCTTGAGTT,sample,145569,144321,5759,138562,11138,127424,70968,4494,35357,5073,106325,11532,3458,1628,8570,7619
GTCCTGCCCTTGAGTT,sample,268765,266775,26135,240640,26921,213719,57588,2694,82735,8721,140323,61981,13977,2951,12829,16456
CTAGGACCCTTGAGTT,sample,190216,189136,7479,181657,22102,159555,102315,9143,31477,4415,133792,12205,4691,2171,22338,15811
CGGATTACCTTGAGTT,sample,158342,156458,10114,146344,22588,123756,80042,5966,23983,2995,104025,10770,4879,1698,15167,17424
GTTAGGACCTTGAGTT,sample,129784,128612,6424,122188,24222,97966,64942,3257,17540,1148,82482,11079,2650,992,26846,17339
AACTCGTACTTGAGTT,sample,70908,69954,6317,63637,6534,57103,20708,1821,21317,2398,42025,10859,4654,1170,3985,3997
GAAGGCGCCTTGAGTT,sample,159976,157971,14441,143530,6844,136686,43317,3338,56498,7050,99815,26483,7312,1947,4116,3909
TTGGTTAACTTGAGTT,sample,144367,142734,8904,133830,24735,109095,57431,3720,26921,3507,84352,17516,4857,1560,12810,17858
GGCATATACTTGAGTT,sample,117809,116185,7532,108653,15411,93242,56467,4024,20271,2473,76738,10007,2502,1004,13725,11879
TCAATATACTTGAGTT,sample,135602,134078,10238,123840,15482,108358,61348,4471,24987,2651,86335,14901,5066,1377,13187,9741
TCGCCTGACTTGAGTT,sample,155926,153595,20969,132626,9993,122633,37096,1869,44282,4784,81378,34602,9522,1674,9148,5898
AGGTCGGACTTGAGTT,sample,139978,138000,16338,121662,13715,107947,42697,3171,34982,3459,77679,23638,6483,1316,8572,9747
GGAGAGTTTCGGAGTT,sample,20801,20479,1101,19378,4228,15150,8663,877,3848,461,12511,1301,1485,825,1203,2972
ATTCTCTTTCGGAGTT,sample,44154,43830,3130,40700,5983,34717,14790,1209,12159,1286,26949,5273,2994,1073,4030,4179
AAGTTCGTTCGGAGTT,sample,49421,49002,2464,46538,11711,34827,22024,1738,6894,773,28918,3398,2167,973,7930,8055
GGTTGCGTTCGGAGTT,sample,47268,46721,3820,42901,6234,36667,17370,839,10503,1261,27873,6694,3529,965,4171,4081
ACGTAAGTTCGGAGTT,sample,18834,18641,1134,17507,3503,14004,9400,475,2627,275,12027,1227,1202,602,3138,2548
TTCGTAATTCGGAGTT,sample,47822,47433,2748,44685,9696,34989,21097,1563,8226,912,29323,3191,2674,1302,4984,6826
TTAGAAGTTCGGAGTT,sample,46906,46438,3720,42718,5276,37442,20342,1082,9439,1209,29781,5370,2892,944,5390,3755
TTCCGTCTTCGGAGTT,sample,41249,40831,5125,35706,4780,30926,11005,769,10502,1254,21507,7396,4120,987,2706,3200
GACGGAGATCGGAGTT,sample,28460,28025,1530,26495,4211,22284,13131,941,5026,670,18157,2516,1820,1028,2479,3055
CCAGAGCGTCGGAGTT,sample,37190,36693,4040,32653,4381,28272,10740,873,9276,1089,20016,6294,3699,819,2951,3044
GTTAGCCGTCGGAGTT,sample,21870,21575,1043,20532,5006,15526,12270,448,1976,276,14246,556,765,636,4136,3546
ACCTCGAGTCGGAGTT,sample,22918,22695,966,21729,4357,17372,12428,843,3006,295,15434,800,1145,682,5129,3097
TGGACGAGTCGGAGTT,sample,22423,22135,3309,18826,1935,16891,5344,366,6163,647,11507,4371,2743,570,1742,1199
GACGATAATCGGAGTT,sample,21490,21227,1947,19280,2549,16731,7369,405,5147,493,12516,3317,2294,533,2466,1761
CTAGGACCTCGGAGTT,sample,31796,31375,1939,29436,4058,25378,15813,1199,5240,557,21053,2569,2163,1145,3884,2862
GCCTGAACTCGGAGTT,sample,46431,45805,5151,40654,5403,35251,15298,1086,9886,1046,25184,7935,3802,850,4201,3743
TTGGCCTCTCGGAGTT,Pos_Ctrl,48585,47841,2723,45118,1843,43275,36469,3287,2375,407,38844,737,4933,5729,1996,662
ACCAATGCTCGGAGTT,sample,39342,38578,4884,33694,3307,30387,11685,758,9845,1014,21530,7085,3402,682,3596,2151
TTGGTTAATCGGAGTT,sample,44015,43382,4895,38487,3282,35205,15036,1027,10202,1296,25238,7644,3472,1018,3072,2291
ATGACCGATCGGAGTT,sample,40428,39927,2561,37366,4220,33146,18988,1359,7979,971,26967,3849,2343,796,4770,2668
ATTCTCTTTGAACCTT,Pos_Ctrl,19265,19104,1065,18039,829,17210,14413,1436,933,105,15346,323,3242,3091,1172,456
GGTTGCGTTGAACCTT,sample,7565,7390,1085,6305,847,5458,1182,65,2249,256,3431,1706,1302,283,219,495
TCCTCCGTTGAACCTT,sample,81250,80455,11157,69298,7658,61640,15807,730,23684,2421,39491,18998,7667,1135,4717,4733
TTCGTAATTGAACCTT,sample,42824,42478,4130,38348,6439,31909,11674,558,11148,1577,22822,6952,3911,930,3672,4202
TAGTACGGTGAACCTT,Pos_Ctrl,20661,20470,1226,19244,935,18309,15417,1414,1024,140,16441,314,3431,3291,1345,404
TGAGCGCGTGAACCTT,sample,40904,40591,3345,37246,6182,31064,16743,1249,7826,944,24569,4302,2980,1148,3422,4376
CAACCGCGTGAACCTT,sample,11768,11595,1450,10145,1299,8846,3735,222,2733,288,6468,1868,1648,613,829,833
GGACCTCTTGAACCTT,sample,42215,41663,5540,36123,3627,32496,9929,419,12075,1210,22004,8863,4335,699,3570,2398
CATAACCTTGAACCTT,sample,86067,85126,5806,79320,10078,69242,33263,2098,20892,2713,54155,10276,4134,1102,11049,7796
GACGGAGATGAACCTT,sample,128788,127368,12097,115271,12307,102964,29118,2203,38708,4734,67826,28201,8324,1845,5919,7814
CCAGAGCGTGAACCTT,sample,55197,54643,4026,50617,9935,40682,22618,1827,9425,1065,32043,5747,3677,1517,5453,6915
CCGCAACGTGAACCTT,Pos_Ctrl,35747,35082,2842,32240,1455,30785,25884,2512,1627,193,27511,569,4505,4573,1948,732
CTTGATAGTGAACCTT,sample,106303,105064,12068,92996,11257,81739,27301,1186,29257,3405,56558,20590,6857,1212,8281,8010
ACCTCGAGTGAACCTT,sample,41954,41546,3192,38354,4604,33750,16281,1087,10278,1093,26559,5011,2849,1099,2987,3206
TGGACGAGTGAACCTT,sample,96790,95815,8607,87208,13085,74123,31224,2229,21774,2431,52998,16465,5279,1236,8489,9191
GACGATAATGAACCTT,sample,42838,42199,6767,35432,3398,32034,5381,361,13867,1357,19248,11068,4455,690,682,1880
CGAGGCAGTGAACCTT,sample,77955,77236,3813,73423,14802,58621,41243,3300,9159,1005,50402,3914,3162,1833,9925,10176
AATCCGTCTGAACCTT,Pos_Ctrl,46819,46287,3069,43218,1985,41233,34916,3194,2132,280,37048,711,5056,5548,2663,973
GTCCTGCCTGAACCTT,sample,103349,102130,8721,93409,11581,81828,40663,1903,23013,2273,63676,13976,5578,1169,12026,7421
GCCTGAACTGAACCTT,sample,90928,90036,6438,83598,11084,72514,41720,2545,15338,1706,57058,11205,4544,1628,8845,7976
ACGTATTATGAACCTT,sample,109900,108853,7318,101535,13707,87828,37547,2991,28332,2783,65879,16175,5705,1316,9737,9230
AACTCGTATGAACCTT,sample,80499,79855,4875,74980,15856,59124,39185,3103,10975,1366,50160,4495,2488,988,11688,11316
TTGGCCTCTGAACCTT,sample,59715,59067,3969,55098,7576,47522,20725,1671,15306,1782,36031,8038,3862,896,5628,5065
AATATATCTGAACCTT,sample,67020,66381,5887,60494,9490,51004,20743,1593,15553,2079,36296,11036,4548,892,7730,6151
AAGAGCGCTGAACCTT,sample,89892,88752,8393,80359,8728,71631,33945,2266,20844,2457,54789,12119,4089,1123,6408,6339
TTGGTTAATGAACCTT,sample,71574,70298,5997,64301,10327,53974,35647,2269,10039,1347,45686,4672,2511,1111,9942,8117
GTACCGTATGAACCTT,Pos_Ctrl,47800,46793,3759,43034,1799,41235,34674,3139,2277,335,36951,810,4914,5474,2131,791
GGCATATATGAACCTT,sample,38809,38155,3722,34433,4237,30196,14159,1234,9265,936,23424,4602,2574,808,2428,3230
AGGTCGGATGAACCTT,sample,151176,148906,23274,125632,9727,115905,24499,1576,47122,4948,71621,37760,10474,1690,5088,5714
TATCAGTTACCGAATT,sample,202954,201314,18959,182355,16020,166335,46732,3061,62894,6452,109626,47196,10251,1947,8738,10096
ACGTAAGTACCGAATT,sample,114793,113880,9288,104592,15904,88688,37972,3501,27349,2998,65321,16868,6506,1730,11368,10713
AGTACCATACCGAATT,sample,94120,93261,13176,80085,12494,67591,23836,1851,22599,2762,46435,16543,5661,1251,6804,8239
ACGTTATGACCGAATT,sample,82399,81692,5781,75911,12556,63355,32229,2423,18650,1727,50879,8326,4701,1802,6702,9104
TTCTAATGACCGAATT,sample,100293,99408,9791,89617,10958,78659,35606,2630,22639,2313,58245,15471,6581,1977,5899,7614
ATGCCTGGACCGAATT,sample,49963,49499,3299,46200,5794,40406,21378,1465,11704,1262,33082,4597,3552,1771,3903,3830
TGAGCGCGACCGAATT,sample,47052,46696,2822,43874,7071,36803,21847,1250,8851,1160,30698,3695,2819,1370,6349,4920
CAACCGCGACCGAATT,sample,40763,40374,3058,37316,3865,33451,15176,1094,11055,1495,26231,4631,3093,1221,2753,2732
GGACCTCTACCGAATT,sample,93429,92450,7219,85231,15582,69649,35725,1642,18917,1806,54642,11559,4744,1079,11566,11227
GTTAGCCGACCGAATT,sample,100355,99135,10858,88277,10655,77622,26596,1790,27677,3186,54273,18373,6668,1556,6424,6985
GGACGTAGACCGAATT,sample,103007,101840,6490,95350,17775,77575,48313,2832,15884,1904,64197,8642,3012,1124,15673,13536
ACCTCGAGACCGAATT,sample,56549,55993,2998,52995,8803,44192,29488,2443,7843,821,37331,3597,3122,1992,5873,6191
TGGACGAGACCGAATT,sample,229771,227369,29703,197666,13107,184559,53892,4824,78148,9595,132040,38100,10935,2304,7239,6902
GGCCAGAGACCGAATT,sample,92747,91843,6643,85200,18519,66681,34260,2639,17715,1752,51975,10315,4494,1327,11393,11755
CATTGCAGACCGAATT,sample,70938,69910,10312,59598,5156,54442,15057,808,21763,2395,36820,14419,5649,1182,3590,3173
CCATGAAGACCGAATT,sample,149561,147849,15938,131911,15195,116716,46959,3753,38235,3848,85194,23921,7646,1770,14956,9990
CGTACGTCACCGAATT,sample,81921,81240,6797,74443,12753,61690,29470,2264,16810,1791,46280,11355,5353,1730,6828,7890
TTGGTACCACCGAATT,sample,125401,124192,11254,112938,12328,100610,40801,3837,30692,3301,71493,21979,6801,1259,9307,7907
CGGATTACACCGAATT,sample,179390,177754,7891,169863,27682,142181,97423,5654,24847,3621,122270,10636,3974,1473,15721,19436
ACGTATTAACCGAATT,sample,243449,240819,17728,223091,26555,196536,86489,6189,59481,5887,145970,38490,7693,2061,19969,20577
AATATATCACCGAATT,Neg_Ctrl,1820,975,605,370,40,330,105,4,113,13,218,95,130,48,26,17
ACCAATGCACCGAATT,sample,143839,142112,14973,127139,16417,110722,37861,2740,38418,3990,76279,27713,7039,1453,9813,11880
TGCTTCGCACCGAATT,sample,24690,24347,5728,18619,1791,16828,2571,199,7100,794,9671,6164,3363,495,528,905
GTCTTAGCACCGAATT,sample,61259,59289,8082,51207,4286,46921,15883,960,17684,1912,33567,10482,4824,1106,4600,2590
TTGGTTAAACCGAATT,sample,87753,86348,7557,78791,10884,67907,27501,2187,22980,2490,50481,12749,4510,1004,5270,7170
AGGTCGGAACCGAATT,sample,135600,133875,14643,119232,10264,108968,50372,2595,31464,3333,81836,21204,6300,1183,11255,7322
ATGACCGAACCGAATT,sample,46042,45378,5784,39594,3482,36112,11646,1044,13194,1512,24840,8716,3812,836,2691,2184
GGAGAGTTGGTCTGGT,sample,3994,3910,278,3632,615,3017,1723,139,796,75,2519,284,669,381,265,376
ATTCTCTTGGTCTGGT,sample,85172,84701,6018,78683,8736,69947,30365,2285,22749,2998,53114,11550,5454,1542,4750,5392
TCCAACTTGGTCTGGT,Neg_Ctrl,947,500,217,283,36,247,112,5,91,13,203,26,97,41,26,13
ACGTTATGGGTCTGGT,sample,85862,85414,2607,82807,18968,63839,47773,4730,7530,947,55303,2859,2472,1743,11176,13138
TTCTAATGGGTCTGGT,sample,36587,36293,3019,33274,7240,26034,13554,940,6693,770,20247,4077,2954,927,4136,4735
TAGTACGGGGTCTGGT,sample,11591,11469,1149,10320,1795,8525,3308,258,2822,287,6130,1850,1684,570,906,1153
TGAGCGCGGGTCTGGT,Neg_Ctrl,670,451,244,207,36,171,66,5,55,7,121,38,71,32,24,24
AATGGTAAGGTCTGGT,sample,69421,68861,5860,63001,6459,56542,22941,1295,21045,2192,43986,9069,4839,1379,5159,4167
CAAGGCCTGGTCTGGT,sample,131362,130190,9292,120898,17547,103351,46843,3877,29604,3166,76447,19861,6493,1701,11896,11626
CCGCAACGGGTCTGGT,sample,70991,70204,5013,65191,8358,56833,27733,2023,17039,1783,44772,8255,4219,1270,7732,6052
GGACGTAGGGTCTGGT,Neg_Ctrl,1196,687,410,277,33,244,88,17,52,22,140,65,79,39,15,20
CTTGATAGGGTCTGGT,sample,85147,84505,3252,81253,16650,64603,48646,3441,8359,1036,57005,3121,2136,1296,14925,12087
TGGACGAGGGTCTGGT,sample,95281,94406,6571,87835,9173,78662,38686,2564,22184,2247,60870,12981,5661,2025,5008,5986
CGAGGCAGGGTCTGGT,sample,72104,71295,4695,66600,10248,56352,30954,2794,14411,2462,45365,5731,2595,968,6736,7032
CGTACGTCGGTCTGGT,Neg_Ctrl,1369,860,433,427,50,377,188,17,108,4,296,60,142,73,28,19
AGTCCGCAGGTCTGGT,sample,84312,83246,6485,76761,13157,63604,37247,2821,13716,1541,50963,8279,3134,957,11952,10062
AATATATCGGTCTGGT,sample,82083,81194,3716,77478,14070,63408,45597,3284,11727,863,57324,1937,1119,724,10241,10373
TGCTTCGCGGTCTGGT,sample,54992,54268,3968,50300,8005,42295,25012,2277,8187,1238,33199,5581,2673,888,5272,5790
GAAGGCGCGGTCTGGT,sample,165147,162868,22867,140001,11714,128287,32294,2015,47720,5517,80014,40741,11740,1951,6898,6914
AAGAGCGCGGTCTGGT,sample,26500,25985,3590,22395,1703,20692,4535,380,8710,1000,13245,6067,3350,554,697,931
GTCTTAGCGGTCTGGT,sample,160680,159038,9798,149240,8929,140311,60611,6106,51109,7905,111720,14580,4105,1445,5215,6791
GTACCGTAGGTCTGGT,sample,83818,82821,6318,76503,8594,67909,38454,3412,15200,1767,53654,9076,4401,1262,6590,5351
GGCATATAGGTCTGGT,Neg_Ctrl,1109,605,355,250,23,227,111,4,76,14,187,22,84,43,20,6
TCGCCTGAGGTCTGGT,sample,82247,81159,6570,74589,8608,65981,34129,2801,16860,1903,50989,10288,4074,1065,5741,5641
ATGACCGAGGTCTGGT,sample,93216,92083,7202,84881,8574,76307,37136,2363,21948,2756,59084,12104,4171,1131,6656,5898
GACCGGAAGGTCTGGT,sample,39954,39502,2666,36836,6295,30541,20166,1463,5391,1008,25557,2513,1762,752,5026,4443
GGAGAGTTCGACGTTA,sample,91829,90834,4929,85905,8516,77389,47782,3833,16710,2197,64492,6867,3330,1034,4698,5811
TATCAGTTCGACGTTA,sample,96321,95595,4901,90694,22006,68688,43418,5094,13839,1619,57257,4718,2573,936,10628,15530
ATTCTCTTCGACGTTA,sample,104669,103415,10288,93127,9820,83307,19973,996,33321,4167,53294,24850,6914,975,4583,5564
TCCTCCGTCGACGTTA,sample,87474,86724,6969,79755,11478,68277,29484,2019,21477,2401,50961,12896,5228,1194,7825,7797
ACGTAAGTCGACGTTA,sample,83877,83095,7393,75702,12953,62749,28658,1950,18243,2315,46901,11583,4963,1053,8493,8954
AGTACCATCGACGTTA,sample,91852,91059,8562,82497,13496,69001,31140,2507,20602,2489,51742,12263,4693,1154,10857,10032
TGAGCGCGCGACGTTA,sample,67896,67404,5368,62036,10194,51842,24067,1233,16502,1624,40569,8416,3798,1022,7978,6858
TTCCGTCTCGACGTTA,sample,93524,92872,6497,86375,19513,66862,42130,2570,12804,2104,54934,7254,3422,1096,11096,13372
TCGCATCTCGACGTTA,sample,43163,42739,2491,40248,6361,33887,16722,1249,9998,1421,26720,4497,2925,1052,4494,4452
ACTATACTCGACGTTA,sample,65964,65314,8139,57175,7141,50034,16274,1352,19539,2035,35813,10834,5395,1142,4632,4728
CCAGAGCGCGACGTTA,sample,113927,112816,5979,106837,25551,81286,52848,4029,15489,2029,68337,6891,2675,1095,16052,17110
GGAGGACGCGACGTTA,sample,103605,102549,10422,92127,9016,83111,22711,1708,34680,3960,57391,20052,6684,1322,2898,5900
CTTGATAGCGACGTTA,sample,51317,50712,5529,45183,9433,35750,18234,1207,9946,1057,28180,5306,3661,1335,4710,6309
ACCTCGAGCGACGTTA,sample,47375,46957,4422,42535,6601,35934,13305,1097,13866,1415,27171,6251,3883,1171,3442,4484
GGCCAGAGCGACGTTA,sample,81661,80939,4514,76425,12592,63833,38145,2151,15988,2078,54133,5471,2905,1037,12126,8987
CGAGGCAGCGACGTTA,sample,104766,103836,8405,95431,13080,82351,33878,2387,26260,2672,60138,17154,6259,1523,9443,8688
AGTCCGCACGACGTTA,sample,194329,192978,12982,179996,16859,163137,84032,5503,47928,5001,131960,20673,6329,1908,17308,12806
TTGGTACCCGACGTTA,sample,370818,367968,31580,336388,26771,309617,140485,8417,90220,9726,230705,60769,12052,2873,22878,17833
CGTATGAACGACGTTA,sample,69723,69010,4201,64809,11680,53129,32740,2592,11082,1349,43822,5366,2823,1162,8910,8394
TTGGCCTCCGACGTTA,sample,167587,166172,10375,155797,20046,135751,59501,2389,49919,6554,109420,17388,4696,1262,17635,14824
GTCTTAGCCGACGTTA,sample,57541,56682,3922,52760,8192,44568,20425,1915,14022,1368,34447,6838,2880,824,3011,5669
CTTCATGACGACGTTA,sample,227122,225137,17792,207345,22538,184807,70872,7955,61815,5929,132687,38236,9714,2023,18476,15967
ATGACCGACGACGTTA,sample,159767,158502,11528,146974,16269,130705,59598,4538,38503,4902,98101,23164,6131,1425,14027,10757
GGAGAGTTTACTAAGT,sample,293829,290953,34570,256383,22914,233469,70982,5941,82605,8255,153587,65686,14207,2815,12002,13751
ATGCCTGGTACTAAGT,sample,33677,33338,1842,31496,8276,23220,15317,1326,4440,413,19757,1724,1276,715,5590,5700
TTCCGTCTTACTAAGT,sample,8196,8082,969,7113,765,6348,2059,175,2371,286,4430,1457,1332,420,341,460
TCGCATCTTACTAAGT,sample,17522,17313,2359,14954,1497,13457,3817,304,5235,549,9052,3552,2489,559,979,904
GCCTTGCTTACTAAGT,sample,8674,8522,852,7670,593,7077,2272,173,2876,276,5148,1480,1466,537,182,367
GACGGAGATACTAAGT,sample,20618,20370,1531,18839,3980,14859,9023,471,3362,366,12385,1637,1395,596,2842,2731
GTTAGCCGTACTAAGT,sample,10872,10695,1143,9552,2198,7354,3856,250,1840,194,5696,1214,1366,655,1194,1392
ACCTCGAGTACTAAGT,sample,10928,10784,1117,9667,1725,7942,3444,222,2548,268,5992,1460,1430,504,1116,1246
GGCCAGAGTACTAAGT,sample,35457,34996,3598,31398,4431,26967,10991,550,8177,1012,19168,6237,3201,654,3748,3004
CATTGCAGTACTAAGT,sample,23958,23610,3526,20084,2855,17229,5943,484,5878,537,11821,4387,3275,960,1542,1896
CGAGGCAGTACTAAGT,sample,70259,69541,7977,61564,5298,56266,20335,1638,22745,2647,43080,8901,5061,1591,2975,3004
CCATGAAGTACTAAGT,sample,28102,27779,2375,25404,4290,21114,11564,815,4994,656,16558,3085,1956,780,4189,3065
GTCCTGCCTACTAAGT,sample,40909,40419,3286,37133,6482,30651,16633,918,7646,897,24279,4557,2510,865,5015,4646
CTAGGACCTACTAAGT,sample,41722,41182,4038,37144,5905,31239,14344,1069,9217,1071,23561,5538,3292,1117,3568,3979
TGCTTCGCTACTAAGT,sample,96658,94854,15606,79248,6382,72866,19632,1281,27110,2937,46742,21906,8472,1383,3183,3708
GTCTTAGCTACTAAGT,sample,29587,29199,2074,27125,2718,24407,14693,1281,5140,424,19833,2869,2134,993,2691,1857
TTGGTTAATACTAAGT,sample,47432,46731,4818,41913,3624,38289,15135,1024,13187,1313,28322,7630,3619,1002,3069,2507
CTTCATGATACTAAGT,sample,42096,41535,3008,38527,2750,35777,17283,1416,11612,1280,28895,4186,2473,1015,3086,1710
ATGACCGATACTAAGT,sample,29298,28938,3452,25486,2921,22565,9241,628,6998,658,16239,5040,2990,764,2559,2085
GACCGGAATACTAAGT,sample,13990,13825,701,13124,2150,10974,7715,548,1825,245,9540,641,1228,845,1681,1460
TATCAGTTTTGCCGCT,sample,185844,184346,12079,172267,27725,144542,63885,3860,45821,5000,109706,25976,6767,1620,23202,19570
TCCAACTTTTGCCGCT,sample,188920,187325,8791,178534,40921,137613,88201,6250,24684,2639,112885,15839,3801,1480,31524,29063
GGTTGCGTTTGCCGCT,sample,38506,38034,2811,35223,6734,28489,15966,1221,7103,678,23069,3521,2408,917,5315,4763
ACGTTATGTTGCCGCT,sample,37164,36757,3316,33441,4318,29123,10875,723,11087,1166,21962,5272,3462,987,3126,2830
TTAGAAGTTTGCCGCT,sample,86836,85960,4254,81706,19968,61738,43346,2774,10801,1203,54147,3614,2712,1539,15115,14014
TCGCATCTTTGCCGCT,sample,85902,85069,4052,81017,20697,60320,37752,2892,12570,1086,50322,6020,2743,1130,12794,14362
GCCTTGCTTTGCCGCT,sample,62087,61250,2386,58864,14343,44521,33770,2612,5769,873,39539,1497,1713,1429,11195,10248
CATAACCTTTGCCGCT,sample,53464,52570,3397,49173,10667,38506,18143,1526,11846,1411,29989,5580,2990,962,4703,7269
ACTATACTTTGCCGCT,sample,72040,71404,5689,65715,9196,56519,26991,1761,16732,2450,43723,8585,4934,1793,8740,6629
GACGGAGATTGCCGCT,sample,65556,64913,5627,59286,9113,50173,21236,1120,15678,1718,36914,10421,5203,1289,6994,6116
CTTGATAGTTGCCGCT,sample,75394,74494,6185,68309,9631,58678,28126,2021,16741,1784,44867,10006,4852,1332,9999,6442
TGGACGAGTTGCCGCT,sample,85791,84994,3707,81287,16870,64417,44186,3042,11652,1465,55838,4072,2076,991,16940,11904
GACGATAATTGCCGCT,sample,59763,58917,3810,55107,11500,43607,28424,1938,8185,771,36609,4289,2037,1030,8315,7744
GGCCAGAGTTGCCGCT,sample,72767,72027,5826,66201,12698,53503,30038,2740,12485,1495,42523,6745,3087,1286,7198,8474
CATTGCAGTTGCCGCT,sample,160883,159436,17366,142070,14633,127437,36712,2829,49499,5569,86211,32828,9229,1751,8852,9608
CGAGGCAGTTGCCGCT,sample,166838,165374,13791,151583,21902,129681,65707,5749,34964,3930,100671,19331,7168,2269,13907,15535
AGTCCGCATTGCCGCT,sample,275434,272453,25931,246522,27198,219324,70625,7665,73863,8642,144488,58529,12025,2443,13990,16229
TTGGTACCTTGCCGCT,sample,117935,116739,9434,107305,19105,88200,46259,3299,23033,2654,69292,12955,5269,1672,13427,13865
CGGATTACTTGCCGCT,sample,132148,130887,8845,122042,20761,101281,56692,4138,24384,2774,81076,13293,5106,1785,16643,14655
GTTAGGACTTGCCGCT,sample,150402,149005,12451,136554,20871,115683,57891,3769,28421,3430,86312,22172,5935,1675,15037,15721
TTGGCCTCTTGCCGCT,sample,60406,59633,6868,52765,8674,44091,22132,1652,11566,1413,33698,7328,3814,1038,6540,5939
AATATATCTTGCCGCT,sample,46234,45458,5786,39672,4187,35485,14776,1093,11419,1193,26195,7004,3933,979,4193,2785
TCAATATATTGCCGCT,sample,96695,95701,5526,90175,11838,78337,46112,3840,17549,2397,63661,8439,3765,1657,8462,8530
CTTCATGATTGCCGCT,sample,99613,98647,5280,93367,12259,81108,51431,3260,18010,1855,69441,6552,3541,1360,12252,9059
TTATTCGATTGCCGCT,sample,83106,81902,8014,73888,8152,65736,25745,2039,21953,2287,47698,13712,5357,1091,5723,5094
ATTCTCTTTTCGACCT,sample,67799,67074,3408,63666,15095,48571,32389,2553,8955,1023,41344,3651,2600,1615,8854,10151
ACGTAAGTTTCGACCT,sample,126662,125521,9851,115670,24782,90888,45265,3010,25401,2500,70666,14712,4919,1407,14287,17259
TTCTAATGTTCGACCT,sample,92112,91233,9290,81943,12140,69803,30242,1749,21936,2280,52178,13596,5793,1238,10584,8341
ATGCCTGGTTCGACCT,sample,87405,86452,7753,78699,7983,70716,27509,1846,24421,2990,51930,13950,5166,1548,4991,5360
CCAGAGCGTTCGACCT,sample,104079,102986,4496,98490,15571,82919,46874,4002,22270,3292,69144,6481,2996,1333,11713,11956
GTTAGCCGTTCGACCT,sample,92206,91273,7935,83338,12492,70846,39157,2398,16812,2147,55969,10332,4525,1071,11543,8338
CTTGATAGTTCGACCT,sample,69620,68539,4976,63563,9615,53948,25507,2172,16978,1727,42485,7564,3700,933,6059,6306
CATTGCAGTTCGACCT,sample,107930,106861,8925,97936,11566,86370,40258,2900,25286,2729,65544,15197,5775,1835,8354,7332
CGAGGCAGTTCGACCT,sample,85984,84942,6321,78621,14893,63728,31284,2847,17551,2027,48835,10019,4447,1058,8661,10177
AATCCGTCTTCGACCT,sample,166517,165119,18788,146331,18552,127779,53251,2811,38703,4671,91954,28343,8338,1757,14862,12087
CGTACGTCTTCGACCT,sample,113127,112021,8534,103487,18038,85449,45375,4191,21777,2507,67152,11599,3963,1207,12075,12338
GTCCTGCCTTCGACCT,sample,88366,87368,6863,80505,11911,68594,32754,2038,20904,2169,53658,10729,4691,1236,5546,7504
CGTATGAATTCGACCT,sample,175431,173555,16878,156677,13753,142924,63657,4153,44226,4516,107883,26372,7684,2078,14354,9504
ACCAATGCTTCGACCT,sample,150301,148963,9941,139022,13934,125088,59304,4699,39073,4551,98377,17461,5361,1726,9216,8581
GTACCGTATTCGACCT,sample,161406,159531,10821,148710,9527,139183,63307,4188,47147,5308,110454,19233,5285,1649,8141,5636
GGCATATATTCGACCT,sample,117940,117026,6732,110294,17598,92696,54466,5325,19248,2778,73714,10879,5030,1661,10231,13014
TCAATATATTCGACCT,sample,371232,367960,42864,325096,24101,300995,67571,3767,117930,12083,185501,99644,15998,3415,14052,13033
TTATTCGATTCGACCT,sample,129851,128803,9828,118975,15877,103098,48582,4662,27183,3153,75765,19518,5701,1440,11613,10268
GACCGGAATTCGACCT,sample,148414,147251,10245,137006,18367,118639,61595,5830,28189,3674,89784,19351,6038,1519,13350,12587
AAGTTCGTTCCAGACT,sample,1573,1524,175,1349,293,1056,390,33,383,32,773,218,314,121,62,175
GGTTGCGTTCCAGACT,sample,7465,7402,738,6664,827,5837,2184,159,2016,221,4200,1257,1281,419,678,477
ACGTTATGTCCAGACT,sample,5117,5050,319,4731,1611,3120,1683,131,723,85,2406,498,767,403,599,936
TTCTAATGTCCAGACT,sample,22320,22117,2702,19415,2942,16473,6334,379,5298,546,11632,3916,2758,663,1880,1894
TGAGCGCGTCCAGACT,sample,38011,37608,3649,33959,5337,28622,11212,920,8736,865,19948,6889,3693,954,2835,3523
CAACCGCGTCCAGACT,sample,15422,15247,1417,13830,2634,11196,5350,355,3232,467,8582,1792,1731,605,1714,1764
TTAGAAGTTCCAGACT,sample,17088,16847,2010,14837,2175,12662,4732,218,4457,486,9189,2769,2042,479,1575,1458
TTCCGTCTTCCAGACT,sample,25251,24994,1838,23156,4582,18574,9986,639,5068,439,15054,2442,1742,741,3160,3387
GCCTTGCTTCCAGACT,sample,42970,42538,2360,40178,8653,31525,22133,1836,4480,524,26613,2552,1799,1247,4811,5996
CAAGGCCTTCCAGACT,sample,21958,21744,2333,19411,3483,15928,7203,574,4428,465,11631,3258,2162,776,1988,2249
CATAACCTTCCAGACT,sample,31179,30616,3581,27035,4564,22471,10963,787,6612,718,17575,3391,2456,1002,3060,3148
CCAGAGCGTCCAGACT,sample,30862,30572,2019,28553,5677,22876,14646,1433,4254,638,18900,1905,2248,1285,3029,3834
GGAGGACGTCCAGACT,sample,54516,53991,4647,49344,3599,45745,17966,1167,17800,2141,35766,6671,3590,1282,2065,2291
CATTGCAGTCCAGACT,sample,42480,41990,3453,38537,6753,31784,15863,1113,8526,901,24389,5381,3316,1115,4084,4856
CATGATTCTCCAGACT,sample,34166,33672,2537,31135,4769,26366,14762,1123,6243,741,21005,3497,2647,1239,3240,3372
TTGGTACCTCCAGACT,sample,50038,48716,5820,42896,4515,38381,15792,1125,12451,1221,28243,7792,4083,1036,3583,2590
GTTAGGACTCCAGACT,Pos_Ctrl,25492,25101,1869,23232,1070,22162,18428,1767,1269,158,19697,540,3883,3754,1255,478
GCCTGAACTCCAGACT,sample,27101,26708,2559,24149,2639,21510,10010,951,6367,502,16377,3680,2694,933,2155,1841
TTGGCCTCTCCAGACT,Pos_Ctrl,21380,21007,1492,19515,827,18688,15626,1434,1087,122,16713,419,3498,3311,989,383
AATATATCTCCAGACT,sample,50096,49420,7322,42098,3448,38650,11894,1074,13578,1721,25472,10383,4776,872,2972,2017
ACCAATGCTCCAGACT,sample,47673,47101,4088,43013,2878,40135,17221,1133,14546,1734,31767,5501,3499,1355,1994,1749
GAAGGCGCTCCAGACT,sample,26596,26249,2113,24136,2753,21383,14862,992,3102,446,17964,1981,1486,834,3122,2022
AAGAGCGCTCCAGACT,sample,31485,30834,3593,27241,2230,25011,8592,610,9265,1008,17857,5536,3188,720,2329,1405
GTCTTAGCTCCAGACT,sample,28488,28022,4600,23422,1856,21566,6864,518,7971,793,14835,5420,3327,831,1330,1166
TCAATATATCCAGACT,sample,23696,23323,2454,20869,2429,18440,9030,644,5437,481,14467,2848,1995,651,1763,1702
TCGCCTGATCCAGACT,sample,15375,15131,1052,14079,2028,12051,7039,457,2995,441,10034,1119,1178,572,1702,1496
AGGTCGGATCCAGACT,sample,24833,24398,1302,23096,3907,19189,14652,1185,2211,235,16863,906,719,588,4803,2930
TTATTCGATCCAGACT,sample,34184,33615,4288,29327,1868,27459,7979,446,11997,1404,19976,5633,3499,919,1283,914
GGTTGCGTACCATTAT,sample,63541,62868,6570,56298,12025,44273,17520,1195,15131,1833,32651,8594,4380,1172,4957,7650
TCCTCCGTACCATTAT,sample,162739,161432,11646,149786,25776,124010,61689,4590,36669,4662,98358,16400,5873,1841,15570,17807
AGTACCATACCATTAT,sample,251992,249449,23821,225628,29246,196382,78546,5247,66995,7029,145541,38565,10295,2420,20799,20698
TAGTACGGACCATTAT,sample,19017,18765,1114,17651,5293,12358,7794,523,2611,300,10405,1130,1564,865,2841,3349
CAACCGCGACCATTAT,sample,80298,79502,5307,74195,16253,57942,33287,2270,13453,1334,46740,7598,3161,1110,12679,11599
AATGGTAAACCATTAT,sample,199043,197787,9443,188344,41046,147298,91652,6249,34941,4694,126593,9762,2997,1518,24895,27147
TTAGAAGTACCATTAT,sample,265790,263717,18719,244998,41733,203265,113614,9590,45553,4257,159167,30251,9498,3029,21426,29900
CTTGATAGACCATTAT,sample,208701,207103,11721,195382,28038,167344,113584,7312,28451,3843,142035,14154,4724,1705,19309,20951
ACCTCGAGACCATTAT,sample,110769,109801,7872,101929,18337,83592,47709,3848,20490,2170,68199,9375,4879,1761,9704,12430
TGGACGAGACCATTAT,sample,107181,105977,8921,97056,19282,77774,41237,2652,19154,1963,60391,12768,4900,1074,11322,12552
GACGATAAACCATTAT,sample,155405,154012,9866,144146,25773,118373,69869,5559,25479,3106,95348,14360,4007,1267,24326,18821
CGAGGCAGACCATTAT,sample,74626,73628,11136,62492,6533,55959,16168,1054,21813,2271,37981,14653,6145,1343,3675,4129
CCATGAAGACCATTAT,sample,197424,195472,14180,181292,26511,154781,87254,6188,35106,4877,122360,21356,5905,1600,24368,19223
AGTCCGCAACCATTAT,sample,265698,263331,20400,242931,35743,207188,103434,7069,54813,6135,158247,35737,8031,2118,31769,26209
CGGATTACACCATTAT,sample,105926,104785,7998,96787,17092,79695,46751,3720,19020,2092,65771,8112,4377,1438,11609,11101
GTTAGGACACCATTAT,sample,209335,207210,22474,184736,13072,171664,59151,4857,64293,6455,123444,36908,9817,2290,12147,8342
ACCAATGCACCATTAT,sample,262124,259050,36661,222389,19348,203041,58745,4992,75271,7718,134016,56315,12906,2463,14370,12385
TGCTTCGCACCATTAT,sample,96453,95596,5898,89698,16838,72860,46617,3414,15050,1900,61667,5879,3452,1405,12271,12204
AAGTTCGTCAATGGAT,sample,29010,28828,1926,26902,5981,20921,10055,806,6636,815,16691,2609,2165,849,2906,3987
GGTTGCGTCAATGGAT,sample,64202,63800,3658,60142,12652,47490,29430,1961,10414,1270,39844,4415,2762,1162,8172,8643
ATGCCTGGCAATGGAT,sample,82258,81517,2746,78771,23164,55607,41875,3079,7462,685,49337,2506,1575,1102,15008,15241
GGACCTCTCAATGGAT,sample,35596,35226,3137,32089,5624,26465,13936,1027,6262,775,20198,4465,2535,772,4494,4202
TCGCATCTCAATGGAT,sample,63638,63039,4544,58495,7538,50957,22305,1059,16541,2302,38846,8750,4103,960,6231,5187
CATAACCTCAATGGAT,sample,129381,128204,9447,118757,23379,95378,46954,3420,24536,3113,71490,17355,5880,1522,16813,16548
CTTGATAGCAATGGAT,sample,98597,97816,6157,91659,16160,75499,44762,3545,16013,1573,60775,9606,5327,2411,11465,11355
GACGATAACAATGGAT,sample,103552,102553,12043,90510,8394,82116,26567,2004,32319,3471,58886,17755,7192,1772,5002,5460
CCATGAAGCAATGGAT,sample,46795,46190,5131,41059,7013,34046,13835,1062,10834,1234,24669,7081,3698,775,4411,4443
CGTACGTCCAATGGAT,sample,156153,154943,11679,143264,22158,121106,63508,4810,32000,3475,95508,17313,4812,1353,19179,15114
CGGATTACCAATGGAT,sample,132647,131191,10161,121030,21617,99413,54790,4009,22649,2392,77439,15573,4988,1139,18446,14911
GCCTGAACCAATGGAT,Neg_Ctrl,1927,947,573,374,41,333,131,19,74,9,205,100,117,68,35,16
CGTATGAACAATGGAT,sample,172477,170213,21222,148991,19533,129458,55881,4220,38041,3175,93922,28141,7912,1558,19013,14486
AATATATCCAATGGAT,Neg_Ctrl,1529,812,625,187,20,167,47,6,61,12,108,41,61,24,21,7
GTACCGTACAATGGAT,sample,121358,119785,12690,107095,10237,96858,27220,2002,37068,4043,64288,26525,7044,1388,7422,6663
TCGCCTGACAATGGAT,sample,63911,62819,7838,54981,6346,48635,16442,1163,16221,1787,32663,13022,5033,906,3331,4070
AGGTCGGACAATGGAT,Pos_Ctrl,62154,60641,4384,56257,2520,53737,44958,4342,3050,371,48008,1016,5400,6311,2799,1187
GGAGAGTTAGATTCAT,sample,99216,98618,7235,91383,11983,79400,36092,2638,22113,2886,58205,15671,6348,1559,11305,7916
TCCAACTTAGATTCAT,sample,130927,129674,8904,120770,7577,113193,46838,3257,38403,4847,85241,19848,5820,1426,3199,4708
CCTCTAGAAGATTCAT,sample,20889,20646,2343,18303,3136,15167,6609,404,4977,476,11586,2701,2160,672,2495,2038
AGTACCATAGATTCAT,sample,53624,52900,3050,49850,13989,35861,27483,2179,4583,818,32066,798,1084,925,9523,9481
ACGTTATGAGATTCAT,sample,78279,77722,2838,74884,18815,56069,43185,3661,6513,985,49698,1725,1164,1024,13501,12957
TAGTACGGAGATTCAT,sample,46231,45602,2765,42837,10695,32142,21010,1441,6343,669,27353,2679,1930,851,8112,6849
CAAGGCCTAGATTCAT,sample,91700,90973,5423,85550,18226,67324,45042,3748,12641,1371,57683,4522,2815,1262,16152,12953
GGAGGACGAGATTCAT,sample,104688,103904,6077,97827,11840,85987,45788,3749,24091,2844,69879,9515,3984,1621,7955,8770
CCGCAACGAGATTCAT,sample,96366,95469,8221,87248,12853,74395,35512,1535,20168,1962,55680,15218,5576,1209,10603,8986
ACCTCGAGAGATTCAT,sample,78448,77728,4383,73345,14060,59285,36130,2159,12394,1457,48524,7145,3337,1204,12535,9888
CATTGCAGAGATTCAT,sample,83263,82328,7070,75258,10697,64561,26858,2191,20893,2524,47751,12095,5053,1244,6579,7114
CCATGAAGAGATTCAT,sample,105558,104609,5494,99115,9280,89835,40084,2921,30323,4240,70407,12267,4283,1379,4340,5632
TTGGTACCAGATTCAT,sample,136584,134830,13541,121289,11687,109602,50921,3543,32097,3074,83018,19967,6261,1391,9891,7321
GCCTGAACAGATTCAT,sample,137887,136314,12438,123876,9828,114048,42319,3587,40325,5291,82644,22526,6878,1752,5935,5964
ACGTATTAAGATTCAT,sample,226426,224283,12460,211823,19550,192273,121654,10518,35409,4548,157063,20144,6277,2146,13743,14439
TGCTTCGCAGATTCAT,sample,59100,58331,6210,52121,8214,43907,23615,1786,10740,853,34355,6913,2735,890,7359,5830
AAGAGCGCAGATTCAT,sample,50259,49445,9195,40250,4197,36053,10457,590,13893,1559,24350,9554,5004,974,2445,2696
TTGGTTAAAGATTCAT,sample,112278,111179,7334,103845,9402,94443,46035,3025,30596,2769,76631,12018,4315,1511,8356,6497
TCGCCTGAAGATTCAT,sample,46885,46175,3853,42322,4442,37880,19376,1418,10376,1455,29752,5255,2953,959,1602,3216
CTTCATGAAGATTCAT,sample,103294,101985,10238,91747,10183,81564,43750,3324,19775,2634,63525,12081,4615,1144,9199,7210
GACCGGAAAGATTCAT,sample,117414,116046,8224,107822,12751,95071,45346,4470,27952,3657,73298,13646,4838,1270,10236,9640
GGAGAGTTCAATCTTG,sample,1815,1727,139,1588,327,1261,758,68,248,34,1006,153,306,202,197,181
ATTCTCTTCAATCTTG,sample,58441,58059,3079,54980,5510,49470,18689,1489,20706,2018,39395,6568,3653,1060,2177,3710
AAGTTCGTCAATCTTG,sample,156288,155367,8116,147251,15509,131742,61772,5657,41015,4565,102787,18733,6258,1782,6389,10486
ACGTTATGCAATCTTG,sample,31216,30982,2598,28384,5901,22483,10945,939,5830,728,16775,4041,2858,863,3217,3693
TTCTAATGCAATCTTG,sample,24349,24131,3081,21050,3566,17484,6929,377,5526,600,12455,4052,2982,797,2094,2269
TAGTACGGCAATCTTG,sample,76085,75460,7033,68427,9784,58643,22793,1714,18659,2292,41452,13185,6055,1240,7176,6779
AATGGTAACAATCTTG,sample,54856,54460,3856,50604,10845,39759,23412,1723,8457,842,31869,5325,3539,1553,7367,7355
TTCCGTCTCAATCTTG,sample,51298,50736,5494,45242,5327,39915,12739,580,15339,1745,28078,9512,4674,895,3230,3452
TCGCATCTCAATCTTG,sample,47019,46751,2134,44617,9799,34818,24350,1742,5502,691,29852,2533,1761,1110,7802,6803
GACGGAGACAATCTTG,sample,104590,103552,9383,94169,11817,82352,35625,2097,26815,2941,62440,14874,5552,1448,7855,8169
CCGCAACGCAATCTTG,sample,124492,123348,14385,108963,7392,101571,30618,2136,45819,4530,76437,18468,7444,1931,6015,4804
CTTGATAGCAATCTTG,sample,121360,120283,12059,108224,13771,94453,42191,3570,28416,2611,70607,17665,5827,1655,12301,9275
ACCTCGAGCAATCTTG,sample,87649,86772,4687,82085,14892,67193,37753,3304,15854,1729,53607,8553,3033,1075,11654,10549
CATTGCAGCAATCTTG,sample,134803,133436,13742,119694,16840,102854,39612,2788,33744,3847,73356,22863,7869,1598,8499,11025
CCATGAAGCAATCTTG,sample,119862,118429,12859,105570,14858,90712,37424,3281,29385,3934,66809,16688,6617,1796,8878,10023
GTTAGGACCAATCTTG,sample,132559,131038,8721,122317,19995,102322,64869,3746,20023,2953,84892,10731,3265,1173,20685,15041
GCCTGAACCAATCTTG,sample,186240,184032,21715,162317,16894,145423,51762,4360,48433,5277,100195,35591,9515,2035,9698,10121
ACGTATTACAATCTTG,sample,79606,78524,8909,69615,6876,62739,27718,1901,19147,2051,46865,11922,5603,1601,4225,4178
CGTATGAACAATCTTG,sample,189075,186551,25136,161415,16356,145059,43546,4286,51437,5685,94983,40105,10471,1984,10621,10125
AATATATCCAATCTTG,sample,138828,136236,20049,116187,11899,104288,37972,2092,33471,3328,71443,27425,7887,1269,10282,7738
AAGAGCGCCAATCTTG,sample,26710,26244,3156,23088,2476,20612,9044,606,6611,767,15655,3584,2612,765,2049,1784
GTCTTAGCCAATCTTG,sample,133039,130791,16274,114517,8475,106042,35072,2451,36440,3831,71512,28248,8517,1578,8281,5715
TTGGTTAACAATCTTG,sample,94075,92650,7032,85618,11538,74080,44650,2981,16276,2206,60926,7967,2996,1049,10530,8496
TCAATATACAATCTTG,sample,87825,86666,5349,81317,10284,71033,48067,3987,12006,1552,60073,5421,2793,1399,7088,8758
TTATTCGACAATCTTG,Neg_Ctrl,2019,1256,492,764,56,708,301,26,237,29,538,115,304,119,19,43
ATGACCGACAATCTTG,sample,81757,80359,9048,71311,7051,64260,30454,2114,17203,2074,47657,12415,4784,1082,6419,4106
TATCAGTTCGTTCCGA,sample,158977,157647,13351,144296,14103,130193,58691,4235,36773,4358,95464,26136,7479,1378,14721,9256
ATTCTCTTCGTTCCGA,sample,141248,140110,7108,133002,29264,103738,62093,4947,21789,2800,83882,12109,3365,1035,15034,19948
TTCGTAATCGTTCCGA,sample,74716,73916,8403,65513,5255,60258,19903,1242,24889,2752,44792,11472,4680,1183,989,3386
ACGTTATGCGTTCCGA,sample,36451,36180,4585,31595,6002,25593,9293,537,8781,1000,18074,5982,3729,885,2821,3475
GGACCTCTCGTTCCGA,sample,39861,39401,2184,37217,9148,28069,17739,1173,6328,718,24067,2111,1611,751,6585,6169
TCGCATCTCGTTCCGA,sample,89577,89004,4697,84307,19942,64365,41836,3401,11981,1074,53817,6073,3226,1193,14878,13471
ACCTCGAGCGTTCCGA,sample,173706,172371,17709,154662,18980,135682,53849,3096,43476,6235,97325,29026,8319,1817,12854,12726
CATGATTCCGTTCCGA,sample,175646,173797,14347,159450,22185,137265,68032,5063,38396,4609,106428,21165,6954,1648,19322,14879
CGTACGTCCGTTCCGA,sample,265599,263425,19786,243639,26025,217614,108598,7056,59269,5769,167867,36922,9209,2410,17034,18932
TTGGTACCCGTTCCGA,sample,256290,254199,22598,231601,25293,206308,91168,7638,58193,6464,149361,42845,10566,2231,24829,16236
CGGATTACCGTTCCGA,sample,175934,174195,9431,164764,14963,149801,83226,5863,39385,3466,122611,17861,4941,1393,18282,9692
GTTAGGACCGTTCCGA,sample,223985,221891,21279,200612,15920,184692,64386,6610,66764,7125,131150,39807,9730,2103,11437,8643
GCCTGAACCGTTCCGA,sample,145011,142737,16306,126431,11286,115145,37024,1783,40099,4315,77123,31924,8340,1425,6403,6828
TGCTTCGCCGTTCCGA,sample,130391,128863,15059,113804,9086,104718,36003,3951,37299,4067,73302,23398,7667,1548,7232,6105
AAGAGCGCCGTTCCGA,sample,213520,211440,24750,186690,15809,170881,55131,3438,60653,5900,115784,45759,10554,1904,11806,9928
CCAATTCCCGTTCCGA,sample,177205,175852,9879,165973,22888,143085,71478,8044,36830,5130,108308,21603,7358,1858,16348,15753
GGAGAGTTCAATTCGG,sample,9156,9028,355,8673,1412,7261,4186,353,1779,258,5965,685,1031,635,524,937
TATCAGTTCAATTCGG,sample,3948,3886,217,3669,631,3038,1595,136,840,96,2435,371,660,347,338,422
ATTCTCTTCAATTCGG,Pos_Ctrl,6139,6106,231,5875,309,5566,4459,531,360,43,4819,173,1538,1414,266,159
GGTTGCGTCAATTCGG,sample,99681,99164,4373,94791,11455,83336,43391,3816,24768,2372,68159,8989,4307,1616,5002,8375
ACGTAAGTCAATTCGG,sample,26434,26201,2478,23723,2078,21645,7032,573,8779,969,15811,4292,2915,833,715,1162
AGTACCATCAATTCGG,sample,103674,102913,5252,97661,13373,84288,42025,3976,24382,2586,66407,11319,3839,1060,7485,9111
TTCGTAATCAATTCGG,sample,112319,111563,8025,103538,8790,94748,39220,3338,32686,4266,71906,15238,5662,1467,4847,5694
ACGTTATGCAATTCGG,Pos_Ctrl,32605,32417,1279,31138,1488,29650,24999,2835,1238,181,26237,397,4315,5000,1598,527
TGAGCGCGCAATTCGG,sample,44406,44078,3072,41006,6907,34099,16191,1284,9488,1003,25679,6133,3759,1048,3890,4552
TTAGAAGTCAATTCGG,sample,45125,44741,4858,39883,6841,33042,13126,765,10902,1253,24028,6996,4229,1004,3779,4430
TCGCATCTCAATTCGG,sample,38923,38495,4415,34080,5300,28780,11944,818,9355,998,21299,5665,3429,1016,3767,3499
GCCTTGCTCAATTCGG,Pos_Ctrl,21750,21518,1201,20317,1164,19153,16261,1486,983,110,17244,313,3593,3458,1520,561
CAAGGCCTCAATTCGG,sample,41023,40347,5643,34704,5730,28974,11966,817,8902,958,20868,6331,3954,1155,2852,3772
GACGGAGACAATTCGG,sample,46486,45974,4743,41231,7059,34172,12588,914,11453,1109,24041,8108,4024,820,4812,4558
CCGCAACGCAATTCGG,Pos_Ctrl,29442,28907,2067,26840,1383,25457,21388,2036,1406,179,22794,448,4191,4115,2105,728
GGACGTAGCAATTCGG,sample,57556,56972,5947,51025,10286,40739,18315,1106,13363,1208,31678,6747,3696,1200,6340,6954
CTTGATAGCAATTCGG,sample,28574,28225,3503,24722,3556,21166,7211,395,7217,797,14428,5546,3538,972,2451,2446
GACGATAACAATTCGG,sample,148928,147452,14154,133298,17297,116001,52236,2584,35587,3953,87823,21641,7104,1621,13201,10857
GGCCAGAGCAATTCGG,sample,89708,88966,3930,85036,18898,66138,51509,3447,7699,851,59208,2632,1989,1611,14542,12810
CCATGAAGCAATTCGG,Pos_Ctrl,85388,83843,5156,78687,3709,74978,63563,5768,3895,520,67458,1232,6211,7576,5072,1559
CGTACGTCCAATTCGG,sample,98041,97028,7796,89232,12277,76955,39256,2865,20355,2043,59611,12436,5614,1822,8571,8472
AGTCCGCACAATTCGG,sample,112717,111435,8749,102686,15903,86783,43470,3206,24468,2167,67938,13472,4859,1269,13639,11654
GTCCTGCCCAATTCGG,sample,135796,134350,10903,123447,20525,102922,53212,4412,25614,3424,78826,16260,6008,1492,13728,14254
TTGGTACCCAATTCGG,sample,188302,186447,20113,166334,19749,146585,44834,3641,53997,5620,98831,38493,10221,2048,9976,13134
CTAGGACCCAATTCGG,sample,158304,156483,19953,136530,17699,118831,43284,2241,38405,4624,81689,30277,8710,1608,15151,11205
CGGATTACCAATTCGG,Pos_Ctrl,66621,65153,4765,60388,2900,57488,48225,4626,3173,472,51398,992,5648,6661,3688,1304
ACGTATTACAATTCGG,sample,126190,124845,8881,115964,18246,97718,62090,5150,18358,2394,80448,9726,3147,1216,13519,13660
AACTCGTACAATTCGG,sample,65356,64364,6965,57399,6324,51075,22277,1677,15210,1303,37487,10608,4316,965,5640,3794
TTGGCCTCCAATTCGG,Pos_Ctrl,61010,59948,4148,55800,2447,53353,44819,4188,3045,431,47864,870,5463,6388,2727,949
ACCAATGCCAATTCGG,sample,82305,80831,4533,76298,11771,64527,39030,2043,14271,2686,53301,6497,2396,870,8146,7988
AAGAGCGCCAATTCGG,sample,93995,92758,5240,87518,12366,75152,49415,2926,15709,1693,65124,5409,2369,1117,8742,8928
GACCGGAACAATTCGG,sample,118155,116904,8053,108851,14709,94142,53633,3038,21402,2507,75035,13562,2970,1106,14601,11089
TATCAGTTAACTCCGG,sample,46348,45789,2640,43149,10384,32765,21342,1868,6159,847,27501,2549,2749,1732,5536,6831
TCCAACTTAACTCCGG,sample,65521,64999,3109,61890,17155,44735,29058,2023,8835,948,37893,3871,2833,1521,8016,11479
CCTCTAGAAACTCCGG,sample,76731,76020,4611,71409,15041,56368,33131,2257,13397,1390,46528,6193,3013,1166,11357,10292
TTCGTAATAACTCCGG,sample,115860,114976,9040,105936,18498,87438,37143,2890,28028,2750,65171,16627,5817,1295,12839,12556
TTCTAATGAACTCCGG,sample,97530,96936,9367,87569,19019,68550,29927,2442,19411,2165,49338,14605,6791,1560,7667,12030
ATGCCTGGAACTCCGG,sample,63284,62673,4921,57752,10094,47658,22659,1988,13997,1373,36656,7641,4237,1315,5995,6943
TTAGAAGTAACTCCGG,sample,76867,76112,5881,70231,20383,49848,28855,2212,10946,924,39801,6911,3072,1063,9639,13538
TTCCGTCTAACTCCGG,sample,19585,19438,1704,17734,3686,14048,7065,559,3693,454,10758,2277,2109,963,1691,2449
CAAGGCCTAACTCCGG,sample,41243,40809,3145,37664,7680,29984,17467,765,6927,726,24394,4099,2513,1090,5902,5220
GACGGAGAAACTCCGG,sample,28627,28314,2274,26040,4837,21203,11798,894,4861,560,16659,3090,2589,1146,3538,3318
GGACGTAGAACTCCGG,sample,3006,2915,192,2723,582,2141,1104,87,588,84,1692,278,562,312,223,362
AGTCCGCAAACTCCGG,sample,191760,189723,19410,170313,21129,149184,59329,3601,48347,4302,107676,33605,8492,1807,15987,13859
ACCAATGCAACTCCGG,sample,85260,84135,8915,75220,6457,68763,26577,1723,23241,2541,49818,14681,5989,1216,6424,4442
GAAGGCGCAACTCCGG,sample,32707,32233,4060,28173,2822,25351,8466,958,9016,1200,17482,5711,3431,716,1648,1868
GTCTTAGCAACTCCGG,sample,75696,74704,8136,66568,6481,60087,23058,1462,20134,2209,43192,13224,5247,1010,5180,4686
GTACCGTAAACTCCGG,sample,69110,68134,4496,63638,3921,59717,27297,1597,20738,2061,48035,8024,3323,1054,1226,2454
TCAATATAAACTCCGG,sample,98587,97362,9228,88134,11303,76831,34263,2287,22845,2275,57108,15161,4484,1043,7230,8005
TCGCCTGAAACTCCGG,sample,73531,72584,4359,68225,10081,58144,35025,2306,13852,1253,48877,5708,2389,871,7621,7122
ATGACCGAAACTCCGG,sample,89365,88293,11178,77115,7437,69678,28516,2118,22056,2787,50572,14201,4327,1054,5757,4696
GACCGGAAAACTCCGG,sample,68888,68214,5848,62366,6578,55788,26137,1730,16855,1676,42992,9390,4149,1077,4681,4524
GGAGAGTTCCTGAAGG,sample,123995,123060,9506,113554,21119,92435,39566,3567,30515,3070,70081,15717,6277,1696,11278,14022
TCCAACTTCCTGAAGG,Neg_Ctrl,2358,1329,885,444,82,362,179,8,121,12,300,42,136,57,40,17
AAGTTCGTCCTGAAGG,sample,149245,148369,5559,142810,38597,104213,81716,6910,10374,1346,92090,3867,3257,2715,13860,26147
ACGTAAGTCCTGAAGG,sample,142184,141034,12330,128704,21901,106803,44154,2633,32314,3735,76468,23967,7686,1638,15104,14162
ACGTTATGCCTGAAGG,sample,98889,98140,9006,89134,17509,71625,30768,2116,21581,2202,52349,14958,6254,1878,7405,12161
TTCTAATGCCTGAAGG,Neg_Ctrl,1318,928,537,391,50,341,103,3,124,20,227,91,104,39,21,45
TTAGAAGTCCTGAAGG,sample,108401,107570,11080,96490,19037,77453,29321,2093,26566,2610,55887,16863,6780,1559,9335,12376
GCCTTGCTCCTGAAGG,sample,85428,84696,8775,75921,11402,64519,25551,2158,20634,2479,46185,13697,5490,1297,8804,7355
CAAGGCCTCCTGAAGG,Neg_Ctrl,1887,1143,607,536,90,446,196,19,143,6,339,82,154,65,48,30
ACTATACTCCTGAAGG,sample,127435,126266,13406,112860,16627,96233,34865,1384,31910,3560,66775,24514,7269,1374,11926,11519
GACGGAGACCTGAAGG,sample,97708,96651,13930,82721,10493,72228,24545,1507,24352,2893,48897,18931,7166,1435,7593,6413
GGACGTAGCCTGAAGG,Neg_Ctrl,1788,1095,737,358,51,307,128,5,94,5,222,75,121,45,30,38
ACCTCGAGCCTGAAGG,sample,54255,53504,5194,48310,6957,41353,14404,1450,14210,2172,28614,9117,3922,842,3180,4614
TGGACGAGCCTGAAGG,sample,110323,109169,9826,99343,16532,82811,34692,3325,24947,2663,59639,17184,4768,1268,11597,11386
GACGATAACCTGAAGG,sample,116660,115487,8795,106692,11707,94985,46878,2785,26111,3101,72989,16110,4831,1453,10535,8729
ACGACTTCCCTGAAGG,Neg_Ctrl,1867,1049,692,357,46,311,125,11,79,8,204,88,118,42,25,20
CATGATTCCCTGAAGG,sample,127089,125748,11786,113962,22615,91347,49264,2847,21759,2778,71023,14699,5405,1480,14875,15245
CGTACGTCCCTGAAGG,sample,66633,65995,3602,62393,15563,46830,32286,2618,7798,859,40084,3269,3016,1831,8127,10550
AGTCCGCACCTGAAGG,sample,80101,79166,5903,73263,17061,56202,36576,3016,11821,1609,48397,3180,2091,952,9317,12330
GTCCTGCCCCTGAAGG,sample,110621,109453,7331,102122,18800,83322,53575,4318,15726,2568,69301,7135,2869,1173,17717,14073
TTGGTACCCCTGAAGG,sample,127315,125925,16871,109054,13928,95126,32558,2017,32263,3464,64821,24824,7263,1372,11999,8475
GTTAGGACCCTGAAGG,Neg_Ctrl,2093,1358,810,548,80,468,205,12,131,17,336,103,157,70,59,25
ACGTATTACCTGAAGG,sample,95196,93682,8506,85176,9080,76096,27073,1972,26299,2723,53372,18029,6238,1381,4090,6156
AATATATCCCTGAAGG,Neg_Ctrl,1765,1126,803,323,23,300,136,3,103,10,239,48,117,42,36,36
TGCTTCGCCCTGAAGG,sample,52878,52026,4079,47947,7991,39956,23800,2279,8535,1378,32335,3964,2305,826,7722,5977
GTCTTAGCCCTGAAGG,sample,52134,51407,3682,47725,9123,38602,25808,2010,6872,633,32680,3279,1954,904,6811,7060
CCAATTCCCCTGAAGG,sample,50634,49589,2984,46605,8618,37987,29182,1840,4873,814,34055,1278,1105,692,8970,6191
GGCATATACCTGAAGG,sample,43560,42840,2880,39960,5622,34338,23491,1385,6167,376,29658,2919,1997,865,5627,4357
TCGCCTGACCTGAAGG,sample,42083,41337,6222,35115,3433,31682,11489,698,10184,1222,21673,8089,4013,899,2136,2265
TTATTCGACCTGAAGG,sample,184939,182431,27223,155208,8680,146528,38150,2008,62795,7660,100945,35915,10775,1983,2834,3326
GGAGAGTTAATATTCG,sample,38438,38109,4301,33808,4481,29327,10546,769,10787,1226,21333,5999,3882,1241,2197,2815
ATTCTCTTAATATTCG,sample,182073,180698,13104,167594,29038,138556,70045,4052,37272,4089,107317,23098,7084,2003,19637,19536
GGTTGCGTAATATTCG,sample,35520,35290,2269,33021,5503,27518,14679,964,7573,856,22252,3446,2802,1350,3282,3833
TCCTCCGTAATATTCG,sample,45787,45461,2707,42754,7151,35603,19959,1741,9088,1083,29047,3732,2669,1237,5790,4834
CCTCTAGAAATATTCG,sample,127297,126144,8261,117883,20765,97118,47227,3040,27899,3175,75126,15777,5686,1678,11360,14014
AGTACCATAATATTCG,sample,67810,67273,3232,64041,14835,49206,32088,2577,10854,955,42942,2732,1678,1156,9043,10456
ACGTTATGAATATTCG,sample,34736,34390,2347,32043,4976,27067,13084,1044,8715,923,21799,3301,2471,969,3888,3713
GCCTTGCTAATATTCG,sample,80285,79577,4866,74711,17893,56818,32173,2443,14554,2149,46727,5499,3023,1145,9397,11994
ACTATACTAATATTCG,sample,90548,89873,4035,85838,19412,66426,42198,2731,14716,2205,56914,4576,2258,1060,14262,14055
CCAGAGCGAATATTCG,sample,59524,58819,2762,56057,10005,46052,29105,2302,9307,1060,38412,4278,2784,1023,7218,6944
GGACGTAGAATATTCG,sample,149473,147921,16569,131352,14533,116819,42204,2897,39728,3928,81932,28062,8187,1546,12288,9462
GACGATAAAATATTCG,sample,95559,94534,6368,88166,12498,75668,34459,2240,23345,2751,57804,12873,4376,1163,9078,8921
GGCCAGAGAATATTCG,sample,89358,88592,6540,82052,13931,68121,32031,1663,21983,2545,54014,9899,4696,1393,8325,10047
ACGACTTCAATATTCG,sample,89286,88211,5187,83024,15043,67981,42971,3359,14293,1200,57264,6158,2609,983,12844,10836
AATCCGTCAATATTCG,sample,144881,143717,6624,137093,10010,127083,65760,5405,37902,4930,103662,13086,4247,1849,8994,7370
AGTCCGCAAATATTCG,sample,55882,55163,3581,51582,5740,45842,23006,1570,14560,1454,37566,5252,2951,1098,3378,4093
GTCCTGCCAATATTCG,sample,149627,148155,13984,134171,19916,114255,51095,3354,32645,3317,83740,23844,7735,1687,15102,12933
TTGGTACCAATATTCG,sample,135850,134639,10572,124067,15144,108923,51893,4798,30330,3461,82223,18441,6514,1614,11975,10521
AACTCGTAAATATTCG,sample,90870,89840,8934,80906,9899,71007,30005,2239,21679,2172,51684,14912,5618,1142,8869,6703
TTGGCCTCAATATTCG,sample,85325,84235,8916,75319,8572,66747,27039,1188,20905,2008,47944,15607,5696,989,6996,5933
GTACCGTAAATATTCG,Pos_Ctrl,40743,39884,2758,37126,1661,35465,29602,2650,2234,240,31836,739,4792,4905,2180,794
TCAATATAAATATTCG,sample,175597,173846,15709,158137,15951,142186,63988,7157,41286,4739,105274,25016,6665,1854,11959,10919
CTTCATGAAATATTCG,sample,115471,113440,18007,95433,7452,87981,19352,1310,34237,3856,53589,29226,9666,1462,4190,4337
GACCGGAAAATATTCG,sample,179658,177972,21495,156477,9329,147148,37591,1778,61230,6653,98821,39896,11228,2135,5560,4664
TATCAGTTAGTCTCCG,sample,108392,107559,6007,101552,23349,78203,43647,2962,18937,2341,62584,10316,3941,1339,15733,15374
TCCAACTTAGTCTCCG,sample,53555,53032,5519,47513,10314,37199,18087,866,9871,990,27958,7385,3522,943,5480,6762
ACGTAAGTAGTCTCCG,sample,128505,127561,8514,119047,25101,93946,46457,3552,25521,2845,71978,15571,4525,1355,15499,16976
AGTACCATAGTCTCCG,sample,105032,104119,7113,97006,20279,76727,40698,3745,19852,2042,60550,10390,4030,1107,13319,14117
TTCGTAATAGTCTCCG,sample,78694,77840,6258,71582,11510,60072,23937,2208,19818,2171,43755,11938,4947,1168,7115,7761
TTCTAATGAGTCTCCG,sample,43619,43310,1464,41846,6557,35289,27062,2107,3747,550,30809,1823,2264,1834,3805,4711
TTAGAAGTAGTCTCCG,sample,54201,53768,3247,50521,12001,38520,22352,1766,9792,1261,32144,3349,3222,1688,5046,7800
TCGCATCTAGTCTCCG,sample,54023,53695,1851,51844,15258,36586,24785,1890,5948,878,30733,3085,2067,1082,8070,9841
GCCTTGCTAGTCTCCG,sample,47993,47516,4157,43359,6862,36497,18002,1044,10146,808,28148,6497,3689,985,5102,4854
ACTATACTAGTCTCCG,sample,104396,103731,6127,97604,11241,86363,44182,3527,26319,3255,70501,9080,4193,1644,8782,7850
CCAGAGCGAGTCTCCG,sample,121529,120450,11416,109034,16775,92259,31465,3037,31270,2994,62735,23493,8264,1514,9650,11052
GGACGTAGAGTCTCCG,sample,128128,127023,10275,116748,12901,103847,37578,3186,37188,3456,74766,22439,8151,1677,9680,9107
ACCTCGAGAGTCTCCG,sample,103064,102240,8751,93489,14763,78726,37874,3439,20372,2393,58246,14648,5787,1524,10322,9730
TGGACGAGAGTCTCCG,sample,95274,94488,5372,89116,17313,71803,45534,5556,13782,1527,59316,5404,3290,1268,11784,12328
CATTGCAGAGTCTCCG,sample,81926,81308,3979,77329,12012,65317,36242,2896,17286,2149,53528,6744,3076,1445,7930,8262
CGTACGTCAGTCTCCG,sample,134486,133582,8476,125106,18092,107014,49582,4016,32527,3486,82109,17403,6334,1953,12575,11803
CGGATTACAGTCTCCG,sample,102063,101103,6109,94994,17601,77393,47140,3818,16564,1691,63704,8180,3582,1118,11665,13025
CGTATGAAAGTCTCCG,sample,115507,114430,5955,108475,8923,99552,50986,3643,29358,4836,80344,10729,4025,1264,7452,6251
TGCTTCGCAGTCTCCG,sample,134351,133118,8185,124933,11637,113296,54798,4609,34666,4589,89464,14634,4962,1587,6409,6321
GTCTTAGCAGTCTCCG,sample,92790,92001,7117,84884,10548,74336,35614,2557,21900,2500,57514,11765,5966,1839,8024,7218
TTGGTTAAAGTCTCCG,sample,126659,125922,5440,120482,20312,100170,62169,4542,22334,1991,84503,9134,3725,1291,16109,14144
GGCATATAAGTCTCCG,sample,74300,73593,4931,68662,7968,60694,26822,1544,17487,2576,44309,12265,4519,1056,5217,5474
AGGTCGGAAGTCTCCG,sample,124773,124062,6885,117177,12178,104999,57510,3829,28263,3896,85773,11501,4104,1311,9462,8704
GACCGGAAAGTCTCCG,sample,43855,43550,1846,41704,5503,36201,19075,1464,11143,904,30218,3615,2330,1082,3089,3746
ACGTAAGTTGCCTACG,sample,294,287,19,268,63,205,119,5,51,5,170,25,78,42,44,31
AGTACCATTGCCTACG,sample,22083,21950,2340,19610,3690,15920,5781,363,5269,545,11050,3962,2744,791,1535,2142
AATGGTAATGCCTACG,sample,18094,17963,908,17055,3549,13506,7935,775,3068,381,11003,1347,1662,951,1545,2447
TTAGAAGTTGCCTACG,sample,12540,12422,651,11771,2190,9581,6624,421,1700,197,8324,639,1184,738,1971,1510
GCCTTGCTTGCCTACG,sample,17121,16950,1151,15799,1732,14067,6427,434,5095,486,11522,1625,1767,800,1363,1221
CATAACCTTGCCTACG,sample,87135,86411,4505,81906,11752,70154,37415,2033,20775,2990,58190,6941,3076,1195,7398,8593
ACTATACTTGCCTACG,sample,19752,19473,2595,16878,1597,15281,4892,229,5687,621,10579,3852,2631,642,1061,1003
GACGGAGATGCCTACG,sample,27947,27615,2472,25143,3547,21596,11229,657,5911,601,17140,3198,2377,694,3840,2466
CCAGAGCGTGCCTACG,sample,24122,23800,2814,20986,2878,18108,5120,407,6909,733,12029,4939,2886,565,1224,1738
GGAGGACGTGCCTACG,sample,41496,41122,3023,38099,6443,31656,14861,1237,9297,1189,24158,5072,3431,1245,3440,4333
CTTGATAGTGCCTACG,sample,33182,32778,3698,29080,3145,25935,10682,660,8104,974,18786,5515,3273,1123,2364,1937
TGGACGAGTGCCTACG,sample,36348,36009,2145,33864,4575,29289,17486,1063,6713,747,24199,3280,2651,1295,4060,3213
GGCCAGAGTGCCTACG,sample,36893,36518,2165,34353,8244,26109,17335,1029,5083,445,22418,2217,1933,1063,4470,5464
ACGACTTCTGCCTACG,sample,34574,34129,4299,29830,3587,26243,9932,729,8629,998,18561,5955,3742,1104,2174,2199
AATCCGTCTGCCTACG,sample,51621,51067,6292,44775,4544,40231,12020,989,14938,1513,26958,10771,4913,1002,2979,2699
AGTCCGCATGCCTACG,sample,61991,61392,4751,56641,4063,52578,23442,1890,17971,2180,41413,7095,3675,1423,3156,2807
GTCCTGCCTGCCTACG,sample,40590,40042,3352,36690,4341,32349,14422,889,9916,1205,24338,5917,3274,936,2890,2827
CGGATTACTGCCTACG,sample,53865,53274,4013,49261,5557,43704,19829,1294,14293,2043,34122,6245,3104,1096,3867,3911
AACTCGTATGCCTACG,sample,13306,13047,1534,11513,1726,9787,3765,262,3500,310,7265,1950,1745,559,657,1154
TTGGCCTCTGCCTACG,sample,37871,37334,5057,32277,2291,29986,9421,689,11890,1264,21311,6722,3804,970,1613,1463
GTCTTAGCTGCCTACG,sample,9058,8846,1678,7168,683,6485,1764,123,2312,241,4076,2045,1512,365,477,438
GGCATATATGCCTACG,Neg_Ctrl,822,435,297,138,20,118,47,4,34,11,81,22,47,26,2,6
TCAATATATGCCTACG,sample,40588,40040,4044,35996,4770,31226,14570,1288,8718,935,23288,5715,3067,841,3527,3191
TTATTCGATGCCTACG,sample,34080,33670,2619,31051,3699,27352,14735,1085,7083,857,21818,3592,2591,1194,2671,2828
GACCGGAATGCCTACG,sample,40743,40339,4813,35526,3285,32241,11467,677,11586,1264,23053,7247,3481,791,2396,1689
GGAGAGTTCTTAGTTC,sample,168595,167505,12110,155395,13043,142352,44504,3822,50345,5493,94849,38188,10392,2264,6261,7060
CAACCGCGCTTAGTTC,sample,34737,34402,4607,29795,3559,26236,7855,581,9843,1084,17698,6873,3864,872,2169,2649
TTCCGTCTCTTAGTTC,sample,124514,123583,9880,113703,16404,97299,39960,2807,31876,3209,71836,19447,7263,1930,9283,10887
TCGCATCTCTTAGTTC,sample,54761,54414,2932,51482,7471,44011,22852,1428,13136,1359,35988,5236,2730,1140,5686,5263
GTTAGCCGCTTAGTTC,sample,280222,278312,18153,260159,24484,235675,124153,9015,65399,9488,189552,27620,9730,3490,12083,15648
GGACGTAGCTTAGTTC,sample,122576,121314,9579,111735,15063,96672,39201,3050,32798,3381,71999,18242,6542,1421,11487,10759
CTTGATAGCTTAGTTC,sample,79330,78621,5727,72894,10660,62234,27265,2396,19524,2073,46789,10976,4628,1168,6347,7150
CCATGAAGCTTAGTTC,sample,92850,91971,7194,84777,13663,71114,33780,2100,21054,2373,54834,11807,5209,1124,11411,9351
GTCCTGCCCTTAGTTC,sample,154942,153611,8346,145265,17342,127923,81850,5936,23013,2622,104863,14502,5316,2155,18527,13252
CGGATTACCTTAGTTC,sample,94958,93478,8068,85410,12134,73276,35425,2946,20724,2238,56149,11943,5161,1308,7430,7818
AATATATCCTTAGTTC,sample,118213,116681,11953,104728,8725,96003,29597,2557,35664,4107,65261,24078,6863,1434,3811,4617
ACCAATGCCTTAGTTC,sample,87043,85614,7074,78540,12287,66253,36219,3086,16271,2166,52490,8511,3948,1100,10988,8506
GAAGGCGCCTTAGTTC,sample,108373,107085,10951,96134,16391,79743,40170,3322,19855,2113,60025,14283,4295,1253,9284,11203
CCAATTCCCTTAGTTC,sample,85423,83992,5893,78099,12363,65736,39819,4311,11934,1623,51753,8049,2472,1082,9707,9189
TTGGTTAACTTAGTTC,sample,139749,137224,16287,120937,18543,102394,49814,3389,27396,2606,77210,19189,4785,1256,12670,12850
GTACCGTACTTAGTTC,sample,112466,111079,8665,102414,14864,87550,43355,2919,24529,3087,67884,13660,4186,1235,11831,10611
TCGCCTGACTTAGTTC,sample,38223,37479,2801,34678,4912,29766,16604,744,7351,807,23955,4260,2317,787,4083,3640
ATTCTCTTCGAGCTTC,sample,160346,159278,9498,149780,14271,135509,54742,3223,49153,6492,103895,21899,6444,1669,8471,9255
AAGTTCGTCGAGCTTC,sample,117748,116694,7541,109153,15959,93194,46853,3650,23025,2571,69878,17095,4811,1208,7006,10847
TTCGTAATCGAGCTTC,sample,85058,84532,4250,80282,23322,56960,39380,2972,8965,981,48345,4662,2240,1126,14810,15071
ACGTTATGCGAGCTTC,sample,80168,79635,4498,75137,11796,63341,31464,2450,19670,1865,51134,7892,3778,1423,7259,8544
TAGTACGGCGAGCTTC,sample,80375,79856,5105,74751,7410,67341,26312,1886,26502,3236,52814,9405,4408,1439,4054,4794
GGACCTCTCGAGCTTC,sample,57761,57289,5382,51907,10984,40923,21767,1511,9994,890,31761,6761,2943,961,6873,7190
CAAGGCCTCGAGCTTC,sample,132485,131472,8174,123298,27309,95989,56109,3651,22341,2979,78450,10909,5324,1906,14285,18833
CATAACCTCGAGCTTC,sample,101745,100920,4249,96671,25794,70877,41683,3499,17613,1765,59296,6317,3763,1550,13025,16748
ACTATACTCGAGCTTC,sample,255349,253492,24061,229431,28860,200571,76900,6329,70862,8526,147762,37954,11414,2439,21463,17469
CTTGATAGCGAGCTTC,sample,35164,34722,2903,31819,4922,26897,12055,683,8547,886,20602,4726,2873,814,4440,3456
TGGACGAGCGAGCTTC,sample,115777,114888,5193,109695,23472,86223,61316,3872,13390,1348,74706,6297,2840,1363,17397,15804
GACGATAACGAGCTTC,sample,90623,89784,5428,84356,12316,72040,45286,3062,14872,2120,60158,6700,3304,1389,9996,9357
CCATGAAGCGAGCTTC,sample,90741,89921,4935,84986,11811,73175,44341,3942,14934,1698,59275,8260,4502,1935,10074,7924
ACGACTTCCGAGCTTC,sample,77067,76309,3398,72911,15459,57452,37881,3321,10944,990,48825,4316,3301,2075,7737,10559
CATGATTCCGAGCTTC,sample,90259,89469,4893,84576,18862,65714,42014,2747,14495,1141,56509,5317,3295,1565,12144,13221
AGTCCGCACGAGCTTC,sample,151380,149931,9370,140561,16527,124034,63448,4852,35455,4413,98903,15866,5448,1693,11855,11299
GTCCTGCCCGAGCTTC,sample,158673,157308,10011,147297,21156,126141,66706,5725,31453,3379,98159,18878,6985,1955,11691,15023
CGTATGAACGAGCTTC,sample,38590,37810,3765,34045,4830,29215,15670,1045,7661,899,23331,3940,2759,876,5242,3818
GAAGGCGCCGAGCTTC,sample,76110,75127,4113,71014,10789,60225,47812,3922,6612,331,54424,1548,1070,791,12740,8178
GTACCGTACGAGCTTC,sample,111633,110345,7537,102808,12324,90484,47766,4083,23248,2373,71014,13014,4736,1223,7473,8804
ATGACCGACGAGCTTC,sample,59839,58793,5978,52815,4378,48437,15677,1044,18472,2250,34149,10994,4275,769,1208,2644
ATTCTCTTGTAGAATG,Pos_Ctrl,75071,74488,2916,71572,2677,68895,58092,5820,3251,508,61343,1224,5744,7389,2919,874
ACGTAAGTGTAGAATG,sample,53532,53043,5768,47275,9777,37498,17914,1260,10263,1157,28177,6904,3139,933,6427,6498
TTCTAATGGTAGAATG,sample,47981,47561,4265,43296,9335,33961,16397,996,9463,1010,25860,6095,3429,883,5171,6099
TAGTACGGGTAGAATG,sample,61179,60770,2528,58242,10802,47440,33777,2649,6798,975,40575,3241,1973,1499,8063,8007
CAACCGCGGTAGAATG,sample,20634,20412,1348,19064,4208,14856,8855,763,2950,471,11805,1817,1912,1000,2430,2684
TTAGAAGTGTAGAATG,sample,58990,58588,2886,55702,14671,41031,29013,1821,7018,554,36031,2625,1780,1141,8071,10261
GGACCTCTGTAGAATG,Pos_Ctrl,20127,19894,1031,18863,899,17964,15070,1475,977,92,16047,350,3379,3237,1389,370
GTTAGCCGGTAGAATG,sample,84021,83078,6774,76304,9695,66609,29006,1045,21439,2276,50445,12843,5362,1102,9233,6774
GGAGGACGGTAGAATG,sample,42211,41802,4418,37384,6825,30559,13680,987,8901,955,22581,6036,3651,1097,4304,4492
CTTGATAGGTAGAATG,sample,118153,117047,7265,109782,19096,90686,53589,4219,20864,2888,74453,9126,3464,1185,13620,13421
ACCTCGAGGTAGAATG,sample,112293,111234,10015,101219,13636,87583,37408,3201,28944,2632,66352,15398,6231,1439,9448,8696
TGGACGAGGTAGAATG,sample,129567,128420,7131,121289,15237,106052,53921,3951,34326,4648,88247,9206,3535,1357,10619,12397
GGCCAGAGGTAGAATG,sample,108529,107506,7287,100219,16821,83398,45201,3294,21047,1975,66248,11881,5479,1623,10946,12334
CGAGGCAGGTAGAATG,Pos_Ctrl,62255,61175,3504,57671,2565,55106,46315,4208,3194,418,49509,971,5592,6498,3491,1179
CCATGAAGGTAGAATG,sample,169189,167494,17395,150099,19376,130723,50430,3304,39954,3989,90384,33046,9789,1871,12647,12601
CATGATTCGTAGAATG,sample,106169,104965,8521,96444,9310,87134,34764,2759,31957,3992,66721,13662,4977,1433,8154,5925
CGTACGTCGTAGAATG,sample,123813,122865,4297,118568,25114,93454,70403,3869,12806,1531,83209,4845,2660,1816,17427,18186
CGGATTACGTAGAATG,sample,152778,151141,13030,138111,15076,123035,57746,4151,35259,3529,93005,22350,6208,1501,12904,10544
ACCAATGCGTAGAATG,Pos_Ctrl,94792,93152,5119,88033,3216,84817,70941,6976,4649,660,75590,1591,6030,8186,3286,1102
TGCTTCGCGTAGAATG,sample,29175,28568,4013,24555,2166,22389,7892,616,7665,838,15557,5378,3149,626,1912,1316
CCAATTCCGTAGAATG,sample,95716,93904,7782,86122,10927,75195,42345,3177,17312,1885,59657,10476,3505,1039,8160,8188
GTACCGTAGTAGAATG,sample,134592,133230,9350,123880,12644,111236,47662,4552,34941,3573,82603,20508,5833,1259,8006,8120
GGCATATAGTAGAATG,sample,132295,130939,7766,123173,14175,108998,62268,5120,24615,2660,86883,14335,5242,1688,9325,10115
CTTCATGAGTAGAATG,sample,114213,112983,8959,104024,10679,93345,48669,3675,24454,3403,73123,13144,3625,1161,9848,9726
ATTCTCTTCAATAGTC,sample,71098,70526,4168,66358,11273,55085,29691,2756,13555,1256,43246,7827,3563,999,5997,8196
CCTCTAGACAATAGTC,sample,81057,80334,6147,74187,9727,64460,26297,2598,19697,1957,45994,13911,5663,1079,5766,6516
ACGTTATGCAATAGTC,sample,61000,60272,9113,51159,5519,45640,12285,614,17662,1948,29947,13131,5956,975,3898,3491
TAGTACGGCAATAGTC,sample,89004,88412,5601,82811,15565,67246,34857,2298,17582,1775,52439,10734,4345,1359,8262,11236
TGAGCGCGCAATAGTC,sample,36095,35715,5063,30652,3019,27633,6838,366,11630,1263,18468,7536,4444,822,1777,1591
AATGGTAACAATAGTC,sample,37785,37492,2596,34896,6871,28025,14635,1128,7807,918,22442,3537,2530,1062,4499,4640
CAAGGCCTCAATAGTC,sample,38013,37656,2819,34837,5657,29180,13751,943,9775,1142,23526,3569,2326,898,4018,4131
CATAACCTCAATAGTC,sample,15624,15486,963,14523,2402,12121,6344,379,3570,473,9914,1355,1658,802,1374,1681
GACGGAGACAATAGTC,sample,47882,47493,2718,44775,10105,34670,21932,1342,6414,973,28346,4009,2388,946,8301,6888
GGAGGACGCAATAGTC,sample,23632,23392,1126,22266,7405,14861,11785,750,1709,125,13494,492,1166,1040,3432,4730
ACGACTTCCAATAGTC,sample,72985,72236,4866,67370,5036,62334,25123,1508,23669,2667,48792,9367,4433,1474,3325,3291
CATGATTCCAATAGTC,sample,97906,97068,8954,88114,15224,72890,31754,2319,20526,2272,52280,16019,5577,1147,10828,10007
AATCCGTCCAATAGTC,sample,102353,101464,8235,93229,14463,78766,36705,2971,22078,2785,58783,14227,5556,1423,8579,9822
GTCCTGCCCAATAGTC,sample,293093,290384,24410,265974,15257,250717,85833,5289,113448,14131,199281,32016,9100,2462,8033,8248
TTGGTACCCAATAGTC,sample,59449,58948,1855,57093,13487,43606,32369,3131,5989,624,38358,1493,1957,1594,9946,9030
CTAGGACCCAATAGTC,sample,65980,65321,3587,61734,8883,52851,31514,2207,12059,1770,43573,5301,3327,1132,12180,6648
GCCTGAACCAATAGTC,sample,73894,73065,7016,66049,6008,60041,19696,1462,21037,2207,40733,15639,5692,1227,3771,3554
CGTATGAACAATAGTC,sample,111729,110817,6428,104389,15928,88461,54522,5221,18909,2706,73431,7103,3495,1691,11438,11906
TTGGCCTCCAATAGTC,sample,79961,79092,9559,69533,7585,61948,17697,1345,22773,2339,40470,17794,5942,1125,3931,4497
GAAGGCGCCAATAGTC,sample,83205,82391,7874,74517,9751,64766,27666,1829,19319,2096,46985,13856,5883,1164,6820,6593
AAGAGCGCCAATAGTC,sample,95285,94406,9920,84486,10721,73765,31235,2387,22320,2177,53555,15646,5656,1300,7522,7435
CCAATTCCCAATAGTC,sample,48652,48166,3508,44658,5967,38691,18004,1397,11142,1308,29146,6840,4381,1435,3692,3865
TTGGTTAACAATAGTC,sample,81112,80403,4264,76139,10976,65163,40974,4640,12111,1359,53085,6079,3213,1399,6986,8008
AGGTCGGACAATAGTC,sample,110750,109789,7365,102424,12266,90158,53962,2636,22146,2041,76108,9373,3097,1158,13857,8763
TTATTCGACAATAGTC,sample,20815,20598,2077,18521,1548,16973,6129,528,6377,765,12506,3174,2457,812,1270,869
GGAGAGTTCGTTACTC,sample,843,826,88,738,109,629,318,21,177,21,495,92,237,108,75,80
TCCAACTTCGTTACTC,Neg_Ctrl,2148,1084,510,574,82,492,234,7,145,19,379,87,168,74,71,26
GGTTGCGTCGTTACTC,sample,126708,125946,5701,120245,33454,86791,50256,3531,22691,3666,72947,6647,3307,1532,16030,21341
CCTCTAGACGTTACTC,sample,77808,77156,5156,72000,13498,58502,26887,2307,19107,2030,45994,8171,3827,1235,7489,8921
ACGTTATGCGTTACTC,sample,139478,138595,8796,129799,30673,99126,56090,3854,24165,3180,80255,11837,4823,1617,17411,20201
TAGTACGGCGTTACTC,sample,127461,126572,9253,117319,21242,96077,43471,2872,30591,3598,74062,15545,7055,2095,8900,15276
AATGGTAACGTTACTC,sample,176235,174861,18701,156160,22888,133272,50301,3232,44320,4872,94621,30547,8612,2180,11399,15766
TTCCGTCTCGTTACTC,sample,134444,133385,8523,124862,30394,94468,58160,2987,21760,2871,79920,8690,4249,1317,22320,20083
GGACCTCTCGTTACTC,sample,137559,136565,8898,127667,35270,92397,51763,4080,22794,2479,74557,11281,5140,1915,11735,23265
TCGCATCTCGTTACTC,Neg_Ctrl,1891,1142,658,484,94,390,163,10,109,12,272,96,139,67,50,55
GCCTTGCTCGTTACTC,sample,69142,68390,6358,62032,11621,50411,26733,1316,12584,1350,39317,8428,4225,1230,7576,7753
GTTAGCCGCGTTACTC,sample,73316,72395,4681,67714,11223,56491,31407,1880,15442,1652,46849,6110,3482,1468,5670,7993
CTTGATAGCGTTACTC,sample,126092,125057,7961,117096,21087,96009,56452,3566,22490,2230,78942,11271,5037,1836,13139,13959
TGGACGAGCGTTACTC,sample,126220,125105,11350,113755,23756,89999,46186,3548,23022,2227,69208,15016,5632,1592,14408,15227
GGCCAGAGCGTTACTC,sample,216429,214354,22838,191516,30317,161199,69142,4926,46190,5128,115332,35813,10671,2245,15389,20294
CCATGAAGCGTTACTC,Neg_Ctrl,2966,1699,867,832,112,720,313,27,178,25,491,177,262,119,69,54
AGTCCGCACGTTACTC,sample,152330,150220,10989,139231,15684,123547,53976,4045,42071,4198,96047,19257,5514,1594,7353,9994
CTAGGACCCGTTACTC,sample,192828,190993,16015,174978,29727,145251,69991,4166,39530,4024,109521,27540,8457,1853,17177,20974
CGGATTACCGTTACTC,sample,174126,172346,12856,159490,30670,128820,75298,3886,30439,3050,105737,16147,4671,1533,21506,21641
GTTAGGACCGTTACTC,sample,160332,158961,9493,149468,29063,120405,78677,6015,24501,2619,103178,8593,4618,2260,15496,22612
GCCTGAACCGTTACTC,sample,142112,140473,11491,128982,19175,109807,56865,3512,29095,3445,85960,16890,5644,1579,15863,13649
ACGTATTACGTTACTC,sample,191414,189470,17350,172120,27585,144535,66748,6299,41041,4380,107789,26067,7784,1758,15213,21347
TTGGCCTCCGTTACTC,sample,202222,200354,19357,180997,13369,167628,65244,4429,64615,6916,129859,26424,8200,2385,5057,7543
TGCTTCGCCGTTACTC,Neg_Ctrl,1677,1011,536,475,32,443,211,7,124,7,335,94,160,63,48,20
GGCATATACGTTACTC,sample,158068,156175,15851,140324,21154,119170,60028,4638,29432,3370,89460,21702,7213,1791,13308,14896
AGGTCGGACGTTACTC,sample,135695,134158,8944,125214,18313,106901,65070,5232,20930,2591,86000,13078,4549,1575,10657,13490
TTATTCGACGTTACTC,sample,143215,141619,14924,126695,13645,113050,45845,3552,34769,4039,80614,24845,7695,1651,11113,8354
GACCGGAACGTTACTC,sample,93554,92811,5418,87393,11594,75799,41060,4082,20000,2347,61060,8310,4125,1601,7795,7913
GGAGAGTTTGGACTGC,sample,183268,181885,21092,160793,24892,135901,41472,2697,50036,5120,91508,36576,11006,2277,10248,16688
TATCAGTTTGGACTGC,sample,81515,80879,5382,75497,9683,65814,28531,2218,22351,2633,50882,10081,4575,1600,6719,5989
ATTCTCTTTGGACTGC,sample,76993,76053,5904,70149,13353,56796,27844,1785,16172,1613,44016,9382,4093,1100,8530,8621
ACGTAAGTTGGACTGC,sample,90966,90331,6155,84176,19516,64660,35361,2154,15342,1917,50703,9886,4221,1132,14562,13488
TTCGTAATTGGACTGC,sample,107740,106817,12121,94696,11633,83063,28492,1798,30399,3358,58891,19016,7414,1773,7054,7434
ACGTTATGTGGACTGC,sample,104998,104299,4708,99591,16777,82814,54056,3524,16057,1688,70113,7489,3983,1700,10440,12612
TAGTACGGTGGACTGC,sample,107736,106905,6549,100356,15948,84408,51963,3467,17040,2034,69003,9904,4389,1587,8439,11732
TGAGCGCGTGGACTGC,sample,77272,76877,3548,73329,11171,62158,40149,3171,11053,1422,51202,6363,4386,2185,8779,7999
TTAGAAGTTGGACTGC,sample,27121,26816,2979,23837,3536,20301,8000,460,6990,926,14990,3925,2701,752,3062,2287
TTCCGTCTTGGACTGC,sample,29163,28908,1956,26952,5138,21814,9863,761,7296,619,17159,3275,2460,735,3081,3610
CAAGGCCTTGGACTGC,sample,49226,48709,3638,45071,8942,36129,18209,1265,9799,1203,28008,5653,2993,880,7087,6058
GGACGTAGTGGACTGC,sample,56954,56401,4390,52011,8999,43012,22481,1323,11723,1341,34204,6144,3505,958,6756,6064
GACGATAATGGACTGC,sample,77864,77138,4329,72809,8854,63955,29325,1737,21683,2519,51008,8691,3712,1156,6919,6133
CGAGGCAGTGGACTGC,sample,93804,92785,9578,83207,13438,69769,27842,1691,21087,2586,48929,16563,6482,1217,8388,8407
CCATGAAGTGGACTGC,sample,88269,87502,5816,81686,14505,67181,36170,3345,16764,1487,52934,9415,4643,1560,8653,9855
CGTACGTCTGGACTGC,sample,86543,85712,4464,81248,16769,64479,40827,2473,13602,1865,54429,5712,3021,1161,11061,12115
GTCCTGCCTGGACTGC,sample,79835,79028,9543,69485,9234,60251,23533,1271,19337,2038,42870,14072,5914,1226,7261,5910
CTAGGACCTGGACTGC,sample,114448,113538,7120,106418,13886,92532,57272,3893,19636,2144,76908,9587,4877,1945,8474,10187
GTTAGGACTGGACTGC,sample,31949,31541,1580,29961,3242,26719,12151,806,9370,1099,21521,3293,2334,1015,1007,2241
ACGTATTATGGACTGC,sample,24911,24475,2385,22090,4028,18062,9769,627,4635,523,14404,2508,2237,904,2751,2777
AACTCGTATGGACTGC,sample,43116,42579,3117,39462,4641,34821,18535,1345,8701,1181,27236,5059,3125,1260,4857,3060
TTGGCCTCTGGACTGC,sample,41908,41503,2719,38784,8073,30711,21615,1623,4886,618,26501,1969,1874,1232,5664,5730
ACCAATGCTGGACTGC,sample,39634,38831,4807,34024,4040,29984,9433,704,11416,1185,20849,7246,3980,897,1622,2638
TGCTTCGCTGGACTGC,sample,44045,43437,4483,38954,4758,34196,15404,1168,10313,1297,25717,6014,3823,1062,3661,3176
CCAATTCCTGGACTGC,sample,37479,36683,4102,32581,3339,29242,13105,845,8687,1048,21792,5557,3288,1071,2614,2207
GTACCGTATGGACTGC,sample,120202,118837,11387,107450,7674,99776,49450,4236,28149,2629,77599,15312,6465,1875,4542,4649
GGCATATATGGACTGC,sample,50814,50022,5236,44786,5399,39387,18448,1595,11696,1134,30144,6514,3515,902,4711,3442
TCGCCTGATGGACTGC,sample,42949,42345,3371,38974,4679,34295,20124,1907,7467,966,27591,3831,2694,1227,3729,3323
TTATTCGATGGACTGC,sample,40489,39978,2572,37406,4874,32532,20331,1735,6469,809,26800,3188,2076,828,5433,3519
GACCGGAATGGACTGC,sample,10007,9794,602,9192,1652,7540,3915,306,2042,299,5957,978,1216,634,719,1033
TATCAGTTCCTTGAGC,sample,196987,195474,22467,173007,25835,147172,45606,2283,52911,5438,98517,40934,11123,2102,14769,17027
ATTCTCTTCCTTGAGC,sample,197388,196122,9835,186287,54222,132065,77730,4784,29350,3740,107080,16461,4268,1371,27771,35314
TCCTCCGTCCTTGAGC,sample,86194,85486,6124,79362,15215,64147,31689,1964,18213,2174,49902,10107,4639,1375,7988,10282
TTCGTAATCCTTGAGC,Pos_Ctrl,71324,70886,3927,66959,3563,63396,53361,5590,3018,359,56379,1068,5872,7089,4619,1737
TTCCGTCTCCTTGAGC,sample,168013,166709,9426,157283,13754,143529,60364,4005,54473,5347,114837,19340,5601,1752,7067,9142
GGACCTCTCCTTGAGC,sample,88572,87716,6688,81028,17613,63415,38288,2688,13295,1736,51583,7408,2897,1096,10426,12156
GCCTTGCTCCTTGAGC,sample,133276,132157,8226,123931,18001,105930,54733,3967,32096,3342,86829,11792,4783,1609,11814,12605
GACGGAGACCTTGAGC,sample,128090,127279,6532,120747,23982,96765,49352,6186,27587,3642,76939,9998,5221,1842,10718,16459
GTTAGCCGCCTTGAGC,Pos_Ctrl,56629,55872,4009,51863,2621,49242,41436,3857,2697,311,44133,941,5541,6393,3383,1275
GGAGGACGCCTTGAGC,sample,218647,216610,29252,187358,21437,165921,51874,2979,60286,6382,112160,44400,12419,2284,13541,13373
GGACGTAGCCTTGAGC,sample,136885,135747,10235,125512,20566,104946,53157,3112,28824,3022,81981,16831,5913,1379,18011,14503
GACGATAACCTTGAGC,sample,192159,190647,13153,177494,31927,145567,57115,3857,46838,5754,103953,32003,9066,1845,18909,21092
CATTGCAGCCTTGAGC,sample,84459,83492,4805,78687,9651,69036,32580,2903,23252,3139,55832,7162,3340,1211,6277,7221
ACGACTTCCCTTGAGC,sample,131257,129860,12079,117781,16422,101359,44218,2247,34710,3049,78928,17135,6004,1406,11874,11676
CATGATTCCCTTGAGC,sample,68664,67786,9649,58137,7905,50232,16708,1117,18430,2238,35138,11739,4976,1110,4706,5224
TTGGTACCCCTTGAGC,Pos_Ctrl,77391,76324,5097,71227,3390,67837,57026,5472,3763,432,60789,1144,5996,7290,4234,1390
CGTATGAACCTTGAGC,sample,305660,301897,47645,254252,26842,227410,51857,3431,88317,9839,140174,73966,15074,2805,11038,15577
TTGGCCTCCCTTGAGC,sample,66405,65557,5314,60243,8273,51970,27160,1083,14787,2064,41947,6876,3472,928,7258,6018
AATATATCCCTTGAGC,sample,158264,156742,15860,140882,18382,122500,58637,4294,32842,3015,91479,23712,7446,1670,17184,12360
AAGAGCGCCCTTGAGC,sample,151808,149759,15476,134283,16593,117690,50045,4560,35566,3801,85611,23718,6900,1469,13612,11051
CCAATTCCCCTTGAGC,sample,76429,74951,5695,69256,8758,60498,28386,2252,18981,2754,47367,8125,3587,1186,4784,5402
GTACCGTACCTTGAGC,sample,174669,172796,18915,153881,15693,138188,45468,3779,48232,5314,93700,35395,9284,2094,8217,9106
AGGTCGGACCTTGAGC,Pos_Ctrl,61802,60645,4522,56123,2466,53657,44707,4456,3035,364,47742,1095,5431,6398,2904,1228
GGAGAGTTCGATATCC,sample,100952,100372,5626,94746,21448,73298,34872,2402,22623,3247,57495,10154,5222,1560,9787,14593
ATTCTCTTCGATATCC,sample,61893,61532,3112,58420,13893,44527,24723,1366,11804,1440,36527,5194,3202,1082,7252,9172
TCCAACTTCGATATCC,sample,90570,89957,2813,87144,24944,62200,40455,3262,13170,1680,53625,3633,2501,1417,9339,16346
ACGTAAGTCGATATCC,sample,158539,157559,10435,147124,26571,120553,54382,3554,39493,4318,93875,18806,6854,1713,19112,17359
CCTCTAGACGATATCC,sample,79181,78562,6521,72041,18057,53984,28745,1376,13174,1460,41919,9229,4186,960,9280,11795
TTCTAATGCGATATCC,sample,69216,68776,4632,64144,12370,51774,27358,1617,14873,1801,42231,6125,3369,1200,5921,8480
TAGTACGGCGATATCC,sample,22804,22635,1544,21091,4617,16474,8861,696,4201,467,13062,2249,1913,811,2560,3077
AATGGTAACGATATCC,sample,143108,142093,7968,134125,26635,107490,50294,2634,34791,3688,85085,16083,4932,1322,16786,18574
TTAGAAGTCGATATCC,sample,105341,104666,7681,96985,13483,83502,33360,2575,32130,3029,65490,12408,5593,2072,5840,9736
TTCCGTCTCGATATCC,sample,107829,106854,8314,98540,13030,85510,31747,1805,31880,4006,63627,16072,5568,1342,4426,8739
GACGGAGACGATATCC,sample,84221,83359,6583,76776,18651,58125,31248,2323,14619,1447,45867,8488,4345,1300,8527,12764
GTTAGCCGCGATATCC,sample,76524,75870,7063,68807,7620,61187,23750,1868,23193,3214,46943,9162,5091,1723,5325,5359
CCATGAAGCGATATCC,sample,118850,117695,6489,111206,18286,92920,55822,4234,22228,1922,78050,8714,4204,1742,12987,13538
AATCCGTCCGATATCC,sample,116703,115564,8372,107192,21553,85639,48746,3718,20231,2447,68977,10497,3672,1213,15158,14755
GTCCTGCCCGATATCC,sample,140987,139417,13808,125609,15531,110078,44366,3029,35632,4232,79998,22819,7019,1642,12085,10886
CTAGGACCCGATATCC,sample,102856,101629,6175,95454,17982,77472,44666,4143,17889,1913,62555,8861,3043,1033,12534,12380
GCCTGAACCGATATCC,sample,128261,126744,11761,114983,18699,96284,44824,2658,28041,2934,72865,17827,5949,1351,10887,12555
ACGTATTACGATATCC,sample,143815,142384,10048,132336,15822,116514,60416,3380,34596,4184,95012,13938,4379,1320,12418,11406
GTCTTAGCCGATATCC,sample,59573,58872,6017,52855,7068,45787,18664,1752,14755,1408,33419,9208,4353,929,4947,4858
TTGGTTAACGATATCC,sample,153146,151927,7490,144437,21329,123108,80950,6703,22730,2675,103680,10050,4860,2188,18296,14305
GGCATATACGATATCC,sample,136263,135116,6033,129083,20603,108480,69051,4780,22678,2352,91729,9619,3216,1289,19376,14861
TTATTCGACGATATCC,sample,35485,35239,1560,33679,5666,28013,17217,1775,6563,699,23780,1759,1877,882,3970,3792
ATGACCGACGATATCC,sample,102584,101857,6657,95200,10764,84436,36628,3128,28844,3125,65472,12711,5486,1538,8338,7050
ATTCTCTTATCTGACC,sample,27611,27334,3964,23370,3462,19908,5517,335,7459,720,12976,5877,3393,587,1893,2207
TCCAACTTATCTGACC,sample,27350,27100,2733,24367,5573,18794,8632,783,5061,613,13693,3705,2214,653,2914,3619
AAGTTCGTATCTGACC,sample,19658,19483,1175,18308,3541,14767,7986,592,4076,494,12062,1619,1713,859,2178,2350
GGTTGCGTATCTGACC,sample,33584,33272,3667,29605,4165,25440,9699,911,8992,1019,18691,4819,3131,878,2615,2678
TCCTCCGTATCTGACC,sample,35695,35374,4032,31342,5370,25972,10089,689,8031,889,18120,6274,3786,904,2973,3464
ACGTAAGTATCTGACC,sample,28360,28121,1254,26867,6649,20218,13504,808,3717,424,17221,1765,1668,971,3992,4609
ACGTTATGATCTGACC,Neg_Ctrl,592,303,148,155,32,123,52,11,33,2,85,25,48,25,20,10
AATGGTAAATCTGACC,sample,23183,22989,1656,21333,3986,17347,9493,662,4468,427,13961,2297,1898,761,2842,3027
GCCTTGCTATCTGACC,sample,30127,29843,2352,27491,5403,22088,11479,786,5855,613,17334,3355,2493,981,3122,3635
ACTATACTATCTGACC,sample,77578,76876,6896,69980,8784,61196,22415,1735,21677,2342,44092,13027,5118,1308,3611,6027
GTTAGCCGATCTGACC,sample,36222,35869,1461,34408,8999,25409,18527,1723,3491,321,22018,1347,1783,1328,4139,6182
GGAGGACGATCTGACC,Neg_Ctrl,717,339,181,158,34,124,51,3,46,3,97,21,56,26,13,7
GACGATAAATCTGACC,sample,42633,42250,6451,35799,4528,31271,10402,523,10797,1320,21199,8229,4504,943,2494,2789
CGAGGCAGATCTGACC,sample,68982,68290,6127,62163,9104,53059,26475,1782,15040,1626,41515,8136,4225,1303,6096,6462
CATGATTCATCTGACC,sample,58761,58146,4861,53285,7583,45702,20710,1941,13573,1680,34283,7798,4453,1270,5810,4839
CGTACGTCATCTGACC,sample,66366,65562,8198,57364,8566,48798,18027,1477,16123,1711,34150,11460,4889,1043,4569,5528
AGTCCGCAATCTGACC,sample,59320,58761,4275,54486,9723,44763,26416,1464,10484,1198,36900,5201,2667,988,8208,6960
CTAGGACCATCTGACC,Neg_Ctrl,974,460,260,200,34,166,82,6,49,2,131,27,79,36,13,11
GTTAGGACATCTGACC,sample,79734,78857,7637,71220,10334,60886,27574,1798,18697,2030,46271,10787,4895,1295,6970,7001
CGTATGAAATCTGACC,sample,51566,50946,2825,48121,8356,39765,27896,1837,6334,1058,34230,2640,1912,841,7869,6215
AAGAGCGCATCTGACC,sample,42361,41949,2415,39534,6294,33240,22121,1031,6147,757,28268,3184,1819,773,7028,4799
CTTCATGAATCTGACC,sample,29449,28965,1717,27248,4582,22666,15022,1242,4151,459,19173,1792,1452,857,2484,3064
TTATTCGAATCTGACC,Neg_Ctrl,357,191,87,104,8,96,49,2,20,3,69,22,46,25,13,3
GACCGGAAATCTGACC,sample,863,792,66,726,111,615,393,34,117,15,510,56,212,145,66,81
ATTCTCTTCTTCTTAC,sample,42109,41759,2714,39045,6423,32622,17595,898,8702,1106,26297,4321,2645,757,3672,4172
AAGTTCGTCTTCTTAC,sample,72507,71930,4299,67631,10215,57416,25661,1797,18603,2147,44264,9208,4346,1106,4310,7148
CCTCTAGACTTCTTAC,sample,23756,23581,1374,22207,2951,19256,8859,744,6863,590,15722,2200,2022,895,1876,2052
AGTACCATCTTCTTAC,sample,48474,48080,4053,44027,7339,36688,14828,934,12389,1315,27217,7222,3937,922,5557,4982
TTCGTAATCTTCTTAC,sample,54013,53665,4440,49225,10806,38419,19209,1030,9844,1322,29053,7014,3629,1055,5694,7253
CAACCGCGCTTCTTAC,sample,16713,16528,1601,14927,2859,12068,5590,304,3391,359,8981,2424,2029,719,1870,1805
TTAGAAGTCTTCTTAC,sample,44678,44373,3662,40711,8405,32306,15445,1101,9297,1043,24742,5420,3031,841,5981,5579
CAAGGCCTCTTCTTAC,sample,77261,76558,7298,69260,10658,58602,24997,2081,19195,2238,44192,10091,4813,1120,7256,6891
CATAACCTCTTCTTAC,sample,101206,100369,7886,92483,10630,81853,33739,2276,30117,3496,63856,12225,4220,1379,6927,6924
GGAGGACGCTTCTTAC,sample,31000,30766,2053,28713,7552,21161,12046,727,5133,416,17179,2839,2327,956,4420,5061
GGCCAGAGCTTCTTAC,sample,86543,85642,6557,79085,12072,67013,34674,3049,17676,1773,52350,9841,4429,1384,9435,8390
CCATGAAGCTTCTTAC,sample,104334,103164,10419,92745,7109,85636,30739,2403,33094,3336,63833,16064,6336,1485,4956,4179
CATGATTCCTTCTTAC,sample,105193,104171,10976,93195,14266,78929,33011,2730,27756,3032,60767,12400,6205,1677,6833,9913
AGTCCGCACTTCTTAC,sample,109439,108035,13983,94052,9025,85027,22996,1773,32338,3737,55334,24183,8050,1589,5820,5917
GTCCTGCCCTTCTTAC,sample,87166,86173,9609,76564,10362,66202,27066,1654,20706,2121,47772,14655,5998,1086,8972,7037
TTGGTACCCTTCTTAC,sample,146701,145066,9442,135624,12302,123322,80145,4589,22682,2594,102827,13312,4776,1414,15100,8768
CGGATTACCTTCTTAC,sample,168688,166861,13419,153442,19184,134258,64385,6257,34739,3751,99124,25126,6777,1637,12758,13049
TGCTTCGCCTTCTTAC,sample,81242,80215,8600,71615,7396,64219,26517,1960,18957,2115,45474,14670,6102,1544,5933,5047
GAAGGCGCCTTCTTAC,sample,78535,77627,6910,70717,9700,61017,30010,1510,18293,2034,48303,9170,4156,1145,8086,7444
GTACCGTACTTCTTAC,sample,69916,68906,6712,62194,8817,53377,26132,2063,14592,1720,40724,8870,3884,940,7769,6431
TCAATATACTTCTTAC,sample,71586,70741,3551,67190,11915,55275,42322,2663,7475,876,49797,1939,1042,760,11844,9291
AGGTCGGACTTCTTAC,sample,19198,18958,2533,16425,1621,14804,5726,453,5059,583,10785,2983,2638,953,1164,945
TTATTCGACTTCTTAC,sample,101626,100737,6646,94091,11860,82231,46233,3963,20817,2394,67050,8824,3209,1255,7890,8387
ATGACCGACTTCTTAC,sample,100916,100036,8501,91535,8558,82977,30924,2594,27607,2881,58531,18971,6341,1334,5301,5426
TCCAACTTACTTCTAC,sample,24210,23985,1909,22076,3175,18901,9305,857,5235,683,14540,2821,1922,606,2455,2081
AAGTTCGTACTTCTAC,sample,31885,31635,970,30665,6239,24426,17927,1795,3121,454,21048,1129,1498,1137,3125,4518
TTCGTAATACTTCTAC,sample,11138,11094,426,10668,3376,7292,5709,367,817,162,6526,237,855,756,2132,2058
ATGCCTGGACTTCTAC,sample,17573,17435,1406,16029,1988,14041,5212,441,5237,713,10449,2438,2427,844,970,1392
AATGGTAAACTTCTAC,sample,29966,29732,4233,25499,3792,21707,6604,445,7671,916,14275,6071,3856,1012,1194,2246
CATAACCTACTTCTAC,sample,110904,109998,11973,98025,10211,87814,30658,1641,33565,4266,64223,17684,7184,1680,6713,6217
GACGGAGAACTTCTAC,sample,63209,62619,5176,57443,10415,47028,22690,1339,13611,1571,36301,7817,3530,1046,7227,6823
GGACGTAGACTTCTAC,sample,47570,47175,3145,44030,12523,31507,24176,1298,4821,353,28997,859,1180,964,7658,8790
TGGACGAGACTTCTAC,sample,66448,65836,4632,61204,5601,55603,23900,1505,20203,1727,44103,8268,4106,1345,4380,3875
CGTACGTCACTTCTAC,sample,42089,41427,6653,34774,3073,31701,7614,371,12670,1237,20284,9809,4693,760,2047,1432
CTAGGACCACTTCTAC,sample,110179,109075,7351,101724,12598,89126,49474,4063,21130,2471,70604,11988,4684,1390,9567,8992
GTTAGGACACTTCTAC,sample,119747,118672,10896,107776,9741,98035,47101,3543,30156,3604,77257,13631,4815,1360,10616,6989
AACTCGTAACTTCTAC,sample,108608,107515,9103,98412,8656,89756,36937,3461,28143,2999,65080,18216,5741,1327,6530,5717
AAGAGCGCACTTCTAC,sample,29921,29429,3392,26037,3722,22315,8587,617,7198,698,15785,5215,2756,556,2066,2474
GTCTTAGCACTTCTAC,sample,66551,65865,5533,60332,7120,53212,26707,1952,14286,1273,40993,8994,3884,1092,4879,4719
AGGTCGGAACTTCTAC,sample,41339,40939,3401,37538,5033,32505,14736,1051,9807,1141,24543,5770,3416,946,2448,3061
TCCTCCGTAGAAGTAA,sample,8184,8149,446,7703,2808,4895,2784,255,1243,130,4027,483,1160,689,595,1553
CCTCTAGAAGAAGTAA,sample,40336,40033,3661,36372,6845,29527,13123,940,9173,761,22296,5530,3430,1019,3607,4629
GGACCTCTAGAAGTAA,sample,45691,45334,3477,41857,10101,31756,14502,888,9078,940,23580,6348,3251,791,5173,6405
GACGGAGAAGAAGTAA,sample,96414,95688,4306,91382,10680,80702,38463,3077,27300,3128,65763,8734,3449,1518,5226,7642
CCAGAGCGAGAAGTAA,sample,100003,99172,4814,94358,19371,74987,45160,2871,19352,2004,64512,5600,3212,1374,10432,13152
GTTAGCCGAGAAGTAA,sample,85127,84551,3774,80777,7900,72877,34490,2544,25612,3546,60102,6685,3575,1763,5727,5545
GGCCAGAGAGAAGTAA,sample,21930,21711,989,20722,5839,14883,9993,848,2617,385,12610,1040,1226,773,3701,3644
CATGATTCAGAAGTAA,sample,145916,144692,8397,136295,16045,120250,61057,5223,34795,4499,95852,14676,4832,1625,11774,11135
GTCCTGCCAGAAGTAA,sample,203629,201731,9622,192109,27668,164441,106615,7412,30645,4516,137260,15253,2842,1222,25055,19667
GCCTGAACAGAAGTAA,sample,300018,297593,18796,278797,19086,259711,106093,8552,89828,12727,195921,42511,8312,2288,10179,10674
ACGTATTAAGAAGTAA,sample,216575,215198,15181,200017,34088,165929,82974,6402,44146,4879,127120,27528,9171,3064,15790,22997
TTGGCCTCAGAAGTAA,sample,311387,307983,39292,268691,21028,247663,67523,5526,94512,9674,162035,70428,15094,3112,10945,11788
TGCTTCGCAGAAGTAA,sample,152594,151332,7525,143807,21876,121931,78091,5909,25250,3092,103341,9589,4789,1722,12408,15594
CCAATTCCAGAAGTAA,sample,244,225,25,200,30,170,91,1,44,2,135,32,69,46,14,13
TCAATATAAGAAGTAA,sample,431,422,40,382,21,361,191,3,100,10,291,57,122,64,54,23
TTATTCGAAGAAGTAA,sample,302,294,38,256,18,238,119,9,70,2,189,38,105,47,24,12
ATGACCGAAGAAGTAA,sample,384,374,51,323,32,291,139,17,88,9,227,38,139,68,24,17
Short,Non_sample,0,NA,NA,NA,NA,NA,NA,NA,NA,NA,NA,NA,NA,NA,NA,NA
Unselected,Non_sample,0,NA,NA,NA,NA,NA,NA,NA,NA,NA,NA,NA,NA,NA,NA,NA
Undetermined,Non_sample,184159487,NA,NA,NA,NA,NA,NA,NA,NA,NA,NA,NA,NA,NA,NA,NA
