Barcode,Sample,Barcoded_Reads,Trimmed_Reads,Unmapped_Reads,Mapped_Reads,Multimapped_Reads,Uniquely_Mapped_Reads,Exon_Reads,Ambiguous_Exon_Reads,Intron_Reads,Ambiguous_Intron_Reads,Gene_Reads,Intergenic_Reads,No_of_Genes,No_of_Transcripts,Mitochondrial_Reads,Ribosomal_Reads
GTCGTTCTCGTTGGTT,sample,89742,88837,3343,85494,18185,67309,40285,2830,18434,2203,58719,3557,2845,1998,8878,13024
AGAGTTCTCGTTGGTT,sample,95719,94568,4872,89696,28073,61623,36708,2612,14947,1850,51655,5506,3041,1603,6833,17229
GGAGAAGCCGTTGGTT,sample,176781,175113,9897,165216,37510,127706,75194,6383,28518,3608,103712,14003,5812,1981,22234,25579
CATACTCCCGTTGGTT,sample,94282,92916,7200,85716,23129,62587,27742,1758,20227,2374,47969,10486,4794,1177,8575,14025
CTAGCGACCGTTGGTT,sample,82247,81260,2683,78577,26265,52312,38322,3831,6801,811,45123,2547,2737,2233,6984,15730
TACGCGAGCGTTGGTT,sample,97518,96666,4418,92248,28412,63836,39304,2828,13126,1482,52430,7096,4054,1721,12339,17516
CCGCAGTCCGTTGGTT,sample,92702,91984,2801,89183,24468,64715,42777,3996,13159,2104,55936,2679,2741,1948,9884,15978
TGGATCAACGTTGGTT,sample,141802,140384,4113,136271,32687,103584,67286,4871,21167,3588,88453,6672,2828,1661,11767,21441
CGGTTGGTCGTTGGTT,sample,521,507,40,467,187,280,183,3,72,7,255,15,106,62,64,97
ACGCTTAACGTTGGTT,sample,75398,74816,3307,71509,25174,46335,29106,2321,10228,1393,39334,3287,2834,1447,10151,14563
GCTCTTCTCGTTGGTT,sample,75013,74397,3369,71028,18658,52370,30404,2214,12881,1604,43285,5267,3943,1988,8622,12327
CTAACCGGCGTTGGTT,sample,45076,44621,1591,43030,14904,28126,18823,1428,5560,512,24383,1803,2426,1589,5849,8747
GGCGTACCCGTTGGTT,sample,402,377,27,350,106,244,167,14,44,4,211,15,103,76,60,62
CAGCTTCGCGTTGGTT,sample,633,618,61,557,209,348,211,14,91,7,302,25,154,91,55,118
TCTCCTAGCGTTGGTT,sample,44986,44518,1198,43320,13404,29916,19638,2087,6202,653,25840,1336,2112,1749,4779,8235
ATGAATAGCGTTGGTT,sample,82776,82097,3092,79005,23606,55399,33457,2807,13492,1461,46949,4182,2824,1650,10817,14835
TCAATCAGCGTTGGTT,sample,55180,54541,1953,52588,19471,33117,17089,1085,10103,1368,27192,3472,2789,1186,4686,10988
TAACGCCACGTTGGTT,sample,3844,3740,177,3563,1192,2371,1540,122,529,42,2069,138,607,393,451,707
CGCGAGACCGTTGGTT,sample,253,246,13,233,60,173,100,6,48,6,148,13,73,37,37,39
CCTAACTACGTTGGTT,sample,365,351,25,326,71,255,154,4,60,14,214,23,101,51,33,49
TCTAGGTTCTATCGTT,sample,82125,81100,4469,76631,22072,54559,32361,2200,13628,1366,45989,5004,2977,1346,11819,13677
CTGGTCTTCTATCGTT,sample,67993,67180,3856,63324,15444,47880,24919,2033,14776,1519,39695,4633,2859,1279,6797,10150
GTCGTTCTCTATCGTT,sample,94086,92816,6543,86273,20833,65440,37627,2275,16141,1679,53768,7718,4209,1433,13312,13971
AGCTGAATCTATCGTT,sample,97454,96207,7437,88770,21276,67494,37884,3641,16394,1549,54278,8026,4541,1868,10434,14126
GACGTATGCTATCGTT,sample,20411,20058,1694,18364,3990,14374,6639,469,4767,508,11406,1991,2053,848,2293,2626
GGAGAAGCCTATCGTT,sample,79084,78203,4836,73367,19899,53468,34225,2341,10317,1191,44542,5394,3582,1763,9542,12826
GAGCCTCCCTATCGTT,sample,65056,63911,5165,58746,17157,41589,22291,1760,10508,980,32799,6050,3562,1194,6962,10368
CCGTACGCCTATCGTT,sample,75531,74669,3588,71081,18163,52918,34082,2180,11270,1314,45352,4072,2602,1566,9095,12441
GATGCGTTCTATCGTT,sample,154259,152373,14114,138259,25461,112798,48323,3464,35964,3575,84287,21472,7204,1472,17000,16637
CCATTCTTCTATCGTT,sample,32539,31882,2450,29432,9615,19817,10640,774,5351,617,15991,2435,2226,993,2646,5711
AGCGTCTTCTATCGTT,sample,53268,52556,2927,49629,16567,33062,24145,1406,4932,733,29077,1846,1770,1155,9904,10054
CGGTTGGTCTATCGTT,sample,60364,59785,2688,57097,15627,41470,31627,2122,5123,533,36750,2065,2698,2181,6319,10603
ACGCTTAACTATCGTT,sample,67146,66577,2342,64235,28148,36087,25459,1538,6364,1022,31823,1704,1789,1160,11295,14871
CTAAGCATCTATCGTT,sample,107488,106446,5311,101135,26386,74749,46452,3043,17459,1935,63911,5860,3139,1271,17545,17685
CTAACCGGCTATCGTT,sample,51009,50371,2022,48349,18111,30238,20420,1444,5899,803,26319,1672,1843,1106,4366,9921
GGCGACGACTATCGTT,sample,85350,84546,2919,81627,19727,61900,41672,3924,11285,1208,52957,3811,3102,1754,8231,13351
ATACCGCCCTATCGTT,sample,69548,68835,3181,65654,18953,46701,32036,2217,8244,955,40280,3249,2537,1594,9803,12216
AAGTAGAGCTATCGTT,sample,62483,61950,2549,59401,18916,40485,29574,2382,5641,784,35215,2104,2709,2091,6979,11538
TCAATCAGCTATCGTT,sample,29915,29502,1990,27512,7461,20051,12855,768,4039,505,16894,1884,2249,1236,3966,4587
GACTAACCCTATCGTT,sample,31761,31236,1147,30089,6275,23814,14214,1072,6083,736,20297,1709,1878,1108,2765,4084
CCTAACTACTATCGTT,sample,304,294,30,264,70,194,128,9,38,6,166,13,84,46,32,46
CTGGTCTTGTCTTCTT,Pos_Ctrl,17902,17543,1283,16260,849,15411,12826,1300,873,135,13699,277,3045,2857,1077,355
AGCTGAATGTCTTCTT,sample,35219,34755,1312,33443,9187,24256,17286,1438,4152,345,21438,1035,2498,2134,2681,6027
CATAATGGGTCTTCTT,sample,11135,10937,953,9984,2179,7805,4116,286,2238,323,6354,842,1382,683,1468,1429
TATACGGAGTCTTCTT,Pos_Ctrl,27850,27432,2182,25250,1211,24039,20209,1816,1379,201,21588,434,4114,4080,1699,526
GAGCCTCCGTCTTCTT,sample,46742,46137,3271,42866,11465,31401,17283,1279,7895,831,25178,4113,3694,1761,4120,7394
GGTAGAGAGTCTTCTT,sample,26219,25899,1557,24342,5954,18388,11605,928,3860,412,15465,1583,2588,1679,2201,4118
TCATACCAGTCTTCTT,sample,53490,52753,2984,49769,14138,35631,21348,1522,8017,1122,29365,3622,2734,1181,8994,8986
GCAACTAGGTCTTCTT,sample,2915,2834,429,2405,382,2023,639,38,828,85,1467,433,769,257,128,205
TACGCGAGGTCTTCTT,sample,34901,34504,967,33537,8276,25261,15868,1181,6202,787,22070,1223,1979,1454,3658,5557
ATACGTTCGTCTTCTT,sample,40131,39348,6102,33246,3005,30241,6394,463,13366,1656,19760,8362,4245,856,439,1509
CCGCAGTCGTCTTCTT,sample,39492,39071,1387,37684,13455,24229,19120,1489,2613,263,21733,744,1600,1574,5426,8206
CCGTACGCGTCTTCTT,sample,49700,48986,2074,46912,11528,35384,24801,1589,6355,802,31156,1837,2001,1467,4204,7558
ATGGCGTTGTCTTCTT,sample,62152,61307,4137,57170,9796,47374,26321,1535,13371,1612,39692,4535,2867,1263,6694,6888
CCATTCTTGTCTTCTT,sample,56092,55301,2503,52798,11536,41262,20937,1343,12859,1781,33796,4342,2398,1131,3532,7621
CTAACCGGGTCTTCTT,sample,48916,48379,3393,44986,11192,33794,19404,1413,7910,823,27314,4244,3126,1390,6763,7380
GCCTATTCGTCTTCTT,sample,9931,9761,720,9041,3265,5776,3179,255,1417,161,4596,764,1153,640,924,2044
ATACCGCCGTCTTCTT,sample,54305,53523,2109,51414,14335,37079,22290,1400,10061,1218,32351,2110,2040,1093,4421,9317
GTCGCGAAGTCTTCTT,sample,63388,62689,2581,60108,18900,41208,31340,2440,5706,709,37046,1013,1730,1446,10906,11670
CGCGGTCGGTCTTCTT,sample,36217,35858,2155,33703,7586,26117,14366,907,7350,955,21716,2539,2849,1641,3748,5105
TCTCCTAGGTCTTCTT,sample,30727,30286,1845,28441,10612,17829,8663,701,5656,580,14319,2229,2239,1047,1782,6031
AAGTAGAGGTCTTCTT,sample,90740,90112,4075,86037,17513,68524,44259,3842,12797,1488,57056,6138,3828,1668,7569,11799
ATTCTACCGTCTTCTT,sample,30151,29694,2497,27197,9227,17970,6447,386,6728,819,13175,3590,2788,830,1661,5191
CGTAGAACGTCTTCTT,sample,21324,21097,1098,19999,6768,13231,8474,733,2805,322,11279,897,1762,1075,2549,3991
CCTAACTAGTCTTCTT,Pos_Ctrl,794,774,52,722,60,662,501,56,71,11,572,23,280,201,70,44
CTGGTCTTTAGGCTCT,sample,58456,57769,2438,55331,16879,38452,25228,1937,7956,1114,33184,2217,2075,1370,9137,10758
GGAGAAGCTAGGCTCT,sample,10414,10099,1140,8959,2202,6757,3433,241,1822,195,5255,1066,1165,530,1368,1290
TCGAACGATAGGCTCT,sample,31631,31290,2109,29181,7050,22131,11843,913,6083,684,17926,2608,2523,1071,3745,4589
CGTCGCCATAGGCTCT,sample,107781,106621,6103,100518,24332,76186,43870,3090,18520,1898,62390,8808,3950,1438,13099,16395
ATTCAAGGTAGGCTCT,sample,155489,154132,7534,146598,34399,112199,77417,5626,19170,2191,96587,7795,3641,2186,21539,23191
GCAACTAGTAGGCTCT,sample,30367,29728,1743,27985,7265,20720,9973,1051,6705,975,16678,2016,2066,1030,1257,4498
TACGCGAGTAGGCTCT,sample,92186,91407,3925,87482,22461,65021,40459,3072,15251,1926,55710,4313,3353,2131,11155,14584
GACTCAAGTAGGCTCT,sample,155006,152924,13447,139477,32266,107211,54815,3645,29590,3636,84405,15525,6116,1540,21709,20981
TGGATCAATAGGCTCT,sample,144673,142456,8731,133725,34462,99263,66610,4636,18747,1962,85357,7308,2678,1122,22674,21847
CGGTTGGTTAGGCTCT,sample,173222,171236,9707,161529,33819,127710,70619,6180,37808,3234,108427,9869,4917,1806,17625,22476
ACGCTTAATAGGCTCT,sample,171306,169616,4637,164979,38636,126343,103491,8408,9364,1395,112855,3685,2930,2655,19240,26115
CATTCGGTTAGGCTCT,sample,124574,122760,6306,116454,32193,84261,47699,4594,20035,2509,67734,9424,3935,1466,9597,20408
CTAAGCATTAGGCTCT,sample,164436,162307,7391,154916,40811,114105,84300,5096,17367,2210,101667,5132,3207,1940,20555,26848
TAACGAAGTAGGCTCT,sample,17632,17379,1262,16117,4637,11480,6006,378,3293,365,9299,1438,2033,1094,1664,2797
GCCTATTCTAGGCTCT,sample,81075,79892,5489,74403,23006,51397,20776,1446,19014,2604,39790,7557,3792,1299,4736,13594
AGCAGAGCTAGGCTCT,sample,78773,77850,5268,72582,24397,48185,31280,2013,10465,1109,41745,3318,3131,2087,8878,14513
CGCGGTCGTAGGCTCT,sample,34061,33579,1717,31862,9262,22600,11570,912,7375,1008,18945,1735,2537,1423,2339,5724
TCTCCTAGTAGGCTCT,sample,90341,89333,4070,85263,22009,63254,38611,2741,15844,1777,54455,4281,3073,1687,12966,14693
ATTCTACCTAGGCTCT,sample,40727,40258,2208,38050,17521,20529,11191,778,6203,617,17394,1740,2650,1315,3611,8646
AGATACTATAGGCTCT,sample,103049,101893,6152,95741,29069,66672,39586,2714,15897,1785,55483,6690,3880,1842,12658,17321
CCTAACTATAGGCTCT,sample,47250,46546,2359,44187,14301,29886,14345,1143,9999,1059,24344,3340,2611,1183,4325,8562
ATATGCAATAGGCTCT,sample,243,240,22,218,47,171,87,5,52,1,139,26,58,47,38,30
AACCGGTTTTGACTAT,sample,635,603,24,579,156,423,218,28,125,22,343,30,157,91,51,98
GTCGTTCTTTGACTAT,Neg_Ctrl,2020,802,473,329,56,273,140,17,74,6,214,36,113,62,24,15
TATACGGATTGACTAT,sample,45887,45188,4341,40847,8663,32184,16818,976,8445,1141,25263,4804,2899,1051,6216,5487
CATACTCCTTGACTAT,sample,38386,37724,2617,35107,7204,27903,17730,1321,5554,728,23284,2570,2377,1316,3933,5153
ATTCAAGGTTGACTAT,sample,54891,54111,5004,49107,9387,39720,20996,1468,9618,780,30614,6858,3705,1228,8586,6104
TGATTCCGTTGACTAT,Pos_Ctrl,19466,19095,1778,17317,830,16487,13785,1341,951,139,14736,271,3341,3191,927,398
GCAACTAGTTGACTAT,sample,13651,13252,819,12433,3113,9320,5087,405,2668,228,7755,932,1633,925,948,2007
ATACGTTCTTGACTAT,sample,44622,43917,2934,40983,10290,30693,20062,1547,5867,671,25929,2546,2718,1641,5139,6804
CCGTACGCTTGACTAT,sample,138521,136732,14496,122236,11578,110658,39465,2956,44142,5912,83607,18183,8053,2262,6331,6905
ATGGCGTTTTGACTAT,Pos_Ctrl,37047,36556,2728,33828,1401,32427,27190,2639,1811,241,29001,546,4437,4780,1590,554
CCATTCTTTTGACTAT,sample,88964,87599,4457,83142,14843,68299,38441,2799,18151,2342,56592,6566,3146,1366,6728,10606
AGCGTCTTTTGACTAT,sample,48417,47814,3608,44206,11464,32742,21944,1572,5540,691,27484,2995,2590,1462,4730,7190
CGGTTGGTTTGACTAT,sample,46898,46221,4132,42089,11489,30600,14128,1012,9066,1103,23194,5291,3489,1229,2403,6967
ACGCTTAATTGACTAT,sample,77248,75798,5856,69942,14883,55059,27075,1771,16594,1868,43669,7751,3648,1182,3516,9453
CCTAGCGGTTGACTAT,Pos_Ctrl,19402,19180,1404,17776,747,17029,14022,1359,1096,155,15118,397,3355,3254,772,355
TGCGCTCCTTGACTAT,sample,75872,74734,5425,69309,16458,52851,28429,2393,13978,1695,42407,6356,3646,1249,7402,10316
GCGTTACCTTGACTAT,sample,86170,84763,6361,78402,18625,59777,32048,2673,14793,1966,46841,8297,4377,1339,7736,12086
CGTCGAGGTTGACTAT,Pos_Ctrl,27650,26984,2235,24749,1123,23626,19583,1917,1454,129,21037,543,4066,4094,1091,420
ATGAATAGTTGACTAT,sample,55673,55020,2993,52027,14569,37458,24691,2013,7163,745,31854,2846,2701,1693,6627,9229
ATTCTACCTTGACTAT,sample,63862,63052,4358,58694,15429,43265,23229,1750,10718,1334,33947,6234,3513,1329,8142,9712
GACTAACCTTGACTAT,sample,46104,45490,2900,42590,10517,32073,17130,1352,9083,1107,26213,3401,2625,1270,4638,6671
CGCGAGACTTGACTAT,sample,31615,31063,3417,27646,6893,20753,9562,656,5896,636,15458,4003,2925,950,3622,4428
CGTAGAACTTGACTAT,sample,51094,50418,2947,47471,12017,35454,24099,1837,5849,477,29948,3192,3046,1847,5234,7576
GCGCAATATTGACTAT,Neg_Ctrl,3655,1288,891,397,96,301,179,8,80,7,259,27,129,54,55,14
AACCGGTTTGCAGTTG,sample,527,518,26,492,125,367,243,4,74,7,317,39,135,83,54,75
GTCGTTCTTGCAGTTG,sample,46899,46310,1849,44461,10646,33815,23757,1968,5667,878,29424,1545,1970,1345,5702,7493
AGAGTTCTTGCAGTTG,sample,23212,22754,1509,21245,5463,15782,7852,614,5128,639,12980,1549,1549,844,1302,3554
AGCTGAATTGCAGTTG,sample,35243,34599,3304,31295,9108,22187,9223,567,7669,851,16892,3877,2851,948,2360,5298
CATAATGGTGCAGTTG,sample,42363,41771,2517,39254,9832,29422,18813,1539,5811,646,24624,2613,2250,1135,6406,6575
CTAGCGACTGCAGTTG,sample,15788,15412,1086,14326,3236,11090,7044,493,2251,285,9295,1017,1681,1077,1917,2073
TCGAACGATGCAGTTG,sample,14767,14439,1035,13404,3586,9818,5129,326,2797,352,7926,1214,1515,782,888,2261
GGTAGAGATGCAGTTG,sample,26889,26442,2244,24198,5152,19046,9247,713,5548,555,14795,2983,2810,1387,1595,3355
GCAACTAGTGCAGTTG,sample,3157,3059,218,2841,589,2252,1212,84,635,126,1847,195,765,456,273,375
TCTCAGGATGCAGTTG,sample,28592,28033,1482,26551,10992,15559,8754,663,4231,526,12985,1385,1789,946,2419,5857
CCATTCTTTGCAGTTG,sample,47582,47023,2148,44875,13439,31436,21048,1462,6557,737,27605,1632,2213,1372,5687,8346
CGGTTGGTTGCAGTTG,sample,65187,64431,2282,62149,13392,48757,31408,2846,10827,820,42235,2856,2305,1603,6611,9527
CATTCGGTTGCAGTTG,sample,54562,53709,2181,51528,15392,36136,21097,1244,9406,1378,30503,3011,2214,1066,5383,9731
TAGCGAGTTGCAGTTG,sample,72261,71481,3894,67587,21381,46206,26059,2059,11562,1180,37621,5346,3311,1330,5151,13187
GAGATTCTTGCAGTTG,sample,55234,54400,3422,50978,14434,36544,18751,1723,10787,1198,29538,4085,2917,1218,3482,8975
AAGGTCTGTGCAGTTG,sample,99308,98469,4856,93613,18617,74996,48746,3409,13616,1687,62362,7538,3992,1746,12842,12824
CCTAGCGGTGCAGTTG,sample,57774,57124,2819,54305,13476,40829,25141,1776,8940,937,34081,4035,3083,1430,6344,8753
CTAACCGGTGCAGTTG,sample,62076,61169,3482,57687,13136,44551,23384,1646,12316,1274,35700,5931,3402,1127,7540,9110
GCTGCTTCTGCAGTTG,sample,50986,50140,3233,46907,14490,32417,21395,1563,6578,705,27973,2176,1913,1073,8764,9092
ATACCGCCTGCAGTTG,sample,67464,66551,5055,61496,13091,48405,27622,1947,11386,1563,39008,5887,3804,1287,7112,8649
GTCGCGAATGCAGTTG,sample,59315,58234,3476,54758,15233,39525,21653,1530,9930,1146,31583,5266,2900,937,6025,9474
CGTCGAGGTGCAGTTG,sample,37939,37382,2099,35283,6282,29001,15242,1424,8595,986,23837,2754,2443,1141,3350,4358
TCTCCTAGTGCAGTTG,sample,75560,74529,4252,70277,14369,55908,31958,2190,13757,1547,45715,6456,3665,1232,9347,9806
AAGTAGAGTGCAGTTG,sample,33003,32563,2625,29938,8976,20962,10545,756,6287,632,16832,2742,2599,987,4393,5414
GACTAACCTGCAGTTG,sample,41717,41229,1611,39618,13270,26348,19811,1451,3678,404,23489,1004,1949,1578,5895,8370
CGTAGAACTGCAGTTG,sample,36063,35436,1646,33790,8332,25458,12976,739,8357,1060,21333,2326,1901,1067,1845,5476
CCTAACTATGCAGTTG,sample,60008,59323,2435,56888,18190,38698,29292,1941,5468,846,34760,1151,2093,1625,9847,11415
TTAACTGATGCAGTTG,sample,871,841,47,794,216,578,396,33,103,4,499,42,205,144,137,142
TCTAGGTTTCATGCTG,sample,647,637,30,607,178,429,274,13,87,16,361,39,146,92,81,116
CTGGTCTTTCATGCTG,sample,24715,24448,1619,22829,6855,15974,9686,690,3562,565,13248,1471,1554,757,4085,4057
GTCGTTCTTCATGCTG,sample,6187,6052,464,5588,1918,3670,1939,126,1079,149,3018,377,821,437,511,1093
AGAGTTCTTCATGCTG,sample,28189,27843,2305,25538,7024,18514,8349,524,5632,630,13981,3379,2523,719,2569,4302
TATACGGATCATGCTG,sample,21537,21296,1043,20253,5551,14702,9072,691,3538,370,12610,1031,1385,880,2874,3665
CATACTCCTCATGCTG,sample,14882,14554,1158,13396,3095,10301,4979,389,2971,362,7950,1600,1936,867,1059,1967
TCATCGAATCATGCTG,sample,8201,7998,1144,6854,1094,5760,1948,174,2130,290,4078,1218,1346,528,317,666
GCAACTAGTCATGCTG,Neg_Ctrl,930,329,192,137,25,112,56,5,31,5,87,15,51,26,18,5
GGCAGGTTTCATGCTG,sample,81426,80425,4591,75834,16643,59191,41189,1974,9742,1150,50931,5136,2552,1126,13453,11335
GATGCGTTTCATGCTG,sample,69353,68420,3382,65038,14526,50512,32250,2314,12016,674,44266,3258,2057,1095,10673,10178
TGCGCGTTTCATGCTG,Neg_Ctrl,1895,862,514,348,55,293,146,6,66,2,212,73,83,40,47,27
CCATTCTTTCATGCTG,sample,51412,50662,2371,48291,13539,34752,22422,1461,7402,1095,29824,2372,1778,1011,8986,8472
CGGTTGGTTCATGCTG,sample,44089,43395,2308,41087,11312,29775,20632,1517,5081,542,25713,2003,2073,1289,6464,7568
CATTCGGTTCATGCTG,sample,47577,46716,2251,44465,9019,35446,17818,1678,10789,1303,28607,3858,2409,1081,3071,6089
TAGCGAGTTCATGCTG,sample,73740,72795,3420,69375,12085,57290,34060,2366,13738,1420,47798,5706,3002,1525,9158,8530
GAGATTCTTCATGCTG,sample,58042,57003,4167,52836,10088,42748,18997,1445,13596,1588,32593,7122,3510,1166,3100,6677
CTAAGCATTCATGCTG,sample,50428,49715,2345,47370,10147,37223,25093,1707,7168,993,32261,2262,1947,1070,9100,6942
CTAACCGGTCATGCTG,Neg_Ctrl,1908,672,390,282,67,215,115,6,55,7,170,32,94,49,37,14
GGCGACGATCATGCTG,sample,14797,14415,1750,12665,2654,10011,4006,311,3428,408,7434,1858,2093,799,684,1624
GCCTATTCTCATGCTG,sample,48806,47966,2144,45822,11475,34347,23722,1685,5904,663,29626,2373,2144,1372,6715,7683
TGCGCTCCTCATGCTG,sample,34605,33968,3825,30143,4899,25244,9904,542,9184,1069,19088,4545,3375,1121,2990,3140
ATACCGCCTCATGCTG,sample,17554,17189,719,16470,4708,11762,7900,596,2363,300,10263,603,1687,1225,1928,3045
GTCGCGAATCATGCTG,sample,28841,28367,1412,26955,7587,19368,14947,817,2606,286,17553,712,1536,1306,4746,5097
CGTCGAGGTCATGCTG,sample,22384,21973,933,21040,5095,15945,10284,730,3565,482,13849,884,1807,1267,2524,3468
CAGCTTCGTCATGCTG,Neg_Ctrl,2022,804,471,333,54,279,150,19,64,12,214,34,109,59,38,19
CGCGGTCGTCATGCTG,sample,15190,14860,1290,13570,3192,10378,5552,367,2940,313,8492,1206,1603,771,2047,2124
TTATGACGTCATGCTG,sample,22348,21889,2051,19838,6042,13796,6723,407,4311,482,11034,1873,2149,871,1843,3610
AAGTAGAGTCATGCTG,sample,35163,34638,2252,32386,6963,25423,15899,967,5750,754,21649,2053,2239,1305,4506,4916
GACTAACCTCATGCTG,sample,35324,34783,1719,33064,8817,24247,15240,1062,5519,630,20759,1796,2110,1376,4216,5836
CGCGAGACTCATGCTG,sample,38251,37576,1718,35858,10592,25266,18267,1085,4024,625,22291,1265,1525,1065,6857,6902
CGTAGAACTCATGCTG,sample,52779,51823,7945,43878,7549,36329,11735,866,13137,1469,24872,9122,5363,1101,4288,4493
AGATACTATCATGCTG,sample,33590,33068,2319,30749,8822,21927,13729,1021,4735,453,18464,1989,2177,1155,4987,5580
ATATGCAATCATGCTG,sample,146,143,12,131,34,97,58,3,25,2,83,9,48,29,19,21
AACCGGTTTTAGGCGG,sample,1807,1693,111,1582,640,942,560,58,219,26,779,79,334,213,116,337
TCTAGGTTTTAGGCGG,sample,39749,39376,2138,37238,10190,27048,15378,1258,6457,919,21835,3036,2670,1361,3275,6380
CTGGTCTTTTAGGCGG,Pos_Ctrl,27885,27484,1714,25770,1216,24554,20595,2024,1336,172,21931,427,4003,4091,1775,500
GTCGTTCTTTAGGCGG,sample,25523,25146,2077,23069,9984,13085,5690,345,4650,369,10340,2031,2065,708,1855,4917
AGCTGAATTTAGGCGG,sample,55943,55187,3518,51669,11437,40232,21863,1724,11097,1374,32960,4174,2928,1483,3987,7607
GACGTATGTTAGGCGG,sample,45945,45048,3770,41278,12832,28446,14347,835,7692,902,22039,4670,2915,865,3635,7464
CATAATGGTTAGGCGG,sample,74200,73388,4849,68539,12053,56486,28491,1663,17626,2210,46117,6496,4033,1538,8727,8083
TATACGGATTAGGCGG,Pos_Ctrl,23952,23607,1545,22062,1014,21048,17792,1635,1153,113,18945,355,3858,3851,1360,404
CTAGCGACTTAGGCGG,sample,37848,37366,1490,35876,10943,24933,18386,1441,3513,489,21899,1104,1843,1359,6186,6721
TCGAACGATTAGGCGG,sample,49987,49533,2056,47477,11417,36060,23130,1698,7509,1253,30639,2470,2324,1418,7156,7399
CGTCGCCATTAGGCGG,sample,65619,64771,2570,62201,15138,47063,32608,2384,8586,1035,41194,2450,2559,1613,9101,10504
TCATACCATTAGGCGG,sample,70394,69772,2877,66895,11831,55064,37075,3063,10696,1199,47771,3031,2672,1882,8710,8639
GGCAGGTTTTAGGCGG,sample,92947,91501,6091,85410,13312,72098,38681,3090,18555,2432,57236,9340,3506,1378,8452,8637
GATGCGTTTTAGGCGG,sample,138698,137037,5351,131686,19798,111888,79254,5610,18223,2171,97477,6630,3450,2038,15359,14925
CATTCGGTTTAGGCGG,sample,22726,22190,3673,18517,3110,15407,5080,374,5482,615,10562,3856,2849,824,1711,1828
TAACGAAGTTAGGCGG,sample,35280,34512,1557,32955,10175,22780,16684,1272,3569,368,20253,887,1945,1602,3817,6207
GCTGCTTCTTAGGCGG,sample,43341,42320,3998,38322,8339,29983,13127,860,10288,972,23415,4736,3366,1182,3781,5291
ATACCGCCTTAGGCGG,sample,107674,106088,5566,100522,16544,83978,56716,3976,15423,1786,72139,6077,3491,1844,11371,12605
GCGTTACCTTAGGCGG,sample,81908,80544,3655,76889,15276,61613,40451,2988,12610,1445,53061,4119,2964,1784,7952,10252
CGTCGAGGTTAGGCGG,sample,22211,21613,1896,19717,4636,15081,6861,656,5056,534,11917,1974,1858,840,1583,2966
TCTCCTAGTTAGGCGG,sample,85102,83468,6122,77346,14316,63030,30292,2321,20049,1862,50341,8506,3860,1290,9315,9731
AAGTAGAGTTAGGCGG,sample,20193,19818,1482,18336,3973,14363,8498,590,3622,441,12120,1212,1679,884,2773,2665
CGTAGAACTTAGGCGG,sample,87663,86421,4142,82279,17517,64762,47652,3244,9497,1144,57149,3225,2617,1650,11795,12026
CCTAACTATTAGGCGG,sample,88232,86771,5348,81423,14473,66950,33884,2592,18503,1834,52387,10137,3843,1404,5176,9078
TTAACTGATTAGGCGG,sample,36880,36270,1206,35064,9225,25839,15938,1068,6184,617,22122,2032,1849,1190,4047,5511
CTGGTCTTTCAGATAC,sample,117765,116243,5056,111187,26052,85135,60840,5438,12507,1574,73347,4776,2691,1461,16387,18338
AGCTGAATTCAGATAC,sample,159635,157875,8008,149867,27215,122652,80358,7928,22668,2681,103026,9017,3980,2103,15642,18397
TCGAACGATCAGATAC,sample,30850,30316,2234,28082,8076,20006,9892,662,5795,586,15687,3071,2267,748,3587,4745
TCATCGAATCAGATAC,sample,48029,47351,2676,44675,11832,32843,23507,1437,5174,819,28681,1906,2067,1229,8888,7675
TACGCGAGTCAGATAC,sample,62241,61439,4647,56792,13463,43329,26802,1788,9091,789,35893,4859,3215,1131,9089,8501
GACTCAAGTCAGATAC,sample,86461,85613,6083,79530,11108,68422,35424,2412,19477,2280,54901,8829,4692,1788,7248,7635
CCGTACGCTCAGATAC,sample,76624,75534,3476,72058,13664,58394,41550,3085,8904,928,50454,3927,2735,1708,7783,9308
GATGCGTTTCAGATAC,sample,14413,14074,849,13225,4210,9015,5686,388,2087,238,7773,616,1333,925,1410,2530
ATGGCGTTTCAGATAC,sample,18555,18152,2128,16024,3941,12083,5746,365,3437,465,9183,2070,1917,722,2143,2383
ACGCTTAATCAGATAC,sample,61323,60249,10217,50032,8582,41450,15159,855,13615,1594,28774,10227,5472,1356,5062,5056
GAGATTCTTCAGATAC,sample,43353,42880,1239,41641,17397,24244,18625,1507,2985,494,21610,633,1322,1168,7058,9484
CCTAGCGGTCAGATAC,sample,51389,50725,2207,48518,12540,35978,24741,1758,6431,543,31172,2505,1965,1182,7627,8238
CTAACCGGTCAGATAC,sample,32757,32197,2129,30068,7398,22670,11658,706,6689,635,18347,2982,1976,904,3105,4468
GGCGACGATCAGATAC,sample,29534,28964,2972,25992,6607,19385,10278,863,4874,531,15152,2839,2592,945,3271,3981
CGCGGTCGTCAGATAC,sample,29233,28795,2145,26650,8257,18393,12183,898,3437,555,15620,1320,1743,992,4791,5159
TCAATCAGTCAGATAC,sample,63769,63111,3429,59682,11215,48467,31323,2552,9130,1102,40453,4360,2869,1437,5441,7580
AACCGGTTTCGCTAGG,sample,26750,25811,1461,24350,7362,16988,9493,636,4610,463,14103,1786,1894,844,3423,4277
GTCGTTCTTCGCTAGG,Neg_Ctrl,2956,946,618,328,71,257,156,6,52,11,208,32,103,49,50,8
GGAGAAGCTCGCTAGG,Neg_Ctrl,2977,1006,761,245,60,185,110,8,43,3,153,21,74,28,34,7
CTAGCGACTCGCTAGG,sample,95942,94891,3660,91231,17093,74138,44928,3330,19311,1965,64239,4604,2359,1668,11408,11995
TGATTCCGTCGCTAGG,sample,55987,55261,1767,53494,12592,40902,31857,2455,4821,552,36678,1217,1909,1753,7907,8409
GCAACTAGTCGCTAGG,sample,7306,7027,709,6318,1141,5177,2390,218,1572,210,3962,787,1354,663,658,756
TACGCGAGTCGCTAGG,sample,67670,66661,4346,62315,14741,47574,26767,1660,12509,1646,39276,4992,3199,1214,6769,9433
GACTCAAGTCGCTAGG,sample,61601,60754,2625,58129,16389,41740,31796,2139,5533,603,37329,1669,2098,1656,8675,10493
ATACGTTCTCGCTAGG,sample,67127,66287,3114,63173,12610,50563,27213,2118,13484,1927,40697,5821,2933,1348,6270,8322
CCGTACGCTCGCTAGG,sample,62582,61490,2853,58637,16827,41810,30114,2704,6239,677,36353,2076,1947,1295,9335,10644
ATGGCGTTTCGCTAGG,sample,43859,43248,6902,36346,7791,28555,10361,609,9384,966,19745,7235,4344,1004,3278,4568
TGCGCGTTTCGCTAGG,sample,15184,14859,1065,13794,4624,9170,5379,333,2330,399,7709,729,1417,917,963,2682
CGGTTGGTTCGCTAGG,sample,34003,33420,2600,30820,8886,21934,13769,743,4443,588,18212,2391,2088,971,5869,5667
GAGATTCTTCGCTAGG,sample,41177,40497,2400,38097,8120,29977,19596,1415,6023,567,25619,2376,2408,1333,8257,5593
AAGGTCTGTCGCTAGG,sample,34928,34293,2099,32194,6767,25427,13819,1008,6963,994,20782,2643,2404,1319,2402,4337
TAACGAAGTCGCTAGG,sample,30694,30166,2268,27898,8536,19362,10761,859,5200,581,15961,1961,2094,1052,1814,5036
TGCGCTCCTCGCTAGG,sample,64198,63144,4748,58396,9420,48976,23327,1951,15424,1559,38751,6715,3314,1160,6888,6827
CGCGGTCGTCGCTAGG,sample,62923,61986,7887,54099,10021,44078,17906,1323,13562,1502,31468,9785,5967,1468,5085,6148
TAACGCCATCGCTAGG,sample,46207,45640,2003,43637,9259,34378,21238,1209,8636,934,29874,2361,2337,1434,6242,6181
ATTCTACCTCGCTAGG,Pos_Ctrl,21939,21555,1901,19654,1020,18634,15434,1427,1240,135,16674,398,3759,3479,1308,503
CGTAGAACTCGCTAGG,sample,10051,9777,1873,7904,1381,6523,2173,89,2354,270,4527,1637,1550,413,839,814
GTCGTTCTCCGTTGCG,sample,87653,85778,7231,78547,15978,62569,36392,2303,15048,1642,51440,7184,4013,1404,12745,10474
AGCTGAATCCGTTGCG,sample,100363,98842,8144,90698,16223,74475,43319,2861,18170,1913,61489,8212,4348,2095,10096,11506
TATACGGACCGTTGCG,sample,29572,29094,2553,26541,5904,20637,11009,920,5450,655,16459,2603,2500,1124,3740,3741
GAGCCTCCCCGTTGCG,sample,64049,63013,3699,59314,14957,44357,25139,2004,11734,1098,36873,4382,2653,1132,9578,9705
CATACTCCCCGTTGCG,sample,54485,53195,1987,51208,10163,41045,24390,1899,10730,1390,35120,2636,2030,1366,4024,7104
GGTAGAGACCGTTGCG,sample,63551,62489,5243,57246,11034,46212,29644,2301,8196,848,37840,5223,3827,1939,6797,7259
TCATCGAACCGTTGCG,sample,46566,45737,2891,42846,10404,32442,20899,877,6341,1325,27240,3000,2138,1030,8787,6845
TCATACCACCGTTGCG,sample,36917,36086,2054,34032,6723,27309,14510,947,8399,1011,22909,2442,1723,948,2015,4451
TGATTCCGCCGTTGCG,sample,26571,25872,1559,24313,4388,19925,10122,700,6117,621,16239,2365,1841,988,1620,2944
CCGTACGCCCGTTGCG,sample,59897,58807,3411,55396,10037,45359,26236,1755,11620,1209,37856,4539,2741,1144,8966,7030
GGCAGGTTCCGTTGCG,sample,65911,64584,5931,58653,14648,44005,16916,1436,15985,2128,32901,7540,3910,1050,3164,9025
ATGGCGTTCCGTTGCG,sample,85020,83996,4433,79563,17358,62205,38612,3565,13080,1114,51692,5834,3449,1875,8099,11277
ACGCTTAACCGTTGCG,sample,11123,10773,1277,9496,2403,7093,2611,167,2810,269,5421,1236,1603,618,568,1427
GAGATTCTCCGTTGCG,sample,56552,55761,4157,51604,9481,42123,24209,1769,9667,1245,33876,5233,3335,1391,6396,6415
CTAAGCATCCGTTGCG,sample,90688,89410,4325,85085,18924,66161,43037,3577,12604,1395,55641,5548,3054,1387,12302,12967
GCTGCTTCCCGTTGCG,sample,56850,56241,2938,53303,10718,42585,25863,2064,10081,1041,35944,3536,3177,1908,5936,7431
GCCTATTCCCGTTGCG,sample,10395,10113,1651,8462,1698,6764,2692,135,2223,235,4915,1479,1519,512,1023,1025
TGCGCTCCCCGTTGCG,sample,53447,52755,3899,48856,11460,37396,23393,1325,8309,1065,31702,3304,2611,1409,7708,7699
CAGCTTCGCCGTTGCG,sample,49852,49064,2514,46550,13089,33461,22705,1375,6508,1070,29213,1803,2061,1358,7450,8773
CGCGGTCGCCGTTGCG,sample,44293,43725,1463,42262,13377,28885,22907,1600,3465,262,26372,651,1378,1269,7908,8408
TTATGACGCCGTTGCG,sample,58716,58122,2427,55695,17424,38271,28317,2001,5719,577,34036,1657,2187,1770,8790,10792
TCAATCAGCCGTTGCG,sample,18288,17945,1636,16309,4561,11748,5122,382,4087,531,9209,1626,1871,737,1612,2790
TAACGCCACCGTTGCG,sample,39368,38949,1752,37197,11908,25289,17327,1431,4071,611,21398,1849,2500,1771,4291,6873
ATTCTACCCCGTTGCG,sample,101685,100682,10507,90175,13773,76402,29342,2244,24750,2852,54092,17214,7373,1562,6466,9389
GACTAACCCCGTTGCG,sample,89937,89130,2502,86628,17069,69559,54554,4132,7899,795,62453,2179,2417,1927,8481,12666
CCTAACTACCGTTGCG,sample,43113,42544,2992,39552,11542,28010,17396,1260,5631,772,23027,2951,2763,1371,4215,7013
GCGCAATACCGTTGCG,sample,59322,58685,1664,57021,21571,35450,26167,2264,5395,634,31562,990,1515,1278,9305,12279
AACCGGTTAGGCCAAG,sample,33858,33527,1721,31806,9560,22246,14685,875,4448,576,19133,1662,2050,1067,5551,5926
TCTAGGTTAGGCCAAG,sample,74728,73945,2876,71069,16026,55043,42229,3257,6861,1038,49090,1658,2005,1639,12336,11096
AGCTGAATAGGCCAAG,sample,39138,38358,3927,34431,8247,26184,13099,943,7858,840,20957,3444,2928,1279,3792,5058
TATACGGAAGGCCAAG,sample,38189,37440,3978,33462,7752,25710,9283,840,9634,1003,18917,4950,3328,917,2379,4758
TCATACCAAGGCCAAG,sample,41955,41018,3326,37692,8187,29505,13899,757,9718,1138,23617,3993,2974,1177,1477,5302
TGATTCCGAGGCCAAG,sample,27221,26654,2180,24474,5133,19341,12097,906,4071,420,16168,1847,2214,1185,2447,3239
GACTCAAGAGGCCAAG,sample,37783,36966,3728,33238,6082,27156,15216,1233,6461,673,21677,3573,2852,1124,4656,4228
CCGTACGCAGGCCAAG,sample,40034,39090,1964,37126,12243,24883,13655,758,7515,578,21170,2377,2107,892,2068,7064
TGCGCGTTAGGCCAAG,sample,94172,93124,4999,88125,15679,72446,47628,3713,13262,1509,60890,6334,3883,2150,9719,11489
AGCGTCTTAGGCCAAG,sample,102669,101219,6433,94786,21951,72835,48480,2950,14105,1731,62585,5569,2910,1047,20965,14902
GCTCTTCTAGGCCAAG,sample,84129,82837,4206,78631,17222,61409,44363,3352,9045,909,53408,3740,2511,1422,13213,12171
GCTGCTTCAGGCCAAG,sample,11713,11430,1149,10281,2360,7921,4285,295,2249,238,6534,854,1432,719,1693,1463
GTCGCGAAAGGCCAAG,sample,61321,60645,2162,58483,19948,38535,24733,2041,8215,983,32948,2563,2498,1592,5366,11398
CAGCTTCGAGGCCAAG,sample,82569,81836,2990,78846,24286,54560,38007,2327,9993,1004,48000,3229,2610,1416,15266,15113
CGCGGTCGAGGCCAAG,sample,63937,63292,3417,59875,15812,44063,24898,1665,11640,1110,36538,4750,3465,1474,8241,10473
TCTCCTAGAGGCCAAG,sample,58248,57656,2667,54989,12052,42937,28011,1902,8613,1056,36624,3355,2916,1958,6667,8377
ATGAATAGAGGCCAAG,sample,43430,42782,2396,40386,10450,29936,15793,1205,8923,1077,24716,2938,2442,1304,3183,6430
TAACGCCAAGGCCAAG,sample,41705,41011,2408,38603,11264,27339,15480,1040,7346,898,22826,2575,2415,1016,7167,6960
GACTAACCAGGCCAAG,Neg_Ctrl,3304,1137,782,355,91,264,155,6,65,5,220,33,124,44,44,16
CGCGAGACAGGCCAAG,sample,52296,51551,2549,49002,18101,30901,19223,1271,7088,954,26311,2365,2402,1238,6748,10095
CGTAGAACAGGCCAAG,sample,69701,68688,6531,62157,14025,48132,20391,1338,16890,1600,37281,7913,4576,1352,7256,8991
AGATACTAAGGCCAAG,sample,63645,62933,4096,58837,13609,45228,25286,1436,12663,1659,37949,4184,3122,1624,6583,8846
GCGCAATAAGGCCAAG,sample,42178,41500,3057,38443,9402,29041,14703,1317,7652,751,22355,4618,3042,1254,1077,5886
TTAACTGAAGGCCAAG,sample,37365,36879,1470,35409,11706,23703,14939,1576,5281,569,20220,1338,1688,1018,3046,6968
AACCGGTTAGAACCGC,sample,46785,46424,1690,44734,13683,31051,21812,1819,4941,594,26753,1885,2262,1655,6122,8281
TCTAGGTTAGAACCGC,sample,38187,37683,2885,34798,5551,29247,13257,962,9743,1281,23000,4004,2995,1426,1356,3623
CTAGCGACAGAACCGC,sample,77489,76511,4327,72184,15841,56343,37674,2775,10822,1149,48496,3923,2954,1484,10088,10727
TCATACCAAGAACCGC,sample,50748,50051,2307,47744,10081,37663,21962,1832,10266,1501,32228,2102,2370,1468,5485,6896
ATACGTTCAGAACCGC,sample,38074,37503,2776,34727,7923,26804,13043,675,8946,936,21989,3204,2726,1044,4548,5170
CCGTACGCAGAACCGC,sample,59794,58969,3480,55489,19632,35857,19290,1603,9374,1155,28664,4435,3009,1100,4748,11363
CCATTCTTAGAACCGC,sample,77538,76559,4248,72311,11840,60471,36786,2692,13271,1567,50057,6155,3640,1738,8039,7970
TAGCGAGTAGAACCGC,sample,35280,34728,1531,33197,7837,25360,15185,923,6808,831,21993,1613,1994,1075,4512,5307
GCTCTTCTAGAACCGC,sample,69375,68253,4041,64212,15837,48375,28570,2655,11295,1604,39865,4251,3155,1339,4081,10303
CTAACCGGAGAACCGC,sample,41992,41416,3212,38204,9563,28641,14888,1024,8207,832,23095,3690,3028,1398,3880,6232
GGCGACGAAGAACCGC,sample,15770,15513,550,14963,6835,8128,6253,467,967,130,7220,311,1264,1144,1904,3398
TAACGAAGAGAACCGC,sample,64014,63308,2794,60514,17331,43183,28447,1767,8909,1251,37356,2809,2422,1250,11226,11080
AGCAGAGCAGAACCGC,sample,28492,27934,2757,25177,5395,19782,9002,634,6735,593,15737,2818,2742,1190,1876,3279
ATACCGCCAGAACCGC,sample,74374,73333,2976,70357,17900,52457,40330,3135,6316,818,46646,1858,1935,1699,9842,11871
CGTCGAGGAGAACCGC,sample,75347,74369,3369,71000,12700,58300,39017,3390,10131,1592,49148,4170,3217,1698,6327,9328
GACTAACCAGAACCGC,sample,12153,11858,1112,10746,2602,8144,4026,227,2587,231,6613,1073,1731,888,525,1601
CGCGAGACAGAACCGC,sample,40603,40015,2300,37715,9174,28541,15290,1013,8477,912,23767,2849,2436,1261,4374,6053
CGTAGAACAGAACCGC,sample,54746,53920,2837,51083,11585,39498,23453,1651,9888,1136,33341,3370,2651,1507,5514,7737
AGATACTAAGAACCGC,sample,52081,51451,3203,48248,12560,35688,22214,1435,8320,1111,30534,2608,2617,1481,7363,7915
GCGCAATAAGAACCGC,sample,33274,32838,1090,31748,14092,17656,13076,876,2736,383,15812,585,1334,1155,4875,7357
TTAACTGAAGAACCGC,sample,39224,38816,3354,35462,9149,26313,15514,1043,5905,654,21419,3197,3126,1414,4718,5870
ATATGCAAAGAACCGC,sample,12814,12578,771,11807,4204,7603,3839,296,2357,297,6196,814,1497,716,1259,2244
AACCGGTTCATCAAGC,sample,5356,5002,249,4753,1701,3052,1950,191,688,42,2638,181,517,341,725,947
TATACGGACATCAAGC,sample,51242,50526,3438,47088,9741,37347,21844,1884,8539,891,30383,4189,2773,1315,5880,6517
GGAGAAGCCATCAAGC,sample,46518,45928,1897,44031,9542,34489,25395,1711,5365,651,30760,1367,2228,1767,5158,6611
TCGAACGACATCAAGC,sample,11566,11294,1529,9765,1951,7814,3616,257,2222,220,5838,1499,1630,662,1125,1253
ATTCAAGGCATCAAGC,sample,57335,56272,4296,51976,12346,39630,23720,1536,9072,1326,32792,3976,2882,1063,8828,7747
GCAACTAGCATCAAGC,sample,16917,16393,929,15464,3509,11955,7127,570,2999,348,10126,911,1702,1136,1327,2198
CCGTACGCCATCAAGC,sample,87794,86385,6089,80296,17084,63212,36023,2012,15868,1953,51891,7356,3910,1179,9649,11416
GATGCGTTCATCAAGC,sample,75387,74499,3395,71104,13385,57719,36976,2308,13056,1262,50032,4117,2716,1296,9687,9096
ACGCTTAACATCAAGC,sample,117237,115604,5167,110437,28231,82206,57535,4371,14332,1420,71867,4548,2698,1274,23050,18529
TAACGAAGCATCAAGC,sample,101862,100329,7780,92549,20766,71783,38783,2872,18173,1757,56956,10198,4084,1192,14903,14091
GCCTATTCCATCAAGC,sample,78684,77205,3405,73800,20058,53742,39289,2866,8805,1119,48094,1663,1445,998,14042,13580
CGTCGAGGCATCAAGC,Pos_Ctrl,28853,28316,2084,26232,1097,25135,20976,1933,1456,193,22432,577,4132,4238,1275,482
TCAATCAGCATCAAGC,sample,108189,106831,15191,91640,16627,75013,27010,1697,25152,2371,52162,18783,8276,1794,8950,10284
TAACGCCACATCAAGC,sample,71043,70330,3421,66909,13663,53246,32884,2134,12449,1524,45333,4255,3548,2045,8400,9158
GACTAACCCATCAAGC,sample,49940,49295,2312,46983,14696,32287,21519,1689,5996,964,27515,2119,2284,1292,8019,9108
TTAACTGACATCAAGC,sample,78845,78230,3090,75140,19498,55642,35847,2466,11962,1790,47809,3577,2486,1593,12335,12897
ATATGCAACATCAAGC,sample,34917,34573,1123,33450,11515,21935,14327,1109,5027,456,19354,1016,1833,1381,4208,6955
AGAGTTCTAGAGAGCC,sample,8549,8317,1262,7055,1631,5424,2394,171,1716,148,4110,995,1314,614,341,932
CATACTCCAGAGAGCC,sample,17910,17456,1523,15933,3960,11973,6674,370,3342,331,10016,1256,1675,746,2598,2480
CGTCGCCAAGAGAGCC,sample,26455,25852,1490,24362,4806,19556,11685,818,4649,503,16334,1901,1812,1116,2922,3117
GATGCGTTAGAGAGCC,sample,69633,68601,6446,62155,11177,50978,26464,2102,12622,1326,39086,8464,4468,1826,5984,7152
AGCGTCTTAGAGAGCC,sample,73901,73204,3011,70193,12862,57331,38063,2902,11603,1596,49666,3167,2589,1965,6528,8645
ACGCTTAAAGAGAGCC,sample,93677,92572,4584,87988,20529,67459,43966,3092,12993,1487,56959,5921,3144,1309,13675,13592
CATTCGGTAGAGAGCC,sample,84316,83624,3443,80181,18272,61909,44264,4162,9077,1430,53341,2976,2414,1637,15558,12629
AAGGTCTGAGAGAGCC,sample,110672,109408,11817,97591,13919,83672,34860,1862,26829,3113,61689,17008,6801,1649,10431,9295
CCTAGCGGAGAGAGCC,sample,32168,31583,2013,29570,9249,20321,10984,1039,4877,760,15861,2661,2163,859,2869,5620
CTAACCGGAGAGAGCC,sample,35830,35306,1474,33832,7911,25921,14468,1064,7133,756,21601,2500,2238,1408,1707,5119
GGCGACGAAGAGAGCC,sample,23807,23510,1633,21877,5106,16771,10046,680,3844,506,13890,1695,2570,1474,2483,3322
AGCAGAGCAGAGAGCC,sample,20752,20338,1250,19088,8097,10991,8029,574,1705,228,9734,455,1273,906,2493,4094
ATACCGCCAGAGAGCC,sample,65429,64501,3637,60864,14454,46410,28536,2218,9650,1140,38186,4866,3228,1301,7219,9681
GGCGTACCAGAGAGCC,sample,77616,76538,5029,71509,14452,57057,30521,3033,14254,1577,44775,7672,3974,1151,11269,9049
CAGCTTCGAGAGAGCC,sample,32355,31602,3225,28377,6924,21453,9280,719,6533,677,15813,4244,2637,711,1540,4204
CGCGGTCGAGAGAGCC,sample,32173,31755,1279,30476,7227,23249,15218,1102,4787,480,20005,1662,1652,997,4441,4826
TTATGACGAGAGAGCC,sample,72544,71669,2660,69009,15818,53191,40777,3642,6296,834,47073,1642,1763,1442,8325,10542
TCAATCAGAGAGAGCC,sample,40290,39685,2897,36788,8968,27820,15225,874,7886,885,23111,2950,2805,1128,5510,6078
GACTAACCAGAGAGCC,sample,53541,52769,2871,49898,14383,35515,23866,1435,6691,885,30557,2638,2015,1211,9908,9162
CGCGAGACAGAGAGCC,sample,30461,29930,2944,26986,8540,18446,9430,536,5116,541,14546,2823,2401,900,3433,4980
GCGCAATAAGAGAGCC,sample,41969,41433,1677,39756,9292,30464,20214,1343,6588,811,26802,1508,2135,1434,6987,6391
CTGGTCTTAGCATTGA,sample,115177,114258,3426,110832,39519,71313,49774,4459,12790,1520,62564,2770,2171,1330,14253,23276
GTCGTTCTAGCATTGA,sample,70974,70283,3074,67209,20794,46415,33948,2401,6958,701,40906,2407,2398,1713,9487,12912
CATACTCCAGCATTGA,sample,132963,131668,5209,126459,30975,95484,71302,4016,14367,1649,85669,4150,3005,1576,26317,20968
CTAGCGACAGCATTGA,sample,37192,36482,3404,33078,5432,27646,9983,1074,9318,1087,19301,6184,4009,1389,1233,3063
GGTAGAGAAGCATTGA,sample,67402,66271,2985,63286,18988,44298,30290,2225,8593,988,38883,2202,2072,1248,10669,11703
TCATCGAAAGCATTGA,sample,74418,73399,3954,69445,14028,55417,26073,2110,18531,2377,44604,6326,3207,1383,3048,9188
TCATACCAAGCATTGA,sample,79345,78201,3900,74301,15855,58446,39756,2829,10472,1165,50228,4224,2943,1528,11425,11280
ATACGTTCAGCATTGA,sample,85775,85053,4047,81006,15970,65036,47058,3649,9323,1192,56381,3814,3470,2487,11294,10620
TGGATCAAAGCATTGA,sample,120814,119069,4460,114609,19651,94958,54447,3768,26904,3287,81351,6552,2930,1465,10033,14224
CCATTCTTAGCATTGA,sample,94655,93618,3740,89878,29634,60244,44190,3056,9644,1106,53834,2248,2168,1587,15257,17332
AGCGTCTTAGCATTGA,sample,126622,125189,6819,118370,33569,84801,58939,3262,16988,1420,75927,4192,2412,1335,22896,21607
CGGTTGGTAGCATTGA,sample,93235,92049,4842,87207,22750,64457,44330,4283,10968,1174,55298,3702,2294,1458,14401,15592
TAGCGAGTAGCATTGA,sample,37510,36950,3772,33178,5646,27532,13006,957,8350,970,21356,4249,3182,1305,3086,3557
AAGGTCTGAGCATTGA,sample,74557,73520,5060,68460,13614,54846,30405,2480,14740,1520,45145,5701,3805,1353,8549,9071
GCCTATTCAGCATTGA,sample,90332,88954,3267,85687,23215,62472,44895,2626,11636,1209,56531,2106,1855,1358,17843,15836
ATACCGCCAGCATTGA,sample,52493,51684,3641,48043,14918,33125,20879,1311,7127,664,28006,3144,2907,1402,7428,9218
GCGTTACCAGCATTGA,sample,34239,33559,2553,31006,7047,23959,14470,807,5465,623,19935,2594,2486,1217,5413,4683
CAGCTTCGAGCATTGA,Neg_Ctrl,3684,1272,828,444,104,340,194,16,88,7,282,35,141,81,60,16
TCTCCTAGAGCATTGA,sample,40452,39699,2863,36836,8362,28474,15375,1152,7810,866,23185,3271,2908,1385,4571,5458
GACTAACCAGCATTGA,sample,47038,46201,2653,43548,10534,33014,18558,1471,8958,1077,27516,2950,2651,1419,4341,6705
CGTAGAACAGCATTGA,sample,67550,66222,5195,61027,17597,43430,22095,2027,11908,1668,34003,5732,3784,1299,6790,10718
GCGCAATAAGCATTGA,sample,85325,84163,3217,80946,20015,60931,43166,3845,9153,1485,52319,3282,2227,1465,11441,13496
TTAACTGAAGCATTGA,sample,129315,127932,3910,124022,24711,99311,77571,5836,11989,1337,89560,2578,2071,1615,16978,17429
TCTAGGTTAATTACCA,sample,44691,44332,1562,42770,13179,29591,18925,1272,7062,656,25987,1676,1729,1163,6346,8022
GTCGTTCTAATTACCA,sample,35617,35180,1127,34053,8646,25407,16726,1122,5734,718,22460,1107,1707,1147,5331,5736
CATACTCCAATTACCA,sample,41727,41290,1354,39936,11202,28734,21000,1429,4638,592,25638,1075,1752,1317,10067,7488
CTAGCGACAATTACCA,sample,62615,61940,3427,58513,15143,43370,27689,1722,9051,1026,36740,3882,2885,1151,10100,9884
TCGAACGAAATTACCA,sample,25076,24772,1359,23413,5777,17636,11155,606,3912,630,15067,1333,1676,853,4101,3835
GCTCTTCTAATTACCA,sample,31649,31109,1998,29111,7277,21834,11965,927,5650,1076,17615,2216,2244,1148,3473,4567
CCTAGCGGAATTACCA,sample,19695,19401,803,18598,3617,14981,8730,595,3786,646,12516,1224,1983,1327,871,2393
TAACGAAGAATTACCA,sample,66588,65819,2657,63162,15978,47184,33838,2156,8217,798,42055,2175,1929,1315,12504,10630
CGTCGAGGAATTACCA,sample,45513,44766,3265,41501,11707,29794,15953,1259,7314,677,23267,4591,2994,1052,4289,7576
TTATGACGAATTACCA,sample,81095,80112,7988,72124,12348,59776,21203,1547,21189,2349,42392,13488,4511,1315,4053,8075
TAACGCCAAATTACCA,sample,44429,43416,5132,38284,10614,27670,9993,792,9287,1087,19280,6511,3273,626,2555,6145
CCTAACTAAATTACCA,sample,67395,66559,3980,62579,11833,50746,31986,2287,10675,1299,42661,4499,3107,1476,5976,8322
GCGCAATAAATTACCA,sample,82443,81528,5101,76427,15486,60941,36015,2610,12943,1696,48958,7677,4065,1490,10476,10317
CTGGTCTTTAGATGAC,Pos_Ctrl,3340,3303,176,3127,226,2901,2407,295,126,21,2533,52,898,815,213,109
AGAGTTCTTAGATGAC,sample,56976,56224,3111,53113,17877,35236,18765,1248,10572,1328,29337,3323,2319,1056,4416,10387
TATACGGATAGATGAC,sample,79763,79013,2830,76183,19296,56887,36753,2561,12607,1537,49360,3429,2288,1225,11830,12981
GAGCCTCCTAGATGAC,sample,57706,56978,2618,54360,14647,39713,22775,1390,10339,2018,33114,3191,2018,1124,5261,9729
CATACTCCTAGATGAC,Pos_Ctrl,21629,21228,1531,19697,1017,18680,15709,1491,980,163,16689,337,3572,3557,1327,438
CGTCGCCATAGATGAC,sample,55408,54533,2565,51968,10244,41724,23473,1559,12093,1535,35566,3064,2365,1256,6711,7030
ATTCAAGGTAGATGAC,sample,70526,69743,4432,65311,18351,46960,30526,2344,9435,1081,39961,3574,2473,1071,13883,11477
TGATTCCGTAGATGAC,Pos_Ctrl,19200,18953,1293,17660,777,16883,14219,1439,797,96,15016,332,3363,3353,1079,339
GCAACTAGTAGATGAC,sample,23567,23103,984,22119,5832,16287,11030,667,3449,458,14479,683,1384,1096,3150,3873
CCGCAGTCTAGATGAC,sample,39292,38797,1873,36924,7554,29370,15868,1055,8590,1346,24458,2511,2158,1067,5683,5107
AGCGTCTTTAGATGAC,sample,80248,79145,4445,74700,22402,52298,32454,2704,11453,2093,43907,3594,2768,1405,9445,13681
CTAAGCATTAGATGAC,sample,44380,43698,2218,41480,9015,32465,24029,1707,4960,497,28989,1272,1765,1134,8248,6259
CCTAGCGGTAGATGAC,sample,91659,90493,5007,85486,16521,68965,46402,2985,12792,1333,59194,5453,3308,1340,14819,11082
CTAACCGGTAGATGAC,sample,81739,80755,4282,76473,14446,62027,36292,3132,15612,1780,51904,5211,2836,1483,10514,9744
TGCGCTCCTAGATGAC,sample,110956,109379,10473,98906,18345,80561,39985,2834,22418,2330,62403,12994,5470,1382,13290,11520
ATACCGCCTAGATGAC,sample,91092,89893,5099,84794,22356,62438,39349,2471,12419,1644,51768,6555,3600,1366,13596,14722
CGTCGAGGTAGATGAC,sample,66365,65426,2445,62981,16665,46316,31989,2583,8526,1038,40515,2180,2193,1325,10148,11097
TTATGACGTAGATGAC,sample,55142,54558,3241,51317,11901,39416,24386,1827,8758,1001,33144,3444,2801,1612,7908,8080
TCTCCTAGTAGATGAC,sample,35124,34744,1286,33458,9846,23612,18180,1514,2860,283,21040,775,2320,2163,4181,6403
ATTCTACCTAGATGAC,sample,52926,52023,2155,49868,14582,35286,22730,1761,8015,879,30745,1901,1856,1160,5128,9368
GACTAACCTAGATGAC,sample,33557,33123,1437,31686,7041,24645,17378,1216,4289,586,21667,1176,2159,1616,3338,4630
CGCGAGACTAGATGAC,sample,78089,76825,5858,70967,16633,54334,30830,1893,13884,1415,44714,6312,3645,1111,10578,11502
TCTAGGTTGTTCAGAA,sample,94073,93079,3002,90077,27773,62304,48402,2804,8406,859,56808,1833,1816,1447,16311,17195
CTGGTCTTGTTCAGAA,sample,60889,59929,3519,56410,14522,41888,22954,1496,11537,1189,34491,4712,2962,1370,5543,9219
CTAGCGACGTTCAGAA,sample,73393,72384,3772,68612,15985,52627,32937,2765,10829,1231,43766,4865,3454,1719,8918,10799
CGTCGCCAGTTCAGAA,sample,46365,45412,6024,39388,7170,32218,12851,1031,10240,1153,23091,6943,4252,995,4974,4307
ATTCAAGGGTTCAGAA,sample,57376,56665,2037,54628,11035,43593,25879,1925,11112,1670,36991,3007,2179,1392,6471,7759
GCAACTAGGTTCAGAA,sample,27965,27560,845,26715,7826,18889,14465,1127,2404,368,16869,525,1701,1628,3611,4899
ATACGTTCGTTCAGAA,sample,31979,31459,2396,29063,5991,23072,10266,894,7886,893,18152,3133,2689,1056,2028,3749
ATGGCGTTGTTCAGAA,sample,13929,13509,1483,12026,4078,7948,3268,284,2616,324,5884,1456,1550,662,635,2212
CTAAGCATGTTCAGAA,sample,31965,31671,1209,30462,10759,19703,13729,1124,3719,472,17448,659,1457,1123,5396,6054
AAGGTCTGGTTCAGAA,sample,58093,57579,2207,55372,14256,41116,28039,1950,7680,985,35719,2462,2304,1632,8722,9608
CCTAGCGGGTTCAGAA,sample,5904,5800,329,5471,1304,4167,1979,138,1335,120,3314,595,1125,555,327,835
GCTGCTTCGTTCAGAA,sample,38218,37805,2220,35585,10536,25049,14983,1070,6168,876,21151,1952,2301,1208,5739,6387
GCCTATTCGTTCAGAA,sample,61046,60585,1569,59016,17362,41654,34217,2560,3181,516,37398,1180,2431,2554,7944,11346
TGCGCTCCGTTCAGAA,sample,58280,57247,2471,54776,15213,39563,20920,1912,11569,1769,32489,3393,1892,926,2535,9851
AAGTAGAGGTTCAGAA,sample,18486,18196,652,17544,5774,11770,6303,475,3657,418,9960,917,1894,1233,1037,3397
TCAATCAGGTTCAGAA,sample,51774,51276,2424,48852,13680,35172,23772,1991,5887,675,29659,2847,3303,2064,5984,8880
AGATACTAGTTCAGAA,sample,52337,51636,3394,48242,14867,33375,20142,1255,7410,970,27552,3598,2692,1309,3816,9051
CCTAACTAGTTCAGAA,Pos_Ctrl,27792,26920,2349,24571,1224,23347,19217,1800,1510,249,20727,571,4022,3878,1543,567
TCTAGGTTTTCTGGTT,sample,111222,110213,6799,103414,30892,72522,34718,2695,20074,2277,54792,12758,5520,1936,7276,18224
GTCGTTCTTTCTGGTT,Neg_Ctrl,4376,1299,901,398,100,298,186,11,71,5,257,25,133,65,61,11
CATACTCCTTCTGGTT,sample,28977,28374,2811,25563,4303,21260,10739,804,5734,718,16473,3265,2494,1066,3455,2799
CTAGCGACTTCTGGTT,Neg_Ctrl,5912,1575,1230,345,73,272,146,13,77,4,223,32,139,49,26,9
ATTCAAGGTTCTGGTT,sample,52428,51645,3780,47865,10026,37839,21182,1518,9370,1112,30552,4657,2886,1341,6232,6500
GCAACTAGTTCTGGTT,Neg_Ctrl,2197,734,592,142,22,120,57,9,43,1,100,10,58,32,13,7
ATACGTTCTTCTGGTT,sample,88754,87477,3959,83518,21524,61994,43953,3383,10382,1346,54335,2930,2092,1299,13967,14680
CCGCAGTCTTCTGGTT,sample,79776,78712,3302,75410,17566,57844,43934,3537,7492,811,51426,2070,2212,1796,11887,12453
CTAAGCATTTCTGGTT,sample,136369,134807,7703,127104,27108,99996,63271,4784,20104,2629,83375,9208,3920,1583,18585,17759
AAGGTCTGTTCTGGTT,sample,102480,101050,5945,95105,22556,72549,44860,3341,15869,1689,60729,6790,3505,1258,15842,14974
CTAACCGGTTCTGGTT,sample,43276,42523,2870,39653,10606,29047,15628,1480,7493,754,23121,3692,2698,1022,4677,6367
GGCGACGATTCTGGTT,sample,86771,85445,5704,79741,15846,63895,39396,2929,12888,1863,52284,6819,3619,1632,10048,10408
GCTGCTTCTTCTGGTT,sample,39171,38655,2016,36639,9513,27126,14192,1065,8303,888,22495,2678,2217,1181,3095,6295
GCCTATTCTTCTGGTT,sample,43403,42984,2199,40785,8959,31826,21082,1462,6023,651,27105,2608,3014,2052,5356,5852
GCGTTACCTTCTGGTT,sample,1769,1701,126,1575,483,1092,726,59,183,19,909,105,317,220,254,274
GTCGCGAATTCTGGTT,sample,57119,56504,2138,54366,12964,41402,29084,2160,7405,819,36489,1934,2242,1807,7651,8677
ATGAATAGTTCTGGTT,sample,77112,76213,4279,71934,20955,50979,35499,2693,8847,1020,44346,2920,2478,1416,12277,13290
TCAATCAGTTCTGGTT,sample,51220,50602,2283,48319,10701,37618,21735,1496,10028,1183,31763,3176,2562,1518,6291,7207
CGTAGAACTTCTGGTT,sample,93957,92971,2880,90091,23410,66681,53605,4499,5667,1059,59272,1851,1894,1806,10754,15409
TCTAGGTTGTTCGGTT,sample,59065,58596,2369,56227,12778,43449,29697,2340,7522,939,37219,2951,2772,1931,7567,8754
GAGCCTCCGTTCGGTT,sample,76460,75532,2575,72957,18542,54415,38080,2522,9846,1255,47926,2712,2813,2231,7888,12188
CATACTCCGTTCGGTT,sample,82662,81592,5205,76387,19540,56847,34226,2529,12736,1252,46962,6104,4082,1523,9966,13120
TCGAACGAGTTCGGTT,sample,68574,67465,6123,61342,12707,48635,24165,1381,14063,1500,38228,7526,4260,1168,10005,7786
GGTAGAGAGTTCGGTT,sample,48424,47446,2644,44802,15149,29653,18973,1294,6375,811,25348,2200,2308,1295,5950,8741
TCATCGAAGTTCGGTT,sample,24700,24107,1296,22811,7992,14819,8896,665,3741,369,12637,1148,1966,1160,1933,4448
TCATACCAGTTCGGTT,sample,54662,53787,4459,49328,13666,35662,17174,1264,9884,1041,27058,6299,3826,1036,6922,8177
TGATTCCGGTTCGGTT,sample,91465,90470,3403,87067,15595,71472,54077,3942,8873,1319,62950,3261,2905,2165,11431,11149
GCAACTAGGTTCGGTT,sample,23155,22287,1231,21056,4890,16166,9115,658,4240,585,13355,1568,1883,1060,1829,3113
ATACGTTCGTTCGGTT,sample,90795,89763,2680,87083,16595,70488,50141,3943,12313,1278,62454,2813,2524,2174,7229,12497
TCTCAGGAGTTCGGTT,sample,71712,70749,2988,67761,8949,58812,30432,1834,18557,1994,48989,5995,2983,1546,3433,6092
AGCGTCTTGTTCGGTT,sample,90375,89448,3872,85576,16648,68928,40376,2819,18187,2414,58563,5132,2835,1524,8139,11814
CGGTTGGTGTTCGGTT,sample,83182,82009,2472,79537,16639,62898,50914,3790,6136,659,57050,1399,1406,1433,13099,12076
TAACGAAGGTTCGGTT,sample,57795,57383,1799,55584,19204,36380,25262,2103,6127,658,31389,2230,2329,1619,7467,11350
GGCGTACCGTTCGGTT,sample,72777,71965,4317,67648,17278,50370,29072,2025,12585,1414,41657,5274,3993,1640,9503,10819
GTCGCGAAGTTCGGTT,sample,55079,54472,1578,52894,20521,32373,24566,1864,4359,647,28925,937,1843,1724,6104,11521
CAGCTTCGGTTCGGTT,sample,116099,114850,4650,110200,32338,77862,55500,4619,12067,1792,67567,3884,2810,1552,19219,20446
CGCGGTCGGTTCGGTT,sample,9314,9122,604,8518,2936,5582,2802,252,1831,205,4633,492,1117,556,908,1694
TTATGACGGTTCGGTT,sample,52246,51761,3045,48716,14936,33780,22121,1227,6433,758,28554,3241,2466,1165,9568,9556
TCTCCTAGGTTCGGTT,sample,68897,68095,3328,64767,20701,44066,25926,1551,11352,1353,37278,3884,2795,1267,10325,12126
AAGTAGAGGTTCGGTT,sample,94959,93984,4834,89150,17820,71330,45559,2586,14071,1963,59630,7151,4256,1544,11567,12197
GACTAACCGTTCGGTT,sample,84563,83645,3354,80291,25196,55095,40526,3330,8002,944,48528,2293,2318,1667,14842,15867
CGCGAGACGTTCGGTT,sample,107277,105877,11415,94462,15788,78674,29434,1895,28846,3436,58280,15063,7350,1786,9509,10384
GCGCAATAGTTCGGTT,Neg_Ctrl,3174,1138,657,481,112,369,214,11,108,10,322,26,169,82,52,20
TTAACTGAGTTCGGTT,sample,81846,81166,2370,78796,24578,54218,39823,3184,7981,1323,47804,1907,1734,1160,12857,15809
AACCGGTTTGGCGGTT,sample,59049,58576,2508,56068,10659,45409,27762,1781,10294,1449,38056,4123,3243,2142,3944,6992
GGAGAAGCTGGCGGTT,sample,99695,98658,3901,94757,19796,74961,50321,4141,14154,1324,64475,5021,3064,1618,12856,13440
CATACTCCTGGCGGTT,sample,85340,84116,4037,80079,26585,53494,31936,2440,13561,960,45497,4597,3379,1358,9127,15866
CTAGCGACTGGCGGTT,sample,39664,39173,2650,36523,8117,28406,16059,1041,7328,1064,23387,2914,2385,1032,6002,5524
TCGAACGATGGCGGTT,sample,102900,101735,4254,97481,16441,81040,49749,3370,20606,1964,70355,5351,3211,1493,14250,11985
CCGCAGTCTGGCGGTT,sample,102457,101541,2737,98804,27287,71517,56737,4499,7596,1094,64333,1591,2239,2119,12086,17807
CCGTACGCTGGCGGTT,sample,24284,23683,1716,21967,4501,17466,10363,900,4111,396,14474,1696,1962,893,2955,2991
GATGCGTTTGGCGGTT,sample,117806,115963,6812,109151,24487,84664,47071,3574,20951,2600,68022,10468,3973,1221,11753,16111
GAGATTCTTGGCGGTT,sample,116797,114749,7883,106866,30454,76412,30788,2923,24574,2875,55362,15252,6051,1348,5080,18178
CCTAGCGGTGGCGGTT,sample,51900,51217,3139,48078,10576,37502,20923,1360,9842,1222,30765,4155,2758,1314,7221,6930
GCTGCTTCTGGCGGTT,sample,74427,73786,2475,71311,27352,43959,31537,2532,7032,926,38569,1932,2053,1446,11606,15016
AAGTAGAGTGGCGGTT,sample,96097,94848,5162,89686,19740,69946,42755,3094,15857,2459,58612,5781,3388,1737,12817,13380
TAACGCCATGGCGGTT,sample,38198,37024,2418,34606,7777,26829,12246,847,9549,1138,21795,3049,2535,1202,1047,4936
CGCGAGACTGGCGGTT,sample,72280,71323,4237,67086,16578,50508,26619,1873,14763,1996,41382,5257,3135,1507,9380,10707
CCTAACTATGGCGGTT,sample,102266,101067,5200,95867,28535,67332,44887,3165,13477,1803,58364,4000,2932,1713,15126,18246
GCGCAATATGGCGGTT,sample,133341,132098,4501,127597,32171,95426,67186,4491,17348,2363,84534,4038,2769,1951,21432,20850
AGAGTTCTTCCTTATT,sample,50748,50201,1831,48370,13047,35323,28755,1503,3675,683,32430,707,1264,1214,10481,9162
GAGCCTCCTCCTTATT,sample,62682,62099,4797,57302,11584,45718,29927,1922,8822,886,38749,4161,3762,2378,5318,7241
CATACTCCTCCTTATT,sample,54316,53531,6362,47169,8076,39093,15588,1136,12797,1333,28385,8239,4337,1174,5260,5301
CTAGCGACTCCTTATT,sample,72751,71808,7019,64789,13601,51188,29086,2277,11937,1257,41023,6631,3417,1289,9225,8799
TCGAACGATCCTTATT,sample,36930,36497,1319,35178,7481,27697,18876,1866,4852,744,23728,1359,1641,1219,5849,5024
TCATCGAATCCTTATT,sample,15093,14865,821,14044,3344,10700,7538,586,1594,226,9132,756,1775,1421,1134,2141
ATACGTTCTCCTTATT,sample,49383,48836,5286,43550,5521,38029,11434,785,14133,1622,25567,10055,5359,1566,2186,3491
TGGATCAATCCTTATT,sample,93640,92644,4298,88346,15401,72945,46565,3635,14867,2477,61432,5401,2769,1434,9791,10401
GATGCGTTTCCTTATT,sample,50940,49854,3284,46570,11845,34725,19328,1794,8735,1036,28063,3832,2266,904,2599,7306
GGCGACGATCCTTATT,sample,75521,74480,5322,69158,13923,55235,25581,2204,15914,1798,41495,9738,4495,1069,9029,8671
TGCGCTCCTCCTTATT,sample,65203,64512,2826,61686,16553,45133,32367,2550,7074,940,39441,2202,2065,1318,9791,11107
ATACCGCCTCCTTATT,sample,31430,30982,1782,29200,10960,18240,9874,673,4935,551,14809,2207,2187,932,3300,6110
GTCGCGAATCCTTATT,sample,21387,20857,1628,19229,5626,13603,5752,331,4751,775,10503,1994,1789,607,1380,3440
CGTCGAGGTCCTTATT,Pos_Ctrl,21172,20904,1750,19154,832,18322,15383,1545,986,120,16369,288,3515,3464,931,392
TTATGACGTCCTTATT,sample,57551,57002,1968,55034,16903,38131,29774,2038,4528,567,34302,1224,1727,1458,11576,10752
TCTCCTAGTCCTTATT,sample,45907,45410,3354,42056,11996,30060,14119,925,9006,1045,23125,4965,2916,976,4209,7178
ATGAATAGTCCTTATT,sample,10339,10168,1525,8643,1484,7159,2799,217,2289,233,5088,1621,1629,561,941,843
TAACGCCATCCTTATT,sample,53921,53336,2979,50357,14428,35929,18934,1302,10078,1126,29012,4489,3108,1262,3803,8813
CGCGAGACTCCTTATT,sample,16423,16230,1092,15138,4425,10713,5917,538,2692,394,8609,1172,1659,893,1385,2700
GCGCAATATCCTTATT,sample,36142,35429,2989,32440,8541,23899,13223,844,5905,874,19128,3053,2503,1051,3861,5202
GTCGTTCTAATAAGGT,sample,73606,72844,3147,69697,15334,54363,33790,2340,12510,1508,46300,4215,2900,1684,8479,9883
GGAGAAGCAATAAGGT,sample,63265,62435,2874,59561,16620,42941,27777,1967,8456,1286,36233,3455,2284,1107,10046,10756
GAGCCTCCAATAAGGT,sample,92483,91437,3062,88375,19189,69186,48634,4237,11671,1209,60305,3435,2636,1816,11452,13733
ATTCAAGGAATAAGGT,sample,79333,78313,4200,74113,11711,62402,38427,2265,14351,1633,52778,5726,3449,1893,6857,8336
GACTCAAGAATAAGGT,sample,142301,140768,8218,132550,22100,110450,65649,5966,25357,2663,91006,10815,4323,1639,17428,15319
CCGCAGTCAATAAGGT,sample,30657,29844,3140,26704,8463,18241,7519,591,6049,653,13568,3429,2647,765,2035,4740
CCGTACGCAATAAGGT,sample,94259,92966,6926,86040,19836,66204,38140,2404,16525,1897,54665,7238,3914,1436,15074,12956
ATGGCGTTAATAAGGT,Pos_Ctrl,34409,33981,2453,31528,1492,30036,25177,2343,1706,240,26883,570,4388,4444,2233,723
TGCGCGTTAATAAGGT,sample,9982,9798,378,9420,3912,5508,3767,350,987,120,4754,284,1055,868,402,2037
AGCGTCTTAATAAGGT,sample,155894,154029,11919,142110,32152,109958,61790,4347,26554,2527,88344,14740,5771,1383,26001,20034
TAGCGAGTAATAAGGT,sample,140894,139463,7429,132034,26723,105311,62429,4342,25093,3025,87522,10422,3916,1508,19584,17671
GCTCTTCTAATAAGGT,sample,112035,110195,6665,103530,24164,79366,42368,2921,21916,2608,64284,9553,4083,1288,9522,15039
CCTAGCGGAATAAGGT,Pos_Ctrl,24221,23931,1623,22308,1107,21201,17745,1741,1172,131,18917,412,3850,3856,1156,443
GCCTATTCAATAAGGT,sample,54653,53996,2384,51612,16248,35364,19724,1528,10357,810,30081,2945,2527,1375,6019,9834
GTCGCGAAAATAAGGT,sample,155420,153319,10800,142519,24659,117860,50989,4435,36755,3936,87744,21745,7351,1632,18371,16606
CGCGGTCGAATAAGGT,sample,78607,77794,3768,74026,14758,59268,35673,3321,13777,1427,49450,5070,2941,1363,8437,10140
AAGTAGAGAATAAGGT,sample,50232,49503,3911,45592,9215,36377,20486,1164,9346,1057,29832,4324,3441,1769,6340,6031
ATTCTACCAATAAGGT,sample,37016,36401,3244,33157,7929,25228,12294,923,7699,795,19993,3517,2977,1086,5118,5121
GACTAACCAATAAGGT,sample,69274,68560,2611,65949,13993,51956,35969,2610,9468,1078,45437,2831,2966,2404,6195,9622
CGCGAGACAATAAGGT,sample,60940,60055,2349,57706,16832,40874,28396,2151,7418,1038,35814,1871,2289,1826,7067,10733
CGTAGAACAATAAGGT,sample,63552,62845,2643,60202,14627,45575,34188,2615,6067,958,40255,1747,2624,2099,9205,10021
TCTAGGTTCAGGACCA,sample,71185,70399,3298,67101,19530,47571,31731,2428,9152,1275,40883,2985,2685,1494,9815,12292
GTCGTTCTCAGGACCA,sample,54233,53336,2673,50663,11908,38755,21345,1678,11129,1104,32474,3499,2371,1149,3080,7836
AGCTGAATCAGGACCA,sample,62851,61795,4015,57780,19097,38683,25250,1356,8620,716,33870,2741,2276,1127,10038,11160
CATAATGGCAGGACCA,sample,65395,64447,5578,58869,14145,44724,22299,1663,12639,1204,34938,6919,3958,1121,7469,8931
GGAGAAGCCAGGACCA,sample,49164,48177,3629,44548,14636,29912,13961,1033,9426,1129,23387,4363,2754,973,2880,8468
CATACTCCCAGGACCA,sample,90637,89579,3725,85854,16165,69689,45208,3488,14882,1705,60090,4406,2823,1535,13098,11052
CTAGCGACCAGGACCA,sample,28778,28215,1455,26760,6618,20142,10555,732,6268,770,16823,1817,2015,1012,2868,4237
TCGAACGACAGGACCA,sample,36141,35274,3046,32228,8937,23291,9678,797,8206,677,17884,3933,2507,777,2004,5438
GGTAGAGACAGGACCA,sample,74261,73185,3497,69688,18831,50857,36021,2872,8606,764,44627,2594,2146,1192,12910,12780
ATTCAAGGCAGGACCA,sample,46191,45409,3686,41723,10280,31443,15694,1149,8483,945,24177,5172,3507,1237,3439,6404
GACTCAAGCAGGACCA,sample,79754,78848,3491,75357,18197,57160,39146,3244,9943,1029,49089,3798,2345,1358,12068,12260
CCGCAGTCCAGGACCA,sample,80312,79415,3362,76053,15700,60353,43869,3076,8806,1202,52675,3400,2866,1821,11230,10887
TGGATCAACAGGACCA,sample,108505,107243,4728,102515,25386,77129,54339,3852,12658,1661,66997,4619,2927,1723,13443,17238
CCATTCTTCAGGACCA,sample,66170,65235,3775,61460,13173,48287,24771,1659,14651,1828,39422,5378,3244,1448,7701,8971
ACGCTTAACAGGACCA,sample,86326,85227,3946,81281,23778,57503,40414,3009,9746,1055,50160,3279,3066,2061,13016,15129
GCTCTTCTCAGGACCA,sample,123610,122218,6316,115902,23665,92237,54179,3639,22069,2251,76248,10099,4252,2192,6982,15431
GCCTATTCCAGGACCA,sample,28487,28064,2107,25957,6444,19513,11505,799,4376,492,15881,2341,2446,1258,3769,3959
CGTCGAGGCAGGACCA,sample,40047,39412,2268,37144,13448,23696,14833,1169,5200,614,20033,1880,2022,1048,6081,7833
CAGCTTCGCAGGACCA,Neg_Ctrl,3964,1511,1024,487,105,382,214,7,111,1,325,49,156,73,68,18
TCTCCTAGCAGGACCA,sample,89932,88990,6795,82195,17393,64802,35528,1742,16756,1941,52284,8835,4773,1639,14213,11437
TCAATCAGCAGGACCA,sample,87833,86797,4839,81958,15765,66193,35797,3399,18271,2374,54068,6352,3063,1366,8891,10345
ATTCTACCCAGGACCA,sample,40811,40134,3032,37102,11132,25970,15383,1076,6251,746,21634,2514,2558,1100,6121,6588
GACTAACCCAGGACCA,sample,104252,103106,3894,99212,34258,64954,42061,3007,14251,1692,56312,3943,2379,1380,8698,20363
GGTAGAGACCTCGTTG,sample,54780,53838,2630,51208,14059,37149,21594,1349,9860,1200,31454,3146,2347,1179,3389,8908
TACGCGAGCCTCGTTG,sample,41719,40912,2651,38261,9925,28336,18036,1190,5707,686,23743,2717,1887,864,7549,6531
GACTCAAGCCTCGTTG,sample,41723,41080,3391,37689,10901,26788,13788,1261,6813,735,20601,4191,2965,1164,2851,6710
CCGTACGCCCTCGTTG,sample,36835,36023,3619,32404,8246,24158,10611,968,7674,739,18285,4166,2746,852,1642,5000
TGCGCGTTCCTCGTTG,Neg_Ctrl,4280,1629,1276,353,46,307,175,48,39,1,214,44,92,49,26,18
ACGCTTAACCTCGTTG,sample,110760,109950,2859,107091,32705,74386,58142,4795,8301,955,66443,2193,2121,1826,18331,20768
CATTCGGTCCTCGTTG,sample,38556,37833,2251,35582,10004,25578,13594,1026,7269,900,20863,2789,2338,1191,2529,6251
TAGCGAGTCCTCGTTG,sample,28394,27912,2819,25093,6987,18106,9231,541,5258,447,14489,2629,2140,748,3979,4196
GAGATTCTCCTCGTTG,sample,8269,8015,851,7164,3137,4027,1313,74,1492,187,2805,961,934,339,242,1467
CTAAGCATCCTCGTTG,sample,21931,21449,1449,20000,6167,13833,7769,537,3530,516,11299,1481,1671,901,2638,3725
AAGGTCTGCCTCGTTG,sample,43579,42768,2440,40328,10976,29352,13814,1132,10797,1075,24611,2534,2156,993,2476,6877
CTAACCGGCCTCGTTG,Neg_Ctrl,3407,1156,753,403,119,284,134,9,71,11,205,59,115,59,25,16
GCGTTACCCCTCGTTG,sample,36728,36099,2996,33103,6121,26982,15176,1321,5887,622,21063,3976,2847,1292,3150,3960
CGCGGTCGCCTCGTTG,sample,47982,47307,2735,44572,8969,35603,21798,1750,8085,804,29883,3166,2587,1223,6881,6056
ATTCTACCCCTCGTTG,Pos_Ctrl,42047,41418,3000,38418,1651,36767,30585,2884,2291,273,32876,734,4872,5471,1790,610
CGTAGAACCCTCGTTG,sample,76383,74907,6719,68188,13730,54458,24407,1551,15894,1919,40301,10687,4063,965,7372,8653
GCGCAATACCTCGTTG,sample,111764,110805,3075,107730,15887,91843,71506,6286,9897,1472,81403,2682,2881,2504,8954,11957
CTGGTCTTTTGCGGAC,sample,34686,34422,1429,32993,11094,21899,14437,978,4326,472,18763,1686,1790,944,5967,6541
GTCGTTCTTTGCGGAC,sample,63087,62600,2153,60447,14864,45583,34234,2211,6291,739,40525,2108,2241,1536,10325,10324
AGAGTTCTTTGCGGAC,sample,48315,47881,1632,46249,15339,30910,24321,1696,3758,444,28079,691,1675,1560,4795,9208
GGAGAAGCTTGCGGAC,sample,68662,68049,3569,64480,17565,46915,32339,2260,8263,703,40602,3350,2436,1134,12744,10827
CATACTCCTTGCGGAC,sample,73821,73063,2899,70164,19511,50653,36213,2927,8615,645,44828,2253,1814,1318,12874,12779
TCATCGAATTGCGGAC,sample,68126,67319,2897,64422,17003,47419,34208,2266,7518,1206,41726,2221,1623,942,14449,11608
CCGTACGCTTGCGGAC,sample,59102,58487,3117,55370,11805,43565,25887,2006,10305,1378,36192,3989,2741,1234,9110,8046
GGCAGGTTTTGCGGAC,sample,66341,65594,5111,60483,10854,49629,24223,1956,13991,1935,38214,7524,3844,1273,7266,6962
TGCGCGTTTTGCGGAC,sample,73811,72827,6446,66381,20725,45656,20404,1502,13621,1544,34025,8585,4122,1085,5166,11267
ACGCTTAATTGCGGAC,sample,68872,68030,2881,65149,17965,47184,33323,2467,7514,1027,40837,2853,2381,1325,8989,11824
CATTCGGTTTGCGGAC,sample,87436,86605,3354,83251,14740,68511,43547,3364,14282,2335,57829,4983,2683,1538,9240,10598
CTAAGCATTTGCGGAC,sample,90836,89580,8298,81282,13059,68223,29863,2308,18808,2003,48671,15241,6070,1530,3414,8691
GGCGACGATTGCGGAC,sample,73646,72635,5387,67248,12113,55135,30676,2846,13560,1404,44236,6649,3618,1457,6083,8518
TAACGAAGTTGCGGAC,sample,49180,48569,4129,44440,11054,33386,16854,1186,9061,1159,25915,5126,3307,1058,5898,6730
GCCTATTCTTGCGGAC,sample,55248,54491,2139,52352,11218,41134,28581,1978,7755,741,36336,2079,1966,1347,7259,7679
ATACCGCCTTGCGGAC,sample,41358,40768,2126,38642,10689,27953,16677,1069,6678,1031,23355,2498,1991,934,4705,6795
GTCGCGAATTGCGGAC,sample,50303,49439,4890,44549,9071,35478,17778,1309,9831,1230,27609,5330,3335,1058,5210,5821
CAGCTTCGTTGCGGAC,sample,136127,134157,15264,118893,19207,99686,37322,2568,32609,3384,69931,23803,8858,1815,10076,12261
TTATGACGTTGCGGAC,sample,80757,79820,5646,74174,16515,57659,31460,2365,14397,1796,45857,7641,4121,1436,5912,10857
ATGAATAGTTGCGGAC,sample,69035,68095,2970,65125,15298,49827,29583,2144,11834,1635,41417,4631,2428,1493,4281,9905
AAGTAGAGTTGCGGAC,sample,59086,58441,2049,56392,15593,40799,29706,2730,5769,632,35475,1962,2379,1825,6764,10093
TAACGCCATTGCGGAC,sample,60914,59914,4333,55581,11142,44439,21056,1626,13762,1371,34818,6624,3527,1202,3621,6830
AGATACTATTGCGGAC,sample,99917,98732,5971,92761,17962,74799,48114,3606,14474,2245,62588,6360,3283,1317,11871,11728
ATATGCAATTGCGGAC,sample,231,228,16,212,57,155,79,7,45,5,124,19,58,31,29,35
AGAGTTCTTCCATTGG,sample,24171,23930,1300,22630,6977,15653,8382,549,5027,678,13409,1017,1399,779,1908,4101
GACGTATGTCCATTGG,sample,52591,52114,1865,50249,12998,37251,27955,1912,4584,648,32539,2152,1916,1279,8444,8727
GGAGAAGCTCCATTGG,sample,60497,59863,1994,57869,14221,43648,30618,1886,7518,1048,38136,2578,2156,1408,6445,9353
CATACTCCTCCATTGG,sample,64306,63597,2459,61138,10926,50212,35425,2618,9143,844,44568,2182,2135,1392,8476,8184
TCGAACGATCCATTGG,sample,50428,49630,2146,47484,14175,33309,23751,1708,5628,456,29379,1766,1568,775,8754,9209
CGTCGCCATCCATTGG,sample,31972,31484,2389,29095,7136,21959,13261,711,5069,585,18330,2333,2135,978,4734,4587
TCATACCATCCATTGG,sample,55118,54400,2363,52037,11311,40726,28663,2110,7343,653,36006,1957,2621,1886,5653,7566
CCGCAGTCTCCATTGG,sample,97276,95963,4038,91925,17028,74897,53657,3494,12765,1171,66422,3810,2228,1486,14944,11886
TCTCAGGATCCATTGG,sample,93360,92457,3400,89057,17939,71118,52290,3862,10140,1040,62430,3786,2928,2032,10443,12146
CCATTCTTTCCATTGG,sample,29500,28991,1772,27219,8398,18821,14088,912,2599,304,16687,918,1599,1202,4697,5322
TAGCGAGTTCCATTGG,sample,24169,23691,1469,22222,5588,16634,8637,698,5138,504,13775,1657,1903,1022,1352,3421
GCTCTTCTTCCATTGG,sample,78495,77589,10675,66914,7456,59458,19917,1352,23904,2691,43821,11594,6380,1910,4200,4602
GAGATTCTTCCATTGG,sample,20986,20705,646,20059,6923,13136,9612,732,2153,222,11765,417,1715,1442,2389,4108
AAGGTCTGTCCATTGG,sample,45537,45069,1409,43660,10243,33417,25260,2131,4485,460,29745,1081,2016,1858,6079,6840
GGCGACGATCCATTGG,sample,26520,25845,3988,21857,4476,17381,4747,360,6691,744,11438,4839,3233,764,923,2704
GCTGCTTCTCCATTGG,sample,27388,26987,2187,24800,7498,17302,11085,630,3377,386,14462,1824,2073,1257,4267,4543
GCCTATTCTCCATTGG,sample,34604,34031,3070,30961,6647,24314,10417,685,8632,900,19049,3680,2929,1123,1614,4298
GGCGTACCTCCATTGG,sample,30606,30099,2629,27470,4990,22480,11138,887,6562,906,17700,2987,2470,1197,2951,3129
GTCGCGAATCCATTGG,sample,51708,51068,2593,48475,10308,38167,28360,2251,4683,478,33043,2395,2961,2258,4939,7022
CGTCGAGGTCCATTGG,sample,31713,31237,1387,29850,7386,22464,16903,1391,2801,403,19704,966,1767,1561,4451,5070
CGCGGTCGTCCATTGG,sample,23331,22913,1335,21578,4499,17079,8020,609,5947,695,13967,1808,1826,968,1122,2985
TCTCCTAGTCCATTGG,sample,57615,56941,2027,54914,15684,39230,29200,1968,5716,617,34916,1729,1482,1251,11093,10329
ATGAATAGTCCATTGG,sample,30707,30135,2585,27550,7739,19811,9300,641,5952,723,15252,3195,2580,1029,2242,4586
AAGTAGAGTCCATTGG,sample,42389,41759,2808,38951,8118,30833,17475,1051,7953,952,25428,3402,2583,1278,5437,5559
GACTAACCTCCATTGG,Neg_Ctrl,3171,1408,853,555,143,412,243,5,102,19,345,43,158,76,72,31
CGTAGAACTCCATTGG,sample,11360,11026,1157,9869,2536,7333,3838,235,2035,235,5873,990,1307,618,1439,1533
CCTAACTATCCATTGG,sample,31816,31229,3529,27700,6115,21585,11803,788,5175,588,16978,3231,2501,1042,4388,3809
GCGCAATATCCATTGG,sample,36580,36010,2243,33767,7268,26499,16457,1185,6162,559,22619,2136,2378,1483,4289,5037
TTAACTGATCCATTGG,sample,29818,29335,3006,26329,6328,20001,9469,475,5943,731,15412,3383,2721,954,3478,3932
AACCGGTTCATAGGCG,sample,124363,123365,3038,120327,44522,75805,59011,4747,8233,1319,67244,2495,2710,2443,15472,25864
AGCTGAATCATAGGCG,sample,99947,98345,7350,90995,24948,66047,28135,1879,23615,3120,51750,9298,4176,1418,5813,14814
GAGCCTCCCATAGGCG,sample,16944,16628,992,15636,5621,10015,5703,518,2209,294,7912,1291,1721,896,1877,3106
CATACTCCCATAGGCG,sample,87850,86478,3209,83269,21871,61398,34514,2537,17789,2277,52303,4281,2626,1346,6468,14348
TCATACCACATAGGCG,sample,45264,44624,1772,42852,10584,32268,21908,1914,6229,636,28137,1581,2099,1595,5867,6766
GCAACTAGCATAGGCG,sample,12532,12151,1010,11141,3691,7450,4394,219,1865,214,6259,758,1471,785,1789,2144
CCGCAGTCCATAGGCG,sample,140441,138836,5452,133384,26002,107382,83887,6098,11756,1094,95643,4547,3136,2103,14480,17814
TGGATCAACATAGGCG,sample,34761,33933,2367,31566,6957,24609,11596,837,8014,929,19610,3233,2329,995,2051,4488
CCATTCTTCATAGGCG,sample,56398,55502,3822,51680,13548,38132,22073,1749,9580,1070,31653,3660,2780,1369,8889,8972
AGCGTCTTCATAGGCG,sample,61408,60674,4705,55969,17551,38418,21180,1126,10299,1221,31479,4592,3228,1191,8971,10434
TAGCGAGTCATAGGCG,sample,121411,119741,5129,114612,25295,89317,59192,4227,17960,1708,77152,6230,2972,1284,21109,16211
GAGATTCTCATAGGCG,sample,32745,31988,3568,28420,5564,22856,9600,660,7469,833,17069,4294,3087,950,2516,3350
AAGGTCTGCATAGGCG,sample,143312,141702,12792,128910,19341,109569,58513,4284,26501,2847,85014,17424,6497,1779,17586,13586
CTAACCGGCATAGGCG,sample,57931,56496,5015,51481,11374,40107,18224,1321,12529,1524,30753,6509,3759,1055,2980,7054
TTATGACGCATAGGCG,sample,70196,69433,3677,65756,21623,44133,27781,2456,9335,1055,37116,3506,2752,1407,8679,13182
ATGAATAGCATAGGCG,sample,92692,91769,5965,85804,17344,68460,40789,2558,16507,2417,57296,6189,3936,1968,10708,11912
GACTAACCCATAGGCG,sample,65805,65079,6191,58888,10729,48159,20867,1779,14305,1493,35172,9715,4279,1126,5704,6920
TCTAGGTTTTGGAGAG,sample,26223,25992,1062,24930,6267,18663,13549,950,3009,335,16558,820,1450,1051,5396,4225
CTGGTCTTTTGGAGAG,Pos_Ctrl,16315,16041,1043,14998,724,14274,12043,1319,593,83,12636,236,2793,2784,986,351
AGCTGAATTTGGAGAG,sample,90662,89670,3798,85872,31860,54012,39467,3291,7229,965,46696,3060,2749,1866,10250,18137
GACGTATGTTGGAGAG,sample,92419,91447,5581,85866,16158,69708,37981,3042,17190,2241,55171,9254,5001,2232,8086,10226
GAGCCTCCTTGGAGAG,sample,120392,118960,4363,114597,34623,79974,60098,4913,10017,1443,70115,3503,2725,1713,17232,22584
CATACTCCTTGGAGAG,sample,91148,90170,2818,87352,22704,64648,48895,3762,8701,880,57596,2410,2534,2276,11305,14927
CTAGCGACTTGGAGAG,sample,77646,76742,3253,73489,20383,53106,37116,3046,9104,1105,46220,2735,2982,2114,10029,12910
GGTAGAGATTGGAGAG,sample,81546,80461,2955,77506,26729,50777,38296,3082,6350,700,44646,2349,2080,1620,11779,15690
TCATCGAATTGGAGAG,sample,67047,66154,4811,61343,12293,49050,29021,2196,10914,1533,39935,5386,3500,1522,11278,8210
TGATTCCGTTGGAGAG,Pos_Ctrl,29972,29516,2521,26995,1229,25766,21587,1978,1553,191,23140,457,4186,4268,1514,546
TACGCGAGTTGGAGAG,sample,54992,53980,3543,50437,11423,39014,19610,1671,12069,1358,31679,4306,3024,1351,3327,7525
AGCGTCTTTTGGAGAG,sample,81665,80457,3441,77016,14739,62277,43367,3118,11356,1330,54723,3106,2392,1894,7766,10487
GAGATTCTTTGGAGAG,sample,106197,104545,3919,100626,26308,74318,55170,3224,11824,952,66994,3148,1873,1135,20406,17382
CCTAGCGGTTGGAGAG,sample,23073,22619,2983,19636,2998,16638,6015,324,6449,717,12464,3133,2771,917,1600,1835
GGCGACGATTGGAGAG,sample,68337,67217,6220,60997,11362,49635,23205,1353,16358,1662,39563,7057,3927,1416,7150,7718
AGCAGAGCTTGGAGAG,sample,54955,54006,3689,50317,14562,35755,18720,1172,10366,1116,29086,4381,2416,1077,4969,8874
CGTCGAGGTTGGAGAG,sample,48679,47974,2052,45922,15787,30135,22117,1586,4096,601,26213,1735,2007,1390,7382,9139
TAACGCCATTGGAGAG,sample,56253,55390,5095,50295,9323,40972,22147,1488,10737,1158,32884,5442,3973,1919,5773,5953
GACTAACCTTGGAGAG,sample,50526,49746,3103,46643,11874,34769,23916,1891,5639,818,29555,2505,2821,1935,6222,7357
CGCGAGACTTGGAGAG,sample,29739,29190,2209,26981,8421,18560,10571,806,4803,430,15374,1950,2647,1388,3224,5005
GTCGTTCTTTCAAGCC,sample,43768,43152,2346,40806,11170,29636,19246,1130,5966,767,25212,2527,2331,1212,6829,6994
GACGTATGTTCAAGCC,sample,30021,29544,1367,28177,11123,17054,11462,723,3455,267,14917,1147,1589,958,4881,6049
CATAATGGTTCAAGCC,sample,59387,58454,3631,54823,14904,39919,24115,1509,9162,1198,33277,3935,2425,890,10700,9508
CATACTCCTTCAAGCC,sample,32770,32149,1456,30693,8741,21952,14593,1048,4246,414,18839,1651,1974,1128,3653,5336
TCGAACGATTCAAGCC,sample,20575,20087,1533,18554,4712,13842,6975,664,3960,505,10935,1738,1837,876,1175,2872
TGATTCCGTTCAAGCC,sample,54459,53754,2458,51296,9967,41329,28301,1794,7562,769,35863,2903,2559,1615,6396,6939
GCAACTAGTTCAAGCC,sample,17815,17337,938,16399,4164,12235,7748,501,2613,317,10361,1056,1667,1047,1996,2650
ATACGTTCTTCAAGCC,sample,40708,40144,2278,37866,10962,26904,15912,1315,6524,678,22436,2475,2594,1463,2966,6782
CCGCAGTCTTCAAGCC,sample,50187,49053,3667,45386,8642,36744,17580,1144,10904,1283,28484,5833,3661,1169,2093,5522
TGGATCAATTCAAGCC,sample,40695,40130,3341,36789,8240,28549,18033,1127,5496,694,23529,3199,2579,1113,5371,5421
TGCGCGTTTTCAAGCC,sample,63407,62773,2468,60305,14754,45551,29027,2306,10225,1022,39252,2971,2461,1452,8109,9802
CGGTTGGTTTCAAGCC,sample,26880,26432,1335,25097,5536,19561,13083,1065,3842,381,16925,1190,1691,1137,3048,3724
CTAACCGGTTCAAGCC,sample,37063,36464,3216,33248,5526,27722,11330,703,10560,1189,21890,3940,3259,1390,1225,3517
GCCTATTCTTCAAGCC,sample,32318,31892,1302,30590,7414,23176,14248,1344,5283,599,19531,1702,2159,1620,1483,4820
CGTCGAGGTTCAAGCC,Pos_Ctrl,25507,25075,2101,22974,990,21984,18402,1809,1135,171,19537,467,3873,3892,1021,360
TCTCCTAGTTCAAGCC,sample,72950,72023,5123,66900,19491,47409,23580,1636,13377,1511,36957,7305,4359,1398,7742,12022
ATGAATAGTTCAAGCC,sample,51534,50813,4531,46282,10481,35801,17022,956,10786,1410,27808,5627,3662,1460,3411,6469
AAGTAGAGTTCAAGCC,sample,73850,72901,5295,67606,13359,54247,33109,2422,10591,1040,43700,7085,4261,2004,6749,8641
TCAATCAGTTCAAGCC,sample,40306,39894,1475,38419,10464,27955,19524,1562,5044,713,24568,1112,2089,1737,5343,6848
CGTAGAACTTCAAGCC,sample,29568,28878,3822,25056,5639,19417,6102,499,7870,883,13972,4063,2998,861,1177,3597
AGATACTATTCAAGCC,sample,41314,40791,1787,39004,14197,24807,18800,1314,3661,386,22461,646,1706,1518,6046,8526
ATATGCAATTCAAGCC,sample,29877,29500,978,28522,10175,18347,10055,980,5408,708,15463,1196,1737,1158,1934,5876
TCTAGGTTAACTTAAC,sample,100338,99542,3979,95563,22574,72989,44924,3888,15087,1957,60011,7133,3403,1185,13526,14904
GTCGTTCTAACTTAAC,Neg_Ctrl,2109,781,391,390,98,292,175,9,76,12,251,20,136,76,52,15
AGCTGAATAACTTAAC,sample,74190,73534,2539,70995,21823,49172,35491,2343,7648,1022,43139,2668,2254,1603,11751,13217
TATACGGAAACTTAAC,sample,56196,55604,2638,52966,11873,41093,20369,1895,14035,1160,34404,3634,2436,1203,3063,7733
GGTAGAGAAACTTAAC,sample,73522,72822,2001,70821,22413,48408,37268,2206,6537,1031,43805,1366,1590,1219,14462,14343
TGATTCCGAACTTAAC,sample,89334,88502,4048,84454,20103,64351,43240,3156,11774,1495,55014,4686,3354,1586,12965,13076
GCAACTAGAACTTAAC,Neg_Ctrl,1880,577,416,161,30,131,92,1,29,5,121,4,63,45,15,3
TACGCGAGAACTTAAC,sample,80151,79240,3377,75863,20776,55087,37680,2849,9772,1163,47452,3623,2463,1137,13215,12989
CCGCAGTCAACTTAAC,sample,25601,25054,2363,22691,7930,14761,6634,369,4755,423,11389,2580,1990,684,1787,4389
CCGTACGCAACTTAAC,sample,58840,58097,2526,55571,12269,43302,31260,2675,6635,637,37895,2095,2274,1432,6911,8339
TCTCAGGAAACTTAAC,sample,55248,54213,2597,51616,14477,37139,22701,1567,9131,1225,31832,2515,2012,1008,3564,9411
ATGGCGTTAACTTAAC,sample,103540,102080,4478,97602,20181,77421,47699,3403,17479,2643,65178,6197,2825,1305,9791,13595
ACGCTTAAAACTTAAC,sample,87870,86580,3239,83341,17082,66259,38453,2685,19060,1583,57513,4478,2187,1280,6895,12370
CATTCGGTAACTTAAC,sample,111972,110753,8794,101959,12508,89451,47334,3263,23794,2783,71128,12277,5414,2190,6593,8014
GAGATTCTAACTTAAC,sample,104471,103040,6305,96735,24050,72685,43083,3516,16942,1973,60025,7171,3414,1311,11775,14980
GCCTATTCAACTTAAC,sample,80462,79264,4179,75085,17590,57495,33851,2370,13087,1557,46938,6630,3162,1276,10245,11401
CGCGGTCGAACTTAAC,sample,51315,50601,5441,45160,6458,38702,13536,969,14600,1525,28136,8072,4169,1248,1833,3963
TCTCCTAGAACTTAAC,sample,68409,67591,2829,64762,12937,51825,35249,2574,8992,1227,44241,3783,2899,2042,6071,9193
TAACGCCAAACTTAAC,sample,75823,74859,2542,72317,22338,49979,38813,2541,6305,562,45118,1758,1409,1325,13971,13974
TTAACTGAAACTTAAC,sample,36703,36210,1405,34805,13243,21562,15379,892,3935,375,19314,981,1759,1288,5093,7613
CTGGTCTTATACTTGA,sample,87635,86508,6785,79723,17723,62000,36322,2232,14819,1577,51141,7050,3963,1369,14384,11091
AGCTGAATATACTTGA,sample,104382,102960,7140,95820,20664,75156,49203,3108,14374,1409,63577,7062,3354,1507,17268,14166
GACGTATGATACTTGA,sample,73682,72618,3506,69112,18139,50973,35940,1789,8690,868,44630,3686,2669,1131,15954,11494
CATAATGGATACTTGA,sample,99293,98101,9433,88668,18891,69777,32823,2361,19039,2077,51862,13477,5931,1399,9691,11924
TATACGGAATACTTGA,sample,74597,73573,3373,70200,19139,51061,36835,2426,7761,924,44596,3115,2128,1142,14328,13076
CATACTCCATACTTGA,sample,66130,65319,3721,61598,15662,45936,31860,1860,7635,1017,39495,3564,3124,1476,10384,10349
TCGAACGAATACTTGA,sample,13338,13059,1012,12047,2525,9522,4794,299,2983,310,7777,1136,1555,789,788,1586
GGTAGAGAATACTTGA,sample,131010,129543,11118,118425,19268,99157,49729,3775,28201,3504,77930,13948,5524,1623,17597,12751
ATTCAAGGATACTTGA,sample,49784,49227,1703,47524,13335,34189,26688,2119,3934,402,30622,1046,2153,1954,7097,8622
TACGCGAGATACTTGA,sample,47889,46947,4488,42459,9395,33064,15297,1110,9920,1094,25217,5643,3105,985,3035,5898
TCTCAGGAATACTTGA,sample,71444,70541,4190,66351,14824,51527,28385,1376,14808,1981,43193,4977,2754,1240,7076,9955
TGGATCAAATACTTGA,sample,87799,86739,5418,81321,20717,60604,37601,2885,12494,1698,50095,5926,3257,1353,13758,13605
GGCAGGTTATACTTGA,sample,18411,18093,2001,16092,3638,12454,6053,500,3664,309,9717,1928,2023,869,2308,2234
TGCGCGTTATACTTGA,sample,42983,42253,2420,39833,13349,26484,14055,871,7917,812,21972,2829,2459,1308,2348,7712
AGCGTCTTATACTTGA,sample,104286,102471,7404,95067,18439,76628,43041,3331,19212,2099,62253,8945,4075,1652,6188,12045
CGGTTGGTATACTTGA,sample,84665,83384,6938,76446,13761,62685,26450,1916,20874,2802,47324,10643,4673,1443,3868,8851
TAGCGAGTATACTTGA,sample,130658,129221,6607,122614,20929,101685,57592,4528,26215,3237,83807,10113,3737,1532,15948,14235
GCTCTTCTATACTTGA,sample,147931,146115,6672,139443,30479,108964,68216,4961,24491,2127,92707,9169,3398,1238,23861,21193
GAGATTCTATACTTGA,sample,19658,19395,3394,16001,1991,14010,4650,265,5290,469,9940,3336,2541,687,1464,1103
CTAAGCATATACTTGA,sample,157949,156006,11322,144684,23300,121384,66372,4185,30844,3748,97216,16235,5800,1739,18736,16435
CTAACCGGATACTTGA,sample,117422,115997,3451,112546,21301,91245,71769,4372,12141,1064,83910,1899,1973,1813,14272,15301
AGCAGAGCATACTTGA,sample,54853,54198,2717,51481,14311,37170,22848,1786,9216,975,32064,2345,2340,1364,7017,9084
GGCGTACCATACTTGA,sample,47502,46961,1929,45032,12922,32110,20502,1869,6409,1067,26911,2263,2101,1098,6258,7777
CAGCTTCGATACTTGA,Neg_Ctrl,3427,1068,631,437,94,343,212,6,80,7,292,38,134,77,68,11
AAGTAGAGATACTTGA,sample,52340,51972,2143,49829,15398,34431,22110,1789,7481,718,29591,2333,2884,1731,4827,9437
GCGCAATAATACTTGA,sample,59170,58086,5077,53009,14746,38263,23786,1613,7676,895,31462,4293,3233,1659,7466,9282
TCTAGGTTATCCGCGA,sample,70133,69299,5041,64258,16247,48011,26990,1676,12147,1307,39137,5891,3430,1140,10114,10504
GTCGTTCTATCCGCGA,sample,18907,18571,2153,16418,3472,12946,6652,607,3184,387,9836,2116,2026,922,1951,2099
AGAGTTCTATCCGCGA,sample,37006,36611,1753,34858,9681,25177,18822,1517,3439,314,22261,1085,2073,1557,6208,6362
GACGTATGATCCGCGA,sample,60474,59729,4091,55638,12354,43284,28140,2280,7435,879,35575,4550,3217,1604,7218,8059
CATAATGGATCCGCGA,sample,50429,49768,5362,44406,10250,34156,17489,868,9573,1066,27062,5160,3579,1011,7465,6376
TATACGGAATCCGCGA,sample,26236,25697,3669,22028,6559,15469,4662,364,5596,675,10258,4172,2728,597,1551,3379
GAGCCTCCATCCGCGA,sample,59920,59037,3866,55171,14224,40947,25866,1386,9243,854,35109,3598,2764,1142,11745,9118
CTAGCGACATCCGCGA,sample,64188,63352,3395,59957,16317,43640,28172,2453,7975,899,36147,4141,2399,1153,10281,10486
TCATCGAAATCCGCGA,sample,64765,63960,3400,60560,14136,46424,29727,2515,9401,1412,39128,3369,2680,1428,8835,9442
TGGATCAAATCCGCGA,sample,119920,118739,4737,114002,25294,88708,63758,5234,12923,1340,76681,5453,3180,1989,14530,17617
GGCAGGTTATCCGCGA,sample,31572,30903,3956,26947,6942,20005,5056,368,7865,818,12921,5898,3335,699,1308,3846
CGGTTGGTATCCGCGA,sample,60259,59523,2414,57109,11405,45704,30810,2087,9041,1153,39851,2613,2477,1827,6857,7646
GCTCTTCTATCCGCGA,sample,101651,100172,4426,95746,23156,72590,46910,4334,14317,1877,61227,5152,3021,1534,13737,15323
GAGATTCTATCCGCGA,sample,88641,87201,6756,80445,16851,63594,31928,2711,17669,1861,49597,9425,4114,1233,10366,10874
AAGGTCTGATCCGCGA,sample,74422,73462,2762,70700,14296,56404,41365,2903,8301,1005,49666,2830,2968,2243,8571,9724
CTAACCGGATCCGCGA,sample,51737,51104,4802,46302,5488,40814,22473,1723,9637,1079,32110,5902,4112,1844,4626,3456
GCTGCTTCATCCGCGA,sample,29978,29394,3057,26337,8042,18295,8448,509,5713,588,14161,3037,2598,916,2907,4476
TGCGCTCCATCCGCGA,sample,51343,50628,1851,48777,16126,32651,24430,1966,4453,559,28883,1243,1756,1416,8743,10102
GGCGTACCATCCGCGA,sample,32423,31765,1911,29854,10592,19262,10574,820,5202,530,15776,2136,2188,1052,2795,6069
CGTCGAGGATCCGCGA,sample,22868,22540,1384,21156,7490,13666,8473,595,3100,318,11573,1180,1802,1006,2879,4292
CAGCTTCGATCCGCGA,sample,66261,65412,3637,61775,12747,49028,29967,2039,11694,1230,41661,4098,2881,1586,9390,8530
ATGAATAGATCCGCGA,sample,93531,92464,3120,89344,27510,61834,46915,3356,8768,1152,55683,1643,1283,1108,20915,17740
AAGTAGAGATCCGCGA,sample,71688,70754,4196,66558,19421,47137,26834,1845,11969,1812,38803,4677,2807,1222,7857,12147
GACTAACCATCCGCGA,sample,62923,61975,4703,57272,12104,45168,23749,1735,11782,1746,35531,6156,3433,1491,6731,7854
CCTAACTAATCCGCGA,sample,99613,98428,5222,93206,25061,68145,44583,3268,13404,2099,57987,4791,3591,1833,13579,16082
AACCGGTTAGGACTCA,sample,39540,39036,1638,37398,11619,25779,18117,1278,4293,506,22410,1585,2039,1338,4729,7187
CTGGTCTTAGGACTCA,sample,28753,28043,2818,25225,6525,18700,5852,479,7313,992,13165,4064,2683,709,1153,3983
GTCGTTCTAGGACTCA,sample,72670,71773,3269,68504,17472,51032,37359,2613,6962,1027,44321,3071,2598,1530,10727,11523
AGAGTTCTAGGACTCA,sample,76544,75619,3577,72042,20137,51905,39956,2945,6576,1242,46532,1186,1413,1161,14734,13339
AGCTGAATAGGACTCA,sample,72197,71294,5148,66146,12430,53716,26321,1673,17050,1968,43371,6704,3951,1455,8208,8299
GAGCCTCCAGGACTCA,sample,117894,116530,6227,110303,27822,82481,53367,3660,15069,1585,68436,8800,3896,1398,19999,18467
CTAGCGACAGGACTCA,sample,35597,34904,3417,31487,4146,27341,10889,784,9891,1187,20780,4590,3171,1120,1182,2714
TCGAACGAAGGACTCA,sample,71613,70668,4598,66070,14259,51811,31687,2308,10997,1344,42684,5475,3468,1208,11330,9781
TCATACCAAGGACTCA,sample,33851,33359,2486,30873,7312,23561,10305,883,7776,756,18081,3841,2323,955,2365,4773
GCAACTAGAGGACTCA,sample,9205,8923,474,8449,2019,6430,4490,307,1117,133,5607,383,1136,843,1228,1271
GATGCGTTAGGACTCA,sample,59254,58378,3696,54682,10968,43714,24155,1850,11017,1237,35172,5455,3573,1659,2270,6981
ATGGCGTTAGGACTCA,sample,73446,72390,3785,68605,24041,44564,24090,1625,12005,1707,36095,5137,2966,1035,8556,14117
CCATTCTTAGGACTCA,sample,113108,111154,7026,104128,24170,79958,46708,3452,17752,2335,64460,9711,3950,1314,9126,15152
AGCGTCTTAGGACTCA,sample,126729,125054,6111,118943,24127,94816,68586,5016,13578,2164,82164,5472,2908,1725,13059,16317
CATTCGGTAGGACTCA,sample,51778,51171,2865,48306,10397,37909,23428,2096,8120,1124,31548,3141,2854,1651,6641,6907
TAGCGAGTAGGACTCA,sample,58015,57288,1848,55440,14542,40898,26076,1858,9135,1240,35211,2589,1887,1343,7838,9582
GAGATTCTAGGACTCA,sample,66603,65855,3140,62715,13115,49600,34831,1854,9122,1025,43953,2768,2725,1718,10720,9349
CCTAGCGGAGGACTCA,sample,57532,56909,2626,54283,13286,40997,25517,1597,9407,1301,34924,3175,2573,1425,8663,8687
GGCGACGAAGGACTCA,sample,56964,56123,2941,53182,14505,38677,25905,1549,7531,871,33436,2821,2461,1563,5812,9181
GCCTATTCAGGACTCA,sample,81289,80302,3932,76370,19104,57266,34255,1573,13978,1872,48233,5588,3287,1385,12775,12678
AGCAGAGCAGGACTCA,sample,125731,123791,7530,116261,22799,93462,54170,3944,21536,2723,75706,11089,4834,1522,16153,15664
GTCGCGAAAGGACTCA,sample,141120,139690,7989,131701,25765,105936,67030,4569,20602,2913,87632,10822,5357,2134,10884,17299
ATGAATAGAGGACTCA,sample,155453,153736,9119,144617,29320,115297,84181,6178,15759,1588,99940,7591,4123,1931,19526,20073
AAGTAGAGAGGACTCA,sample,117434,115901,6859,109042,20626,88416,54742,3338,18583,1936,73325,9817,4618,1753,14831,13872
TAACGCCAAGGACTCA,sample,89223,87948,6033,81915,14357,67558,32177,2703,20010,2509,52187,10159,5130,1562,5996,9566
ATTCTACCAGGACTCA,sample,82545,81578,2157,79421,14164,65257,44665,2980,13269,1586,57934,2757,2001,1460,8417,10036
CCTAACTAAGGACTCA,Pos_Ctrl,36781,35876,2451,33425,1361,32064,26666,2668,1889,225,28555,616,4518,4895,1380,506
TATACGGATATTGAAC,sample,68142,67654,1610,66044,15395,50649,34849,3268,9519,1224,44368,1789,2027,1689,9065,10008
TCGAACGATATTGAAC,sample,46564,46118,1257,44861,12387,32474,25655,1758,3846,574,29501,641,1685,1521,7877,8079
GGTAGAGATATTGAAC,sample,51094,50617,2154,48463,9174,39289,27107,1947,6871,964,33978,2400,2714,1802,5804,6431
CGTCGCCATATTGAAC,sample,48274,47750,2407,45343,12314,33029,21539,1392,6585,740,28124,2773,2737,1079,8639,8085
TGATTCCGTATTGAAC,sample,58217,57623,1863,55760,15091,40669,30666,2242,5999,564,36665,1198,1894,1516,7614,9943
TACGCGAGTATTGAAC,sample,50751,50174,2809,47365,9012,38353,23879,2028,7938,990,31817,3518,2884,1752,3799,5726
GACTCAAGTATTGAAC,sample,67329,66582,2281,64301,18244,46057,34703,2547,6105,878,40808,1824,1973,1368,11388,11482
GGCAGGTTTATTGAAC,sample,101608,100241,4948,95293,21237,74056,47487,3107,14522,1526,62009,7414,3602,1065,13893,14107
ATGGCGTTTATTGAAC,sample,101706,100488,5049,95439,19627,75812,43763,3277,19248,2319,63011,7205,3432,1264,10411,13077
ACGCTTAATATTGAAC,sample,140737,138895,6393,132502,31468,101034,61933,4409,21218,3441,83151,10033,3389,1344,11884,20479
TAGCGAGTTATTGAAC,sample,116449,114771,7036,107735,26691,81044,49363,3321,17322,2055,66685,8983,4410,1206,18669,16354
GAGATTCTTATTGAAC,sample,75046,73645,3450,70195,14777,55418,29667,1935,16689,2017,46356,5110,2610,1090,5544,9664
CTAAGCATTATTGAAC,sample,93999,92667,3385,89282,15240,74042,48935,4229,15301,1487,64236,4090,2254,1500,8922,11061
AAGGTCTGTATTGAAC,sample,40685,40105,3626,36479,6137,30342,17868,1336,6525,579,24393,4034,3077,1323,5281,4211
AGCAGAGCTATTGAAC,sample,35492,34820,4118,30702,5608,25094,9488,542,9310,1108,18798,4646,3145,1032,1142,3455
ATACCGCCTATTGAAC,sample,148335,146651,8202,138449,21430,117019,73858,5160,22884,2370,96742,12747,4851,1817,16587,15505
GTCGCGAATATTGAAC,sample,22529,22000,1948,20052,5199,14853,8956,569,3508,381,12464,1439,1922,1119,2715,3319
CGTCGAGGTATTGAAC,sample,23745,23291,1890,21401,3953,17448,8556,573,5228,626,13784,2465,2413,1104,2053,2577
TCTCCTAGTATTGAAC,sample,87780,86557,4703,81854,12595,69259,44361,3444,14361,1825,58722,5268,3047,1525,8881,8830
TAACGCCATATTGAAC,sample,89541,88079,5085,82994,13969,69025,44582,3682,13236,1500,57818,6025,3127,1377,10411,10250
ATTCTACCTATTGAAC,sample,102899,101247,10335,90912,12305,78607,35503,2718,21967,2646,57470,15773,6533,1434,10870,8497
CGTAGAACTATTGAAC,sample,75475,74078,3274,70804,10483,60321,36846,2934,13845,1447,50691,5249,3347,1663,2393,6948
ATATGCAATATTGAAC,sample,101016,99910,4131,95779,18289,77490,49911,4376,15256,2219,65167,5728,3192,1421,11890,12018
AGCTGAATGTTCAACT,sample,43556,42945,2429,40516,8707,31809,20320,1316,7228,859,27548,2086,2174,1360,6278,5983
CTAGCGACGTTCAACT,sample,39670,39180,2771,36409,7387,29022,19265,1515,5277,441,24542,2524,2620,1776,4399,4721
TCATACCAGTTCAACT,sample,31966,31532,2062,29470,6265,23205,14537,1146,4955,667,19492,1900,2328,1376,4661,4341
GACTCAAGGTTCAACT,sample,33221,32699,1625,31074,7110,23964,17405,865,3972,476,21377,1246,1614,1012,7273,5111
ATACGTTCGTTCAACT,sample,22228,21923,1065,20858,5587,15271,9524,840,3505,412,13029,990,1732,1164,1701,3585
ATGGCGTTGTTCAACT,sample,24752,24314,2199,22115,3443,18672,6490,557,7361,874,13851,3390,2870,998,866,2003
TGCGCGTTGTTCAACT,sample,23116,22766,1455,21311,4155,17156,10771,693,3777,430,14548,1485,1556,797,4191,2902
AGCGTCTTGTTCAACT,sample,35418,34813,2602,32211,5289,26922,14441,877,7765,710,22206,3129,1971,865,3423,3190
CGGTTGGTGTTCAACT,sample,35285,34673,1299,33374,7938,25436,20772,1347,2603,308,23375,406,907,905,8757,5651
GCTCTTCTGTTCAACT,sample,39049,38505,1878,36627,6420,30207,18148,1423,7749,862,25897,2025,1997,1433,4135,4633
CCTAGCGGGTTCAACT,sample,13552,13279,607,12672,3468,9204,7098,545,1134,141,8232,286,1246,1090,1979,2252
TAACGAAGGTTCAACT,sample,49192,48569,3719,44850,8060,36790,21227,1400,10010,1139,31237,3014,2227,1201,6069,5595
AGCAGAGCGTTCAACT,sample,26377,25909,1828,24081,3797,20284,11088,743,5789,840,16877,1824,1806,992,2871,2574
TGCGCTCCGTTCAACT,sample,21291,20954,1038,19916,5550,14366,11427,906,1474,154,12901,405,813,817,4454,3796
GTCGCGAAGTTCAACT,sample,16540,16218,1034,15184,4159,11025,7261,530,2253,277,9514,704,1331,934,2464,2688
CGTCGAGGGTTCAACT,sample,8882,8728,883,7845,1585,6260,2906,192,1776,215,4682,1171,1403,649,880,1006
CAGCTTCGGTTCAACT,sample,27665,27190,1661,25529,4542,20987,13738,1094,4138,390,17876,1627,1940,1224,3113,3154
TCAATCAGGTTCAACT,sample,20319,19942,1417,18525,3444,15081,8959,427,3552,334,12511,1809,1708,769,2419,2239
CGTAGAACGTTCAACT,sample,21207,20706,949,19757,2955,16802,10753,789,3982,389,14735,889,1460,1099,1379,2041
CCTAACTAGTTCAACT,sample,26865,26441,2205,24236,3935,20301,11247,830,4676,527,15923,3021,2487,1127,2497,2492
GCGCAATAGTTCAACT,Neg_Ctrl,909,342,184,158,36,122,71,9,33,0,104,9,60,28,23,5
TTAACTGAGTTCAACT,sample,26885,26497,1451,25046,5155,19891,13777,908,3280,336,17057,1590,1997,1338,2990,3431
ATATGCAAGTTCAACT,sample,31556,31221,1213,30008,6703,23305,16535,1329,3918,535,20453,988,1761,1262,3591,4516
CTGGTCTTCTGAGGTT,sample,144156,142258,6850,135408,31633,103775,69583,4760,21111,3198,90694,5123,3060,1785,21652,22363
AGCTGAATCTGAGGTT,sample,134357,132289,10104,122185,31617,90568,50594,3330,23634,2699,74228,10311,4350,1557,19325,21048
GAGCCTCCCTGAGGTT,sample,150207,148302,10226,138076,23730,114346,71815,4430,23765,2278,95580,12058,5182,2190,16212,16488
TCGAACGACTGAGGTT,sample,107612,106256,4803,101453,24642,76811,54906,4322,11768,1538,66674,4277,2959,1819,15360,16452
ATTCAAGGCTGAGGTT,sample,72099,71268,3672,67596,19344,48252,33500,2789,9341,1021,42841,1601,2673,2338,8464,12449
GCAACTAGCTGAGGTT,sample,19680,19148,1169,17979,4314,13665,8301,654,3582,376,11883,752,1806,1309,2380,2795
TGGATCAACTGAGGTT,sample,110024,108854,3981,104873,20884,83989,56387,5395,17509,1582,73896,3116,2875,2511,11174,14706
ATGGCGTTCTGAGGTT,sample,42933,42134,2961,39173,7144,32029,19948,1034,7521,714,27469,2812,2153,1141,7979,4951
CGGTTGGTCTGAGGTT,sample,52044,51178,3612,47566,9262,38304,15287,1127,13533,1770,28820,6587,3887,1123,2390,5741
GCTCTTCTCTGAGGTT,sample,57327,56513,2682,53831,10887,42944,23689,2063,12723,1203,36412,3266,3247,2054,3447,6999
CTAAGCATCTGAGGTT,sample,192250,190615,6347,184268,29683,154585,123071,9560,14230,2441,137301,5283,3433,3068,17146,20528
GGCGACGACTGAGGTT,sample,89877,88055,8368,79687,17754,61933,22403,1532,21634,2666,44037,13698,5650,1301,6245,10955
TAACGAAGCTGAGGTT,sample,22140,21716,1810,19906,4652,15254,7085,616,4756,517,11841,2280,2012,834,1808,2876
ATACCGCCCTGAGGTT,sample,51351,50647,4118,46529,10889,35640,19434,1522,8979,1180,28413,4525,3778,1780,5384,6999
GCGTTACCCTGAGGTT,sample,86027,84720,4351,80369,21867,58502,40488,2519,10679,1750,51167,3066,2528,1670,12855,13888
CGTCGAGGCTGAGGTT,sample,139221,137576,6045,131531,26540,104991,84210,8477,9423,1168,93633,1713,1783,1853,19558,19202
CAGCTTCGCTGAGGTT,sample,125709,123666,6920,116746,26429,90317,52799,3759,21170,2108,73969,10481,4606,1451,18364,17873
CGCGGTCGCTGAGGTT,sample,126324,124913,6272,118641,16138,102503,64740,5396,20689,2750,85429,8928,4443,1896,15762,11101
TTATGACGCTGAGGTT,sample,155365,153565,8450,145115,23623,121492,72590,5883,28476,2691,101066,11852,4857,1786,21080,16231
ATGAATAGCTGAGGTT,sample,112534,110778,10585,100193,18024,82169,37266,2769,24842,3160,62108,14132,6108,1535,12257,11840
ATTCTACCCTGAGGTT,sample,132649,130971,5280,125691,26750,98941,75286,5388,13326,1953,88612,2988,1984,1670,17309,19639
GCGCAATACTGAGGTT,sample,112593,111033,5636,105397,20156,85241,55777,4771,15398,1948,71175,7347,3821,1995,10906,12530
AGAGTTCTAGACCGTT,sample,81979,81081,3872,77209,20499,56710,36034,2982,12552,1707,48586,3435,2812,1786,10618,13202
AGCTGAATAGACCGTT,sample,118258,116452,8953,107499,26474,81025,32319,2475,26563,2803,58882,16865,5189,1637,6022,16107
TATACGGAAGACCGTT,sample,30868,30509,1180,29329,9972,19357,11889,843,4815,624,16704,1186,2350,1541,2959,5892
GAGCCTCCAGACCGTT,sample,133802,132479,6826,125653,34970,90683,63363,4700,14985,1963,78348,5672,3092,1740,22121,22153
TCATACCAAGACCGTT,sample,133810,132620,4991,127629,36879,90750,73627,3608,10403,881,84030,2231,1802,1758,23632,23885
GACTCAAGAGACCGTT,sample,109620,108382,5858,102524,22364,80160,53567,3298,15734,1578,69301,5983,3674,1493,22394,15687
ATACGTTCAGACCGTT,sample,86470,85322,6173,79149,20171,58978,35497,2424,13193,1379,48690,6485,3541,1205,15737,12998
CGGTTGGTAGACCGTT,sample,106321,105161,4626,100535,22075,78460,54158,4387,12579,1053,66737,6283,3502,1773,12773,14664
GGCGACGAAGACCGTT,sample,46675,45973,1683,44290,13145,31145,23790,1764,4071,466,27861,1054,1803,1599,6792,8546
TAACGAAGAGACCGTT,sample,79795,78877,3097,75780,12813,62967,38080,3191,15277,2176,53357,4243,2260,1541,7901,8865
GCTGCTTCAGACCGTT,sample,25999,25281,2190,23091,5866,17225,8211,486,5685,682,13896,2161,2173,828,2081,3529
TGCGCTCCAGACCGTT,sample,53428,52677,3146,49531,12329,37202,25456,1994,6704,670,32160,2378,2556,1784,7723,7909
GCGTTACCAGACCGTT,sample,131715,129609,7377,122232,30534,91698,62937,4896,15699,1780,78636,6386,3632,1569,22531,20228
CAGCTTCGAGACCGTT,sample,102203,100728,3788,96940,19709,77231,55567,4001,11743,1153,67310,4767,3174,1710,18313,12372
GACTAACCAGACCGTT,sample,25224,24499,2567,21932,3476,18456,6236,597,7352,989,13588,3282,2360,872,889,2325
AGATACTAAGACCGTT,sample,102744,101102,5953,95149,14237,80912,47296,3858,21544,2174,68840,6040,3344,1625,5624,9838
CTGGTCTTCTTGAGTT,sample,152843,151704,5754,145950,41800,104150,77043,6963,15536,1901,92579,2707,2560,1914,26689,26006
GTCGTTCTCTTGAGTT,sample,149527,148137,5515,142622,42672,99950,70753,5156,16376,1487,87129,6178,3501,1714,25386,26746
GACGTATGCTTGAGTT,sample,68502,67678,3405,64273,14261,50012,27360,2006,14025,1730,41385,4891,3202,1414,10332,9252
GAGCCTCCCTTGAGTT,sample,134745,133598,8335,125263,25499,99764,51551,3974,29344,3560,80895,11335,4918,1855,16122,16979
CATACTCCCTTGAGTT,sample,139987,138444,5451,132993,37302,95691,66378,4852,16316,2373,82694,5772,2658,1715,21265,23865
GGTAGAGACTTGAGTT,sample,173327,171536,9783,161753,39958,121795,87094,5981,19963,2487,107057,6270,3553,1823,25885,26246
ATACGTTCCTTGAGTT,sample,92732,91453,10970,80483,13604,66879,24487,1066,22118,2196,46605,17012,6455,1235,12178,8239
CCGCAGTCCTTGAGTT,sample,95025,94015,2938,91077,24917,66160,55231,3679,5091,610,60322,1549,2016,2242,14966,15633
CCGTACGCCTTGAGTT,sample,72426,71127,4896,66231,17375,48856,33343,2872,8231,1171,41574,3239,2584,1462,7739,10909
GATGCGTTCTTGAGTT,sample,138487,136661,8961,127700,29482,98218,66922,4331,17619,1542,84541,7804,3871,1752,20556,19064
TGCGCGTTCTTGAGTT,sample,118277,116927,6304,110623,19889,90734,54669,3327,22867,2749,77536,7122,3641,1687,18875,13564
AGCGTCTTCTTGAGTT,sample,68605,67617,3904,63713,14840,48873,29317,2407,12645,1568,41962,2936,2601,1633,8242,10121
CTAACCGGCTTGAGTT,sample,52705,51623,2832,48791,10921,37870,21002,1332,11069,1227,32071,3240,2272,1311,3463,7244
AGCAGAGCCTTGAGTT,sample,19998,19325,2365,16960,4485,12475,4908,399,4355,447,9263,2366,2248,848,1002,2713
TGCGCTCCCTTGAGTT,sample,62067,61054,4698,56356,13842,42514,23270,1776,11290,1210,34560,4968,3527,1371,7859,8881
GGCGTACCCTTGAGTT,sample,160065,157315,12998,144317,21646,122671,68179,4991,29856,3223,98035,16422,6903,2024,18768,14070
CAGCTTCGCTTGAGTT,sample,100093,97674,7560,90114,12970,77144,39163,3351,21240,3087,60403,10303,4357,1579,6914,7282
AAGTAGAGCTTGAGTT,sample,93724,91835,7838,83997,14285,69712,34972,2139,20173,2253,55145,10175,4815,1346,11268,9780
ATTCTACCCTTGAGTT,sample,124173,122081,5954,116127,23910,92217,61650,4612,17082,2087,78732,6786,3637,1702,17046,15852
AGATACTACTTGAGTT,sample,145323,142792,9977,132815,28340,104475,65835,5611,21101,2039,86936,9889,4140,1532,17910,19233
TTAACTGACTTGAGTT,sample,34661,34267,2263,32004,6126,25878,16667,1206,4848,493,21515,2664,2472,1582,4097,4174
ATATGCAACTTGAGTT,sample,129831,128419,7261,121158,20878,100280,55142,4412,25243,3054,80385,12429,4710,1791,12451,13176
GTCGTTCTTCGGAGTT,sample,22777,22459,1411,21048,5716,15332,6975,544,5305,608,12280,1900,2363,1235,1144,3457
AGCTGAATTCGGAGTT,sample,37254,36871,1807,35064,5618,29446,15651,1382,8784,1222,24435,2407,2829,1817,2102,3892
CTAGCGACTCGGAGTT,sample,38673,38000,1945,36055,8107,27948,16867,1392,6821,1051,23688,1817,2100,1313,5425,5533
GGTAGAGATCGGAGTT,sample,54376,53629,1948,51681,14968,36713,28303,1780,4809,544,33112,1277,1848,1474,10380,9982
CGTCGCCATCGGAGTT,sample,46641,45891,4000,41891,7834,34057,17152,1152,9770,1046,26922,4937,3488,1495,4527,4989
CCGTACGCTCGGAGTT,sample,34841,33974,2417,31557,8319,23238,12732,910,6314,693,19046,2589,2280,1009,2941,5265
CCATTCTTTCGGAGTT,sample,50768,49819,2539,47280,9256,38024,26148,1695,7431,755,33579,1995,1957,1359,5571,6475
AGCGTCTTTCGGAGTT,sample,18157,17731,1874,15857,3600,12257,6851,377,3148,375,9999,1506,1524,721,2584,2158
ACGCTTAATCGGAGTT,sample,132665,131186,11532,119654,18185,101469,52711,4024,31885,4023,84596,8826,3844,1673,15738,12429
GCTCTTCTTCGGAGTT,sample,38511,37452,2783,34669,8354,26315,12040,1027,8969,1034,21009,3245,2476,954,2477,5302
CCTAGCGGTCGGAGTT,sample,24941,24533,1550,22983,4821,18162,11404,607,3999,496,15403,1656,1863,1129,3878,3287
TAACGAAGTCGGAGTT,sample,41128,40553,1922,38631,11181,27450,19338,1197,5008,579,24346,1328,1780,1296,6279,7098
GCCTATTCTCGGAGTT,sample,23491,22898,1850,21048,3972,17076,11400,639,3256,421,14656,1360,1794,1105,3681,2870
ATACCGCCTCGGAGTT,sample,48230,47482,3420,44062,6603,37459,17562,1340,11983,1656,29545,4918,3436,1312,2108,4416
CGTCGAGGTCGGAGTT,Pos_Ctrl,27065,26512,1601,24911,888,24023,20145,1958,1265,212,21410,443,4164,4300,1201,343
ATGAATAGTCGGAGTT,sample,78385,77145,5319,71826,11883,59943,36136,2847,12329,1480,48465,7151,3351,1229,10233,8955
TCAATCAGTCGGAGTT,sample,53602,52901,2270,50631,6738,43893,26869,2148,9835,1526,36704,3515,2588,1546,3874,4564
ATTCTACCTCGGAGTT,sample,56782,55743,4079,51664,10052,41612,22445,1751,10247,1645,32692,5524,3063,1209,4313,6699
CGCGAGACTCGGAGTT,sample,46258,45230,3597,41633,8543,33090,19187,1255,7525,996,26712,4127,2635,1020,6099,5578
TTAACTGATCGGAGTT,sample,63239,62507,4252,58255,7592,50663,29688,2151,11150,1239,40838,6435,3490,1541,6412,5106
CTGGTCTTTGAACCTT,Pos_Ctrl,48484,48082,2284,45798,2236,43562,36826,3930,1997,224,38823,585,5059,5817,3229,875
GTCGTTCTTGAACCTT,sample,19492,19248,1117,18131,3552,14579,8833,576,3344,447,12177,1379,1684,1098,2913,2663
AGAGTTCTTGAACCTT,sample,74210,73697,2450,71247,21345,49902,37602,3339,6324,714,43926,1923,2275,1881,9723,13453
GGTAGAGATGAACCTT,Pos_Ctrl,49744,48879,3337,45542,2095,43447,36340,3423,2556,335,38896,793,5302,5877,2823,812
CGTCGCCATGAACCTT,sample,61424,60594,3338,57256,11582,45674,27019,1754,12276,1507,39295,3118,2689,1596,8100,7970
TCATCGAATGAACCTT,sample,99319,98227,4119,94108,16883,77225,48982,3232,18804,2000,67786,4207,2697,1735,15074,11908
GCAACTAGTGAACCTT,sample,35727,34842,1888,32954,8042,24912,15236,1086,6286,755,21522,1549,1724,1083,5780,5326
GACTCAAGTGAACCTT,sample,89131,87879,5715,82164,18666,63498,39445,3004,12370,1440,51815,7239,3771,1529,12496,12451
CCGTACGCTGAACCTT,sample,59605,58701,2792,55909,14787,41122,28527,2322,6423,1194,34950,2656,2617,1830,7018,9536
GGCAGGTTTGAACCTT,sample,83949,82765,4516,78249,24358,53891,40574,2453,7980,427,48554,2457,1957,1276,17167,15375
ATGGCGTTTGAACCTT,Pos_Ctrl,37718,37064,2696,34368,1755,32613,27284,2588,1877,288,29161,576,4591,4719,2078,733
AGCGTCTTTGAACCTT,sample,14293,13970,1213,12757,2482,10275,5285,443,3200,399,8485,948,1480,719,1859,1578
CGGTTGGTTGAACCTT,sample,83363,82121,3946,78175,20461,57714,43091,3493,8091,1106,51182,1933,1863,1488,12728,13499
ACGCTTAATGAACCTT,sample,97949,96660,4373,92287,21379,70908,47818,4006,13224,1490,61042,4370,2878,1597,16246,14933
TAGCGAGTTGAACCTT,sample,89523,88225,8946,79279,11221,68058,28834,2001,21131,2641,49965,13451,6377,2204,6739,7697
AAGGTCTGTGAACCTT,sample,67313,66392,4810,61582,12847,48735,24404,1534,14349,1707,38753,6741,3339,1392,7156,8640
CCTAGCGGTGAACCTT,Pos_Ctrl,18550,18268,1232,17036,847,16189,13456,1268,983,178,14439,304,3390,3154,1077,396
CTAACCGGTGAACCTT,sample,29678,29215,1502,27713,6990,20723,14446,1350,3593,465,18039,869,1671,1336,4766,4486
ATACCGCCTGAACCTT,sample,19746,19211,1690,17521,3129,14392,6717,536,4606,510,11323,2023,1961,817,1541,2158
CAGCTTCGTGAACCTT,sample,71590,70275,3652,66623,16173,50450,32658,2966,9678,1082,42336,4066,2737,1266,6232,10306
TCTCCTAGTGAACCTT,sample,90985,89856,3903,85953,18858,67095,47002,3600,11591,1362,58593,3540,2490,1429,13823,13150
ATTCTACCTGAACCTT,Pos_Ctrl,46377,45428,3189,42239,1847,40392,33741,3017,2582,294,36323,758,5207,5761,2252,686
CGTAGAACTGAACCTT,sample,70210,68849,4521,64328,10405,53923,26022,2378,16404,1670,42426,7449,3616,1197,4422,7031
ATATGCAATGAACCTT,sample,79169,78481,7783,70698,9683,61015,22112,1202,19934,2075,42046,15692,5996,1264,6755,5881
TATACGGAACCGAATT,sample,96277,95395,4438,90957,27086,63871,44347,3312,10763,1181,55110,4268,3052,1966,12413,17283
GGAGAAGCACCGAATT,sample,92978,91990,3339,88651,20105,68546,41950,2569,17164,1903,59114,4960,2743,1641,8534,13620
CATACTCCACCGAATT,sample,127589,126418,4595,121823,29539,92284,71832,5814,10393,1206,82225,3039,2959,2444,15694,19970
CGTCGCCAACCGAATT,sample,58182,57427,2948,54479,13990,40489,28545,2833,5716,657,34261,2738,2695,1780,5203,9029
ATACGTTCACCGAATT,sample,68951,68181,3931,64250,12505,51745,24300,1914,16880,1976,41180,6675,3633,1487,4165,8134
CCATTCTTACCGAATT,sample,110974,109676,4652,105024,16398,88626,63760,4601,13933,2000,77693,4332,3293,2819,10858,12744
AAGGTCTGACCGAATT,sample,115766,114146,6914,107232,20601,86631,62059,4408,13271,1013,75330,5880,3121,1721,17624,14831
CTAACCGGACCGAATT,sample,79905,79076,3721,75355,15843,59512,40741,2903,10295,1288,51036,4285,3197,1905,12648,11253
GGCGACGAACCGAATT,sample,45771,44871,2293,42578,12340,30238,21995,1710,4328,649,26323,1556,1981,1712,5679,7698
TAACGAAGACCGAATT,sample,90316,89146,5793,83353,17344,66009,43311,3392,12257,1306,55568,5743,3528,1481,12886,11465
GCTGCTTCACCGAATT,sample,88771,87409,4399,83010,17064,65946,42421,3110,13749,2174,56170,4492,2432,1512,13281,11111
TGCGCTCCACCGAATT,sample,78377,77123,3365,73758,15814,57944,40847,3355,8951,814,49798,3977,2932,1880,6882,10186
GCGTTACCACCGAATT,sample,93346,91325,6202,85123,21374,63749,39441,2747,13406,1576,52847,6579,3495,1080,13809,13973
GGCGTACCACCGAATT,sample,49337,48280,2621,45659,10490,35169,21960,1291,9217,605,31177,2096,2268,1371,3940,7100
CAGCTTCGACCGAATT,Neg_Ctrl,4427,1411,972,439,78,361,216,28,84,5,300,28,149,81,53,13
CGCGGTCGACCGAATT,sample,43545,42881,2288,40593,10217,30376,20986,1717,5165,651,26151,1857,2436,1717,5450,6482
ATGAATAGACCGAATT,sample,101516,99957,11131,88826,11283,77543,26040,2457,28680,3176,54720,17190,6305,1597,4793,6467
TCAATCAGACCGAATT,sample,95895,94341,6445,87896,21123,66773,39786,2270,14358,1522,54144,8837,3377,1131,15255,13648
TTAACTGAACCGAATT,sample,131781,130130,5515,124615,26700,97915,75782,6800,12703,1437,88485,1193,1276,1088,25599,19044
AACCGGTTGGTCTGGT,sample,94027,93123,3809,89314,30362,58952,41459,2613,10376,1002,51835,3502,2442,1250,16577,17986
GTCGTTCTGGTCTGGT,Neg_Ctrl,3325,1143,700,443,118,325,233,9,57,3,290,23,131,82,41,18
GGAGAAGCGGTCTGGT,sample,23403,23098,1472,21626,5494,16132,10128,630,3309,554,13437,1511,1940,1146,2886,3570
CTAGCGACGGTCTGGT,sample,94763,93866,3017,90849,18220,72629,52623,5251,10076,1390,62699,3289,3386,2714,6608,12608
TCGAACGAGGTCTGGT,sample,103793,102862,3772,99090,32213,66877,54865,3958,6308,665,61173,1081,1521,1655,19183,20531
CGTCGCCAGGTCTGGT,Neg_Ctrl,3295,1194,772,422,112,310,194,13,66,5,260,32,129,81,65,20
ATTCAAGGGGTCTGGT,sample,105138,104040,3944,100096,27613,72483,57320,3350,8969,1342,66289,1502,1300,1230,24039,18468
GCAACTAGGGTCTGGT,sample,21507,21040,1320,19720,4333,15387,9464,805,3893,477,13357,748,1939,1442,2298,2932
TGCGCGTTGGTCTGGT,Neg_Ctrl,3099,1333,891,442,107,335,201,21,49,18,250,46,102,68,81,26
CATTCGGTGGTCTGGT,sample,24648,24130,3188,20942,3683,17259,7215,505,5448,517,12663,3574,2653,881,2098,2145
CCTAGCGGGGTCTGGT,sample,36682,36118,1552,34566,8668,25898,18936,1384,4027,476,22963,1075,1602,1258,6277,5666
CTAACCGGGGTCTGGT,Neg_Ctrl,2247,855,521,334,60,274,173,11,63,3,236,24,104,56,49,14
GCTGCTTCGGTCTGGT,sample,60011,59196,3504,55692,11132,44560,25483,1775,11994,1459,37477,3849,2878,1656,6597,7512
GCCTATTCGGTCTGGT,sample,53206,52327,1955,50372,12822,37550,28605,2164,5494,488,34099,799,1738,1549,10328,8895
GCGTTACCGGTCTGGT,sample,98517,97295,2607,94688,12363,82325,61354,4823,12589,1453,73943,2106,2489,2481,9849,8463
GTCGCGAAGGTCTGGT,sample,88892,87717,4607,83110,21034,62076,40553,3390,12984,1273,53537,3876,2965,1501,14118,14494
CAGCTTCGGGTCTGGT,sample,87505,86266,4625,81641,13842,67799,41625,3703,15764,1783,57389,4924,2961,1647,12428,9688
TCTCCTAGGGTCTGGT,sample,54535,53780,2678,51102,10127,40975,25929,1843,9419,1233,35348,2551,2597,1709,4621,7064
AAGTAGAGGGTCTGGT,sample,113081,111794,6190,105604,19844,85760,58226,4789,14400,2338,72626,6007,3384,1724,13396,14673
TAACGCCAGGTCTGGT,sample,101203,99596,5403,94193,21688,72505,48063,3131,14500,1740,62563,5071,2822,1268,18093,14341
GACTAACCGGTCTGGT,Neg_Ctrl,3220,1262,773,489,125,364,249,13,68,7,317,27,149,80,61,32
CGCGAGACGGTCTGGT,sample,54510,53561,3501,50060,8808,41252,27260,1660,7871,831,35131,3630,2591,1259,8834,6307
AGATACTAGGTCTGGT,sample,48433,47368,3869,43499,10005,33494,14829,1656,11603,1020,26432,4386,2802,903,2203,6517
ATATGCAAGGTCTGGT,sample,104525,103461,4361,99100,18880,80220,51207,4140,15910,2042,67117,6921,3094,1303,17862,13372
AACCGGTTCGACGTTA,sample,270645,268345,20298,248047,40725,207322,85431,7688,69565,9149,154996,35489,9150,2389,26007,27718
GTCGTTCTCGACGTTA,sample,65696,64839,4483,60356,14137,46219,25831,1855,11767,1401,37598,5365,3822,1514,9387,9220
TCATACCACGACGTTA,sample,75928,74695,7574,67121,16330,50791,25932,1931,14022,1734,39954,7172,4315,1365,6470,9868
CATTCGGTCGACGTTA,sample,75202,74405,2519,71886,11532,60354,39752,2988,13347,1501,53099,2766,3039,2384,5345,8153
ATACCGCCCGACGTTA,sample,170760,168647,9635,159012,33733,125279,76606,5465,26094,4217,102700,12897,4627,1585,28026,23126
GCGTTACCCGACGTTA,sample,118530,117187,4130,113057,29118,83939,63566,4828,11526,1260,75092,2759,2562,1995,17626,19003
CGCGGTCGCGACGTTA,sample,81820,80832,4100,76732,15256,61476,33384,2264,19491,2141,52875,4196,2442,1360,6514,10168
TCAATCAGCGACGTTA,sample,99393,98041,3650,94391,15368,79023,48406,2758,20996,2015,69402,4848,2439,1317,6439,10399
AGATACTACGACGTTA,sample,145912,144238,6130,138108,22363,115745,64689,5171,35329,3406,100018,7150,2382,1443,6892,15185
GCGCAATACGACGTTA,sample,144886,143199,4364,138835,19757,119078,69968,5547,32869,3179,102837,7515,2252,1610,4666,13693
TTAACTGACGACGTTA,sample,153496,152238,7526,144712,27399,117313,71694,6467,24551,3905,96245,10696,4384,1508,23055,18863
AACCGGTTTACTAAGT,sample,46922,46294,1657,44637,13684,30953,21706,1397,5443,703,27149,1704,2006,1281,5137,8648
GTCGTTCTTACTAAGT,sample,23510,23136,1628,21508,5479,16029,10367,576,3136,384,13503,1566,1735,844,4248,3574
AGAGTTCTTACTAAGT,sample,50408,49863,2913,46950,9922,37028,24185,1744,7848,746,32033,2505,2407,1529,7804,6887
CATAATGGTACTAAGT,sample,9604,9405,981,8424,1602,6822,3455,259,1893,239,5348,976,1331,619,1151,992
TATACGGATACTAAGT,sample,71999,71236,2951,68285,13818,54467,39138,2532,9691,1129,48829,1977,1997,1519,12540,9874
CGTCGCCATACTAAGT,sample,55196,54552,2444,52108,11181,40927,28192,1809,7832,894,36024,2200,2230,1519,8992,7645
TCATACCATACTAAGT,sample,41549,40964,1914,39050,8614,30436,18749,1765,6928,991,25677,2003,2115,1515,2824,5624
GCAACTAGTACTAAGT,sample,16828,16443,960,15483,2768,12715,9389,674,1904,226,11293,522,2040,1831,1355,2078
CCGCAGTCTACTAAGT,sample,8591,8338,871,7467,1600,5867,3021,221,1606,227,4627,792,1266,622,745,952
TCTCAGGATACTAAGT,sample,65314,64194,3767,60427,14190,46237,25110,2056,12293,1367,37403,5411,2979,1072,8352,9201
ACGCTTAATACTAAGT,sample,102750,101315,6775,94540,16149,78391,47669,4379,16236,1427,63905,8680,4449,1394,15864,11797
CTAAGCATTACTAAGT,sample,60228,59092,4405,54687,10224,44463,26181,1762,10159,1206,36340,5155,3395,1315,7085,6593
CGTCGAGGTACTAAGT,sample,6498,6330,660,5670,1262,4408,2454,116,1188,133,3642,517,986,517,765,792
TTATGACGTACTAAGT,sample,189246,187144,20121,167023,11690,155333,45620,3038,67815,7968,113435,30892,10139,2149,8090,6104
TCTCCTAGTACTAAGT,sample,86137,84837,3402,81435,14873,66562,45471,4077,11885,1338,57356,3791,2088,1133,11726,10183
TAACGCCATACTAAGT,sample,70969,69965,4138,65827,13697,52130,31380,2687,11651,1028,43031,5384,2987,1412,8134,8564
AGATACTATACTAAGT,sample,52163,51478,3317,48161,8768,39393,27284,1723,6880,748,34164,2758,2387,1306,7013,5743
CCTAACTATACTAAGT,sample,63744,62665,4297,58368,9963,48405,25545,1621,13591,1440,39136,6208,3714,1112,5537,6452
AACCGGTTTTGCCGCT,sample,265042,262728,19553,243175,41970,201205,104272,7690,49147,5846,153419,34250,9657,3196,28208,27705
GACGTATGTTGCCGCT,sample,31173,30601,2366,28235,8171,20064,11503,794,4964,672,16467,2131,2229,1067,3436,4969
TCGAACGATTGCCGCT,sample,121735,120725,5163,115562,18225,97337,58792,4839,24245,2628,83037,6833,4164,2484,12408,13734
TCATCGAATTGCCGCT,sample,80717,79849,3393,76456,19012,57444,31759,3297,15752,2643,47511,3993,2538,1549,8393,12970
TGATTCCGTTGCCGCT,sample,56761,55967,2995,52972,10479,42493,22722,1618,13765,1661,36487,2727,2808,1407,7040,6739
TACGCGAGTTGCCGCT,sample,59409,58648,2310,56338,15335,41003,24395,1963,10555,1631,34950,2459,2285,1356,8971,9455
GATGCGTTTTGCCGCT,sample,34100,33564,2611,30953,6773,24180,15375,1104,4755,546,20130,2400,2106,1042,4462,4364
TGCGCGTTTTGCCGCT,sample,124621,122407,6384,116023,30154,85869,54039,4323,18383,3196,72422,5928,3256,1403,9002,19509
AGCGTCTTTTGCCGCT,sample,164975,163188,9452,153736,34410,119326,83208,6660,19159,2362,102367,7937,3843,1539,31498,24402
CGGTTGGTTTGCCGCT,sample,132125,131034,5142,125892,22266,103626,73498,6276,15173,1722,88671,6957,3928,2482,15082,15678
ACGCTTAATTGCCGCT,sample,70402,69328,4313,65015,19158,45857,23379,2404,13217,1474,36596,5383,2812,920,7283,11234
GAGATTCTTTGCCGCT,sample,190226,188281,6273,182008,47907,134101,101767,7914,18239,2506,120006,3675,2656,1942,29316,31701
CGCGGTCGTTGCCGCT,sample,118201,116717,4782,111935,21458,90477,71012,5050,10669,1238,81681,2508,2023,1449,22797,14937
AAGTAGAGTTGCCGCT,sample,117133,115668,4725,110943,15431,95512,62687,4403,20585,2447,83272,5390,2716,1654,16133,11700
TCAATCAGTTGCCGCT,sample,124551,122917,5627,117290,24815,92475,65213,4078,15926,2183,81139,5075,2549,1268,22883,17376
TCTAGGTTTTCGACCT,sample,71252,70320,6645,63675,10860,52815,23388,1558,17021,1787,40409,9061,4763,1745,4455,7336
CTGGTCTTTTCGACCT,sample,104280,103006,4831,98175,30779,67396,48694,3563,9968,806,58662,4365,3111,1872,15067,18864
CATAATGGTTCGACCT,sample,35216,34734,1898,32836,12300,20536,14338,1050,2863,421,17201,1864,2112,1425,4892,6643
GGAGAAGCTTCGACCT,sample,67928,67171,3557,63614,17188,46426,28767,2195,10092,1001,38859,4371,3477,1943,6370,10599
GAGCCTCCTTCGACCT,sample,54267,53370,3643,49727,12772,36955,21403,1302,9431,1036,30834,3783,3135,1337,7216,8418
TCGAACGATTCGACCT,sample,59385,58622,3997,54625,16739,37886,21708,1797,9320,1014,31028,4047,3058,1500,5272,10077
CGTCGCCATTCGACCT,sample,86363,85284,3868,81416,18947,62469,45555,3107,9998,966,55553,2843,2739,2058,10536,12674
TGATTCCGTTCGACCT,sample,113161,112025,5423,106602,18064,88538,58849,3944,18291,2245,77140,5209,3680,2207,11308,13271
ATACGTTCTTCGACCT,sample,13221,12933,956,11977,2221,9756,6038,380,2293,239,8331,806,1496,910,1907,1453
CCGTACGCTTCGACCT,sample,74914,73602,6971,66631,15460,51171,26740,2218,13302,1422,40042,7489,4147,1222,9946,9261
TCTCAGGATTCGACCT,sample,39666,39172,3741,35431,6985,28446,14244,817,8366,805,22610,4214,3096,1019,6289,4431
TGGATCAATTCGACCT,sample,104267,103113,6984,96129,21174,74955,44904,3352,16380,1893,61284,8426,4715,1822,15467,13911
GGCAGGTTTTCGACCT,sample,72085,71178,4104,67074,18889,48185,34767,2245,7492,979,42259,2702,2554,1572,12093,12243
GATGCGTTTTCGACCT,sample,54117,53475,2345,51130,9643,41487,25566,2231,10125,1372,35691,2193,2845,2166,5355,6733
TGCGCGTTTTCGACCT,sample,79582,78266,6152,72114,19393,52721,29701,2166,13049,1208,42750,6597,3679,1327,7908,11941
GGCGACGATTCGACCT,sample,46734,45980,4255,41725,7015,34710,18292,1177,9838,1113,28130,4290,2944,1164,6546,4595
TAACGAAGTTCGACCT,sample,22522,22191,1869,20322,3056,17266,8567,716,5048,575,13615,2360,2433,1176,1847,2016
GCGTTACCTTCGACCT,sample,156635,154493,6173,148320,31624,116696,88769,6716,14352,1735,103121,5124,2620,1564,28133,21332
CGTCGAGGTTCGACCT,sample,105738,104164,6690,97474,22344,75130,43783,2707,18797,1968,62580,7875,3966,1143,11819,14447
TTATGACGTTCGACCT,sample,161495,159984,6636,153348,27433,125915,87082,6479,21917,2737,108999,7700,3084,1731,19938,18975
CCTAACTATTCGACCT,sample,138618,137303,4117,133186,28819,104367,76715,6517,14245,1858,90960,5032,3106,1827,15829,20038
ATATGCAATTCGACCT,sample,24693,24474,1563,22911,3937,18974,11912,779,4082,461,15994,1740,1847,983,3600,2654
AACCGGTTTCCAGACT,sample,37616,37149,1966,35183,13359,21824,13458,1245,4959,607,18417,1555,1826,1116,2852,7191
TCTAGGTTTCCAGACT,sample,78397,77842,2715,75127,19291,55836,36135,2760,12232,1691,48367,3018,2697,2008,8226,12222
AGAGTTCTTCCAGACT,sample,119463,118608,3494,115114,23852,91262,73708,5076,9151,955,82859,2372,2809,2657,13200,16281
CATAATGGTCCAGACT,sample,87361,86447,3098,83349,25959,57390,43644,3450,7235,536,50879,2525,2376,1483,14548,15971
CATACTCCTCCAGACT,sample,92728,91672,5038,86634,19404,67230,43106,3260,13251,1754,56357,5859,3808,1607,15149,13230
CTAGCGACTCCAGACT,sample,63173,62418,3177,59241,11492,47749,27881,1648,12926,1764,40807,3530,2838,1471,9483,7964
TCGAACGATCCAGACT,sample,53960,53223,1769,51454,14220,37234,28659,1776,5081,605,33740,1113,1534,1404,10670,9181
GGTAGAGATCCAGACT,sample,49287,48704,2862,45842,10648,35194,19284,1235,10087,1259,29371,3329,2609,1286,4986,7014
CGTCGCCATCCAGACT,sample,73861,73055,3316,69739,14011,55728,36908,1918,12257,1526,49165,3119,2213,1316,13894,9841
TCATCGAATCCAGACT,sample,76367,75675,3485,72190,18212,53978,37117,2669,9728,1139,46845,3325,2565,1458,13697,12209
TCATACCATCCAGACT,sample,45984,45355,3079,42276,10527,31749,18911,1223,7323,793,26234,3499,2648,1125,6418,6578
ATTCAAGGTCCAGACT,sample,66422,65773,2678,63095,20022,43073,32065,1918,6553,571,38618,1966,2158,1620,12012,12525
TGATTCCGTCCAGACT,sample,45194,44624,2452,42172,12083,30089,18882,1442,7128,921,26010,1716,1887,1226,6366,7808
CCGTACGCTCCAGACT,sample,56191,55346,2331,53015,12130,40885,28981,1871,6929,891,35910,2213,2068,1376,12025,8238
TGGATCAATCCAGACT,sample,65304,64729,2481,62248,11618,50630,34440,2809,9731,964,44171,2686,2721,2076,8403,8303
TGCGCGTTTCCAGACT,sample,30200,29684,1928,27756,5228,22528,12944,859,6239,771,19183,1715,1911,1023,4377,3651
AGCGTCTTTCCAGACT,sample,25899,25393,2153,23240,4602,18638,8823,707,6138,680,14961,2290,2115,1002,2431,2939
TAGCGAGTTCCAGACT,sample,37574,36904,2609,34295,7729,26566,16528,1218,6373,721,22901,1726,2019,1199,5283,5105
GCTCTTCTTCCAGACT,sample,22773,22202,2756,19446,3626,15820,5251,389,6537,880,11788,2763,2721,811,1145,2382
CTAAGCATTCCAGACT,sample,25968,25270,3008,22262,6382,15880,6776,547,5230,497,12006,2830,2192,739,2016,3601
CTAACCGGTCCAGACT,sample,7272,7066,450,6616,1691,4925,3583,215,829,69,4412,229,1038,751,1181,1083
AGCAGAGCTCCAGACT,sample,5661,5482,948,4534,784,3750,1324,58,1353,134,2677,881,1034,353,393,453
TGCGCTCCTCCAGACT,Pos_Ctrl,16625,16250,1435,14815,727,14088,11628,1065,974,135,12602,286,3043,2691,1090,314
GCGTTACCTCCAGACT,sample,86363,84903,3444,81459,18837,62622,48068,2842,8760,1282,56828,1670,1483,1169,18698,12906
GGCGTACCTCCAGACT,sample,76189,74891,4605,70286,12046,58240,36361,3108,12343,1701,48704,4727,2439,1130,11104,8118
CGTCGAGGTCCAGACT,Pos_Ctrl,32351,31688,2379,29309,1225,28084,23705,2141,1547,185,25252,506,4390,4609,1602,404
AAGTAGAGTCCAGACT,sample,78163,77154,3621,73533,10725,62808,41422,1967,13507,1561,54929,4351,2847,1452,12973,7844
AGATACTATCCAGACT,sample,78919,77587,7046,70541,11647,58894,32236,2368,15141,1647,47377,7502,3605,1223,10378,7526
TTAACTGATCCAGACT,sample,92313,91193,5682,85511,14839,70672,42736,3032,15934,1503,58670,7467,3417,1396,11487,10021
AACCGGTTACCATTAT,sample,111609,110360,4672,105688,36545,69143,49433,3132,11947,1276,61380,3355,2484,1464,16518,21676
AGCTGAATACCATTAT,sample,140845,139124,9353,129771,25401,104370,57639,3852,27609,3619,85248,11651,5164,2051,17371,17012
CATACTCCACCATTAT,sample,106300,104847,4112,100735,19282,81453,50299,2845,20239,3178,70538,4892,2959,1834,12710,13342
GGTAGAGAACCATTAT,sample,90019,89011,5076,83935,22106,61829,40564,2760,12203,1338,52767,4964,3739,1704,14552,14338
TCATCGAAACCATTAT,sample,113084,112306,4466,107840,25625,82215,63073,5236,9006,1223,72079,3677,3618,2530,18114,16459
ATTCAAGGACCATTAT,sample,165876,164374,8052,156322,45086,111236,81688,6849,14324,1468,96012,6907,3320,1910,26438,28031
TGATTCCGACCATTAT,sample,31290,30800,1714,29086,9937,19149,14177,988,2714,395,16891,875,1676,1232,5131,5869
TACGCGAGACCATTAT,sample,151369,149060,7883,141177,26297,114880,67094,4866,25228,2668,92322,15024,5517,1756,12982,18013
ATACGTTCACCATTAT,sample,46324,45494,4782,40712,9078,31634,14072,1011,9774,998,23846,5779,3438,943,4821,5535
CCGTACGCACCATTAT,sample,97673,96407,3299,93108,23529,69579,51020,3859,11267,1109,62287,2324,2233,1966,12449,15676
TGGATCAAACCATTAT,sample,160182,158234,10546,147688,23676,124012,66920,4352,35075,3563,101995,14102,5291,1881,18958,15451
TGCGCGTTACCATTAT,sample,104403,103146,4174,98972,22178,76794,53055,3217,13172,1212,66227,6138,3686,2045,16991,14667
CATTCGGTACCATTAT,sample,117683,116010,5931,110079,25235,84844,58260,3756,16985,1618,75245,4225,3063,1720,16201,16434
CTAAGCATACCATTAT,sample,81099,79988,4053,75935,13005,62930,33688,2034,19222,2596,52910,5390,2637,1516,8854,9187
TAACGAAGACCATTAT,sample,113060,111503,3813,107690,19096,88594,57964,4109,18721,2203,76685,5597,2413,1556,12785,12810
GCTGCTTCACCATTAT,sample,129673,127910,4905,123005,21551,101454,67908,5151,19500,2972,87408,5923,2801,1946,12454,15197
GCCTATTCACCATTAT,sample,83852,82553,4467,78086,13219,64867,32506,2382,21099,2722,53605,6158,3186,1403,6975,9217
TGCGCTCCACCATTAT,sample,138716,137046,4456,132590,32812,99778,81732,5534,9918,1140,91650,1454,1434,1395,24479,23188
GCGTTACCACCATTAT,sample,170089,168264,7150,161114,25915,135199,84672,5879,29643,4068,114315,10937,4402,2133,20229,18414
GTCGCGAAACCATTAT,sample,173650,171700,9603,162097,30595,131502,91027,6722,22873,2411,113900,8469,3583,1909,20525,20606
CGTCGAGGACCATTAT,sample,79694,78550,4435,74115,15591,58524,32500,2712,15212,1904,47712,6196,3337,1568,6517,10727
CAGCTTCGACCATTAT,sample,128999,127172,6445,120727,23069,97658,61434,3334,21157,3075,82591,8658,3335,1313,24311,15361
TTATGACGACCATTAT,sample,133482,131525,8015,123510,21623,101887,64598,4932,21522,2233,86120,8602,3905,1422,23941,14773
TCAATCAGACCATTAT,sample,90684,89408,2970,86438,21765,64673,50737,3959,7363,831,58100,1783,1565,1478,15268,14499
GACTAACCACCATTAT,sample,132293,129770,12388,117382,22552,94830,45146,3137,26345,2382,71491,17820,6410,1483,13720,14907
GCGCAATAACCATTAT,sample,141819,140293,4160,136133,29676,106457,75244,8060,17186,2045,92430,3922,2740,1702,14470,19449
TTAACTGAACCATTAT,sample,103805,102325,6313,96012,19459,76553,44786,3359,18845,1653,63631,7910,3520,1273,6317,13664
AACCGGTTCAATGGAT,sample,136165,134756,10888,123868,26001,97867,43621,3473,31190,3326,74811,16257,6154,1794,10458,16108
CTGGTCTTCAATGGAT,sample,106984,105688,7775,97913,15112,82801,41807,3114,25170,3131,66977,9579,4172,1833,12715,10184
GTCGTTCTCAATGGAT,sample,82851,81614,3939,77675,29283,48392,36041,2553,6553,621,42594,2624,2408,1625,14180,16598
GACGTATGCAATGGAT,sample,104355,102807,9785,93022,20915,72107,34161,2383,20860,2359,55021,12344,6063,1653,11303,12856
GGAGAAGCCAATGGAT,sample,114364,113127,6413,106714,24249,82465,54759,3602,15211,1557,69970,7336,4351,2088,15772,16641
GAGCCTCCCAATGGAT,sample,17489,17070,1952,15118,4037,11081,4989,376,3470,378,8459,1868,1851,721,1883,2304
CATACTCCCAATGGAT,sample,139082,137286,6459,130827,29370,101457,76484,6196,12478,1804,88962,4495,2902,1751,26193,20382
TCATACCACAATGGAT,sample,110407,109034,5507,103527,24070,79457,50713,3849,17193,2277,67906,5425,3026,1500,16126,16129
GCAACTAGCAATGGAT,sample,41444,40509,1734,38775,7381,31394,23130,1579,4838,652,27968,1195,2142,1769,5584,5286
GACTCAAGCAATGGAT,sample,75772,74682,6532,68150,17135,51015,27974,2277,13278,1378,41252,6108,3938,1362,11483,10932
GGCAGGTTCAATGGAT,sample,105590,104189,6575,97614,14621,82993,45102,2529,25200,3323,70302,6839,3752,1832,12550,10365
TGCGCGTTCAATGGAT,sample,140101,138530,6374,132156,28889,103267,72188,5988,17436,2443,89624,5212,3439,2000,23774,19662
CGGTTGGTCAATGGAT,sample,83821,82611,6946,75665,14755,60910,29818,2026,18441,1855,48259,8770,4422,1551,9099,9276
GCTCTTCTCAATGGAT,sample,112861,111391,9963,101428,13298,88130,39842,3237,30072,3385,69914,11594,5248,1826,10962,8522
GCCTATTCCAATGGAT,sample,117319,115637,6783,108854,22894,85960,58497,5159,14527,2210,73024,5567,3365,1509,16225,15103
ATACCGCCCAATGGAT,Neg_Ctrl,4936,1889,1051,838,165,673,428,41,152,10,580,42,266,167,116,42
CAGCTTCGCAATGGAT,Neg_Ctrl,4207,1434,810,624,114,510,333,24,101,20,434,32,198,118,107,20
TCTCCTAGCAATGGAT,sample,164179,162441,7470,154971,29816,125155,87569,5651,20827,4009,108396,7099,3427,1741,21002,20037
TCAATCAGCAATGGAT,sample,133254,131656,7905,123751,24007,99744,58733,3104,23921,2452,82654,11534,4710,1567,16869,15350
TAACGCCACAATGGAT,sample,167328,165440,7156,158284,31595,126689,92137,5768,18962,2604,111099,7218,3804,1811,29887,21397
ATTCTACCCAATGGAT,sample,150588,149181,5660,143521,19411,124110,72093,6095,33254,3619,105347,9049,3811,1965,13300,13267
AGATACTACAATGGAT,sample,7257,7002,1327,5675,1949,3726,1038,86,1421,145,2459,1036,934,239,255,955
CCTAACTACAATGGAT,Pos_Ctrl,43103,42377,2247,40130,1515,38615,32436,3217,2015,297,34451,650,4831,5546,1975,436
GCGCAATACAATGGAT,sample,190119,188261,11891,176370,32422,143948,93044,6266,29103,3789,122147,11746,3951,1374,30112,22974
TTAACTGACAATGGAT,sample,201574,200500,4631,195869,33335,162534,137062,12215,10362,482,147424,2413,2099,2236,26766,24493
TCTAGGTTAGATTCAT,sample,116076,115149,4285,110864,28397,82467,56900,4164,14789,1589,71689,5025,2962,1448,19348,18423
GTCGTTCTAGATTCAT,sample,25844,25539,1760,23779,5132,18647,10197,760,5223,555,15420,1912,2149,1007,3952,3266
AGAGTTCTAGATTCAT,sample,86973,85984,4088,81896,24100,57796,34551,2343,14224,1598,48775,5080,2942,1265,6832,14171
GACGTATGAGATTCAT,sample,113768,112740,5687,107053,27201,79852,60307,3923,10492,1071,70799,4059,3071,1754,19246,18613
TATACGGAAGATTCAT,sample,91603,90708,5441,85267,16362,68905,41678,3102,16309,1887,57987,5929,3815,2036,11066,10962
TCGAACGAAGATTCAT,sample,87242,86144,4475,81669,19472,62197,36578,2423,14041,1540,50619,7615,4284,1531,12083,13142
CGTCGCCAAGATTCAT,sample,53259,52593,2568,50025,11051,38974,30485,1844,4266,681,34751,1698,2148,1681,8220,7697
ATTCAAGGAGATTCAT,sample,73693,72773,3033,69740,16780,52960,32303,2382,12684,1930,44987,3661,2589,1449,6062,10941
CCGTACGCAGATTCAT,sample,59734,58887,2338,56549,12039,44510,27901,1725,11259,1510,39160,2115,2205,1521,6373,8158
ATGGCGTTAGATTCAT,sample,11580,11357,1454,9903,2051,7852,3993,353,1978,201,5971,1327,1505,734,1246,1268
TGCGCGTTAGATTCAT,sample,87844,86688,6225,80463,18380,62083,33192,2521,15267,2228,48459,8875,4631,1391,8342,11963
ACGCTTAAAGATTCAT,sample,108326,107200,4228,102972,18398,84574,51494,3586,19907,2815,71401,6772,3072,1662,13743,12855
CATTCGGTAGATTCAT,sample,70294,69182,3073,66109,18007,48102,31336,2427,10404,1045,41740,2890,2199,1189,10470,11159
TAGCGAGTAGATTCAT,sample,51548,50798,2139,48659,12208,36451,25875,2169,5757,845,31632,1805,2421,1817,6407,7949
CTAAGCATAGATTCAT,sample,81636,80505,4896,75609,15266,60343,36537,2133,14090,1751,50627,5832,3335,1433,12147,10095
AAGGTCTGAGATTCAT,sample,23110,22791,1425,21366,4326,17040,11344,916,3252,483,14596,1045,1734,1069,3502,2907
GGCGACGAAGATTCAT,sample,51089,50174,2668,47506,8921,38585,22054,1534,10412,1401,32466,3184,2443,1390,3591,6023
TAACGAAGAGATTCAT,sample,96006,95015,3425,91590,18160,73430,51549,4090,12728,1569,64277,3494,1838,1395,18051,12975
GCCTATTCAGATTCAT,sample,78441,77462,3456,74006,16607,57399,39992,3452,8933,978,48925,4044,3062,1945,10400,11169
TGCGCTCCAGATTCAT,sample,71248,69996,4289,65707,10127,55580,30145,2427,15236,2040,45381,5732,2811,1296,5448,6991
GCGTTACCAGATTCAT,sample,101862,100436,5316,95120,17252,77868,50213,3547,15352,1727,65565,7029,3459,1682,13103,11781
GTCGCGAAAGATTCAT,sample,90085,88628,4309,84319,17058,67261,42898,3452,14211,1286,57109,5414,3090,1388,14218,12086
CGTCGAGGAGATTCAT,sample,26292,25758,2366,23392,4101,19291,10640,909,4687,458,15327,2597,2369,1005,3262,2604
TTATGACGAGATTCAT,sample,79278,78507,3273,75234,14986,60248,45700,4150,7346,747,53046,2305,2560,2019,13425,10513
TCAATCAGAGATTCAT,sample,79277,78358,3437,74921,16263,58658,42865,2505,9235,809,52100,3244,2490,1501,12233,11203
GACTAACCAGATTCAT,sample,45149,43950,3876,40074,8265,31809,15926,1314,8793,958,24719,4818,3124,1024,3016,5350
AGATACTAAGATTCAT,sample,42241,41520,3263,38257,6087,32170,18114,1512,8422,963,26536,3159,2431,1099,5832,3950
TTAACTGAAGATTCAT,sample,19999,19668,1229,18439,2853,15586,10112,675,3342,416,13454,1041,1464,846,3240,2024
TCTAGGTTCAATCTTG,sample,97552,96862,3013,93849,22168,71681,44200,2940,17803,2090,62003,4648,2443,1389,16378,14773
CTAGCGACCAATCTTG,sample,119043,117324,7734,109590,20980,88610,57382,4477,15628,1996,73010,9127,4500,1871,18045,14248
TCATCGAACAATCTTG,sample,104087,103027,4027,99000,21843,77157,56356,4608,10550,1316,66906,4327,3921,2716,9590,14621
TCATACCACAATCTTG,sample,83371,82307,5568,76739,13123,63616,32596,2144,18721,2510,51317,7645,3854,1436,10689,8804
ATTCAAGGCAATCTTG,sample,83720,82911,4854,78057,17313,60744,38733,2398,13150,1884,51883,4579,3089,1411,16086,11498
GCAACTAGCAATCTTG,sample,26253,25371,2801,22570,2518,20052,5942,504,8561,977,14503,4068,3434,914,806,1357
CCGTACGCCAATCTTG,sample,44114,43336,3797,39539,8368,31171,17240,1437,7130,993,24370,4371,2932,1080,6849,5361
ATGGCGTTCAATCTTG,sample,92852,91906,4507,87399,21373,66026,46306,4192,9504,1392,55810,4632,3402,2261,11672,13720
CGGTTGGTCAATCTTG,sample,67051,66145,2955,63190,14121,49069,39053,3217,4665,437,43718,1697,2200,1837,9922,9696
TAGCGAGTCAATCTTG,sample,27026,26454,2481,23973,5102,18871,9711,693,5039,569,14750,2859,2288,790,3296,3277
GCTCTTCTCAATCTTG,sample,37265,36707,2723,33984,5959,28025,15471,1095,7609,980,23080,2870,2846,1496,3413,4086
CTAAGCATCAATCTTG,sample,95584,94532,3923,90609,21196,69413,52390,4664,8573,914,60963,2872,2446,1745,15686,14243
AAGGTCTGCAATCTTG,sample,84823,83906,4297,79609,13287,66322,42471,3501,14022,1439,56493,4889,3091,1629,9159,8853
CCTAGCGGCAATCTTG,sample,32731,32140,1883,30257,7993,22264,13560,1005,5186,530,18746,1983,2061,968,4895,5149
GCTGCTTCCAATCTTG,sample,106177,105010,7259,97751,17539,80212,44983,3484,17297,2117,62280,12331,6149,2436,9849,11534
ATACCGCCCAATCTTG,sample,100164,98736,6329,92407,15191,77216,47010,3517,17775,2026,64785,6888,3802,1654,14129,10455
GCGTTACCCAATCTTG,sample,121333,119458,16862,102596,12740,89856,30992,2077,31242,3544,62234,22001,7850,1771,7824,6936
GGCGTACCCAATCTTG,sample,35671,35039,3494,31545,5426,26119,13443,951,7241,845,20684,3639,2834,1117,4393,3575
ATGAATAGCAATCTTG,sample,78758,77483,3594,73889,13211,60678,35363,2791,16530,1735,51893,4259,2510,1341,9205,9034
CGCGAGACCAATCTTG,sample,92094,90576,3720,86856,14521,72335,50258,3106,13374,1565,63632,4032,2433,1367,15086,10365
GCGCAATACAATCTTG,Neg_Ctrl,3581,1287,854,433,88,345,214,6,74,14,288,37,143,86,70,16
CATAATGGCGTTCCGA,sample,86546,85399,4031,81368,17741,63627,43957,3362,10541,1119,54498,4648,3145,1913,8924,11860
CTAGCGACCGTTCCGA,sample,75927,74504,7430,67074,12166,54908,23304,1478,18048,2118,41352,9960,5062,1503,4343,7648
CGTCGCCACGTTCCGA,sample,75280,74268,3215,71053,21020,50033,35291,3447,7714,920,43005,2661,2827,1999,10047,13078
TCATACCACGTTCCGA,sample,68169,67255,2625,64630,12198,52432,31788,2452,13343,1734,45131,3115,2620,1951,7041,8153
ATTCAAGGCGTTCCGA,sample,81540,80538,4963,75575,18783,56792,37246,2118,11757,1505,49003,4166,3299,1604,11600,12198
GCAACTAGCGTTCCGA,sample,29001,28364,1350,27014,5774,21240,13161,1231,5044,725,18205,1079,1980,1555,2914,3838
TACGCGAGCGTTCCGA,sample,85253,84157,3460,80697,14008,66689,42517,2978,14349,1821,56866,5024,2766,1707,10667,9976
GACTCAAGCGTTCCGA,sample,92373,91128,7189,83939,17951,65988,35358,2094,17086,2427,52444,9023,4207,1497,12450,11264
ATACGTTCCGTTCCGA,sample,79161,77808,3204,74604,15169,59435,36208,2578,15615,1762,51823,3272,2252,1353,6953,10383
GGCAGGTTCGTTCCGA,sample,98257,96913,4508,92405,26294,66111,47573,2238,11424,810,58997,4066,2996,1239,20179,16772
ATGGCGTTCGTTCCGA,sample,134034,132705,7775,124930,19492,105438,63713,4474,25641,2635,89354,8975,4727,2148,16216,13074
CCATTCTTCGTTCCGA,sample,121203,119639,6358,113281,18735,94546,69108,4696,13313,1297,82421,6132,4079,2307,11271,13170
CGGTTGGTCGTTCCGA,sample,79468,78581,3429,75152,17474,57678,35104,2495,13970,1559,49074,4550,3247,1746,10264,11402
TAACGAAGCGTTCCGA,sample,20531,20155,2269,17886,2678,15208,8000,634,4049,417,12049,2108,1943,746,2777,1543
GCCTATTCCGTTCCGA,sample,142031,140492,11215,129277,19970,109307,58526,4711,28750,3212,87276,14108,5833,1712,15778,13062
GCGTTACCCGTTCCGA,sample,58378,57456,3148,54308,6863,47445,22978,2028,16024,2072,39002,4343,2995,1539,1930,4905
GTCGCGAACGTTCCGA,sample,86567,85212,8105,77107,6801,70306,27266,1980,25231,2980,52497,12849,6239,1891,2430,3944
CGCGGTCGCGTTCCGA,sample,36383,35845,2225,33620,5672,27948,15653,1070,7445,1107,23098,2673,2377,1114,4911,3881
TTATGACGCGTTCCGA,sample,96637,95779,3612,92167,22552,69615,54786,4332,7627,959,62413,1911,2682,2494,10480,15496
TCTCCTAGCGTTCCGA,sample,140708,139288,8201,131087,26244,104843,65573,5138,21975,2792,87548,9365,4874,2018,16106,17802
TCAATCAGCGTTCCGA,sample,90233,89139,4016,85123,12500,72623,45165,4229,16388,2128,61553,4713,3119,1633,6438,8620
GCGCAATACGTTCCGA,sample,141656,140483,6608,133875,28906,104969,71765,5065,18544,2652,90309,6943,3428,1515,19207,19419
CTGGTCTTCAATTCGG,Pos_Ctrl,127518,125423,7587,117836,4732,113104,95116,8896,6322,736,101438,2034,6959,9462,7236,1719
GTCGTTCTCAATTCGG,sample,140728,138388,6448,131940,32097,99843,64408,4162,21055,2261,85463,7957,3894,1573,20711,21006
GGAGAAGCCAATTCGG,sample,63002,62129,3918,58211,12210,46001,30288,1913,8866,1163,39154,3771,3016,1486,9769,8312
CATACTCCCAATTCGG,Pos_Ctrl,60116,58950,3654,55296,2454,52842,44676,4009,2875,418,47551,864,5751,6784,3844,961
TACGCGAGCAATTCGG,sample,121854,120504,10052,110452,14808,95644,30105,2245,34760,3901,64865,24633,8249,1856,8565,9401
GACTCAAGCAATTCGG,Pos_Ctrl,42792,42080,2726,39354,1599,37755,31623,2826,2235,323,33858,748,5042,5466,2590,528
ATGGCGTTCAATTCGG,Pos_Ctrl,38610,38235,1906,36329,1448,34881,29652,2722,1714,208,31366,585,4649,5183,2069,537
GAGATTCTCAATTCGG,Pos_Ctrl,66859,66009,3705,62304,2420,59884,50142,4967,3355,352,53497,1068,5806,7118,3687,730
CCTAGCGGCAATTCGG,sample,98317,97088,3328,93760,24685,69075,52304,3856,9098,944,61402,2873,2503,1799,14964,15673
CTAACCGGCAATTCGG,sample,143164,141695,5353,136342,32811,103531,74474,6358,15145,1438,89619,6116,3701,2023,19459,20882
AGCAGAGCCAATTCGG,Pos_Ctrl,28285,28086,1276,26810,1129,25681,21807,2212,1116,163,22923,383,4144,4577,1588,405
CGTCGAGGCAATTCGG,Pos_Ctrl,20670,20301,1300,19001,867,18134,15304,1407,973,156,16277,294,3545,3327,1673,413
CAGCTTCGCAATTCGG,sample,43615,43189,1574,41615,7085,34530,21004,2005,7985,650,28989,2886,2663,1525,3638,4416
TTATGACGCAATTCGG,sample,74061,73173,3657,69516,14708,54808,35080,4009,10253,868,45333,4598,2637,1133,11247,9481
TCTCCTAGCAATTCGG,sample,134997,133547,4263,129284,27976,101308,65563,6416,19937,2710,85500,6682,3105,1668,13902,18184
ATGAATAGCAATTCGG,sample,78989,77996,2851,75145,19273,55872,33139,3114,13380,1997,46519,4242,2789,1400,7407,11788
AAGTAGAGCAATTCGG,sample,137809,136311,5554,130757,30298,100459,71762,5832,14862,1924,86624,6079,2730,1602,14865,20182
GTCGTTCTAACTCCGG,sample,65162,64417,2004,62413,19135,43278,30156,3049,7014,593,37170,2466,2752,1924,7222,11460
AGAGTTCTAACTCCGG,sample,101567,100529,9790,90739,17301,73438,35514,2389,21127,2003,56641,12405,5569,1455,13903,11419
GAGCCTCCAACTCCGG,sample,138005,136494,5622,130872,31117,99755,76513,5484,12968,1345,89481,3445,2380,1689,24594,21217
GGTAGAGAAACTCCGG,sample,100107,98963,5213,93750,21917,71833,45819,3534,15180,1797,60999,5503,3592,1882,13905,14574
TCATACCAAACTCCGG,sample,105694,104522,6593,97929,24553,73376,51171,3306,12579,1539,63750,4781,3225,1416,19143,16282
CCGTACGCAACTCCGG,sample,72610,71596,3679,67917,19243,48674,33274,1918,9256,1077,42530,3149,2614,1437,12989,12153
GATGCGTTAACTCCGG,sample,135354,134099,4890,129209,37654,91555,68455,4244,13474,1715,81929,3667,2726,1658,25342,24738
ATGGCGTTAACTCCGG,sample,150453,148477,6865,141612,33394,108218,65516,4109,23481,2433,88997,12679,4389,1254,27088,21870
CCATTCTTAACTCCGG,sample,208301,205882,9581,196301,29896,166405,109377,9208,33216,3262,142593,11342,4472,1996,24625,21166
CGGTTGGTAACTCCGG,sample,71832,70667,5419,65248,12106,53142,22880,1242,18728,2336,41608,7956,4071,1204,3371,7136
ACGCTTAAAACTCCGG,sample,96230,95007,3543,91464,15223,76241,52803,4682,13929,1325,66732,3502,2822,1990,10081,10460
CATTCGGTAACTCCGG,sample,134510,133078,4904,128174,25805,102369,78518,5950,12506,1984,91024,3411,2534,1874,19458,18201
CCTAGCGGAACTCCGG,sample,60876,59628,2999,56629,10697,45932,26192,1676,12729,1810,38921,3525,2160,1152,3934,6931
CTAACCGGAACTCCGG,sample,115653,113953,5498,108455,20225,88230,56497,4784,18925,2040,75422,5984,3041,1454,15600,13393
GGCGACGAAACTCCGG,sample,71704,70643,3862,66781,14724,52057,33552,2804,10295,1184,43847,4222,2926,1308,13259,10109
GCCTATTCAACTCCGG,sample,98354,97029,4536,92493,18391,74102,54692,3977,10740,1598,65432,3095,2561,1517,18640,12701
GGCGTACCAACTCCGG,sample,6824,6630,623,6007,1522,4485,2620,162,1105,120,3725,478,1035,524,1059,983
CGTCGAGGAACTCCGG,sample,95495,93999,4422,89577,18579,70998,52084,3728,10419,1310,62503,3457,2951,1691,13608,13028
CGCGAGACAACTCCGG,sample,113252,111630,4907,106723,14902,91821,57615,4148,21707,1742,79322,6609,2667,1311,12063,10320
GCGCAATAAACTCCGG,sample,112659,111121,7262,103859,19811,84048,55124,3490,16045,1904,71169,7485,3117,1263,16200,13481
GTCGTTCTCCTGAAGG,Neg_Ctrl,3839,1420,932,488,118,370,231,19,81,14,312,25,149,76,64,15
AGAGTTCTCCTGAAGG,sample,66655,65160,5758,59402,14805,44597,23646,1672,12469,1521,36115,5289,3301,1253,4210,8950
AGCTGAATCCTGAAGG,sample,120557,118468,12103,106365,23438,82927,52295,3524,16473,1713,68768,8922,3661,1496,19230,15921
GGAGAAGCCCTGAAGG,sample,52009,50987,4342,46645,11731,34914,22427,1314,6714,636,29141,3823,2809,1474,8198,7276
CTAGCGACCCTGAAGG,Neg_Ctrl,3090,1286,831,455,101,354,233,20,61,8,294,32,143,78,71,27
GGTAGAGACCTGAAGG,sample,27200,26438,3570,22868,4817,18051,6119,484,6695,581,12814,4172,3020,968,1180,2608
TCATCGAACCTGAAGG,sample,67156,65962,4708,61254,12927,48327,28852,2321,10228,1387,39080,5539,3260,1556,5550,8897
TACGCGAGCCTGAAGG,sample,39155,38455,2792,35663,6726,28937,18389,1146,5949,754,24338,2699,2474,1167,7205,4560
GACTCAAGCCTGAAGG,sample,76721,75587,4153,71434,15000,56434,40125,3169,8004,1245,48129,3891,3175,1800,10078,10011
ATACGTTCCCTGAAGG,Neg_Ctrl,3003,1231,831,400,81,319,187,9,84,3,271,36,134,64,65,15
TGGATCAACCTGAAGG,sample,50642,49825,2630,47195,13538,33657,24774,1629,5190,573,29964,1491,2051,1575,8867,8633
ATGGCGTTCCTGAAGG,sample,47647,46922,4499,42423,8100,34323,16791,1457,10018,1169,26809,4888,3296,1178,6746,5313
TGCGCGTTCCTGAAGG,Neg_Ctrl,2801,1159,811,348,72,276,160,14,69,3,229,30,112,62,31,12
CCATTCTTCCTGAAGG,sample,58321,57271,2939,54332,15808,38524,31062,1858,4075,616,35137,913,1605,1429,11765,10097
AGCGTCTTCCTGAAGG,sample,46724,45821,3093,42728,9450,33278,25515,1286,4259,620,29774,1598,2269,1670,5818,6609
TAGCGAGTCCTGAAGG,sample,120156,117947,4918,113029,27658,85371,68143,3522,10270,1461,78413,1975,1325,1106,28946,19234
GCTCTTCTCCTGAAGG,sample,123366,121492,5869,115623,21292,94331,59499,3818,21733,2805,81232,6476,3069,1681,18124,14781
CTAAGCATCCTGAAGG,Neg_Ctrl,3689,1515,1105,410,86,324,216,9,57,11,273,31,115,58,71,16
TGCGCTCCCCTGAAGG,Neg_Ctrl,2545,1484,1075,409,78,331,183,16,81,7,264,44,125,65,52,78
CAGCTTCGCCTGAAGG,Neg_Ctrl,3201,1215,814,401,81,320,173,18,72,14,245,43,121,67,39,13
TAACGCCACCTGAAGG,sample,81863,80366,6388,73978,13145,60833,35932,2730,14551,1785,50483,5835,3855,1350,10671,9027
ATTCTACCCCTGAAGG,sample,94671,93106,5423,87683,19436,68247,44992,3286,13204,914,58196,5851,3606,1506,12908,12987
CGTAGAACCCTGAAGG,sample,120704,119085,8707,110378,12838,97540,49038,2921,31447,3807,80485,10327,5428,1666,11495,8934
AGATACTACCTGAAGG,sample,47388,46464,6102,40362,3443,36919,12866,1028,13806,1395,26672,7824,4064,1200,863,1827
CCTAACTACCTGAAGG,sample,93001,91987,3498,88489,16499,71990,53355,3938,9696,1270,63051,3731,3229,2138,12808,11403
GCGCAATACCTGAAGG,sample,31951,31215,2259,28956,5938,23018,13856,1409,5220,487,19076,2046,1912,927,3549,3825
TTAACTGACCTGAAGG,sample,71393,70556,3466,67090,10814,56276,31710,2563,14503,1698,46213,5802,2873,1200,6525,7253
GACGTATGAATATTCG,sample,69395,68142,3595,64547,14344,50203,26732,1850,15199,1612,41931,4810,3261,1364,6852,9212
CATACTCCAATATTCG,sample,83052,82042,3096,78946,17862,61084,40235,2752,13821,1624,54056,2652,2545,1844,11080,11783
CTAGCGACAATATTCG,sample,86294,85135,9921,75214,11167,64047,21840,1398,24960,2962,46800,12887,6178,1551,6708,6910
TCGAACGAAATATTCG,sample,64687,63874,3295,60579,17242,43337,28481,2271,8452,1262,36933,2871,2988,1648,9792,10513
GGTAGAGAAATATTCG,sample,128421,126894,5815,121079,28492,92587,59531,3936,17988,2960,77519,8172,3674,1514,25374,19211
CGTCGCCAAATATTCG,sample,98819,97786,3671,94115,23995,70120,54039,3580,8081,1163,62120,3257,3196,2424,13265,15826
GACTCAAGAATATTCG,sample,125488,124098,7021,117077,21290,95787,52981,3229,25385,3107,78366,11085,4185,1436,18072,14559
CCGCAGTCAATATTCG,sample,58384,57626,3617,54009,10946,43063,21249,1492,13452,1545,34701,5325,3274,1527,3267,7273
CCGTACGCAATATTCG,sample,81072,80116,2802,77314,20546,56768,44482,3585,5835,800,50317,2066,2140,1815,12340,13578
TGCGCGTTAATATTCG,sample,127941,126882,4664,122218,25794,96424,73441,5767,12353,1271,85794,3592,2986,2431,16905,18166
ACGCTTAAAATATTCG,sample,66902,66129,3053,63076,14301,48775,38593,3253,4349,542,42942,2038,2902,2691,7517,9798
CATTCGGTAATATTCG,sample,10870,10636,863,9773,3027,6746,3791,316,1707,213,5498,719,1596,943,966,1800
CCTAGCGGAATATTCG,sample,28947,28482,1258,27224,6440,20784,13123,948,4862,635,17985,1216,2002,1464,3491,4372
CTAACCGGAATATTCG,sample,71219,70584,2974,67610,14976,52634,34119,2384,10999,2050,45118,3082,2360,1504,11000,10142
TAACGAAGAATATTCG,sample,80654,79819,3605,76214,18516,57698,37283,2476,12674,1956,49957,3309,2296,1492,11486,12433
GCTGCTTCAATATTCG,sample,56499,55665,4702,50963,11393,39570,19971,1094,11237,1042,31208,6226,4176,1481,6551,7403
ATACCGCCAATATTCG,sample,137786,136514,5230,131284,34223,97061,74139,5792,12115,1326,86254,3689,3040,2355,17487,22110
GCGTTACCAATATTCG,sample,95508,93516,7862,85654,17060,68594,33127,2638,19480,2278,52607,11071,4760,1359,5215,10769
CGCGGTCGAATATTCG,sample,107251,106138,3172,102966,15718,87248,63157,5008,12704,1949,75861,4430,3013,2116,13334,11595
AAGTAGAGAATATTCG,sample,43334,42600,2813,39787,6770,33017,19438,1173,8100,1043,27538,3263,2422,1105,6370,4622
TAACGCCAAATATTCG,sample,138573,136532,8232,128300,20514,107786,56433,3552,31578,4022,88011,12201,4767,1498,16687,14173
ATTCTACCAATATTCG,Pos_Ctrl,53325,52428,3256,49172,1866,47306,39669,3619,2748,348,42417,922,5444,6304,2669,690
GACTAACCAATATTCG,sample,78982,77799,4618,73181,15762,57419,33528,2560,12859,1176,46387,7296,4164,1775,4887,10369
CGCGAGACAATATTCG,sample,105465,103784,8398,95386,15147,80239,37581,3045,23582,2508,61163,13523,5465,1545,8184,10495
CCTAACTAAATATTCG,sample,136439,134886,5753,129133,18492,110641,77125,5491,18103,2416,95228,7506,3949,2053,15337,12546
GCGCAATAAATATTCG,sample,116839,115255,5099,110156,22336,87820,58138,3939,17211,1627,75349,6905,3537,1630,15148,15096
ATATGCAAAATATTCG,sample,146787,145442,4374,141068,23989,117079,78349,5352,24459,3122,102808,5797,2769,1421,24554,17093
AGCTGAATAGTCTCCG,sample,107005,105431,5357,100074,24405,75669,39658,3034,24031,3328,63689,5618,2202,1230,6467,15776
GAGCCTCCAGTCTCCG,sample,105802,104674,4428,100246,29692,70554,49243,3621,12405,1655,61648,3630,2981,1564,17095,18661
CTAGCGACAGTCTCCG,sample,105296,104057,4841,99216,22332,76884,44206,3501,20690,2946,64896,5541,2990,1738,7823,14600
TCGAACGAAGTCTCCG,sample,99579,98602,3741,94861,27869,66992,47265,3346,10359,1380,57624,4642,2627,1208,22298,17866
CGTCGCCAAGTCTCCG,sample,171197,169755,6522,163233,41277,121956,84239,5963,22308,2959,106547,6487,3635,1803,29963,28037
GCAACTAGAGTCTCCG,sample,12339,12145,660,11485,2640,8845,5340,421,2305,281,7645,498,1755,1230,1082,1758
TCTCAGGAAGTCTCCG,sample,154273,153051,4159,148892,38852,110040,83736,6299,15791,1387,99527,2827,2467,1753,28441,25947
TGGATCAAAGTCTCCG,sample,128411,127235,3557,123678,42075,81603,66960,3611,8459,1013,75419,1560,1160,1127,31746,25851
TGCGCGTTAGTCTCCG,sample,104084,102848,6157,96691,29719,66972,37500,2671,17128,2217,54628,7456,3956,1254,15084,18564
CCATTCTTAGTCTCCG,sample,243119,240689,18040,222649,36462,186187,90372,5331,50699,4938,141071,34847,9068,2257,31106,24129
ATACCGCCAGTCTCCG,sample,54356,53801,4944,48857,7947,40910,13936,1141,15146,1735,29082,8952,5294,1650,1936,5297
TTATGACGAGTCTCCG,sample,108181,107460,4559,102901,22981,79920,57687,4540,12358,892,70045,4443,2698,1304,20168,14825
TCTCCTAGAGTCTCCG,sample,158519,157305,6731,150574,30321,120253,82460,5420,20364,2447,102824,9562,4467,1994,25307,21272
AAGTAGAGAGTCTCCG,sample,103118,102071,2933,99138,25273,73865,57262,3490,10310,844,67572,1959,2009,1644,14793,16457
AGCTGAATTGCCTACG,sample,25919,25685,941,24744,7654,17090,12949,1385,1937,218,14886,601,1444,1279,3462,4431
GAGCCTCCTGCCTACG,sample,120306,119099,10545,108554,18659,89895,39699,2340,30416,2880,70115,14560,6551,1900,9972,12747
TCGAACGATGCCTACG,sample,51465,50992,2287,48705,11631,37074,25276,1971,6375,955,31651,2497,2653,1759,8963,7655
GGTAGAGATGCCTACG,sample,74278,73550,2974,70576,18205,52371,40063,3121,6530,880,46593,1777,1984,1675,12653,12081
TACGCGAGTGCCTACG,sample,69908,69272,3198,66074,16256,49818,35353,2991,7822,814,43175,2838,2533,1813,10186,10935
CCGTACGCTGCCTACG,sample,4358,4269,288,3981,961,3020,2044,126,532,76,2576,242,694,482,642,630
TAGCGAGTTGCCTACG,sample,18950,18596,1620,16976,4403,12573,6081,470,3783,436,9864,1803,1736,687,1700,2639
GCTCTTCTTGCCTACG,sample,66245,65487,2925,62562,13997,48565,32069,2528,8903,1102,40972,3963,2568,1647,7174,8960
AAGGTCTGTGCCTACG,sample,35105,34666,2323,32343,6315,26028,15158,955,6749,806,21907,2360,2205,1106,6073,4380
GCGTTACCTGCCTACG,sample,53430,52823,2430,50393,10190,40203,25990,1887,8090,1067,34080,3169,2210,1280,6204,6806
GACTAACCTGCCTACG,Neg_Ctrl,2475,773,571,202,40,162,92,9,39,5,131,17,76,37,30,6
AGATACTATGCCTACG,sample,69114,68250,5044,63206,7877,55329,32469,2314,13548,1315,46017,5683,3368,1600,7118,5223
TCTAGGTTCTTAGTTC,sample,179547,178070,8212,169858,35270,134588,94879,6934,20587,2966,115466,9222,3322,1951,28304,24777
CATAATGGCTTAGTTC,sample,103865,102989,4600,98389,28987,69402,45692,3344,13943,2100,59635,4323,3020,1693,16740,18780
GAGCCTCCCTTAGTTC,sample,145552,143673,8073,135600,30823,104777,61177,4484,23948,2759,85125,12409,5526,1988,10474,20483
TCGAACGACTTAGTTC,sample,101649,100770,3807,96963,20365,76598,47573,3558,18513,1769,66086,5185,3551,2122,12371,13619
TCATACCACTTAGTTC,sample,109589,108439,4663,103776,34403,69373,54674,4902,6613,877,61287,2307,2375,2047,15879,20957
GCAACTAGCTTAGTTC,sample,41972,41020,2843,38177,8267,29910,19486,1459,6639,823,26125,1503,2080,1463,5465,5416
ACGCTTAACTTAGTTC,sample,112208,110701,6944,103757,17952,85805,46905,4289,24261,2565,71166,7785,3806,1899,11098,12570
CATTCGGTCTTAGTTC,sample,175518,173218,6949,166269,27079,139190,102231,6561,22084,1613,124315,6701,2416,1736,26766,18164
TAGCGAGTCTTAGTTC,sample,70631,70110,2550,67560,9864,57696,42104,3320,8548,1017,50652,2707,2926,1876,7103,6888
GAGATTCTCTTAGTTC,sample,85544,84001,4226,79775,14937,64838,36184,2342,18847,2325,55031,5140,2549,1387,6327,10263
AAGGTCTGCTTAGTTC,sample,103130,101875,6587,95288,22186,73102,39483,2545,19688,2082,59171,9304,4589,1478,11637,14613
CCTAGCGGCTTAGTTC,sample,57949,57248,2312,54936,12138,42798,29200,2276,7508,752,36708,3062,3107,2122,6960,8046
CTAACCGGCTTAGTTC,sample,37676,37130,2984,34146,10850,23296,11882,977,6239,553,18121,3645,2982,1209,3822,6434
GCTGCTTCCTTAGTTC,sample,79187,77782,6285,71497,18564,52933,29170,1932,12888,1641,42058,7302,3978,1022,11982,11565
AGCAGAGCCTTAGTTC,sample,41335,40109,5800,34309,4716,29593,8873,706,11856,1553,20729,6605,4156,999,1014,2882
ATACCGCCCTTAGTTC,sample,130213,128502,4931,123571,19972,103599,74681,5882,15278,1694,89959,6064,3206,2287,11871,14928
GGCGTACCCTTAGTTC,sample,150518,148351,14093,134258,18605,115653,55869,3724,30662,3407,86531,21991,8604,2159,10353,11900
GTCGCGAACTTAGTTC,sample,150560,148444,5632,142812,30881,111931,88991,7005,11259,1405,100250,3271,2465,1955,18859,21322
TTATGACGCTTAGTTC,sample,80288,79389,3495,75894,10607,65287,39549,3172,16352,1708,55901,4506,3621,2290,8321,7436
ATTCTACCCTTAGTTC,sample,71944,70655,5242,65413,15478,49935,26077,1676,13617,1336,39694,7229,3763,1363,7007,9542
CGCGAGACCTTAGTTC,sample,33858,33117,3890,29227,3782,25445,11246,788,8057,868,19303,4486,3545,1302,2692,2173
CGTAGAACCTTAGTTC,sample,102940,101425,5040,96385,16093,80292,50012,4740,17064,2311,67076,6165,2686,1516,12743,11594
TTAACTGACTTAGTTC,sample,207052,205092,10757,194335,24581,169754,85033,6721,55725,7523,140758,14752,4444,1966,19080,17552
ATATGCAACTTAGTTC,sample,114415,113209,9628,103581,17275,86306,45048,3564,22272,3016,67320,12406,5667,1499,13482,10883
AACCGGTTCGAGCTTC,sample,192922,191720,5519,186201,52476,133725,104511,7342,15720,2178,120231,3974,2929,2413,33218,33404
GAGCCTCCCGAGCTTC,sample,112574,111504,4971,106533,21729,84804,42687,2920,26937,3306,69624,8954,4956,2052,9140,14391
TCGAACGACGAGCTTC,sample,41575,40772,3752,37020,11165,25855,11468,799,8344,881,19812,4363,3009,914,3751,6559
ATACGTTCCGAGCTTC,sample,103723,102318,4299,98019,21247,76772,47059,3535,19156,1940,66215,5082,2887,1683,13550,14648
TCTCAGGACGAGCTTC,sample,126003,124721,4422,120299,28349,91950,61143,4440,20046,2083,81189,4238,2383,1638,21092,19125
TGGATCAACGAGCTTC,sample,117559,115675,9982,105693,23562,82131,31875,2430,27253,2741,59128,17832,5948,1426,8540,14964
GGCAGGTTCGAGCTTC,sample,145229,143648,6148,137500,34082,103418,73555,5869,15215,1671,88770,7108,2868,1511,22269,22545
TGCGCGTTCGAGCTTC,sample,114208,113025,6382,106643,13542,93101,49327,4368,27019,3089,76346,9298,4571,2645,4747,8993
ACGCTTAACGAGCTTC,sample,85694,84663,4190,80473,16453,64020,34681,2103,19604,2016,54285,5616,3155,1497,9218,10973
TAGCGAGTCGAGCTTC,sample,84825,83574,5561,78013,21287,56726,26473,1591,17004,1984,43477,9674,4899,1470,4587,13285
GCTCTTCTCGAGCTTC,sample,102859,101660,5138,96522,20569,75953,48012,3488,16255,2367,64267,5831,4100,1937,9615,13960
CTAACCGGCGAGCTTC,sample,90380,89227,5544,83683,15585,68098,35388,2654,18523,2097,53911,9436,3644,1478,9949,9050
GGCGACGACGAGCTTC,sample,96056,94913,5431,89482,12207,77275,39865,2823,23839,3240,63704,7508,4213,1908,7671,8693
TAACGAAGCGAGCTTC,sample,109600,108427,5187,103240,24973,78267,52705,3910,14756,1560,67461,5336,3197,1439,19547,16858
ATACCGCCCGAGCTTC,sample,71303,70170,3134,67036,14241,52795,39057,2464,7886,863,46943,2525,2228,1392,7599,9719
CGTCGAGGCGAGCTTC,sample,73682,72466,2705,69761,15470,54291,36262,2804,11571,1007,47833,2647,1837,1352,12413,9918
CGCGGTCGCGAGCTTC,sample,121681,120367,4352,116015,23685,92330,68221,4544,13973,1353,82194,4239,2274,1534,19620,16850
TTATGACGCGAGCTTC,sample,116394,114969,7472,107497,21090,86407,50046,3695,18308,1778,68354,12580,5659,1714,13959,13272
AAGTAGAGCGAGCTTC,sample,161050,159518,8452,151066,29562,121504,72736,5532,26050,2431,98786,14755,6384,2134,20553,18954
GACTAACCCGAGCTTC,sample,111776,110144,3563,106581,17561,89020,56995,3419,21168,2798,78163,4640,2243,1411,12714,12836
TTAACTGACGAGCTTC,sample,92514,91537,3854,87683,8698,78985,44961,4108,19797,2522,64758,7597,3940,1934,3786,6350
AACCGGTTGTAGAATG,sample,118627,117472,4230,113242,20932,92310,62364,3560,19236,2164,81600,4986,2595,1820,14121,15323
CTGGTCTTGTAGAATG,Pos_Ctrl,45544,44771,2675,42096,1830,40266,34027,3096,2184,235,36211,724,5089,5509,3018,507
AGCTGAATGTAGAATG,sample,110330,108364,8100,100264,27023,73241,45354,2901,15148,1911,60502,7927,3226,1117,20473,15658
CTAGCGACGTAGAATG,sample,64007,63213,3448,59765,10595,49170,28128,2211,13775,1555,41903,3501,2959,1687,8065,7454
GGTAGAGAGTAGAATG,sample,77558,76551,3041,73510,14362,59148,33260,2267,16777,2010,50037,4834,2649,1642,4877,10031
ATTCAAGGGTAGAATG,sample,95370,94126,4704,89422,21904,67518,45878,3302,13887,1149,59765,3302,2891,1507,14371,14644
GCAACTAGGTAGAATG,Pos_Ctrl,7942,7841,371,7470,445,7025,5735,630,433,68,6168,159,2299,2223,581,167
CCGCAGTCGTAGAATG,sample,75067,73793,3783,70010,16555,53455,37687,2152,10235,1055,47922,2326,2167,1192,16181,10685
TCTCAGGAGTAGAATG,sample,107175,105846,5086,100760,16875,83885,59125,5054,13388,1660,72513,4658,3334,1987,14885,11777
TGGATCAAGTAGAATG,sample,104254,103110,4617,98493,23989,74504,50702,3215,14398,1751,65100,4438,2977,1565,18417,15906
GGCAGGTTGTAGAATG,sample,68962,67880,5519,62361,7424,54937,18397,1654,22334,2615,40731,9937,3998,1167,1863,4768
ACGCTTAAGTAGAATG,sample,142227,140213,9196,131017,23368,107649,57483,4610,28494,2616,85977,14446,5407,1564,18616,15641
GCTCTTCTGTAGAATG,Pos_Ctrl,49022,48543,2394,46149,1914,44235,37308,3305,2444,265,39752,913,5290,6129,3045,575
GAGATTCTGTAGAATG,sample,67627,66764,2367,64397,9550,54847,30984,1992,15330,2396,46314,4145,2734,1913,3333,6916
GCCTATTCGTAGAATG,sample,108678,106931,5432,101499,22039,79460,48011,4934,15265,1755,63276,9495,3549,1128,13269,14429
GGCGTACCGTAGAATG,sample,78966,77629,4010,73619,12382,61237,40906,2946,12012,1304,52918,4069,3129,1638,6033,8309
CGCGGTCGGTAGAATG,Pos_Ctrl,32452,31977,1841,30136,1153,28983,24511,2232,1540,210,26051,490,4547,4889,1673,411
TTATGACGGTAGAATG,sample,126620,125256,4201,121055,26080,94975,74282,4320,12471,1630,86753,2272,1693,1230,24615,17665
TCTCCTAGGTAGAATG,sample,126298,124862,6576,118286,28503,89783,57547,4578,17765,2005,75312,7888,3575,1322,22611,18809
AAGTAGAGGTAGAATG,sample,141346,139765,5708,134057,25834,108223,81108,5660,14717,2483,95825,4255,2196,1422,22698,19058
AGATACTAGTAGAATG,sample,89003,88051,5282,82769,21247,61522,44749,3985,8564,762,53313,3462,2431,1274,11917,13264
CCTAACTAGTAGAATG,sample,161422,159677,7271,152406,27657,124749,84897,6018,22733,2466,107630,8635,2992,1240,24559,18812
GTCGTTCTCAATAGTC,sample,66715,66111,2781,63330,15928,47402,30564,2224,10261,1303,40825,3050,2386,1342,11358,10926
AGAGTTCTCAATAGTC,sample,79967,79510,1936,77574,26340,51234,42082,3814,3735,522,45817,1081,1942,2109,10796,15467
GACGTATGCAATAGTC,sample,67950,67289,3195,64094,15996,48098,25286,2597,13536,1500,38822,5179,2877,1435,5263,9903
CATAATGGCAATAGTC,sample,57025,56583,2595,53988,14173,39815,24426,1762,9184,1007,33610,3436,3111,1529,7934,8799
GAGCCTCCCAATAGTC,sample,19405,19226,744,18482,7333,11149,7055,527,2359,259,9414,949,1878,1153,2132,3917
GGTAGAGACAATAGTC,sample,94935,93910,2688,91222,26264,64958,50318,3213,8335,1006,58653,2086,2073,1547,14431,16733
TCATCGAACAATAGTC,sample,103029,102011,3875,98136,28997,69139,51223,2378,10968,1176,62191,3394,2599,1411,17506,18155
ATTCAAGGCAATAGTC,sample,108816,107871,3603,104268,23581,80687,57816,4172,13708,1523,71524,3468,2119,1701,16911,16847
CCGTACGCCAATAGTC,sample,81316,80534,3292,77242,16927,60315,42345,3005,9946,1165,52291,3854,3567,2094,11091,11001
TGCGCGTTCAATAGTC,sample,46022,45381,3516,41865,8351,33514,16749,1173,10161,1069,26910,4362,3145,1151,4992,5154
CCATTCTTCAATAGTC,sample,88832,87752,4531,83221,18173,65048,37694,2893,16726,1983,54420,5752,3191,1377,10782,12398
CGGTTGGTCAATAGTC,sample,72168,71469,3370,68099,16407,51692,32345,2314,11054,1597,43399,4382,3261,1661,9321,10819
ACGCTTAACAATAGTC,sample,97078,95612,3904,91708,19485,72223,40442,2709,21180,2648,61622,5244,2557,1401,6302,12537
TAGCGAGTCAATAGTC,sample,152565,150980,5443,145537,35572,109965,77956,6911,16426,2260,94382,6412,3284,1862,20877,23433
GGCGACGACAATAGTC,sample,86346,84977,4201,80776,15560,65216,40699,2701,16042,1819,56741,3955,2753,1586,9067,10878
GCTGCTTCCAATAGTC,sample,118393,117329,4042,113287,24567,88720,71794,5171,7999,1102,79793,2654,2187,1949,14281,17584
AGCAGAGCCAATAGTC,sample,84646,83723,3815,79908,15809,64099,43053,3496,11996,1832,55049,3722,2644,1799,10090,10537
GGCGTACCCAATAGTC,sample,4620,4516,472,4044,948,3096,1701,106,747,98,2448,444,792,436,582,585
GTCGCGAACAATAGTC,sample,22772,22349,2571,19778,4280,15498,8416,695,3893,457,12309,2037,2422,1103,2939,2792
CGCGGTCGCAATAGTC,sample,88374,87089,4243,82846,14348,68498,45561,3706,11766,970,57327,6495,3033,1237,12639,10466
TTATGACGCAATAGTC,sample,154133,152482,8320,144162,22551,121611,80234,5139,23272,2569,103506,10397,4698,1730,22113,15918
TCTCCTAGCAATAGTC,sample,58309,57414,2065,55349,14183,41166,31822,2940,4602,642,36424,1160,1713,1643,5423,9447
TCAATCAGCAATAGTC,sample,55770,54528,4451,50077,10041,40036,20616,1498,11232,956,31848,5734,3292,1019,2764,6413
ATTCTACCCAATAGTC,sample,75732,74228,7775,66453,11280,55173,20774,1168,19774,2039,40548,11418,5459,1243,2218,7514
GCGCAATACAATAGTC,sample,87210,85727,8330,77397,12748,64649,33111,2348,16870,2125,49981,10195,4867,1288,11492,8469
ATATGCAACAATAGTC,sample,4568,4408,323,4085,699,3386,1744,121,989,104,2733,428,842,431,439,423
AACCGGTTCGTTACTC,sample,190421,188843,4558,184285,56507,127778,91213,7650,20336,3534,111549,5045,2928,2207,21086,35305
TCTAGGTTCGTTACTC,sample,32193,31731,1813,29918,7119,22799,12520,800,6579,842,19099,2058,2250,1116,3404,4543
CTGGTCTTCGTTACTC,sample,136331,135219,5462,129757,40284,89473,63120,4294,14907,1414,78027,5738,3610,2204,22984,24936
GTCGTTCTCGTTACTC,Neg_Ctrl,6057,2283,1168,1115,266,849,540,35,179,32,719,63,330,186,158,47
GACGTATGCGTTACTC,sample,54720,54080,2430,51650,19320,32330,21192,1785,6137,851,27329,2365,2260,1131,6819,10222
CATAATGGCGTTACTC,sample,138856,137596,5325,132271,29523,102748,69377,5031,20367,2552,89744,5421,3046,1970,19735,20816
TATACGGACGTTACTC,sample,148154,146450,6205,140245,31570,108675,61561,4932,27869,5010,89430,9303,3622,1581,19598,20463
GAGCCTCCCGTTACTC,sample,2434,2330,165,2165,627,1538,1033,83,255,32,1288,135,480,339,322,374
TCGAACGACGTTACTC,sample,71193,70285,2107,68178,16452,51726,42119,2855,5044,506,47163,1202,2543,2541,9661,11364
CGTCGCCACGTTACTC,sample,113729,112026,4788,107238,30200,77038,59099,3545,10257,1232,69356,2905,2125,1497,21942,19197
TCATCGAACGTTACTC,sample,76634,75549,3040,72509,16360,56149,36519,2323,12417,1626,48936,3264,2565,1725,11256,10713
ATTCAAGGCGTTACTC,sample,14932,14551,1503,13048,3066,9982,5193,325,2972,315,8165,1177,1584,735,1752,1882
GCAACTAGCGTTACTC,sample,26239,25736,1109,24627,5531,19096,11381,1047,4891,610,16272,1167,2596,1953,1560,3597
TACGCGAGCGTTACTC,Neg_Ctrl,3650,1393,770,623,132,491,269,22,153,17,422,30,211,111,73,25
GACTCAAGCGTTACTC,sample,97832,96477,6575,89902,23279,66623,36973,3057,17353,2091,54326,7149,3656,1585,12415,14177
ATACGTTCCGTTACTC,sample,19017,18393,1699,16694,3994,12700,5486,417,4325,541,9811,1931,2015,784,1412,2498
CCGCAGTCCGTTACTC,sample,93293,91889,6161,85728,16245,69483,33024,2297,23486,2881,56510,7795,4034,1805,6317,11006
TGGATCAACGTTACTC,sample,134356,132114,5835,126279,23393,102886,61650,5386,26221,3511,87871,6118,2939,1603,13854,16605
GGCAGGTTCGTTACTC,sample,139539,137470,5102,132368,30375,101993,70388,6113,17743,1932,88131,5817,3172,1795,20546,20051
ATGGCGTTCGTTACTC,sample,85247,84150,2787,81363,17495,63868,38724,3713,16223,1820,54947,3388,2515,1571,10449,11630
CGGTTGGTCGTTACTC,sample,91802,90468,2923,87545,20000,67545,55016,4055,6818,560,61834,1096,1778,1723,17471,14204
CATTCGGTCGTTACTC,sample,96640,95043,9838,85205,13118,72087,28510,2183,22708,2227,51218,16459,5840,1270,10212,8066
GCTCTTCTCGTTACTC,sample,134711,132893,12744,120149,21650,98499,46055,3606,27545,2807,73600,18486,7039,1668,17076,13445
GAGATTCTCGTTACTC,Neg_Ctrl,5187,1936,1099,837,173,664,369,26,151,15,520,103,262,131,84,38
CTAAGCATCGTTACTC,sample,225364,222755,10374,212381,49193,163188,115168,7862,27226,2558,142394,10374,4514,1729,41003,32572
AAGGTCTGCGTTACTC,sample,156316,154039,9098,144941,33489,111452,71179,5737,20749,1846,91928,11941,4713,1636,24564,21409
CCTAGCGGCGTTACTC,sample,146223,144490,12922,131568,20813,110755,47697,3200,35561,4049,83258,20248,7862,1868,13779,12969
TAACGAAGCGTTACTC,sample,137051,135659,7092,128567,27363,101204,68190,4820,19062,2453,87252,6679,3915,1746,24480,18439
GTCGCGAACGTTACTC,sample,134282,132543,8347,124196,20459,103737,57643,4002,26908,3044,84551,12140,4889,2008,11779,13278
CGTCGAGGCGTTACTC,sample,42418,41334,2978,38356,9965,28391,13509,1252,9562,969,23071,3099,2575,992,3315,6121
CAGCTTCGCGTTACTC,sample,219786,217871,13083,204788,41384,163404,101200,6873,31259,3096,132459,20976,6960,2093,35386,26994
TTATGACGCGTTACTC,Neg_Ctrl,4475,1992,913,1079,208,871,546,31,187,20,733,87,340,177,148,59
TCTCCTAGCGTTACTC,sample,125040,123251,7356,115895,21375,94520,55813,3175,23035,2116,78848,10381,4684,1519,18014,14508
AAGTAGAGCGTTACTC,sample,29950,29540,1814,27726,7278,20448,11591,870,5560,600,17151,1827,3022,1754,2227,4633
TAACGCCACGTTACTC,sample,168861,166339,15599,150740,23008,127732,47214,4235,46989,4743,94203,24551,7915,1890,11284,15621
GACTAACCCGTTACTC,sample,105726,103771,7812,95959,18006,77953,42171,2710,21300,2086,63471,9686,4998,1465,14866,11965
CGCGAGACCGTTACTC,sample,23621,23118,1392,21726,4721,17005,10922,783,3211,506,14133,1583,1980,1196,2184,3077
CGTAGAACCGTTACTC,sample,105800,104410,4920,99490,13537,85953,49631,4134,22717,2651,72348,6820,3677,1821,5741,9764
CCTAACTACGTTACTC,sample,37234,36580,2068,34512,8182,26330,14925,888,7018,851,21943,2648,2598,1240,3877,5279
TCTAGGTTTGGACTGC,sample,66824,66238,4362,61876,10727,51149,19927,1925,19196,2261,39123,7840,5007,2019,2174,6490
TCATCGAATGGACTGC,sample,126739,125609,3718,121891,31799,90092,72939,4634,9856,999,82795,1664,1480,1560,26697,21586
TACGCGAGTGGACTGC,sample,84800,83820,8683,75137,12604,62533,27437,1996,17977,2102,45414,13021,6053,1792,9171,7535
GGCAGGTTTGGACTGC,sample,47775,47246,1842,45404,13231,32173,19223,1377,8308,1146,27531,2119,2337,1539,5393,8014
TGCGCGTTTGGACTGC,sample,35857,35203,2455,32748,9323,23425,13099,899,6141,708,19240,2578,2359,1036,3374,5718
AGCGTCTTTGGACTGC,sample,43501,42912,2379,40533,12272,28261,17059,884,6978,921,24037,2419,2409,1310,6249,7429
ACGCTTAATGGACTGC,sample,84946,83967,2685,81282,25039,56243,42281,3756,6567,967,48848,2672,2667,1874,9691,14797
CATTCGGTTGGACTGC,sample,128989,127254,4386,122868,22088,100780,64082,5843,22381,3158,86463,5316,2803,1641,20464,15872
TAGCGAGTTGGACTGC,sample,36958,35631,1760,33871,6083,27788,15816,1424,7653,1053,23469,1842,1971,1193,1862,3895
CTAAGCATTGGACTGC,sample,106062,104648,6188,98460,23392,75068,53555,3768,12077,1031,65632,4637,2893,1414,16668,15816
CTAACCGGTGGACTGC,sample,81836,80703,3320,77383,18252,59131,41779,3084,10668,1628,52447,1972,2022,1298,14715,12506
TGCGCTCCTGGACTGC,sample,26678,26285,1180,25105,7201,17904,12876,895,2967,434,15843,732,1691,1207,4698,4660
ATACCGCCTGGACTGC,sample,36633,36089,1732,34357,10509,23848,17885,1266,3313,411,21198,973,1995,1594,6210,6729
CGTCGAGGTGGACTGC,sample,85694,84494,4294,80200,14907,65293,39486,2464,15290,1919,54776,6134,3320,1322,11600,10427
CAGCTTCGTGGACTGC,sample,55142,54102,5518,48584,8971,39613,18823,1159,11050,1291,29873,7290,4143,1119,5760,5312
TTATGACGTGGACTGC,sample,90297,89205,2369,86836,22971,63865,49418,3875,8091,779,57509,1702,2172,1877,13765,14969
ATGAATAGTGGACTGC,sample,70231,69130,2363,66767,15250,51517,33971,3384,9332,909,43303,3921,3028,1813,6344,9994
GCGCAATATGGACTGC,sample,113488,112105,4777,107328,16981,90347,61947,4727,15285,2151,77232,6237,4107,1944,13230,11763
AACCGGTTCCTTGAGC,sample,103837,102944,5462,97482,25919,71563,48424,3458,13208,1492,61632,4981,3510,1960,15991,16287
GTCGTTCTCCTTGAGC,sample,105588,104217,4381,99836,23569,76267,50263,2897,16214,1961,66477,4932,3217,1594,17897,15680
AGCTGAATCCTTGAGC,sample,116419,115302,6926,108376,21897,86479,52751,4291,19973,2559,72724,6905,4075,2125,15910,15133
TATACGGACCTTGAGC,sample,111065,109916,3733,106183,33568,72615,57448,3454,8023,1119,65471,2571,2368,1541,21223,20782
GAGCCTCCCCTTGAGC,Pos_Ctrl,48672,47993,3255,44738,2135,42603,35937,3393,2300,292,38237,681,5331,6000,2935,754
CATACTCCCCTTGAGC,sample,88898,87772,9635,78137,15628,62509,27949,1640,19214,2210,47163,11496,6015,1478,10988,10238
CGTCGCCACCTTGAGC,sample,128173,126496,8524,117972,31279,86693,47546,3169,21478,2774,69024,11726,5338,1569,18809,18855
GCAACTAGCCTTGAGC,sample,36370,35729,1966,33763,8275,25488,16901,1264,5174,508,22075,1641,2312,1521,4842,5311
CCGCAGTCCCTTGAGC,sample,102540,101194,4346,96848,20286,76562,51730,2882,16171,1949,67901,3830,2265,1568,15475,13459
GGCAGGTTCCTTGAGC,Pos_Ctrl,35736,35179,2580,32599,1561,31038,26119,2475,1621,236,27740,587,4595,4767,2040,574
CGGTTGGTCCTTGAGC,sample,43376,42589,2395,40194,8234,31960,16340,1186,10144,1244,26484,3046,2716,1469,2117,5500
GCTCTTCTCCTTGAGC,sample,93377,92354,3851,88503,26869,61634,43824,2660,9803,1270,53627,4077,3395,2004,13179,16579
GAGATTCTCCTTGAGC,sample,26751,26310,1036,25274,4063,21211,14649,1276,3795,445,18444,1046,2656,2308,1132,2848
CTAAGCATCCTTGAGC,sample,70199,69579,3132,66447,16458,49989,38046,2857,6387,759,44433,1940,2822,2482,9457,10812
GGCGACGACCTTGAGC,sample,62469,61517,4880,56637,13057,43580,26897,2191,9374,923,36271,4195,3044,1554,8647,8402
GCTGCTTCCCTTGAGC,Pos_Ctrl,35781,35207,2536,32671,1489,31182,26194,2380,1800,228,27994,580,4692,4878,2328,586
GCCTATTCCCTTGAGC,sample,54301,53711,1890,51821,17810,34011,25362,1752,4948,695,30310,1254,1974,1480,9625,10410
TGCGCTCCCCTTGAGC,sample,42067,41476,1880,39596,9799,29797,19140,1394,6416,670,25556,2177,2540,1727,4855,6519
ATACCGCCCCTTGAGC,sample,65052,64269,2411,61858,15038,46820,34428,2951,6913,725,41341,1803,2623,2188,7533,9907
GTCGCGAACCTTGAGC,sample,116492,114670,4883,109787,24362,85425,59161,4433,14423,2124,73584,5284,3132,1783,11128,15820
CAGCTTCGCCTTGAGC,sample,75828,74644,2374,72270,15154,57116,41355,3140,8704,1074,50059,2843,2736,2144,6481,9995
CGCGGTCGCCTTGAGC,sample,84612,83559,4127,79432,19358,60074,39278,3488,12034,1103,51312,4171,3218,1594,9567,12945
TTATGACGCCTTGAGC,sample,134014,132649,6942,125707,18711,106996,67896,5089,22320,2377,90216,9314,4584,2152,16554,12914
ATTCTACCCCTTGAGC,sample,119938,118257,7166,111091,20846,90245,59967,4004,16264,1962,76231,8048,4133,1684,17397,14709
CGTAGAACCCTTGAGC,sample,39582,38720,2325,36395,5003,31392,14751,1186,10038,1130,24789,4287,3317,1425,1099,3104
AGATACTACCTTGAGC,sample,86160,84952,4564,80388,12822,67566,39726,3135,18250,1516,57976,4939,2655,1331,11498,9128
CCTAACTACCTTGAGC,Pos_Ctrl,49049,48165,2895,45270,1737,43533,36636,3493,2265,353,38901,786,5158,6024,2320,587
ATATGCAACCTTGAGC,sample,396,379,17,362,72,290,190,18,51,9,241,22,108,79,56,55
AGAGTTCTCGATATCC,sample,95864,94821,3981,90840,28256,62584,45094,3776,9146,1093,54240,3475,2266,1565,8517,17254
GACGTATGCGATATCC,sample,91565,90449,3293,87156,22301,64855,38027,3025,17149,2346,55176,4308,2652,1432,8751,15454
GGAGAAGCCGATATCC,sample,159764,158469,5099,153370,40949,112421,82270,5630,17689,2048,99959,4784,2509,2017,23751,26486
TCGAACGACGATATCC,sample,107188,106389,3740,102649,28989,73660,56679,4674,8969,1089,65648,2249,2555,1982,15792,19181
CGTCGCCACGATATCC,sample,120927,119503,6181,113322,26763,86559,57800,3834,15657,1696,73457,7572,3629,1496,22495,18134
ATACGTTCCGATATCC,sample,50414,49987,2539,47448,12911,34537,21618,1497,7285,791,28903,3346,2886,1536,2748,7974
CCGCAGTCCGATATCC,sample,34364,33945,1251,32694,9278,23416,14645,1248,5726,648,20371,1149,1698,1233,4889,5537
TGGATCAACGATATCC,sample,21796,21481,1541,19940,4264,15676,9812,741,3147,275,12959,1701,1859,1060,2772,2851
ATGGCGTTCGATATCC,sample,68537,67865,4520,63345,14703,48642,33996,2147,8069,908,42065,3522,2873,1611,12203,9577
AGCGTCTTCGATATCC,sample,55830,54928,4612,50316,13651,36665,20133,1252,9479,1327,29612,4474,2842,919,8028,8223
CTAACCGGCGATATCC,sample,44309,43664,1676,41988,9042,32946,17022,1191,10670,1441,27692,2622,2060,1238,2685,6338
GTCGCGAACGATATCC,sample,136224,134874,4251,130623,28863,101760,80973,5877,10632,1074,91605,3204,2380,2004,23931,18988
CAGCTTCGCGATATCC,sample,135091,133444,4445,128999,22840,106159,76762,6106,17173,1397,93935,4721,2526,1813,16909,16093
ATGAATAGCGATATCC,sample,94708,94043,3044,90999,26233,64766,48592,4361,8522,1267,57114,2024,2458,1962,14698,17273
GACTAACCCGATATCC,sample,109158,107833,4337,103496,26490,77006,55453,4592,11995,1671,67448,3295,2319,1385,15210,17880
CGCGAGACCGATATCC,sample,82722,82126,2617,79509,16565,62944,42237,3031,12792,1648,55029,3236,2838,2024,10694,11317
ATATGCAACGATATCC,sample,171,169,7,162,55,107,69,5,22,2,91,9,47,31,33,31
CTGGTCTTATCTGACC,sample,122897,121845,4653,117192,28726,88466,62647,4759,14630,1941,77277,4489,2531,1757,18646,18949
CATACTCCATCTGACC,Neg_Ctrl,3017,1056,604,452,87,365,231,10,75,13,306,36,145,74,69,17
TCGAACGAATCTGACC,sample,71065,70260,2884,67376,12980,54396,35234,2651,12084,1309,47318,3118,2216,1440,12620,9105
TCATCGAAATCTGACC,sample,46564,46008,2166,43842,12806,31036,20218,1650,5897,810,26115,2461,2504,1284,7165,8050
TACGCGAGATCTGACC,sample,57954,57284,3100,54184,10993,43191,22281,1421,13650,1797,35931,4042,2454,1097,6018,7463
CCGCAGTCATCTGACC,sample,102156,101187,4945,96242,20870,75372,51207,4125,13033,1803,64240,5204,3486,1689,14608,13657
CCGTACGCATCTGACC,sample,60027,59110,3531,55579,10368,45211,25952,1632,12013,1289,37965,4325,2727,1231,8401,6876
GATGCGTTATCTGACC,Neg_Ctrl,3014,905,682,223,36,187,124,5,31,6,155,21,83,39,38,10
CCATTCTTATCTGACC,sample,99198,97906,3920,93986,19645,74341,56471,4046,9438,1158,65909,3228,2302,1807,13370,14013
TAGCGAGTATCTGACC,sample,11163,10988,746,10242,1375,8867,3573,277,3620,356,7193,1041,1672,766,700,877
CTAAGCATATCTGACC,sample,49943,49372,1743,47629,9149,38480,23694,1732,9675,1115,33369,2264,2412,1745,4437,6526
AAGGTCTGATCTGACC,sample,44207,43614,2682,40932,11754,29178,19572,1403,5171,712,24743,2320,1980,1094,6577,7492
CCTAGCGGATCTGACC,sample,26790,26447,2083,24364,7197,17167,10898,889,3393,365,14291,1622,1932,1097,3541,4382
GGCGACGAATCTGACC,sample,51351,50437,2669,47768,8057,39711,22292,1399,11457,1072,33749,3491,2334,1023,3409,5619
GCCTATTCATCTGACC,Neg_Ctrl,3400,1063,724,339,88,251,159,11,58,4,217,19,122,58,61,11
AGCAGAGCATCTGACC,sample,109814,108648,6260,102388,18484,83904,58498,3902,14132,1898,72630,5474,3029,1677,16963,12585
GGCGTACCATCTGACC,sample,100466,99508,4690,94818,23331,71487,49077,3639,11895,1285,60972,5591,3355,1479,20014,15512
CAGCTTCGATCTGACC,sample,53483,52374,3343,49031,12252,36779,19454,1291,10237,1618,29691,4179,2781,1047,5034,7855
GCGCAATAATCTGACC,Neg_Ctrl,3451,1153,853,300,80,220,138,12,49,3,187,18,104,60,49,12
TTAACTGAATCTGACC,sample,291,281,22,259,51,208,138,4,50,1,188,15,91,58,48,34
GTCGTTCTCTTCTTAC,sample,93484,92379,3264,89115,17997,71118,51660,3875,11314,1854,62974,2415,2791,2362,8858,11954
GACGTATGCTTCTTAC,sample,76457,75541,5530,70011,18071,51940,28580,2297,13164,1461,41744,6438,4166,1863,6891,10876
GGAGAAGCCTTCTTAC,sample,39431,38816,3169,35647,9309,26338,16264,862,5776,572,22040,2864,2434,999,6138,5612
CATACTCCCTTCTTAC,sample,147207,145713,5026,140687,36327,104360,75381,3298,17293,2413,92674,5975,3409,1514,29543,23491
TCATCGAACTTCTTAC,sample,39373,38988,2253,36735,8296,28439,16564,1206,7315,822,23879,2532,2761,1504,5519,5244
GACTCAAGCTTCTTAC,sample,62983,62081,5251,56830,5080,51750,23132,1716,17710,1723,40842,7469,4870,2300,1491,2680
CCGCAGTCCTTCTTAC,sample,88648,87527,4219,83308,14724,68584,40965,2593,18380,1689,59345,4957,2826,1584,8876,10198
CCGTACGCCTTCTTAC,sample,81345,80340,2652,77688,21245,56443,44944,3319,5765,758,50709,1657,1937,1716,15966,13969
TGGATCAACTTCTTAC,sample,117732,116237,5018,111219,29760,81459,61324,3959,12264,1426,73588,2486,1587,1073,29061,19305
CGGTTGGTCTTCTTAC,sample,106120,105157,5750,99407,23558,75849,49232,3984,14902,1764,64134,5967,4610,2460,13529,14934
CCTAGCGGCTTCTTAC,sample,88152,87275,2966,84309,19963,64346,51911,5315,4959,756,56870,1405,1815,2015,12707,13847
AGCAGAGCCTTCTTAC,sample,56869,55907,2968,52939,13020,39919,28529,1971,6775,630,35304,2014,2339,1681,8492,8534
TGCGCTCCCTTCTTAC,sample,138960,137562,5500,132062,29122,102940,76136,5646,14377,1576,90513,5205,3225,1869,21652,20207
ATACCGCCCTTCTTAC,sample,121832,120313,6795,113518,24830,88688,53167,3941,20132,2454,73299,8994,4519,1553,23318,16824
GGCGTACCCTTCTTAC,sample,95662,94435,3731,90704,20129,70575,50797,3029,11228,1074,62025,4447,2805,1629,11302,13239
ATGAATAGCTTCTTAC,sample,109949,108702,7812,100890,16758,84132,46513,2657,21581,2613,68094,10768,5375,2061,10827,11416
GCGCAATACTTCTTAC,sample,110635,109227,4927,104300,17098,87202,54258,4246,19692,2603,73950,6403,3149,1443,10547,11153
TTAACTGACTTCTTAC,sample,27013,26204,848,25356,5275,20081,11119,1050,5816,754,16935,1342,1501,979,1374,3399
ATATGCAACTTCTTAC,sample,180,173,13,160,26,134,80,4,26,5,106,19,57,36,28,19
AACCGGTTACTTCTAC,sample,76723,76180,1642,74538,18626,55912,39417,3070,9495,1296,48912,2634,1898,1545,11323,12552
CATAATGGACTTCTAC,sample,84690,83902,6208,77694,13132,64562,36009,2796,14730,1756,50739,9271,5262,2290,7744,8386
GGAGAAGCACTTCTAC,sample,57379,56523,2974,53549,10565,42984,23535,1222,13231,1887,36766,3109,1991,1160,4158,7388
GAGCCTCCACTTCTAC,sample,63346,62528,2326,60202,13260,46942,29119,1746,11765,1370,40884,2942,2209,1314,9647,9313
CTAGCGACACTTCTAC,sample,89184,88192,4555,83637,23040,60597,39998,2254,11583,1439,51581,5323,3119,1477,15226,14931
GGTAGAGAACTTCTAC,sample,89886,88772,5887,82885,21250,61635,35986,2620,14755,1765,50741,6509,3797,1441,10650,13417
CGTCGCCAACTTCTAC,sample,67300,66614,2139,64475,17427,47048,32367,3106,8780,1128,41147,1667,2524,1914,9217,11244
ATTCAAGGACTTCTAC,sample,108949,107998,3369,104629,33274,71355,55470,4356,8945,849,64415,1735,1922,1677,20836,21163
TGATTCCGACTTCTAC,sample,49656,49055,2136,46919,14840,32079,20063,1904,7306,751,27369,2055,2249,1421,5147,8831
GACTCAAGACTTCTAC,sample,66381,65477,2659,62818,18389,44429,32160,2035,7020,770,39180,2444,2151,1293,10036,11573
ATACGTTCACTTCTAC,sample,77534,76642,2756,73886,17996,55890,38495,2879,10561,1450,49056,2505,2271,1346,12016,12150
ATGGCGTTACTTCTAC,sample,61446,60518,3203,57315,13926,43389,23810,1973,12270,1319,36080,4017,2460,1343,3929,8933
CCATTCTTACTTCTAC,sample,49008,48268,2104,46164,12140,34024,21510,1535,7535,867,29045,2577,2496,1650,5417,7679
CGGTTGGTACTTCTAC,sample,79916,78995,6589,72406,11291,61115,30225,2079,18104,1858,48329,8849,4920,1608,10244,7119
CTAACCGGACTTCTAC,sample,63287,62495,4665,57830,13473,44357,28645,1949,7919,1098,36564,4746,3034,1184,11049,8410
GCCTATTCACTTCTAC,sample,101049,100032,5275,94757,20924,73833,51865,3292,12264,1528,64129,4884,3038,1704,17264,14198
TGCGCTCCACTTCTAC,sample,91303,90296,3589,86707,20387,66320,49641,3929,9021,1017,58662,2712,2143,1377,16133,13887
GCGTTACCACTTCTAC,sample,132565,131204,5138,126066,27106,98960,73309,5422,13904,1975,87213,4350,3263,1853,18627,17565
TCTCCTAGACTTCTAC,sample,126535,125277,4293,120984,28397,92587,72686,5524,10797,1313,83483,2267,2270,2010,18555,20045
TCAATCAGACTTCTAC,sample,64856,64080,4351,59729,11346,48383,32029,2189,9312,805,41341,4048,2944,1103,14239,7954
GACTAACCACTTCTAC,sample,131681,130248,8188,122060,22070,99990,56621,4215,24777,3383,81398,10994,4874,1401,23063,15688
CGCGAGACACTTCTAC,sample,87997,87138,2814,84324,11166,73158,54210,3915,10317,925,64527,3791,3288,2400,8254,8222
AACCGGTTAGAAGTAA,sample,114444,113449,4420,109029,26923,82106,55822,4284,16222,2014,72044,3764,2816,1514,22587,17685
GTCGTTCTAGAAGTAA,sample,126538,125409,4907,120502,32480,88022,62567,4504,14010,2083,76577,4858,3145,1770,20843,20958
GAGCCTCCAGAAGTAA,sample,86663,85908,3266,82642,16320,66322,40401,2817,16493,2103,56894,4508,2687,1661,12859,11878
TCGAACGAAGAAGTAA,sample,39564,39175,1311,37864,12650,25214,18824,1304,3725,495,22549,866,2331,1919,5822,7712
TCATCGAAAGAAGTAA,sample,94484,93224,4815,88409,24161,64248,38548,2792,15550,2194,54098,5164,2942,1354,10176,15329
GACTCAAGAGAAGTAA,sample,99023,98164,4956,93208,19428,73780,47783,3255,14151,1669,61934,6922,4236,1763,15828,12793
TGGATCAAAGAAGTAA,sample,120938,119477,13917,105560,17585,87975,23555,1129,35289,3961,58844,24041,8403,1607,6022,10768
GGCAGGTTAGAAGTAA,sample,56165,55455,3229,52226,13044,39182,21615,1571,11291,970,32906,3735,3031,1175,8135,8189
GATGCGTTAGAAGTAA,sample,53311,52627,2598,50029,13228,36801,25049,1690,6935,898,31984,2229,2241,1062,11275,8236
CTAAGCATAGAAGTAA,sample,112996,111809,3572,108237,29253,78984,60830,3388,10432,1866,71262,2468,1859,1459,23572,18750
CCTAGCGGAGAAGTAA,sample,45269,44168,3002,41166,8170,32996,16850,1195,9848,971,26698,4132,2784,961,2864,5223
GCTGCTTCAGAAGTAA,sample,149756,148036,4363,143673,34556,109117,77662,7386,17677,1460,95339,4932,3039,1945,22859,22980
GCCTATTCAGAAGTAA,sample,74569,73780,2563,71217,16015,55202,39530,3510,9076,903,48606,2183,2311,1590,11691,10731
TGCGCTCCAGAAGTAA,sample,97258,96506,3032,93474,15716,77758,58882,4288,10084,1136,68966,3368,3650,3079,9165,10940
GCGTTACCAGAAGTAA,sample,172047,170645,7325,163320,30746,132574,87241,6835,24684,2530,111925,11284,5580,2771,18387,21092
TCAATCAGAGAAGTAA,sample,220067,217893,23908,193985,23765,170220,61189,3811,57324,6571,118513,41325,11880,2403,17505,14860
ATTCTACCAGAAGTAA,sample,165267,163385,8752,154633,27384,127249,77858,4502,28821,3404,106679,12664,5520,1798,25834,17738
CCTAACTAAGAAGTAA,sample,148833,147719,10431,137288,22930,114358,52833,3254,34647,4154,87480,19470,6949,1805,15293,14832
Short,Non_sample,0,NA,NA,NA,NA,NA,NA,NA,NA,NA,NA,NA,NA,NA,NA,NA
Unselected,Non_sample,1380388,NA,NA,NA,NA,NA,NA,NA,NA,NA,NA,NA,NA,NA,NA,NA
Undetermined,Non_sample,151772172,NA,NA,NA,NA,NA,NA,NA,NA,NA,NA,NA,NA,NA,NA,NA
