Barcode,Sample,Barcoded_Reads,Trimmed_Reads,Unmapped_Reads,Mapped_Reads,Multimapped_Reads,Uniquely_Mapped_Reads,Exon_Reads,Ambiguous_Exon_Reads,Intron_Reads,Ambiguous_Intron_Reads,Gene_Reads,Intergenic_Reads,No_of_Genes,No_of_Transcripts,Mitochondrial_Reads,Ribosomal_Reads
AACCGGTTCGTTGGTT,sample,129330,128584,9387,119197,10249,108948,43111,2786,39906,4782,83017,18363,7428,2757,7594,5937
TCTAGGTTCGTTGGTT,sample,233533,232271,6370,225901,29739,196162,156190,12461,18683,2020,174873,6808,3451,2718,29259,21597
CATAATGGCGTTGGTT,sample,155917,155125,5217,149908,11959,137949,100780,7036,19738,2157,120518,8238,5575,4751,12108,8042
GGTAGAGACGTTGGTT,sample,342,326,9,317,27,290,191,11,56,4,247,28,118,73,41,11
TGATTCCGCGTTGGTT,sample,146,144,7,137,14,123,86,2,27,0,113,8,59,31,5,10
GACTCAAGCGTTGGTT,sample,287,283,22,261,23,238,157,9,48,2,205,22,112,64,32,16
ATACGTTCCGTTGGTT,sample,205,202,13,189,12,177,104,9,36,2,140,26,64,44,19,10
CCGTACGCCGTTGGTT,sample,246,236,13,223,31,192,134,8,23,2,157,25,77,53,17,17
GGCAGGTTCGTTGGTT,sample,118,117,15,102,9,93,78,0,8,3,86,4,44,30,14,4
GCTCTTCTCGTTGGTT,sample,246,242,17,225,21,204,154,8,17,3,171,22,97,75,37,11
GCTGCTTCCGTTGGTT,sample,238,237,14,223,30,193,133,7,38,2,171,13,72,48,26,25
CGTCGAGGCGTTGGTT,sample,146,144,8,136,8,128,90,3,19,0,109,16,58,35,27,5
TCTCCTAGCGTTGGTT,sample,93,93,9,84,5,79,58,6,7,0,65,8,36,21,14,2
ATGAATAGCGTTGGTT,sample,235,232,19,213,12,201,118,5,32,11,150,35,82,45,19,6
AAGTAGAGCGTTGGTT,sample,225,217,17,200,21,179,133,12,16,2,149,16,71,57,20,9
AACCGGTTCTATCGTT,sample,105849,105307,5014,100293,9574,90719,51852,4352,22297,2389,74149,9829,4898,2409,10257,5815
GTCGTTCTCTATCGTT,sample,4452,4370,846,3524,245,3279,845,39,1352,107,2197,936,902,231,246,139
TCATCGAACTATCGTT,sample,769,753,51,702,85,617,322,30,177,19,499,69,232,127,56,49
TCATACCACTATCGTT,sample,184,174,9,165,11,154,86,6,35,1,121,26,68,40,17,7
ATTCAAGGCTATCGTT,sample,211,205,27,178,11,167,87,5,43,1,130,31,65,35,25,7
GACTCAAGCTATCGTT,sample,246,241,17,224,27,197,128,20,24,3,152,22,69,52,27,16
CCGCAGTCCTATCGTT,sample,208,205,13,192,12,180,108,7,29,8,137,28,71,41,8,3
TGCGCGTTCTATCGTT,sample,38550,38378,5450,32928,3521,29407,16427,1166,5983,655,22410,5176,3539,2069,2829,1882
AGCGTCTTCTATCGTT,sample,88737,88055,8212,79843,8382,71461,31022,2301,19563,2097,50585,16478,6010,1850,8794,5309
GAGATTCTCTATCGTT,sample,4787,4748,339,4409,411,3998,1960,217,1100,116,3060,605,1040,554,424,245
AAGGTCTGCTATCGTT,sample,3093,3018,85,2933,416,2517,2297,125,70,0,2367,25,379,442,645,288
CTAACCGGCTATCGTT,sample,7898,7801,335,7466,447,7019,4397,359,1529,142,5926,592,1463,1007,631,243
TAACGAAGCTATCGTT,sample,10624,10494,905,9589,942,8647,4279,265,2396,317,6675,1390,1618,765,1077,631
AGCAGAGCCTATCGTT,sample,5602,5497,204,5293,640,4653,4199,297,93,22,4292,42,578,682,1211,419
ATACCGCCCTATCGTT,sample,4209,4086,123,3963,489,3474,2968,270,123,27,3091,86,427,477,1000,345
GGCGTACCCTATCGTT,sample,2264,2203,144,2059,115,1944,1003,51,579,63,1582,248,503,252,250,80
GTCGCGAACTATCGTT,sample,2312,2273,165,2108,197,1911,1160,55,369,30,1529,297,569,349,268,135
AAGTAGAGCTATCGTT,sample,2016,1995,272,1723,159,1564,721,49,409,18,1130,367,492,263,150,107
CGCGAGACCTATCGTT,sample,198,194,13,181,28,153,113,7,23,1,136,9,63,35,29,10
TTAACTGACTATCGTT,sample,113,113,8,105,2,103,77,5,13,0,90,8,46,27,4,2
CTGGTCTTGTCTTCTT,Pos_Ctrl,27979,27605,1859,25746,1530,24216,20122,1708,1630,263,21752,493,4028,3981,1903,794
AGAGTTCTGTCTTCTT,sample,56457,56040,4603,51437,5040,46397,25704,1888,12257,1495,37961,5053,4201,2581,4344,3572
CATAATGGGTCTTCTT,sample,78373,77901,2849,75052,11035,64017,49295,3668,5998,557,55293,4499,3197,2070,13369,7931
TATACGGAGTCTTCTT,Pos_Ctrl,23088,22827,1536,21291,1539,19752,16483,1415,1290,152,17773,412,3800,3568,1491,770
GGAGAAGCGTCTTCTT,sample,88536,87973,1531,86442,9890,76552,67625,7115,700,231,68325,881,765,1301,12494,6820
TCATACCAGTCTTCTT,sample,37061,36833,1772,35061,5437,29624,21471,1778,3336,450,24807,2589,2267,1449,6261,3791
ATTCAAGGGTCTTCTT,sample,97389,96712,4348,92364,9365,82999,53899,6419,11361,1224,65260,10096,3971,1340,11601,5494
TGATTCCGGTCTTCTT,sample,7260,7028,187,6841,950,5891,5132,621,85,10,5217,43,443,612,1062,638
CTAAGCATGTCTTCTT,sample,98414,97600,5441,92159,6976,85183,50339,3092,19321,2188,69660,10243,5318,2796,7722,4412
CCTAGCGGGTCTTCTT,sample,41099,40856,1132,39724,5812,33912,27729,2260,1926,192,29655,1805,2329,2125,5905,4262
GGCGACGAGTCTTCTT,sample,73585,73093,2650,70443,8313,62130,50901,3831,4065,344,54966,2989,1937,1605,13651,5809
GCCTATTCGTCTTCTT,sample,50142,49798,4476,45322,3822,41500,19302,1491,10692,1213,29994,8802,5150,2032,4493,2261
AGCAGAGCGTCTTCTT,sample,70843,70323,4056,66267,3886,62381,30991,2057,18816,2341,49807,8176,4819,2181,6683,2482
TTATGACGGTCTTCTT,sample,89144,88577,8148,80429,7106,73323,33674,2825,20791,1905,54465,14128,6279,1772,7920,4406
ATGAATAGGTCTTCTT,sample,73064,72627,3516,69111,7166,61945,41871,3212,8890,953,50761,7019,3825,1365,12196,4621
AGATACTAGTCTTCTT,sample,426,419,33,386,18,368,229,26,84,7,313,22,148,101,49,15
CCTAACTAGTCTTCTT,Pos_Ctrl,404,395,18,377,48,329,231,21,40,9,271,28,129,93,41,24
GCGCAATAGTCTTCTT,sample,174,172,5,167,29,138,90,9,23,1,113,15,74,54,19,15
TCTAGGTTTAGGCTCT,sample,191592,190434,6299,184135,22257,161878,130604,10730,11398,1011,142002,8135,2997,2338,29003,16349
CTGGTCTTTAGGCTCT,sample,104673,103761,11469,92292,7969,84323,48919,2967,19421,2066,68340,10950,6353,3352,17193,4612
GTCGTTCTTAGGCTCT,sample,160113,158825,8232,150593,21997,128596,91857,5904,16290,1764,108147,12781,5512,2727,23847,15470
GACGTATGTAGGCTCT,sample,138889,137857,4067,133790,18844,114946,102755,8068,2480,311,105235,1332,1572,2063,28943,14414
GGAGAAGCTAGGCTCT,sample,101899,100875,9672,91203,10690,80513,36579,2720,22375,2094,58954,16745,7277,2942,7458,6577
GGTAGAGATAGGCTCT,sample,88782,88432,2781,85651,16329,69322,53370,4884,6089,829,59459,4150,4153,3758,11155,11403
TCATACCATAGGCTCT,sample,179412,178567,5433,173134,31770,141364,102554,8573,16206,1438,118760,12593,4224,2025,29683,22406
TGATTCCGTAGGCTCT,sample,147076,146243,7165,139078,15968,123110,68127,5309,30346,2856,98473,16472,5788,2268,21353,10070
TCTCAGGATAGGCTCT,sample,145140,144232,8348,135884,18787,117097,77312,6041,17797,2057,95109,13890,5761,2097,24644,11990
GATGCGTTTAGGCTCT,sample,200201,199101,4349,194752,29107,165645,147119,13053,2896,387,150015,2190,1420,2111,41340,20473
GCTCTTCTTAGGCTCT,sample,183870,182699,3868,178831,20213,158618,127139,9968,13030,1696,140169,6785,2658,1750,33458,14450
AAGGTCTGTAGGCTCT,sample,146352,145360,7278,138082,16864,121218,73345,5160,22303,2378,95648,18032,6637,2247,21933,11091
CCTAGCGGTAGGCTCT,sample,100132,99504,2486,97018,14737,82281,73926,5569,1483,172,75409,1131,1189,1673,20980,10425
CTAACCGGTAGGCTCT,sample,152232,151178,8423,142755,14612,128143,77690,6492,22896,2852,100586,18213,6266,1950,16845,9508
GGCGACGATAGGCTCT,sample,190055,188821,4707,184114,22687,161427,146748,9299,3126,290,149874,1964,2617,3945,28717,17288
GCTGCTTCTAGGCTCT,sample,129756,128807,3358,125449,16382,109067,96192,7246,3202,478,99394,1949,1140,1429,29045,11811
GCCTATTCTAGGCTCT,sample,130039,129143,2966,126177,20365,105812,94937,7308,1819,319,96756,1429,1290,1710,25651,14834
GCGTTACCTAGGCTCT,sample,130572,129501,6422,123079,14333,108746,69134,5060,20334,2201,89468,12017,5387,2208,17643,8623
GTCGCGAATAGGCTCT,sample,153841,152581,7747,144834,10697,134137,88235,6139,23841,2607,112076,13315,4352,2021,16151,7458
AAGTAGAGTAGGCTCT,sample,99398,98592,4739,93853,11013,82840,51192,4784,14790,1588,65982,10486,4202,1538,10736,7107
ATTCTACCTAGGCTCT,sample,140254,139056,9470,129586,9695,119891,60990,5825,28251,2684,89241,22141,7664,1704,16619,5538
CCTAACTATAGGCTCT,sample,2249,2156,118,2038,230,1808,1425,135,136,20,1561,92,484,403,398,171
ATATGCAATAGGCTCT,sample,557,553,36,517,41,476,312,24,76,9,388,55,171,108,71,35
GTCGTTCTTTGACTAT,Neg_Ctrl,1209,739,246,493,59,434,288,16,57,8,345,65,162,106,56,17
GGAGAAGCTTGACTAT,Neg_Ctrl,938,537,257,280,38,242,151,19,50,2,201,20,107,66,23,14
GAGCCTCCTTGACTAT,sample,74782,74235,10237,63998,5182,58816,23746,1386,17071,1982,40817,14631,6153,2072,4029,2770
CATACTCCTTGACTAT,sample,108719,108002,4451,103551,13394,90157,77527,6198,3422,299,80949,2711,2282,2507,19083,9890
TCGAACGATTGACTAT,sample,90975,90484,2154,88330,13761,74569,65471,3831,3190,557,68661,1520,1150,1405,19030,10171
TGATTCCGTTGACTAT,Pos_Ctrl,21281,20939,1803,19136,1124,18012,14898,1317,1243,183,16141,371,3603,3263,1327,601
GATGCGTTTTGACTAT,sample,45257,44922,2747,42175,4309,37866,20910,1825,8230,772,29140,6129,3586,1230,5782,2696
ATGGCGTTTTGACTAT,Pos_Ctrl,17599,17436,1134,16302,1045,15257,12733,1276,793,153,13526,302,3129,3020,957,514
AGCGTCTTTTGACTAT,sample,122155,121139,6950,114189,7556,106633,58735,3997,26771,3177,85506,13953,4841,2012,11674,5416
CGGTTGGTTTGACTAT,sample,75293,74717,2831,71886,7421,64465,47130,4305,7786,882,54916,4362,2182,1405,12594,5028
GAGATTCTTTGACTAT,sample,104406,103461,12164,91297,6606,84691,32911,2002,26323,2694,59234,20761,7104,2137,6440,3252
CCTAGCGGTTGACTAT,Pos_Ctrl,12618,12494,955,11539,614,10925,9087,882,664,94,9751,198,2624,2333,787,370
CTAACCGGTTGACTAT,sample,62961,62486,1640,60846,7694,53152,47244,3531,1400,239,48644,738,1007,1312,11720,5580
GCGTTACCTTGACTAT,sample,112938,111868,7054,104814,8539,96275,64316,5312,13990,1340,78306,11317,5096,1805,14571,5478
CGTCGAGGTTGACTAT,Pos_Ctrl,16835,16420,1479,14941,840,14101,11723,899,1017,106,12740,356,3090,2678,922,486
CGCGGTCGTTGACTAT,sample,44745,44201,3812,40389,4098,36291,20241,1693,7404,851,27645,6102,4027,1726,4444,2667
ATGAATAGTTGACTAT,sample,132057,130792,10907,119885,9703,110182,51642,4591,27347,3175,78989,23427,6856,1693,12876,5244
TAACGCCATTGACTAT,sample,18943,18562,5090,13472,762,12710,2066,134,5385,565,7451,4560,2918,454,337,258
ATTCTACCTTGACTAT,sample,10682,10504,2588,7916,528,7388,1405,95,3013,285,4418,2590,1963,347,256,194
CGCGAGACTTGACTAT,sample,68719,68066,4383,63683,4380,59303,32865,2134,15272,1477,48137,7555,2904,1259,7303,3131
CCTAACTATTGACTAT,sample,9716,9545,288,9257,968,8289,6767,591,641,95,7408,195,762,820,1733,664
GCGCAATATTGACTAT,Neg_Ctrl,380,329,34,295,26,269,169,20,41,2,210,37,93,60,40,12
GTCGTTCTTGCAGTTG,sample,81189,80578,4370,76208,6963,69245,37026,2697,18126,2601,55152,8795,4596,2007,10146,4833
AGCTGAATTGCAGTTG,sample,36528,36254,2076,34178,2491,31687,16624,1213,8605,796,25229,4449,2779,1312,4215,1536
GAGCCTCCTGCAGTTG,sample,35642,35439,1584,33855,5271,28584,20641,1656,3354,346,23995,2587,2420,1627,4802,3464
TCGAACGATGCAGTTG,sample,80197,79744,1541,78203,10311,67892,60395,4594,1624,282,62019,997,2773,3751,9970,7244
CGTCGCCATGCAGTTG,sample,68336,67874,1599,66275,9820,56455,50384,4220,1276,102,51660,473,844,1177,18793,7468
TACGCGAGTGCAGTTG,sample,191127,189865,6353,183512,15346,168166,129839,9224,14811,1612,144650,12680,5775,3019,17861,9955
CCGTACGCTGCAGTTG,sample,96275,95647,3873,91774,10233,81541,64326,4676,6546,726,70872,5267,4356,3477,10526,7183
TCTCAGGATGCAGTTG,sample,63467,63013,1852,61161,8481,52680,45240,3693,1950,268,47190,1529,1499,1528,16292,5615
TGGATCAATGCAGTTG,sample,62530,62007,4882,57125,6381,50744,29689,2248,10499,1164,40188,7144,4047,1531,7790,3922
GATGCGTTTGCAGTTG,sample,128790,127966,5183,122783,7545,115238,85455,6254,12469,1299,97924,9761,5203,2691,11461,4551
TGCGCGTTTGCAGTTG,sample,97390,96818,2934,93884,7701,86183,58417,4529,15831,2218,74248,5188,2169,1579,9433,5395
AGCGTCTTTGCAGTTG,sample,65901,65275,4771,60504,4943,55561,38153,2561,7309,679,45462,6859,3810,2207,6105,3311
CGGTTGGTTGCAGTTG,sample,38383,38042,3068,34974,2555,32419,19203,1333,6826,898,26029,4159,4095,2233,3618,1475
CATTCGGTTGCAGTTG,sample,53793,53299,2674,50625,4319,46306,29761,2250,9421,945,39182,3929,4006,2599,4696,3250
GAGATTCTTGCAGTTG,sample,51895,51448,3168,48280,5496,42784,28441,2358,6788,647,35229,4550,2736,1412,8888,3628
GGCGACGATGCAGTTG,sample,57750,57240,4027,53213,5145,48068,25340,1632,11695,1191,37035,8210,4043,1350,7482,3311
TAACGAAGTGCAGTTG,sample,47558,47014,4133,42881,3472,39409,17586,1499,10803,1063,28389,8458,4693,1382,4446,2163
TGCGCTCCTGCAGTTG,sample,61760,61114,2372,58742,4809,53933,39528,2959,6879,579,46407,3988,3057,1892,6030,2987
GACTAACCTGCAGTTG,sample,90212,89302,4606,84696,5826,78870,51146,4098,15138,1596,66284,6892,3567,1818,10016,3840
AGATACTATGCAGTTG,sample,59408,58874,4223,54651,3949,50702,24878,2080,13185,1437,38063,9122,4516,1523,5225,2459
CCTAACTATGCAGTTG,sample,27508,27220,1009,26211,2262,23949,15311,1092,4745,539,20056,2262,2040,1198,3403,1365
AACCGGTTTCATGCTG,sample,6225,6166,434,5732,441,5291,3361,201,1069,120,4430,540,1319,764,584,275
AGCTGAATTCATGCTG,sample,35156,34887,2406,32481,4220,28261,19716,1246,4255,429,23971,2615,2250,1415,5928,2978
GACGTATGTCATGCTG,sample,34789,34390,3337,31053,2690,28363,12825,811,7829,856,20654,6042,4247,1696,2925,1466
TATACGGATCATGCTG,sample,56046,55536,5787,49749,2986,46763,25660,1345,11972,1476,37632,6310,2982,1676,5119,1959
GGTAGAGATCATGCTG,sample,23826,23558,1781,21777,2561,19216,10393,577,4833,470,15226,2943,2100,846,2138,1756
TCATCGAATCATGCTG,sample,101930,101332,3128,98204,8581,89623,72293,5670,6311,798,78604,4551,3377,2189,16870,5413
TCATACCATCATGCTG,sample,96341,95505,5832,89673,7127,82546,42734,3094,20522,1903,63256,14293,5733,1565,9235,3920
GCAACTAGTCATGCTG,Neg_Ctrl,512,211,113,98,7,91,65,1,10,6,75,9,51,31,16,1
TACGCGAGTCATGCTG,sample,105181,104215,8470,95745,7579,88166,40414,3308,22069,2479,62483,19896,6583,1512,10075,3958
CCGTACGCTCATGCTG,sample,30846,30574,871,29703,3937,25766,22849,1788,602,69,23451,458,962,1106,7746,2780
GATGCGTTTCATGCTG,sample,27318,27051,2134,24917,1556,23361,11122,681,6919,845,18041,3794,3127,1427,2255,871
TGCGCGTTTCATGCTG,Neg_Ctrl,667,430,168,262,12,250,173,9,31,3,204,34,106,64,36,12
AGCGTCTTTCATGCTG,sample,41439,41163,1435,39728,2973,36755,27666,2235,4165,611,31831,2078,3725,3419,3762,1959
CGGTTGGTTCATGCTG,sample,48025,47646,2250,45396,4882,40514,28621,2043,5949,683,34570,3218,3019,2220,5134,3411
ACGCTTAATCATGCTG,sample,54125,53798,3034,50764,5196,45568,31566,2349,6641,581,38207,4431,3210,1978,5924,3777
CTAACCGGTCATGCTG,Neg_Ctrl,437,289,106,183,18,165,119,8,27,0,146,11,79,50,28,9
GGCGACGATCATGCTG,sample,34019,33849,746,33103,3469,29634,25173,2090,1221,190,26394,960,1714,1807,5764,2453
TAACGAAGTCATGCTG,sample,26476,26359,1221,25138,2660,22478,14683,1286,3260,351,17943,2898,2105,1017,3636,1809
GCGTTACCTCATGCTG,sample,25538,25300,731,24569,2815,21754,19659,1450,394,18,20053,233,737,971,5817,2144
CAGCTTCGTCATGCTG,Neg_Ctrl,508,368,90,278,20,258,152,13,54,3,206,36,102,62,34,10
CGCGGTCGTCATGCTG,sample,26907,26635,1196,25439,2549,22890,17361,1262,2414,272,19775,1581,1546,1068,4338,1611
TCTCCTAGTCATGCTG,sample,19909,19655,1237,18418,1757,16661,11235,877,2493,277,13728,1779,1602,831,3269,1087
ATGAATAGTCATGCTG,sample,69048,68440,4240,64200,5649,58551,38791,2701,8475,957,47266,7627,4317,2045,6626,3940
AAGTAGAGTCATGCTG,sample,46169,45701,3117,42584,3268,39316,21983,1701,8959,1086,30942,5587,3415,1421,5166,2087
CTGGTCTTTTAGGCGG,Pos_Ctrl,34096,33556,1995,31561,1936,29625,24787,2166,1821,221,26608,630,4419,4447,2423,1010
TATACGGATTAGGCGG,Pos_Ctrl,28219,27839,1800,26039,1643,24396,20095,1950,1621,198,21716,532,4242,4164,1967,975
TCATCGAATTAGGCGG,sample,82271,81942,2058,79884,12781,67103,52458,4534,5788,630,58246,3693,3528,2742,12409,8575
TCATACCATTAGGCGG,sample,107535,106914,7676,99238,9620,89618,42783,3680,24429,2807,67212,15919,6358,2292,10684,6577
TGATTCCGTTAGGCGG,sample,119773,119028,3170,115858,17158,98700,78810,5477,9244,1251,88054,3918,2444,1926,23103,12031
TACGCGAGTTAGGCGG,sample,124900,124162,4516,119646,14892,104754,79199,6478,10343,1104,89542,7630,4324,2420,17927,10360
GACTCAAGTTAGGCGG,sample,56776,56221,2855,53366,8211,45155,28636,2311,8194,1081,36830,4933,3101,1241,7989,5427
CCGTACGCTTAGGCGG,sample,154277,153450,4458,148992,19686,129306,105287,7883,8970,913,114257,6253,3888,3326,20810,14210
TCTCAGGATTAGGCGG,sample,93808,93065,5022,88043,8801,79242,45789,2849,18718,1980,64507,9906,4473,1793,13434,6054
ACGCTTAATTAGGCGG,sample,129424,128475,9834,118641,9707,108934,67652,5695,17913,1955,85565,15719,5242,1819,18036,5893
AAGGTCTGTTAGGCGG,sample,133575,132744,2083,130661,8236,122425,109047,10457,1978,100,111025,843,1456,2268,14297,5215
TAACGAAGTTAGGCGG,sample,145909,145007,5440,139567,11326,128241,84822,7818,18322,2147,103144,15132,6122,2185,18233,6604
CGTCGAGGTTAGGCGG,sample,121560,120584,6387,114197,9726,104471,69699,4251,16259,1653,85958,12609,5314,2163,15560,6404
CAGCTTCGTTAGGCGG,sample,101879,100930,6451,94479,8813,85666,54116,3751,15268,1639,69384,10892,4913,1736,13805,5439
CGCGGTCGTTAGGCGG,sample,109630,108836,2371,106465,11692,94773,84668,8287,1049,146,85717,623,1205,1782,16637,8823
GACTAACCTTAGGCGG,sample,164059,162250,11499,150751,8094,142657,78706,4828,38055,4063,116761,17005,7781,3563,6735,4436
AGATACTATTAGGCGG,sample,138563,137651,4042,133609,13195,120414,107794,7561,2711,445,110505,1903,1432,1697,21726,10355
TCTAGGTTTCAGATAC,sample,24910,24790,956,23834,2324,21510,16141,1857,2210,291,18351,1011,2697,2439,1609,1606
GTCGTTCTTCAGATAC,sample,58844,58612,1509,57103,11988,45115,37585,2887,2593,310,40178,1740,2294,2256,7826,8233
GAGCCTCCTCAGATAC,sample,32363,32076,1018,31058,4711,26347,23942,1373,561,120,24503,351,639,869,9431,3145
CATACTCCTCAGATAC,sample,50357,49851,3979,45872,3139,42733,21741,1485,9633,956,31374,8918,4621,1651,5177,1611
TCATACCATCAGATAC,sample,79562,78894,1507,77387,7651,69736,61023,5773,1550,318,62573,1072,1073,1048,15206,5439
GCAACTAGTCAGATAC,sample,17298,17170,361,16809,1538,15271,13705,1235,198,28,13903,105,1162,1627,1801,1010
GACTCAAGTCAGATAC,sample,43540,43211,798,42413,4849,37564,34419,2402,332,43,34751,368,695,1009,6933,3358
ATACGTTCTCAGATAC,sample,22900,22692,1275,21417,1731,19686,11363,856,4409,469,15772,2589,2201,838,3298,1065
CCGCAGTCTCAGATAC,sample,40038,39711,2637,37074,2899,34175,21887,1793,5364,543,27251,4588,2797,1226,4733,1722
TCTCAGGATCAGATAC,sample,56806,56497,1340,55157,4707,50450,44326,3642,1295,156,45621,1031,2036,2396,8726,3218
CGGTTGGTTCAGATAC,sample,38717,38366,1909,36457,2974,33483,24747,1659,3826,457,28573,2794,2441,1426,6189,1921
GCTCTTCTTCAGATAC,sample,57305,56891,1065,55826,5230,50596,44940,3993,1155,99,46095,409,837,1210,11857,4164
GGCGACGATCAGATAC,sample,55805,55223,3846,51377,3193,48184,31716,2483,7418,677,39134,5890,3945,1856,4394,1941
CAGCTTCGTCAGATAC,sample,34177,33813,2247,31566,2408,29158,17862,1471,4942,537,22804,4346,2786,1129,3870,1793
CGCGGTCGTCAGATAC,sample,19041,18792,1931,16861,980,15881,7518,385,4447,544,11965,2987,2696,1097,1611,508
TTATGACGTCAGATAC,sample,38989,38706,1482,37224,3093,34131,26540,1548,3540,386,30080,2117,2125,1481,5112,2071
TCTCCTAGTCAGATAC,sample,65708,65089,2625,62464,4883,57581,38393,2952,10595,1252,48988,4389,1529,1087,8982,4076
GACTAACCTCAGATAC,sample,22206,21954,757,21197,2411,18786,16570,1463,320,235,16890,198,541,715,5150,1720
CCTAACTATCAGATAC,sample,53868,53379,3292,50087,4421,45666,31701,2628,5882,699,37583,4756,3623,2174,5670,2972
ATATGCAATCAGATAC,sample,176,176,9,167,15,152,118,2,22,1,140,9,73,52,23,6
TCTAGGTTTCGCTAGG,sample,70015,69535,4902,64633,10680,53953,37356,2695,7068,809,44424,6025,4385,2412,11840,7423
GTCGTTCTTCGCTAGG,Neg_Ctrl,797,470,166,304,29,275,188,12,43,5,231,27,117,67,46,12
AGCTGAATTCGCTAGG,sample,52604,52238,3524,48714,4702,44012,28445,1757,7606,835,36051,5369,4129,2447,4974,3116
GGAGAAGCTCGCTAGG,Neg_Ctrl,614,419,190,229,16,213,150,9,33,2,183,19,80,49,36,13
CTAGCGACTCGCTAGG,sample,44695,44261,2616,41645,4409,37236,19751,1394,8949,1426,28700,5716,3017,1144,6625,3049
CGTCGCCATCGCTAGG,sample,69167,68570,5564,63006,6386,56620,34089,2418,10505,1135,44594,8473,5003,2265,6130,4325
ATTCAAGGTCGCTAGG,sample,119246,118288,8282,110006,6176,103830,56920,4391,22174,2372,79094,17973,7300,2618,10756,3146
TACGCGAGTCGCTAGG,sample,22997,22715,2538,20177,1937,18240,7813,586,4962,559,12775,4320,2823,792,2298,1171
GGCAGGTTTCGCTAGG,sample,5183,5059,264,4795,708,4087,3565,254,155,15,3720,98,483,514,1224,522
CGGTTGGTTCGCTAGG,sample,65503,65043,2444,62599,6837,55762,45887,3136,4478,494,50365,1767,1771,1766,10852,5068
GCTCTTCTTCGCTAGG,sample,35073,34723,1057,33666,3921,29745,26684,1993,546,51,27230,471,811,1083,7045,2775
GAGATTCTTCGCTAGG,sample,32180,31995,1950,30045,3269,26776,20416,1706,2660,291,23076,1703,2070,1566,6243,2158
GCCTATTCTCGCTAGG,sample,21740,21441,742,20699,2443,18256,15776,1406,601,71,16377,402,712,852,4970,1880
AGCAGAGCTCGCTAGG,sample,47785,47363,3146,44217,4073,40144,26633,2148,6455,724,33088,4184,2828,1334,7501,2814
GTCGCGAATCGCTAGG,sample,25185,24913,1310,23603,2169,21434,15643,1145,2268,245,17911,2133,2160,1498,3014,1268
TAACGCCATCGCTAGG,sample,37705,37433,1855,35578,2543,33035,22869,1852,4273,384,27142,3657,2735,1622,5570,1764
ATTCTACCTCGCTAGG,Pos_Ctrl,8012,7908,680,7228,403,6825,5613,514,494,39,6107,165,1960,1563,401,226
CGCGAGACTCGCTAGG,sample,27554,27263,1189,26074,1810,24264,15971,1024,4837,598,20808,1834,2648,2012,2108,1205
AGATACTATCGCTAGG,sample,41916,41478,2518,38960,3249,35711,24064,1907,5253,590,29317,3897,2859,1555,4273,2214
TTAACTGATCGCTAGG,sample,2448,2391,117,2274,203,2071,1427,117,291,18,1718,218,594,440,293,117
AACCGGTTCCGTTGCG,sample,133785,133077,4988,128089,13792,114297,84089,6719,14164,1727,98253,7598,5434,4377,14036,9349
TCTAGGTTCCGTTGCG,sample,132303,131483,3708,127775,20675,107100,92642,6549,4380,430,97022,3099,1628,1657,29373,15786
GTCGTTCTCCGTTGCG,sample,130140,129278,3375,125903,18937,106966,96978,6687,1598,404,98576,1299,1277,1851,26521,15039
AGCTGAATCCGTTGCG,sample,143280,142281,7965,134316,18037,116279,78281,6288,16495,1614,94776,13601,5214,1981,23408,12209
GACGTATGCCGTTGCG,sample,108431,107600,8246,99354,7714,91640,40114,2934,28647,3103,68761,16842,6669,2012,9676,4481
CATAATGGCCGTTGCG,sample,65052,64612,2701,61911,11692,50219,35414,3537,6687,694,42101,3887,3220,1941,5368,8070
CTAGCGACCCGTTGCG,sample,139706,138869,7700,131169,13490,117679,75968,6270,18165,1918,94133,15358,6731,3145,15052,8696
TCATCGAACCGTTGCG,sample,104282,103762,2794,100968,14784,86184,76703,5820,1962,112,78665,1587,1001,1265,26543,10798
ATTCAAGGCCGTTGCG,sample,154992,154039,6817,147222,14541,132681,97083,6812,15307,1468,112390,12011,6231,3311,16380,9460
TGATTCCGCCGTTGCG,sample,81339,80995,2108,78887,12326,66561,57067,4151,3171,385,60238,1787,1831,1887,12875,8992
CCGTACGCCCGTTGCG,sample,79583,78868,2693,76175,9481,66694,60093,4352,1577,69,61670,603,985,1287,19709,6996
TGGATCAACCGTTGCG,sample,137561,136330,12752,123578,11624,111954,55308,4555,27554,2851,82862,21686,7352,1802,15577,6762
TGCGCGTTCCGTTGCG,sample,14749,14514,4177,10337,727,9610,1145,46,4304,553,5449,3562,2333,288,143,311
CCATTCTTCCGTTGCG,sample,58978,58190,4425,53765,6302,47463,30783,2261,7871,841,38654,5707,3955,2394,7187,4171
TAGCGAGTCCGTTGCG,sample,84919,84059,8885,75174,6873,68301,34857,2637,16681,1719,51538,12407,6215,1879,8736,3947
GCCTATTCCCGTTGCG,sample,87229,86220,9093,77127,6165,70962,33744,2300,17921,1594,51665,15403,7185,2657,6814,3462
AGCAGAGCCCGTTGCG,sample,102448,101597,6500,95097,6935,88162,47767,3300,22007,2144,69774,12944,5529,1841,12623,3588
CGTCGAGGCCGTTGCG,sample,102925,101897,8069,93828,7621,86207,47664,3422,18411,1828,66075,14882,6210,1698,12813,5250
CGCGGTCGCCGTTGCG,sample,67664,67090,2267,64823,8439,56384,47896,3968,2435,855,50331,1230,1561,1579,11592,6016
TCAATCAGCCGTTGCG,sample,103913,103181,2547,100634,10968,89666,80068,6592,1837,272,81905,897,1183,1727,16621,7836
CGCGAGACCCGTTGCG,sample,68642,67915,4698,63217,6958,56259,31502,2405,11541,1348,43043,9463,4313,1435,6935,4258
AGCTGAATAGGCCAAG,sample,136872,136122,7045,129077,18206,110871,74614,5740,16633,1913,91247,11971,5112,1888,23611,11286
CATAATGGAGGCCAAG,sample,118514,117763,5317,112446,12526,99920,64194,4918,18084,2174,82278,10550,3748,1628,13824,8043
GGAGAAGCAGGCCAAG,sample,178411,177133,8639,168494,15647,152847,87181,6782,33240,3159,120421,22485,6430,1864,20513,9247
TCGAACGAAGGCCAAG,sample,82590,82115,3668,78447,8801,69646,44690,3204,14039,1463,58729,6250,3709,2284,11205,6484
TGATTCCGAGGCCAAG,sample,274962,273419,8379,265040,17306,247734,199204,12308,19366,1774,218570,15082,6027,3044,24189,10181
CCATTCTTAGGCCAAG,sample,39183,38780,2815,35965,4893,31072,23576,1865,2899,305,26475,2427,3335,2856,4081,3380
GCTCTTCTAGGCCAAG,sample,106383,105578,6752,98826,10094,88732,54310,3772,17426,2165,71736,11059,5302,1944,12600,6495
GAGATTCTAGGCCAAG,sample,92387,91913,4589,87324,10667,76657,53395,4202,10078,1088,63473,7894,3837,2015,12966,6699
CTAAGCATAGGCCAAG,sample,123137,122477,7606,114871,9644,105227,62839,5203,19789,2197,82628,15199,6742,2573,12774,6460
CCTAGCGGAGGCCAAG,sample,45210,44869,2205,42664,3969,38695,27531,2110,5215,565,32746,3274,3874,2830,5296,2669
GCTGCTTCAGGCCAAG,sample,74710,74109,4926,69183,5697,63486,36243,2445,13650,1716,49893,9432,4561,1799,9476,3682
CGCGGTCGAGGCCAAG,sample,67129,66554,3919,62635,7286,55349,34495,2424,10170,945,44665,7315,3246,1167,10304,4914
ATGAATAGAGGCCAAG,sample,105941,105239,3809,101430,10277,91153,67010,4245,10428,857,77438,8613,3740,2213,13346,7100
TCAATCAGAGGCCAAG,sample,98806,98215,5217,92998,8688,84310,53649,4313,13863,1349,67512,11136,5091,1880,13620,5775
GACTAACCAGGCCAAG,Neg_Ctrl,1121,810,249,561,60,501,365,28,57,4,422,47,211,148,83,39
CCTAACTAAGGCCAAG,sample,150155,148858,10461,138397,12238,126159,71485,4820,27450,2808,98935,19596,7144,2151,12018,8364
TTAACTGAAGGCCAAG,sample,93286,92713,5831,86882,7430,79452,47543,3584,14963,1552,62506,11810,5995,2733,7108,4353
ATATGCAAAGGCCAAG,sample,2104,2082,136,1946,156,1790,1021,104,325,37,1346,303,462,302,255,92
GTCGTTCTAGAACCGC,sample,182529,181571,17951,163620,29292,134328,103079,8077,9781,1986,112860,11405,2987,1902,28819,19719
GACGTATGAGAACCGC,sample,137722,136935,3832,133103,19318,113785,96115,8216,4763,657,100878,4034,2132,1696,29228,13449
CATACTCCAGAACCGC,sample,108947,108520,1931,106589,17875,88714,78610,6888,1592,306,80202,1318,2523,3640,10623,13138
GCAACTAGAGAACCGC,sample,18958,18762,1672,17090,1799,15291,8145,592,3774,436,11919,2344,2947,1708,695,1070
TACGCGAGAGAACCGC,sample,77159,76368,4665,71703,7296,64407,46652,4229,8190,821,54842,4515,5146,4163,4439,5030
CCGCAGTCAGAACCGC,sample,71380,70659,4387,66272,7856,58416,41467,2610,7888,882,49355,5569,4580,3027,7004,5292
TCTCAGGAAGAACCGC,sample,55067,54513,4390,50123,3798,46325,21167,1463,14727,1610,35894,7358,4389,1907,4101,2121
TGGATCAAAGAACCGC,sample,134666,133302,14095,119207,9547,109660,50720,2897,28874,3201,79594,23968,7450,2201,10691,5285
GGCAGGTTAGAACCGC,sample,127368,126361,6175,120186,13003,107183,84861,6426,8668,1119,93529,6109,4276,3531,13684,9196
ATGGCGTTAGAACCGC,sample,70111,69433,6047,63386,6080,57306,33857,1997,12881,2043,46738,6528,4261,2504,8281,3879
TGCGCGTTAGAACCGC,sample,63221,62760,4427,58333,8068,50265,33993,2494,7194,758,41187,5826,2632,1897,10669,5971
AGCGTCTTAGAACCGC,sample,152069,150851,10347,140504,7811,132693,56399,4031,46811,4810,103210,20642,6675,2081,7959,2733
CGGTTGGTAGAACCGC,sample,104066,102983,8424,94559,7475,87084,42212,3328,21045,2097,63257,18402,6002,1330,11557,4641
GCTCTTCTAGAACCGC,sample,144187,143109,8318,134791,8044,126747,73101,5722,27487,3559,100588,16878,6851,2426,15189,4651
CTAAGCATAGAACCGC,sample,151629,150342,10117,140225,9187,131038,61047,3739,40094,4433,101141,21725,6456,2500,10144,4979
TAACGAAGAGAACCGC,sample,129619,128656,5832,122824,12679,110145,73700,5439,17778,1913,91478,11315,3596,1738,17046,8954
AGCAGAGCAGAACCGC,sample,115698,114600,6276,108324,6637,101687,72017,5434,14912,1943,86929,7381,5508,4265,8931,4372
ATACCGCCAGAACCGC,sample,76096,75444,4758,70686,7759,62927,42463,3365,9293,1012,51756,6794,4701,2415,11484,5141
GTCGCGAAAGAACCGC,sample,163093,161630,8611,153019,9762,143257,79325,4766,41603,4782,120928,12781,3818,2294,11629,7076
ATTCTACCAGAACCGC,sample,36521,36205,3344,32861,2808,30053,14134,1104,8598,942,22732,5275,3469,1252,3424,1409
GCGCAATAAGAACCGC,sample,60378,59753,6261,53492,6401,47091,18342,1560,13722,1394,32064,12073,5992,2238,2162,3734
GTCGTTCTCATCAAGC,sample,124188,123198,5982,117216,14436,102780,70308,5039,15393,1896,85701,10144,4548,2041,17443,9507
GGAGAAGCCATCAAGC,sample,75286,74653,4707,69946,11076,58870,34821,2571,12125,1182,46946,8171,4581,1673,8827,7717
CATACTCCCATCAAGC,sample,79138,78546,4060,74486,10390,64096,45286,3364,7905,1171,53191,6370,4148,2678,9902,7268
CGTCGCCACATCAAGC,sample,137559,136335,9208,127127,9804,117323,68429,5421,26196,2997,94625,14280,6695,3531,8484,6617
ATTCAAGGCATCAAGC,sample,87365,86662,5271,81391,9763,71628,51901,4124,8136,907,60037,6560,5366,3938,7542,6776
ATACGTTCCATCAAGC,sample,110631,109783,5614,104169,10985,93184,60223,4541,15415,2083,75638,10922,4019,1808,15744,7203
CCGTACGCCATCAAGC,sample,124646,123483,10545,112938,9385,103553,58392,3672,21862,2433,80254,17194,7292,2866,8932,6306
GATGCGTTCATCAAGC,sample,119009,118123,5471,112652,8164,104488,79186,6258,9592,1163,88778,8289,5159,3447,7983,5193
ACGCTTAACATCAAGC,sample,57917,57450,4435,53015,4160,48855,28205,1930,11368,1186,39573,6166,4913,2505,7986,2730
CATTCGGTCATCAAGC,sample,134546,133461,9750,123711,9947,113764,63187,4421,27573,3271,90760,15312,6958,2708,10535,6154
TAGCGAGTCATCAAGC,sample,108262,107476,3536,103940,10376,93564,73195,5555,9971,935,83166,3908,2230,1774,14444,7382
GCTCTTCTCATCAAGC,sample,66009,65536,2260,63276,6695,56581,47933,3660,2829,330,50762,1829,3931,4398,5081,4752
GAGATTCTCATCAAGC,sample,99165,98532,3377,95155,11626,83529,66946,6545,6008,740,72954,3290,2291,1672,16255,7693
GGCGACGACATCAAGC,sample,78367,77867,2469,75398,9274,66124,53796,3800,4867,542,58663,3119,2966,2482,9969,6347
CGTCGAGGCATCAAGC,Pos_Ctrl,24456,24118,1924,22194,1207,20987,17237,1656,1436,211,18673,447,3842,3639,1363,654
ATGAATAGCATCAAGC,sample,63189,62781,1701,61080,7432,53648,47163,3375,1986,159,49149,965,1066,1185,15552,5150
AAGTAGAGCATCAAGC,sample,105538,104514,6858,97656,8120,89536,58877,4485,13193,1712,72070,11269,5854,2872,9477,5596
TAACGCCACATCAAGC,sample,33557,33249,3202,30047,3392,26655,13823,969,6380,666,20203,4817,3485,1307,3377,2121
ATTCTACCCATCAAGC,sample,78787,78137,5841,72296,5143,67153,42979,2599,11438,1143,54417,8994,5082,2322,7354,3344
GACTAACCCATCAAGC,sample,77996,77301,5297,72004,5877,66127,44040,3764,9333,818,53373,8172,4037,1670,10678,3603
AGATACTACATCAAGC,sample,110704,109758,7809,101949,5164,96785,45073,2878,31907,3720,76980,13207,6158,2746,5169,2719
CCTAACTACATCAAGC,sample,113569,112442,9296,103146,7067,96079,43024,3106,26881,2884,69905,20184,7304,2075,9155,3833
GCGCAATACATCAAGC,sample,57381,56839,3447,53392,5099,48293,29664,2659,8693,972,38357,6305,3806,1557,6894,3250
ATATGCAACATCAAGC,sample,20201,20073,2433,17640,1155,16485,5519,452,6562,773,12081,3179,3254,1103,1385,540
TATACGGAAGAGAGCC,sample,41609,41220,1997,39223,5808,33415,25850,1889,3365,385,29215,1926,2746,2227,5520,3976
CATACTCCAGAGAGCC,sample,38542,38138,2078,36060,5962,30098,23669,1354,2574,301,26243,2200,1773,1197,6549,4165
TCATACCAAGAGAGCC,sample,76162,75471,3419,72052,7898,64154,44398,3629,8378,883,52776,6866,4392,2400,2804,4927
CCGTACGCAGAGAGCC,sample,67522,66819,6037,60782,3709,57073,29078,2034,15709,1885,44787,8367,5684,2780,3754,2157
TCTCAGGAAGAGAGCC,sample,61333,60735,3428,57307,5852,51455,36895,2953,5958,710,42853,4939,3034,1250,11925,3663
CGGTTGGTAGAGAGCC,sample,92827,92175,2217,89958,10762,79196,70069,6700,1315,192,71384,920,1372,2167,12465,7998
ACGCTTAAAGAGAGCC,sample,53532,53048,4957,48091,3813,44278,21081,1527,13713,1549,34794,6408,3714,1424,5764,2391
CATTCGGTAGAGAGCC,sample,79970,79320,4344,74976,5146,69830,40210,2306,17507,1764,57717,8043,3612,1541,8607,2960
GAGATTCTAGAGAGCC,sample,65459,64991,3431,61560,7754,53806,45414,3295,2736,327,48150,2034,3179,3492,6593,5703
CTAAGCATAGAGAGCC,sample,78722,78034,4731,73303,8813,64490,42772,2767,9730,989,52502,8232,4419,2122,10893,6036
CTAACCGGAGAGAGCC,sample,68070,67419,4144,63275,6236,57039,38666,2584,8183,932,46849,6674,4116,2078,5663,4506
TAACGAAGAGAGAGCC,sample,82436,81811,2646,79165,5814,73351,55901,3889,9453,1059,65354,3049,2909,2624,7737,4122
AGCAGAGCAGAGAGCC,sample,40447,40103,2933,37170,4974,32196,16939,1128,7198,755,24137,6176,3446,1084,5967,3216
GGCGTACCAGAGAGCC,sample,60342,59770,3866,55904,5496,50408,28912,1713,10345,997,39257,8441,4682,1716,6087,3170
CGTCGAGGAGAGAGCC,sample,68340,67816,4704,63112,6183,56929,31835,2387,11892,1385,43727,9430,4758,1603,7216,3882
CAGCTTCGAGAGAGCC,sample,36301,35942,3131,32811,3723,29088,14940,1040,7091,738,22031,5279,3722,1389,3288,2335
CGCGGTCGAGAGAGCC,sample,62092,61632,1599,60033,7324,52709,46401,4713,830,209,47231,556,1039,1534,11363,5365
ATGAATAGAGAGAGCC,sample,59090,58696,3115,55581,6344,49237,29054,2087,10017,1350,39071,6729,3605,1338,8079,4647
AAGTAGAGAGAGAGCC,sample,83325,82772,3709,79063,8357,70706,49247,3852,9286,858,58533,7463,4216,1836,10551,5783
TAACGCCAAGAGAGCC,sample,51359,51069,2488,48581,6506,42075,27141,2233,6722,684,33863,5295,3136,1370,8594,4199
ATTCTACCAGAGAGCC,sample,69360,68977,3132,65845,6987,58858,38358,2972,9334,939,47692,7255,4141,1605,11747,4437
GACTAACCAGAGAGCC,sample,20114,20000,1135,18865,2371,16494,8807,665,4605,452,13412,1965,2785,1562,1465,1599
TTAACTGAAGAGAGCC,sample,67853,67385,2526,64859,6481,58378,46617,3601,4545,677,51162,2938,1994,1526,12000,4489
AACCGGTTAGCATTGA,sample,30791,30661,943,29718,5387,24331,19310,1794,1819,227,21129,1181,2225,2113,4137,3608
GTCGTTCTAGCATTGA,sample,108048,107405,3621,103784,16087,87697,79568,4782,2231,146,81799,970,1063,1497,22832,12137
CATACTCCAGCATTGA,sample,90405,89598,6556,83042,8842,74200,31617,2147,20736,2342,52353,17358,6235,1468,6980,5661
GACTCAAGAGCATTGA,sample,114213,113429,4255,109174,8694,100480,72777,5487,11292,1300,84069,9624,4495,2352,9922,5224
TCTCAGGAAGCATTGA,sample,124199,123429,6689,116740,10513,106227,68652,4478,16531,1962,85183,14604,5697,2253,15552,6405
AGCGTCTTAGCATTGA,sample,172541,171388,6187,165201,20133,145068,114742,9518,11979,1624,126721,7205,3637,2822,24301,15043
TAGCGAGTAGCATTGA,sample,122166,121522,2593,118929,16398,102531,90708,7032,2930,307,93638,1554,2994,3883,20363,13011
ATACCGCCAGCATTGA,sample,123219,122179,6799,115380,10256,105124,65969,4138,19683,2303,85652,13031,5646,2084,15221,6475
GGCGTACCAGCATTGA,sample,81953,81323,5958,75365,8176,67189,44952,3625,9574,1086,54526,7952,4703,2462,11553,5005
GTCGCGAAAGCATTGA,sample,114099,113323,2268,111055,9586,101469,91201,7354,1299,239,92500,1376,1060,1621,16130,7275
CAGCTTCGAGCATTGA,Neg_Ctrl,898,588,217,371,24,347,240,13,53,1,293,40,149,95,51,13
GACTAACCAGCATTGA,sample,95616,95019,4993,90026,9443,80583,45518,4099,16269,1762,61787,12935,5720,1657,11445,5850
CGCGAGACAGCATTGA,sample,73379,72920,2980,69940,11600,58340,41607,2666,7131,844,48738,6092,3766,2033,8731,7940
TTAACTGAAGCATTGA,sample,114906,114346,2819,111527,13262,98265,87751,6522,2829,81,90580,1082,883,1276,18521,8843
TCTAGGTTAATTACCA,sample,83658,82950,6697,76253,5487,70766,32701,2616,21125,2101,53826,12223,5413,2082,5854,3163
GAGCCTCCAATTACCA,sample,15191,14985,1250,13735,1847,11888,8202,516,1710,173,9912,1287,1381,792,3678,1252
TCATACCAAATTACCA,sample,789,771,90,681,74,607,372,38,103,12,475,82,226,143,77,46
GCAACTAGAATTACCA,sample,24579,24435,452,23983,3613,20370,17873,1889,328,36,18201,244,1229,1882,3409,2446
GACTCAAGAATTACCA,sample,61389,61054,2543,58511,7623,50888,40842,3119,3899,703,44741,2325,1751,1457,13069,5287
CCGTACGCAATTACCA,sample,75482,75145,5147,69998,7242,62756,38628,3383,11484,1327,50112,7934,4524,2053,8330,5076
TCTCAGGAAATTACCA,sample,67507,67136,4348,62788,7047,55741,35090,2896,10759,1167,45849,5829,4556,2651,10111,4637
ATGGCGTTAATTACCA,sample,72721,72291,2312,69979,6498,63481,50599,4327,4638,563,55237,3354,2326,1478,11172,4443
CCATTCTTAATTACCA,sample,83318,82743,3044,79699,6969,72730,61822,5293,2972,253,64794,2390,1442,1263,11259,5040
CGGTTGGTAATTACCA,sample,62140,61769,1506,60263,6111,54152,48555,3992,965,204,49520,436,790,1159,12365,4018
ACGCTTAAAATTACCA,sample,78132,77639,1653,75986,7383,68603,63203,3867,1070,49,64273,414,1051,1623,12222,5598
CATTCGGTAATTACCA,sample,91123,90512,3567,86945,5789,81156,53885,5602,14651,1716,68536,5302,2459,1372,10620,4358
GAGATTCTAATTACCA,sample,72156,71362,8080,63282,3725,59557,17808,1278,20252,2110,38060,18109,6826,1194,4474,1691
CTAAGCATAATTACCA,sample,91992,91246,5011,86235,6070,80165,51236,3578,15209,1517,66445,8625,3732,1660,9979,3952
GGCGACGAAATTACCA,sample,65943,65374,4154,61220,4823,56397,31260,2222,14000,1707,45260,7208,3626,1762,6041,2814
GCCTATTCAATTACCA,sample,43053,42511,5347,37164,1735,35429,12139,715,13610,1691,25749,7274,5286,1945,1040,821
AGCAGAGCAATTACCA,sample,57495,56973,2649,54324,4387,49937,39035,2989,4050,476,43085,3387,2723,1737,6439,2866
GCGTTACCAATTACCA,sample,64295,63590,4030,59560,3609,55951,35188,2518,11212,1318,46400,5715,4435,2560,7160,2131
CGCGGTCGAATTACCA,sample,42017,41652,1424,40228,4698,35530,28173,2250,2853,290,31026,1964,1957,1352,8525,3311
TAACGCCAAATTACCA,sample,49680,49314,1323,47991,5161,42830,38779,2926,705,43,39484,377,840,1140,9319,3867
AGATACTAAATTACCA,sample,88057,87348,12268,75080,4524,70556,24275,2129,22999,2405,47274,18748,7128,1856,4527,2314
TTAACTGAAATTACCA,sample,46170,45709,3762,41947,3416,38531,21645,2037,7258,760,28903,6831,3609,1334,4984,1899
TCTAGGTTTAGATGAC,sample,8262,8201,197,8004,1584,6420,5306,477,347,57,5653,233,1104,1145,940,1064
CTGGTCTTTAGATGAC,Pos_Ctrl,8181,8114,481,7633,585,7048,5844,670,381,37,6225,116,1802,1678,622,307
CATACTCCTAGATGAC,Pos_Ctrl,8423,8319,528,7791,592,7199,5971,644,353,59,6324,172,1957,1742,675,327
TCGAACGATAGATGAC,sample,28667,28447,2642,25805,3676,22129,12121,1017,4560,526,16681,3905,3566,1920,2755,2330
CGTCGCCATAGATGAC,sample,136911,136161,2917,133244,15831,117413,104124,8731,2177,470,106301,1911,1531,2121,25247,11060
TGATTCCGTAGATGAC,Pos_Ctrl,44604,44273,2235,42038,2185,39853,33352,3482,2112,252,35464,655,4971,5778,1959,1135
TACGCGAGTAGATGAC,sample,139189,138382,9448,128934,14687,114247,72390,5388,18789,1922,91179,15758,6136,2182,20413,9071
GACTCAAGTAGATGAC,sample,68917,68340,2446,65894,10159,55735,40000,3423,7461,815,47461,4036,2708,1573,9803,7005
ATACGTTCTAGATGAC,sample,57430,57129,1296,55833,9794,46039,40112,3602,1295,219,41407,811,2544,3173,7804,6845
TGGATCAATAGATGAC,sample,26695,26396,2184,24212,2255,21957,11931,835,5178,513,17109,3500,2662,1185,3481,1655
AGCGTCTTTAGATGAC,sample,142787,141836,5003,136833,16433,120400,95406,8063,8619,1006,104025,7306,4088,2642,20738,10607
TAGCGAGTTAGATGAC,sample,101470,100764,5323,95441,9619,85822,66275,5709,7359,598,73634,5881,3259,2113,14435,6410
TAACGAAGTAGATGAC,sample,154541,153715,3593,150122,15749,134373,116978,9847,4290,472,121268,2786,2271,2530,18481,10360
GCTGCTTCTAGATGAC,sample,118655,117759,4500,113259,7864,105395,79007,5509,13805,1365,92812,5709,3761,2715,11563,5006
AGCAGAGCTAGATGAC,sample,126166,125011,9403,115608,10330,105278,56684,4335,22414,2046,79098,19799,6266,1649,16141,5927
ATACCGCCTAGATGAC,sample,106938,106223,2283,103940,9667,94273,85166,7386,727,153,85893,841,806,1235,22765,6551
GCGTTACCTAGATGAC,sample,121953,121135,2344,118791,11674,107117,95357,8570,1526,254,96883,1410,1183,1802,19652,8173
ATTCTACCTAGATGAC,sample,85547,84858,4614,80244,9457,70787,46035,3830,11220,1247,57255,8455,3745,1447,12683,6335
CGCGAGACTAGATGAC,sample,156120,154694,7058,147636,11714,135922,92680,9254,18242,2036,110922,13710,5977,2617,12526,7992
TTAACTGATAGATGAC,sample,128480,127532,5421,122111,11441,110670,78150,5898,13445,1828,91595,11349,5028,1971,17075,7591
AACCGGTTGTTCAGAA,sample,141615,140627,4509,136118,20604,115514,91459,8144,8858,1040,100317,6013,4089,2963,16947,14450
GTCGTTCTGTTCAGAA,sample,65440,64944,2329,62615,8153,54462,43715,3465,4533,409,48248,2340,1640,1400,13791,6116
AGAGTTCTGTTCAGAA,sample,47390,46961,1784,45177,6102,39075,35091,2536,777,38,35868,633,748,1004,12789,4333
AGCTGAATGTTCAGAA,sample,75024,74395,3971,70424,8035,62389,44424,3595,8142,884,52566,5344,3830,2239,8988,5290
GACGTATGGTTCAGAA,sample,40052,39624,2485,37139,3791,33348,22247,1589,5496,554,27743,3462,3322,2147,5579,2577
CATACTCCGTTCAGAA,sample,117339,116293,5090,111203,9816,101387,81936,5291,7511,767,89447,5882,4734,3852,6288,7056
CTAGCGACGTTCAGAA,sample,105943,105010,5099,99911,9143,90768,52831,3695,19990,2718,72821,11534,5384,1923,12846,6335
ATACGTTCGTTCAGAA,sample,81978,81384,2354,79030,9306,69724,59554,4476,2825,365,62379,2504,2907,3378,6992,6777
GGCAGGTTGTTCAGAA,sample,31446,31096,2382,28714,3602,25112,18954,1236,2778,280,21732,1864,1485,1068,6879,2317
GATGCGTTGTTCAGAA,sample,41793,41522,10787,30735,2587,28148,8201,521,9822,1009,18023,8595,3814,1048,2496,1204
CGGTTGGTGTTCAGAA,sample,34706,34260,2414,31846,2805,29041,15711,1104,6302,836,22013,5088,3058,1153,4507,1681
ACGCTTAAGTTCAGAA,sample,136846,135868,6751,129117,8777,120340,70031,4879,25666,3336,95697,16428,5744,2013,11882,5547
TAACGAAGGTTCAGAA,sample,3666,3629,126,3503,482,3021,2088,167,527,60,2615,179,848,650,411,311
ATACCGCCGTTCAGAA,sample,69563,69143,1375,67768,7024,60744,53750,5283,1272,97,55022,342,719,1027,12398,5375
GGCGTACCGTTCAGAA,sample,87780,86940,4993,81947,6158,75789,43200,3488,14368,1509,57568,13224,5146,1399,9185,3478
TTATGACGGTTCAGAA,sample,91547,90967,4501,86466,6790,79676,43202,2771,21274,2662,64476,9767,4533,1800,9273,4254
ATGAATAGGTTCAGAA,sample,71701,71174,5176,65998,6963,59035,36017,2804,10219,1083,46236,8912,3928,1678,8670,4516
CCTAACTAGTTCAGAA,Pos_Ctrl,28266,27842,1628,26214,1293,24921,20887,1752,1540,216,22427,526,4197,4304,1688,680
ATATGCAAGTTCAGAA,sample,94726,94191,3196,90995,8815,82180,59043,5101,10372,1114,69415,6550,3925,2361,11704,5941
GTCGTTCTTTCTGGTT,Neg_Ctrl,1175,806,253,553,35,518,293,32,152,5,445,36,195,122,64,18
AGCTGAATTTCTGGTT,sample,75604,75064,1923,73141,13163,59978,54008,4141,913,121,54921,795,1950,2675,9352,10352
GAGCCTCCTTCTGGTT,sample,66209,65558,6241,59317,4511,54806,22136,1557,17798,2038,39934,11277,5330,1423,6098,2718
CTAGCGACTTCTGGTT,Neg_Ctrl,1280,716,297,419,29,390,237,14,62,11,299,66,143,101,32,13
ATTCAAGGTTCTGGTT,sample,117517,116748,6865,109883,12146,97737,55863,4313,18753,1813,74616,16995,6574,2332,9985,7789
GCAACTAGTTCTGGTT,Neg_Ctrl,719,333,202,131,14,117,83,7,15,1,98,11,63,48,20,2
TACGCGAGTTCTGGTT,sample,112385,111385,7962,103423,9067,94356,58430,5128,15940,1636,74370,13222,5837,2084,11957,5510
GACTCAAGTTCTGGTT,sample,100382,99521,5566,93955,5372,88583,49472,3229,22925,2470,72397,10487,5392,2512,8999,3401
ATGGCGTTTTCTGGTT,sample,36992,36652,2304,34348,3927,30421,20669,1511,4803,481,25472,2957,3135,2213,3799,2716
CATTCGGTTTCTGGTT,sample,1161,1143,90,1053,117,936,530,32,223,10,753,141,341,193,133,61
AAGGTCTGTTCTGGTT,sample,87888,87426,1761,85665,11034,74631,67192,5767,834,138,68026,700,913,1344,20316,8097
CCTAGCGGTTCTGGTT,sample,63962,63559,5527,58032,5004,53028,29338,2292,11322,1268,40660,8808,5004,1824,7335,3102
TAACGAAGTTCTGGTT,sample,79038,78511,1928,76583,8525,68058,59978,4297,2487,394,62465,902,968,1153,16684,6172
CAGCTTCGTTCTGGTT,sample,91199,90434,3426,87008,7674,79334,63625,4054,6029,596,69654,5030,4472,3390,12543,5220
ATGAATAGTTCTGGTT,sample,89124,88630,4536,84094,7257,76837,44699,2839,17472,1690,62171,10137,4254,1675,13836,4456
AAGTAGAGTTCTGGTT,sample,100416,99683,3597,96086,7014,89072,56791,3810,18797,2256,75588,7418,3265,1765,15863,4783
TCAATCAGTTCTGGTT,sample,113973,112671,6968,105703,5950,99753,47814,3595,33222,4027,81036,11095,5664,2535,6263,3481
TAACGCCATTCTGGTT,sample,72878,72433,1793,70640,7653,62987,56014,4827,1507,54,57521,585,1043,1496,14204,5763
ATTCTACCTTCTGGTT,sample,128901,127842,7848,119994,8269,111725,63150,4609,23045,2816,86195,18105,6932,2346,8041,5206
TCTAGGTTGTTCGGTT,sample,170072,168584,11535,157049,14848,142201,88435,6861,23357,2435,111792,21113,6203,2181,20950,9200
AGAGTTCTGTTCGGTT,sample,110129,109090,6369,102721,10223,92498,67095,4604,11364,1264,78459,8171,3426,1646,15989,6854
GACGTATGGTTCGGTT,sample,38162,37721,3553,34168,3072,31096,13894,1018,9267,852,23161,6065,3801,1277,4911,1735
CATACTCCGTTCGGTT,sample,74315,73621,3105,70516,5015,65501,47129,3228,10249,1109,57378,3786,4967,4357,5029,3183
GGTAGAGAGTTCGGTT,sample,69363,68790,2248,66542,9973,56569,50869,3573,1135,149,52004,843,1448,1758,16566,7099
CGTCGCCAGTTCGGTT,sample,64991,64252,4239,60013,4821,55192,27578,1777,15889,1910,43467,8038,3487,1273,5886,3145
TCATACCAGTTCGGTT,sample,71506,70901,2115,68786,11040,57746,51848,3972,1223,97,53071,606,1045,1358,15166,7876
GCAACTAGGTTCGGTT,sample,40867,40441,2860,37581,2862,34719,18159,1623,7700,812,25859,6425,4439,1759,2496,1621
TACGCGAGGTTCGGTT,sample,133336,132136,9805,122331,7379,114952,61673,4813,24614,3034,86287,20818,5904,1512,12482,3368
TCTCAGGAGTTCGGTT,sample,116289,115437,5141,110296,11922,98374,69396,5997,13005,1358,82401,8618,3457,1918,17234,8017
GATGCGTTGTTCGGTT,sample,139537,138423,6510,131913,7438,124475,90649,5880,14560,1478,105209,11908,5226,2438,8270,4157
ATGGCGTTGTTCGGTT,sample,154602,153460,7740,145720,8709,137011,85076,6323,23386,2786,108462,19440,6392,1973,14647,5055
AGCGTCTTGTTCGGTT,sample,67327,66570,4932,61638,8439,53199,29605,2612,11136,1321,40741,8525,3940,1459,5853,5378
ACGCTTAAGTTCGGTT,sample,139115,138234,4258,133976,12313,121663,98539,7897,8979,945,107518,5303,2812,2114,17940,8601
TAGCGAGTGTTCGGTT,sample,179026,177522,9031,168491,14297,154194,116278,8778,14962,1566,131240,12610,5912,3402,15456,9082
GCTCTTCTGTTCGGTT,sample,147999,139502,12924,126578,15439,111139,96613,6207,4354,578,100967,3387,3232,2958,19121,8679
GAGATTCTGTTCGGTT,sample,132939,131806,8963,122843,9225,113618,66669,4743,22181,2626,88850,17399,7693,2784,12025,4851
CTAAGCATGTTCGGTT,sample,117894,116956,6791,110165,11264,98901,54219,5638,20241,2260,74460,16543,6636,2347,7191,7585
GCCTATTCGTTCGGTT,sample,126870,126119,4697,121422,14121,107301,89729,7396,6015,430,95744,3731,1862,1414,24832,10612
AGCAGAGCGTTCGGTT,sample,169301,168031,7268,160763,11061,149702,105763,8057,21126,2262,126889,12494,5812,3412,12316,7110
TGCGCTCCGTTCGGTT,sample,155678,154460,11178,143282,10291,132991,70851,4838,30857,3524,101708,22921,7954,2369,12925,6596
ATGAATAGGTTCGGTT,sample,154707,153759,6774,146985,14307,132678,94376,6690,15749,1577,110125,14286,6454,3230,15085,9539
GACTAACCGTTCGGTT,sample,40211,39757,1688,38069,5004,33065,20286,1400,6525,796,26811,4058,2608,1018,2895,3008
GCGCAATAGTTCGGTT,Neg_Ctrl,919,626,126,500,44,456,320,18,63,11,383,44,191,123,69,15
AACCGGTTTGGCGGTT,sample,273266,271793,11281,260512,26872,233640,163685,12697,31623,3764,195308,21871,8467,4550,21366,17195
GTCGTTCTTGGCGGTT,sample,190467,188811,8945,179866,21689,158177,107915,8015,21450,2121,129365,18676,6683,2810,25906,14330
AGCTGAATTGGCGGTT,sample,86588,85626,10988,74638,4287,70351,19086,1228,29538,3268,48624,17231,7523,2113,3723,2047
GAGCCTCCTGGCGGTT,sample,194571,193443,8820,184623,24888,159735,122478,8907,17726,2199,140204,8425,4399,3224,25026,17570
GGTAGAGATGGCGGTT,sample,135448,134435,3610,130825,10894,119931,88416,5558,17470,2304,105886,6183,3179,2732,14143,8023
ATTCAAGGTGGCGGTT,sample,48501,47899,4353,43546,5137,38409,18672,1344,9609,966,28281,7818,3987,1054,7153,3522
CCGTACGCTGGCGGTT,sample,136416,135162,5319,129843,14058,115785,84371,6983,12658,2028,97029,9745,3781,2378,20900,10351
CCATTCTTTGGCGGTT,sample,168403,167033,8412,158621,19787,138834,107797,7995,12341,1456,120138,9245,4374,3106,16899,13508
ACGCTTAATGGCGGTT,sample,198752,197647,3329,194318,14084,180234,161634,13844,2704,165,164338,1887,1487,2346,22896,10111
TAGCGAGTTGGCGGTT,sample,191024,189896,3641,186255,19217,167038,148748,13854,2325,338,151073,1773,1767,2403,28576,14281
CTAAGCATTGGCGGTT,sample,254416,252625,9568,243057,15386,227671,172428,12235,25664,2926,198092,14418,5763,3311,23712,9949
CAGCTTCGTGGCGGTT,sample,118226,117176,3327,113849,10643,103206,80820,8433,8603,991,89423,4359,2097,1507,18249,7162
CGCGGTCGTGGCGGTT,sample,153548,152695,5001,147694,13864,133830,103821,7693,11651,1394,115472,9271,5637,3707,11610,8953
TAACGCCATGGCGGTT,sample,111309,110845,2846,107999,11071,96928,76243,7834,6499,649,82742,5703,3388,2183,15497,7637
ATTCTACCTGGCGGTT,sample,140065,139239,3468,135771,14044,121727,107329,10611,821,822,108150,2144,993,1450,24579,10078
CATAATGGTCCTTATT,sample,95134,94317,6198,88119,6735,81384,52874,3792,12795,1427,65669,10496,5559,2735,7396,4313
CTAGCGACTCCTTATT,sample,59145,58597,3337,55260,4976,50284,28595,1912,11174,1270,39769,7333,3086,1215,8588,3600
TCGAACGATCCTTATT,sample,60562,60078,5991,54087,4718,49369,23238,1332,13154,1455,36392,10190,5838,2150,4697,2952
GGTAGAGATCCTTATT,sample,44843,44416,3628,40788,3777,37011,20668,1729,7586,752,28254,6276,3548,1182,6278,2216
CGTCGCCATCCTTATT,sample,106969,106171,5454,100717,5983,94734,45601,3244,30001,3691,75602,12197,4837,1805,10105,3410
TGATTCCGTCCTTATT,sample,43751,43489,1838,41651,3640,38011,26951,2132,5918,730,32869,2280,3850,3368,3606,2607
GCAACTAGTCCTTATT,sample,30008,29703,777,28926,3832,25094,20189,1537,1978,206,22167,1184,1384,1189,5123,2504
TACGCGAGTCCTTATT,sample,58723,58336,2916,55420,5451,49969,30736,2233,10234,1079,40970,5687,3237,1526,7053,3447
TCTCAGGATCCTTATT,sample,59566,59269,3193,56076,7277,48799,28674,2498,8790,989,37464,7848,4559,1817,7341,4411
AGCGTCTTTCCTTATT,sample,50405,49968,1554,48414,5049,43365,38259,2837,1188,72,39447,1009,735,934,11721,3651
CGGTTGGTTCCTTATT,sample,41837,41459,2996,38463,4683,33780,20587,1642,6444,564,27031,4543,3440,1789,5867,3043
ACGCTTAATCCTTATT,sample,14767,14657,2338,12319,902,11417,4767,283,3181,309,7948,2877,2270,865,1252,485
CCTAGCGGTCCTTATT,sample,22670,22399,2454,19945,1370,18575,8362,534,5338,579,13700,3762,3321,1587,1221,616
TAACGAAGTCCTTATT,sample,45396,45078,1477,43601,4504,39097,33798,2745,1867,111,35665,576,777,1140,9517,3276
CGTCGAGGTCCTTATT,Pos_Ctrl,9641,9466,774,8692,491,8201,6684,603,574,108,7258,232,2228,1841,494,290
TTATGACGTCCTTATT,sample,96324,95739,2234,93505,9365,84140,74111,6822,2010,382,76121,815,869,1256,14703,6428
TCAATCAGTCCTTATT,sample,52912,52505,1416,51089,4664,46425,41666,3030,1087,78,42753,564,1892,2579,6289,3421
CGCGAGACTCCTTATT,sample,58034,57563,2752,54811,3818,50993,33752,2699,8145,1007,41897,5390,3182,1545,6054,2192
AGATACTATCCTTATT,sample,97915,97219,4777,92442,5738,86704,62764,4265,9888,1092,72652,8695,4787,2837,7881,3433
AACCGGTTAATAAGGT,sample,185028,183785,11222,172563,14407,158156,76790,4739,49012,5986,125802,21629,7109,2789,18309,8303
CTGGTCTTAATAAGGT,sample,277033,275138,11950,263188,35008,228180,152450,10792,36855,5317,189305,22766,5906,2480,35897,25487
GACGTATGAATAAGGT,sample,24238,24053,1644,22409,3904,18505,11127,883,3349,354,14476,2792,2737,1546,3492,2651
TATACGGAAATAAGGT,sample,167290,165846,11906,153940,15162,138778,84678,5324,24367,2626,109045,21783,7130,1957,35663,8798
CATACTCCAATAAGGT,sample,137256,136140,8253,127887,11053,116834,61222,4091,30090,3593,91312,17838,6203,2165,15298,6624
TCGAACGAAATAAGGT,sample,103701,102877,2062,100815,12709,88106,79595,6051,1436,296,81031,728,885,1122,29192,8872
CCGCAGTCAATAAGGT,sample,172166,170980,8969,162011,17111,144900,89877,7222,25146,3102,115023,19553,7204,2953,17659,11229
CCGTACGCAATAAGGT,sample,143628,142586,4337,138249,17174,121075,109275,8650,1550,184,110825,1416,1075,1576,32057,12398
TGGATCAAAATAAGGT,sample,127167,126428,3147,123281,14052,109229,96375,7256,3773,395,100148,1430,1531,1911,23545,10300
GATGCGTTAATAAGGT,sample,195787,194702,12733,181969,14420,167549,111501,9031,28462,2822,139963,15733,4511,1821,24490,8796
ATGGCGTTAATAAGGT,Pos_Ctrl,25099,24913,1123,23790,1236,22554,18814,1892,1237,126,20051,485,3789,3898,1313,588
AGCGTCTTAATAAGGT,sample,2673,2630,118,2512,232,2280,1534,153,370,42,1904,181,588,440,283,141
AAGGTCTGAATAAGGT,sample,74163,73271,6875,66396,4149,62247,25127,1617,20298,2241,45425,12964,5522,1637,6553,2203
CCTAGCGGAATAAGGT,Pos_Ctrl,15450,15257,1042,14215,868,13347,11222,935,779,130,12001,281,2957,2731,975,452
TTATGACGAATAAGGT,sample,73124,72196,7054,65142,4352,60790,30257,2242,14970,1471,45227,11850,5589,2060,6141,2468
TCTCCTAGAATAAGGT,sample,74158,73426,4094,69332,7245,62087,42903,3030,8514,1088,51417,6552,3256,1545,12294,4774
ATGAATAGAATAAGGT,sample,217313,215646,17969,197677,10470,187207,54460,3274,76207,8195,130667,45071,9354,2304,6187,4155
CCTAACTAAATAAGGT,sample,116430,115427,6324,109103,8678,100425,67366,4455,15514,1933,82880,11157,5964,3408,6345,5282
GCGCAATAAATAAGGT,sample,173218,172535,4629,167906,17663,150243,118942,9884,12089,1559,131031,7769,4486,3006,22402,11854
AACCGGTTCAGGACCA,sample,67188,66761,6325,60436,4032,56404,23521,1594,21076,3079,44597,7134,5712,3133,2299,2335
AGAGTTCTCAGGACCA,sample,123238,121905,11909,109996,10234,99762,46245,3563,26442,3240,72687,20272,7323,2014,13429,6215
GCAACTAGCAGGACCA,sample,112577,112060,2340,109720,8678,101042,81149,7253,6807,1003,87956,4830,4757,3960,9009,5304
GACTCAAGCAGGACCA,sample,40344,40139,782,39357,4146,35211,28960,2612,2291,291,31251,1057,1336,1275,5291,2834
TCTCAGGACAGGACCA,sample,171206,170164,9509,160655,17298,143357,95250,7416,21899,2337,117149,16455,7209,3204,18222,11841
GATGCGTTCAGGACCA,sample,179563,178556,9013,169543,16644,152899,93484,8402,27838,3065,121322,20110,7263,3252,14720,10718
ATGGCGTTCAGGACCA,sample,134257,133439,3546,129893,17410,112483,100103,8465,2414,225,102517,1276,1097,1470,24451,12170
ACGCTTAACAGGACCA,sample,98333,97531,6492,91039,11681,79358,47207,3571,15098,1770,62305,11712,5242,1876,15325,7658
CATTCGGTCAGGACCA,sample,149262,147931,8949,138982,13598,125384,77128,5363,23650,2447,100778,16796,6803,3247,16037,8613
CTAAGCATCAGGACCA,sample,205017,203558,11741,191817,15395,176422,124039,8900,21590,2465,145629,19428,6761,2929,17166,9897
CCTAGCGGCAGGACCA,sample,89933,89350,2407,86943,7121,79822,62188,6194,6615,911,68803,3914,2689,1754,12545,5028
TAACGAAGCAGGACCA,sample,143475,142512,3163,139349,8301,131048,118723,9257,1728,321,120451,1019,1680,2583,9929,5962
GCGTTACCCAGGACCA,sample,93096,92162,4530,87632,7617,80015,56781,3962,11049,1268,67830,6955,3615,2391,10672,5096
CAGCTTCGCAGGACCA,Neg_Ctrl,1351,980,368,612,48,564,367,41,109,3,476,44,246,160,63,23
TTATGACGCAGGACCA,sample,115909,114757,8386,106371,6019,100352,47041,2917,28325,3264,75366,18805,6651,1944,10976,3321
AAGTAGAGCAGGACCA,sample,161940,160467,6099,154368,8282,146086,102483,8134,21834,2323,124317,11312,4863,2770,12493,5361
TAACGCCACAGGACCA,sample,117915,116540,10763,105777,6570,99207,51253,3563,25997,3329,77250,15065,7561,3688,6241,3412
GCGCAATACAGGACCA,sample,41158,40669,3183,37486,2771,34715,18286,1447,9280,1018,27566,4684,3441,1644,3391,1600
TATACGGACCTCGTTG,sample,132881,132105,3118,128987,15639,113348,101285,8975,2139,108,103424,841,1066,1566,28969,12003
CTAGCGACCCTCGTTG,sample,19908,19724,2243,17481,1461,16020,6556,494,5207,708,11763,3055,2756,1076,1712,882
GGTAGAGACCTCGTTG,sample,135467,134395,4010,130385,9007,121378,88704,5011,18247,1960,106951,7456,2997,1576,17224,5219
ATTCAAGGCCTCGTTG,sample,80082,79340,4573,74767,5186,69581,43205,2912,14699,1760,57904,7005,4595,2558,10729,3200
GACTCAAGCCTCGTTG,sample,85869,85389,6836,78553,7892,70661,34021,2436,18136,1834,52157,14234,6231,1840,10731,4105
TCTCAGGACCTCGTTG,sample,110737,110026,2963,107063,8596,98467,77228,4951,11242,1568,88470,3478,3330,3150,11266,5583
GATGCGTTCCTCGTTG,sample,143639,142647,11134,131513,8360,123153,58001,4937,30398,3382,88399,26435,8327,1915,13548,4507
TGCGCGTTCCTCGTTG,Neg_Ctrl,1354,801,370,431,31,400,233,19,82,8,315,58,136,85,78,10
ACGCTTAACCTCGTTG,sample,162352,161021,10536,150485,10723,139762,75218,6132,30279,3354,105497,24779,8407,2531,13301,6512
GCTCTTCTCCTCGTTG,sample,157724,156464,5973,150491,9918,140573,94537,5497,23292,2414,117829,14833,5128,1980,17502,5875
GAGATTCTCCTCGTTG,sample,94378,93685,2198,91487,9470,82017,72689,6216,1390,53,74079,1669,944,1219,16360,6389
CTAACCGGCCTCGTTG,Neg_Ctrl,972,515,222,293,14,279,193,14,43,9,236,20,130,86,34,9
GCTGCTTCCCTCGTTG,sample,117421,116551,6013,110538,7019,103519,58138,5031,24047,2843,82185,13460,5078,2025,12674,4047
GCCTATTCCCTCGTTG,sample,104450,103637,2076,101561,9181,92380,81852,6152,2469,321,84321,1586,1043,1348,15813,6300
AGCAGAGCCCTCGTTG,sample,117995,117288,2863,114425,12505,101920,84803,6753,5483,678,90286,4203,2894,2160,20903,8061
AAGTAGAGCCTCGTTG,sample,108338,107610,2052,105558,9465,96093,86483,7181,1344,119,87827,966,871,1260,22699,6841
TAACGCCACCTCGTTG,sample,69702,68869,9073,59796,4632,55164,18529,1439,17785,1855,36314,15556,6695,2090,3152,2460
ATTCTACCCCTCGTTG,Pos_Ctrl,26400,25966,2070,23896,1410,22486,18723,1581,1443,231,20166,508,4048,3957,1240,784
TTAACTGACCTCGTTG,sample,136238,135523,3797,131726,15096,116630,89184,8254,9446,1067,98630,8679,4923,2809,18696,10170
CTGGTCTTTTGCGGAC,sample,74653,74306,1658,72648,13332,59316,52003,5217,1368,54,53371,674,1038,1622,12128,9128
CATACTCCTTGCGGAC,sample,97591,97158,1940,95218,11559,83659,72560,7072,2547,263,75107,1217,1750,2391,15846,8315
GGTAGAGATTGCGGAC,sample,116651,115921,2592,113329,12137,101192,82032,7327,8799,720,90831,2314,1265,1094,19221,7963
TACGCGAGTTGCGGAC,sample,133286,132518,4333,128185,9893,118292,87776,6799,12502,1592,100278,9623,4810,2079,22015,5843
CCGTACGCTTGCGGAC,sample,38056,37823,1496,36327,5602,30725,23637,2051,2929,312,26566,1796,3355,2961,4468,3865
AGCGTCTTTTGCGGAC,sample,137189,136200,7914,128286,10633,117653,64671,4085,28768,3513,93439,16616,5798,1971,14769,6694
ACGCTTAATTGCGGAC,sample,86737,86201,3354,82847,10082,72765,52080,3499,9919,1207,61999,6060,3961,2269,14671,6876
GAGATTCTTTGCGGAC,sample,49362,48870,3871,44999,3607,41392,20017,1478,12569,1527,32586,5801,4000,1669,4291,2082
CGCGGTCGTTGCGGAC,sample,54016,53591,3498,50093,3826,46267,25053,1912,11326,1350,36379,6626,3850,1479,5341,2142
CGTAGAACTTGCGGAC,sample,143353,142345,6928,135417,12677,122740,87305,6365,15315,1424,102620,12331,4543,1545,18619,8088
CCTAACTATTGCGGAC,sample,126380,125304,5906,119398,8714,110684,64150,4096,26629,2740,90779,13069,4390,1672,11734,5866
AGCTGAATTCCATTGG,sample,83607,82969,7008,75961,6925,69036,32707,2825,16817,1911,49524,14776,5695,1755,8082,3734
CTAGCGACTCCATTGG,sample,76948,76369,3170,73199,7832,65367,48064,3893,7236,843,55300,5331,3245,1706,9001,5464
GGTAGAGATCCATTGG,sample,75556,75095,2596,72499,7833,64666,49650,3844,5828,461,55478,4883,3230,2024,11742,5535
ATTCAAGGTCCATTGG,sample,125280,124448,6649,117799,7186,110613,64485,5064,23348,2770,87833,14946,5795,1953,11733,4280
TGATTCCGTCCATTGG,sample,138098,137474,1741,135733,9610,126123,111632,11670,1300,447,112932,1074,1528,2440,13635,6407
TGGATCAATCCATTGG,sample,15956,15779,2732,13047,707,12340,2774,178,5032,533,7806,3823,2761,607,755,235
ATGGCGTTTCCATTGG,sample,26966,26780,1352,25428,1715,23713,15472,1154,4650,545,20122,1892,2491,1836,1417,1131
TAGCGAGTTCCATTGG,sample,84544,84042,5063,78979,5816,73163,42178,3301,13903,1465,56081,12316,5468,2250,5837,3387
TAACGAAGTCCATTGG,sample,85492,84909,4310,80599,6728,73871,46797,3869,12315,1667,59112,9223,4500,1699,12380,4447
GCGTTACCTCCATTGG,sample,106605,105816,2696,103120,6452,96668,87691,6265,1543,176,89234,993,2019,3172,10461,4495
GGCGTACCTCCATTGG,sample,75479,74922,2339,72583,5719,66864,55097,3546,4189,465,59286,3567,2462,1619,10657,4138
AAGTAGAGTCCATTGG,sample,35521,35171,4200,30971,2461,28510,14335,1096,6750,756,21085,5573,3938,1428,3592,1473
GACTAACCTCCATTGG,Neg_Ctrl,733,507,150,357,24,333,234,33,39,7,273,20,133,95,65,14
GTCGTTCTCATAGGCG,sample,12315,12242,641,11601,1620,9981,6096,556,1930,279,8026,1120,1874,1227,1722,1059
GAGCCTCCCATAGGCG,sample,163315,161550,13162,148388,8319,140069,58039,4012,47661,5295,105700,25062,8168,3075,7205,4664
CTAGCGACCATAGGCG,sample,50484,49819,7074,42745,3222,39523,11899,783,13854,1461,25753,11526,5684,1384,2590,1758
TCTCAGGACATAGGCG,sample,4776,4742,349,4393,486,3907,2050,214,876,87,2926,680,1139,686,312,280
ACGCTTAACATAGGCG,sample,200199,198710,13278,185432,16038,169394,86421,6089,41015,3963,127436,31906,9092,2517,23384,9469
CCTAGCGGCATAGGCG,sample,111587,111002,2147,108855,12845,96010,85420,7331,1711,111,87131,1437,1717,2474,18041,9053
GGCGACGACATAGGCG,sample,57013,56447,3614,52833,4902,47931,33292,2399,6467,687,39759,5086,4487,3038,3945,3359
GCGTTACCCATAGGCG,sample,170935,169532,13169,156363,10273,146090,61668,4205,44019,5018,105687,31180,9009,2443,12311,5303
GTCGCGAACATAGGCG,sample,119551,118570,8519,110051,9353,100698,53515,4149,22907,2532,76422,17595,6584,1871,13683,5377
TTATGACGCATAGGCG,sample,173916,172647,10335,162312,9867,152445,94196,6412,31395,3933,125591,16509,6908,3242,12648,5838
ATGAATAGCATAGGCG,sample,227127,225219,16143,209076,12006,197070,110562,8334,42233,4880,152795,31061,9486,3126,13303,7803
AAGTAGAGCATAGGCG,sample,165603,163970,13655,150315,10647,139668,73671,5362,30720,3169,104391,26746,8585,2648,14790,6550
GACTAACCCATAGGCG,sample,123343,122494,2459,120035,13912,106123,93377,9131,1544,610,94921,1461,934,1311,23698,9349
CCTAACTACATAGGCG,sample,141780,140507,5165,135342,11429,123913,105153,7283,6042,640,111195,4795,3877,3279,22731,7744
TTAACTGACATAGGCG,sample,147926,146622,10267,136355,11986,124369,70081,5989,24348,2731,94429,21220,6873,1932,15718,7312
ATATGCAACATAGGCG,sample,34940,34703,1672,33031,3281,29750,15348,1371,9364,896,24712,2771,2748,1394,3817,1927
TCTAGGTTTTGGAGAG,sample,200451,198898,4466,194432,28650,165782,152361,8921,3022,319,155383,1159,1071,1536,45120,21551
CTGGTCTTTTGGAGAG,Pos_Ctrl,42322,41470,3276,38194,2476,35718,29471,2778,2378,328,31849,763,4796,4874,2791,1232
AGCTGAATTTGGAGAG,sample,165749,164312,10934,153378,16394,136984,79029,6701,27953,3072,106982,20229,6941,2556,19114,10602
GACGTATGTTGGAGAG,sample,135669,134457,9886,124571,10537,114034,71952,4814,20101,1842,92053,15325,7142,3506,10855,6613
CATACTCCTTGGAGAG,sample,106505,105936,5258,100678,10396,90282,54467,4471,17161,1681,71628,12502,6214,2798,10697,6274
TCATCGAATTGGAGAG,sample,131525,130552,12571,117981,7448,110533,41870,3004,37647,3883,79517,24129,8592,2650,9226,4244
ATTCAAGGTTGGAGAG,sample,190035,188938,3273,185665,16513,169152,151069,13875,3081,69,154150,1058,1345,1851,24546,10216
TGATTCCGTTGGAGAG,Pos_Ctrl,49751,49267,2875,46392,2220,44172,36808,3474,2625,373,39433,892,5243,6133,2378,993
GACTCAAGTTGGAGAG,sample,295524,293475,11321,282154,14544,267610,199859,13212,27867,3390,227726,23282,7923,3926,23262,9205
TCTCAGGATTGGAGAG,sample,160932,159620,11790,147830,10216,137614,66302,4790,40077,4732,106379,21713,7187,2389,12900,5655
ATGGCGTTTTGGAGAG,sample,86728,86101,6010,80091,5554,74537,35320,2155,20965,2284,56285,13813,6367,1984,9007,3011
GCTCTTCTTTGGAGAG,sample,115930,114600,7410,107190,10026,97164,56821,4352,19744,2048,76565,14199,5900,1980,13930,5975
TAACGAAGTTGGAGAG,sample,76029,75314,5322,69992,6872,63120,40438,2648,11001,1113,51439,7920,4885,2535,7364,4266
GCTGCTTCTTGGAGAG,sample,119885,118953,6525,112428,9732,102696,71160,4969,15109,2362,86269,9096,4691,2346,16908,6757
CAGCTTCGTTGGAGAG,sample,96742,95798,5276,90522,6543,83979,59010,3968,12053,1409,71063,7539,5195,3404,9139,4198
CGCGGTCGTTGGAGAG,sample,112868,111911,5605,106306,9147,97159,77105,5592,8336,1098,85441,5028,2776,2146,12333,6674
TTATGACGTTGGAGAG,sample,174376,172936,9828,163108,10953,152155,101144,6322,24105,2875,125249,17709,7187,3019,14175,6314
TCTCCTAGTTGGAGAG,sample,101598,100750,5038,95712,10377,85335,59206,4893,11248,1217,70454,8771,4824,2073,18451,7202
TCAATCAGTTGGAGAG,sample,125537,124199,10236,113963,5636,108327,44938,2707,36782,4615,81720,19285,7350,2403,7310,2816
ATTCTACCTTGGAGAG,sample,123244,122053,5793,116260,7324,108936,66979,4844,22916,3139,89895,11058,4412,1914,12628,4215
AACCGGTTTTCAAGCC,sample,170251,169354,8022,161332,16986,144346,100013,7555,20394,1979,120407,14405,5774,2476,28785,11071
GTCGTTCTTTCAAGCC,sample,142778,141348,13619,127729,12023,115706,50897,4365,30846,3325,81743,26273,7854,1842,16367,7011
AGCTGAATTTCAAGCC,sample,34769,34466,2808,31658,3702,27956,13579,1184,7698,835,21277,4660,3498,1546,3962,2409
TATACGGATTCAAGCC,sample,78338,77819,4287,73532,8427,65105,43681,3277,10829,1275,54510,6043,4891,3207,8441,6061
GAGCCTCCTTCAAGCC,sample,92339,91353,9470,81883,5642,76241,25755,1454,27351,3047,53106,18634,7015,1854,4551,3247
CATACTCCTTCAAGCC,sample,95582,94807,6979,87828,8257,79571,49261,4018,14183,1461,63444,10648,6069,2606,9984,5347
TCGAACGATTCAAGCC,sample,63779,63196,5323,57873,6208,51665,22219,1771,14434,1521,36653,11720,4901,1171,6726,4019
ATTCAAGGTTCAAGCC,sample,72946,72388,4760,67628,6015,61613,35605,2678,13131,1760,48736,8439,4599,2021,6014,4140
TGATTCCGTTCAAGCC,sample,109572,108990,2934,106056,10624,95432,82390,5474,3918,631,86308,3019,2932,3226,13111,7968
GACTCAAGTTCAAGCC,sample,68706,68225,2674,65551,7283,58268,40812,2924,8902,1088,49714,4542,2397,1652,10643,5517
ATACGTTCTTCAAGCC,sample,80360,80013,1766,78247,10919,67328,59251,4871,1717,261,60968,1228,2016,2796,10744,7863
TGGATCAATTCAAGCC,sample,82107,81542,2432,79110,9301,69809,60614,4722,2511,320,63125,1642,1988,2416,10956,6834
GATGCGTTTTCAAGCC,sample,50033,49596,3338,46258,4962,41296,27285,1658,6368,695,33653,5290,3249,1534,8408,3055
TGCGCGTTTTCAAGCC,sample,45833,45379,2248,43131,3587,39544,23006,1381,10448,1110,33454,3599,2559,1479,4331,2443
CATTCGGTTTCAAGCC,sample,118797,117852,7264,110588,7239,103349,64020,4941,17544,1731,81564,15113,5663,1841,10893,4040
AAGGTCTGTTCAAGCC,sample,108633,107892,5070,102822,8424,94398,71384,5010,9384,910,80768,7710,4692,2551,12988,5493
CGTCGAGGTTCAAGCC,Pos_Ctrl,16967,16658,1451,15207,770,14437,11871,1098,1014,136,12885,318,3115,2805,951,479
AAGTAGAGTTCAAGCC,sample,107374,106403,7272,99131,7135,91996,62816,4327,13433,1462,76249,9958,6162,3197,8185,4397
TAACGCCATTCAAGCC,sample,121146,120330,5218,115112,7032,108080,81216,6296,9463,1016,90679,10089,4233,2114,9950,3998
CGTAGAACTTCAAGCC,sample,71100,70183,8120,62063,3720,58343,14432,564,22040,2162,36472,19145,6426,905,3736,1791
TTAACTGATTCAAGCC,sample,83564,82566,11186,71380,3527,67853,17751,1148,27841,3176,45592,17937,7501,1747,2335,1411
ATATGCAATTCAAGCC,sample,63981,63410,4912,58498,4619,53879,20209,1546,19022,1768,39231,11334,4439,1239,3481,3248
GTCGTTCTAACTTAAC,Neg_Ctrl,1046,699,162,537,59,478,328,16,84,11,412,39,173,102,101,25
AGCTGAATAACTTAAC,sample,93080,92664,2987,89677,10757,78920,61435,5513,6087,609,67522,5276,3534,2583,11221,7260
GACGTATGAACTTAAC,sample,52980,52650,3556,49094,5364,43730,23366,1670,10097,1294,33463,7303,4008,1429,7922,3550
CATAATGGAACTTAAC,sample,110054,109452,3336,106116,14030,92086,73378,4637,8488,993,81866,4590,2375,1742,19206,9797
GGTAGAGAAACTTAAC,sample,115806,115049,8770,106279,9802,96477,54758,4094,19852,2086,74610,15687,6157,2198,11826,5634
TCATCGAAAACTTAAC,sample,67550,67193,3892,63301,6331,56970,38598,2923,8352,706,46950,6391,4121,2073,8446,4022
TCATACCAAACTTAAC,sample,110646,109975,4966,105009,13182,91827,60235,4535,13847,1684,74082,11526,4092,1580,13116,8723
TGATTCCGAACTTAAC,sample,80450,79800,9196,70604,4754,65850,22147,1796,23135,2474,45282,16298,7311,2065,4139,1995
GCAACTAGAACTTAAC,Neg_Ctrl,609,314,142,172,22,150,105,6,22,0,127,17,71,46,18,8
TACGCGAGAACTTAAC,sample,75791,75330,3953,71377,7388,63989,46243,3247,8744,989,54987,4766,4253,2878,9547,5080
ATACGTTCAACTTAAC,sample,90627,89998,4693,85305,7081,78224,46138,3170,17876,2323,64014,8717,4329,2240,7612,4818
ATGGCGTTAACTTAAC,sample,108315,107611,6180,101431,6551,94880,51962,4070,22725,2611,74687,13512,5595,1936,12674,3899
ACGCTTAAAACTTAAC,sample,126815,125887,8883,117004,9779,107225,59723,4281,22398,2307,82121,18516,6319,1855,16080,5822
CGTCGAGGAACTTAAC,sample,31476,31174,2263,28911,3926,24985,13862,834,5437,566,19299,4286,3187,1277,4347,2503
ATGAATAGAACTTAAC,sample,112049,111281,10094,101187,7069,94118,42345,3004,25290,2519,67635,20960,7244,1848,11136,3849
AAGTAGAGAACTTAAC,sample,99935,99222,3655,95567,6761,88806,64480,5116,12031,1806,76511,5373,3213,2499,11162,4466
TCAATCAGAACTTAAC,sample,60402,59938,2445,57493,5852,51641,40166,3306,4479,395,44645,3295,2045,1256,9977,4038
TAACGCCAAACTTAAC,sample,151437,150169,10577,139592,8912,130680,81748,6422,23172,2244,104920,17094,7875,3225,9184,4809
AACCGGTTATACTTGA,sample,1707,1695,88,1607,154,1453,978,71,249,9,1227,146,490,348,203,102
TCTAGGTTATACTTGA,sample,162825,161928,4648,157280,19355,137925,111964,7815,10002,1296,121966,6848,4542,3773,19401,13833
CATACTCCATACTTGA,sample,161055,159690,4969,154721,12270,142451,122698,9780,5489,606,128187,3878,2858,3352,13373,8817
TCGAACGAATACTTGA,sample,100471,99781,2400,97381,10320,87061,78657,5791,1095,270,79752,1248,1163,1589,21585,8096
ATTCAAGGATACTTGA,sample,231463,229572,13294,216278,10445,205833,117252,8839,48392,5256,165644,26094,8101,2777,15017,5763
TACGCGAGATACTTGA,sample,279710,277951,12017,265934,17172,248762,178601,17536,27451,3003,206052,22171,7247,3097,15323,11144
ATACGTTCATACTTGA,sample,36460,36075,3282,32793,3284,29509,17035,1292,6092,627,23127,4463,3721,1961,3323,1956
TGGATCAAATACTTGA,sample,141563,140962,2449,138513,15107,123406,109686,9748,1751,603,111437,1618,1374,2001,26208,11205
ACGCTTAAATACTTGA,sample,125042,124312,6694,117618,15244,102374,76288,6165,11849,1531,88137,6541,3461,2016,18043,10350
CATTCGGTATACTTGA,sample,178412,177204,12944,164260,14464,149796,91939,6844,33785,4130,125724,13098,5255,2407,19363,9212
GCTCTTCTATACTTGA,sample,114185,113455,3982,109473,10809,98664,70677,4872,14935,1616,85612,6564,3328,2096,23402,7212
CTAAGCATATACTTGA,sample,210989,209737,6201,203536,15283,188253,156736,11263,13654,1260,170390,5340,3322,3885,24707,10768
AAGGTCTGATACTTGA,sample,149554,148352,13900,134452,8386,126066,41918,2882,42683,4488,84601,34095,8680,2033,7522,4286
CCTAGCGGATACTTGA,sample,115470,114755,2634,112121,12649,99472,87609,8422,1994,304,89603,1143,1879,2994,11542,9469
GCTGCTTCATACTTGA,sample,97015,96347,3513,92834,11513,81321,64362,4663,6816,815,71178,4665,4133,3181,8590,7904
CGTCGAGGATACTTGA,sample,101022,100093,6648,93445,7072,86373,37313,1831,26266,2826,63579,18137,5360,1435,7109,4068
CAGCTTCGATACTTGA,Neg_Ctrl,1503,1064,267,797,54,743,490,49,115,9,605,80,273,198,107,39
CGCGGTCGATACTTGA,sample,100875,100121,6972,93149,7394,85755,52497,4711,14153,1533,66650,12861,5734,2156,10267,4193
TTATGACGATACTTGA,sample,151300,150281,5175,145106,13397,131709,102379,8018,13332,986,115711,6994,3243,2268,22026,9641
ATGAATAGATACTTGA,sample,70685,70169,3952,66217,6138,60079,38524,2946,10309,1261,48833,7039,4996,2871,8399,4163
TCAATCAGATACTTGA,sample,154782,153562,9734,143828,11067,132761,81225,5859,23882,2430,105107,19365,7079,2685,11963,6505
GACTAACCATACTTGA,sample,123598,122612,6878,115734,10470,105264,72380,4356,13599,1485,85979,13444,4183,1775,19010,7126
AGATACTAATACTTGA,sample,161126,160206,3741,156465,16830,139635,124457,11238,2891,132,127348,917,1781,2624,25073,12106
CCTAACTAATACTTGA,sample,99411,98717,2355,96362,9778,86584,76505,6879,2141,418,78646,641,1103,1382,24063,7333
ATATGCAAATACTTGA,sample,157799,156852,6004,150848,11907,138941,105101,6777,13509,1621,118610,11933,5317,2927,13006,7461
AACCGGTTATCCGCGA,sample,53009,52704,2309,50395,5012,45383,32417,2319,6344,682,38761,3621,3027,2151,5647,3067
CTGGTCTTATCCGCGA,sample,122781,121648,12326,109322,10168,99154,34112,3022,31216,3360,65328,27444,7469,1442,11110,5810
GACGTATGATCCGCGA,sample,113359,112520,5535,106985,12151,94834,69574,4911,11592,1310,81166,7447,4333,2502,16217,8629
CATAATGGATCCGCGA,sample,170177,168914,9262,159652,12523,147129,108968,7118,16886,1651,125854,12506,6647,4005,13788,8474
CTAGCGACATCCGCGA,sample,166485,165072,7876,157196,10358,146838,105399,7034,21075,2221,126474,11109,5068,3232,13662,6989
TCATCGAAATCCGCGA,sample,163560,162355,5565,156790,13792,142998,105752,11599,13582,1997,119334,10068,2965,1484,23626,8422
ATACGTTCATCCGCGA,sample,209364,208093,9525,198568,14645,183923,133501,10873,20007,2203,153508,17339,7404,3682,19132,8957
TGGATCAAATCCGCGA,sample,182460,181018,12847,168171,15476,152695,86153,6761,30655,3290,116808,25836,7400,1971,21257,9650
GGCAGGTTATCCGCGA,sample,146848,145890,7076,138814,14408,124406,93405,6197,12895,1194,106300,10715,5446,2910,23613,8882
GATGCGTTATCCGCGA,sample,196477,195070,10868,184202,16600,167602,105226,8942,30176,2773,135402,20485,6144,2355,25792,10843
ATGGCGTTATCCGCGA,sample,237949,236397,10966,225431,14861,210570,141786,9867,35360,4070,177146,19487,6465,2983,17351,8949
CCATTCTTATCCGCGA,sample,173004,171523,12676,158847,15465,143382,79517,5902,29466,3181,108983,25316,8128,2547,19309,9377
TAGCGAGTATCCGCGA,sample,188818,187560,8763,178797,17842,160955,106678,8520,26347,2883,133025,16527,5516,2284,27589,12055
AAGGTCTGATCCGCGA,sample,145174,144314,2540,141774,12823,128951,114666,10303,2893,43,117559,1046,919,1366,19078,8794
ATACCGCCATCCGCGA,sample,159045,157602,15801,141801,9220,132581,28495,1544,51943,5517,80438,45082,10402,1884,4408,4852
GGCGTACCATCCGCGA,sample,119589,119092,3193,115899,13702,102197,81395,6439,9485,1085,90880,3793,2884,2265,18996,9780
CAGCTTCGATCCGCGA,sample,120123,118971,10110,108861,10350,98511,47348,3746,23339,2291,70687,21787,6519,1393,13525,6314
CGCGGTCGATCCGCGA,sample,91019,90178,5893,84285,6117,78168,52863,3352,11186,1243,64049,9524,5327,2572,12228,3384
TTATGACGATCCGCGA,sample,167460,166140,12264,153876,10994,142882,84010,6389,26399,2796,110409,23288,7416,2214,15293,6672
CCTAACTAATCCGCGA,sample,89604,88386,10406,77980,6916,71064,32852,2635,18364,2103,51216,15110,6727,2307,5885,4121
ATATGCAAATCCGCGA,sample,113875,113107,7620,105487,8372,97115,46731,3717,25889,2820,72620,17958,6934,2104,9224,4894
TCTAGGTTAGGACTCA,sample,75259,74759,2996,71763,11501,60262,49049,3466,4296,565,53345,2886,3387,2893,11926,8105
GTCGTTCTAGGACTCA,sample,88738,88191,3293,84898,11852,73046,54975,3781,7683,913,62658,5694,4415,2722,14045,8268
AGAGTTCTAGGACTCA,sample,137236,136201,7943,128258,15153,113105,63390,4623,28968,3736,92358,12388,5279,2480,17596,11140
GACGTATGAGGACTCA,sample,161944,160556,8474,152082,13766,138316,97582,6436,18035,1817,115617,14446,6636,3061,16477,8644
TATACGGAAGGACTCA,sample,127093,126200,5089,121111,13356,107755,82394,5859,10970,1173,93364,7359,4284,2323,20369,10107
GGAGAAGCAGGACTCA,sample,100583,99827,3698,96129,13930,82199,67893,4654,5349,461,73242,3842,2081,1584,19888,10085
GAGCCTCCAGGACTCA,sample,129998,129128,3761,125367,14674,110693,92812,7303,5700,647,98512,4231,3370,2836,20153,10715
CGTCGCCAAGGACTCA,sample,151689,150314,7710,142604,13680,128924,87799,6408,18054,2322,105853,14341,6411,2826,14482,9050
TCATACCAAGGACTCA,sample,181478,180275,8250,172025,13582,158443,114803,8049,18027,2037,132830,15527,5550,3128,23851,9205
ATACGTTCAGGACTCA,sample,179482,178059,11239,166820,15032,151788,102415,7454,21438,2148,123853,18333,6526,2738,16549,10807
CCGCAGTCAGGACTCA,sample,119179,118142,6005,112137,12850,99287,69954,5195,13112,1354,83066,9672,5110,2078,21261,8479
GCTCTTCTAGGACTCA,sample,11664,11494,1153,10341,859,9482,5173,407,2066,222,7239,1614,1614,816,1276,517
GAGATTCTAGGACTCA,sample,195551,193997,9784,184213,7785,176428,105532,7387,43066,5853,148598,14590,6831,3639,10809,4075
CTAACCGGAGGACTCA,sample,142781,141908,4969,136939,6553,130386,95045,6670,17461,1851,112506,9359,5183,3231,15237,3859
GCTGCTTCAGGACTCA,sample,125222,124280,6283,117997,9361,108636,73435,5784,15405,1658,88840,12354,5261,2162,15393,5768
GCCTATTCAGGACTCA,sample,140855,139836,4491,135345,9667,125678,93521,8549,13698,1792,107219,8118,3492,2135,16012,6560
ATACCGCCAGGACTCA,sample,136291,135171,5990,129181,8844,120337,75019,6162,23548,3187,98567,12421,4900,2261,15817,5752
GTCGCGAAAGGACTCA,sample,115117,114392,3231,111161,13370,97791,87473,6936,2258,189,89731,935,1230,1637,22232,9632
CAGCTTCGAGGACTCA,sample,79555,78801,7029,71772,4183,67589,28097,1633,23053,2450,51150,12356,6286,2073,8726,1980
CGCGGTCGAGGACTCA,sample,89785,89095,4286,84809,9176,75633,52154,4444,11826,1224,63980,5985,4543,3029,10902,6678
AAGTAGAGAGGACTCA,sample,112102,111009,7152,103857,5310,98547,53703,3922,25398,3176,79101,12348,5908,2640,7408,3035
TCAATCAGAGGACTCA,sample,127895,127069,7127,119942,9769,110173,68422,6129,18775,2168,87197,14679,5800,1892,15646,5784
TAACGCCAAGGACTCA,sample,80073,79500,6135,73365,6383,66982,37527,2642,14507,1783,52034,10523,5872,2477,8582,3945
CGCGAGACAGGACTCA,sample,141266,140157,7088,133069,10085,122984,83902,7095,16564,2167,100466,13256,5504,2608,10931,5927
CGTAGAACAGGACTCA,sample,18331,18049,1836,16213,1450,14763,7854,488,3511,373,11365,2537,2389,1055,1757,873
CCTAACTAAGGACTCA,Pos_Ctrl,29571,29269,1523,27746,1478,26268,22085,1936,1502,151,23587,594,4153,4350,1757,619
TTAACTGAAGGACTCA,sample,188483,187148,7864,179284,13657,165627,109168,8678,26330,3199,135498,18252,7011,2668,24162,8297
AGCTGAATTATTGAAC,sample,57404,57216,1088,56128,8722,47406,41119,3956,1316,237,42435,778,2554,3343,6753,6063
GACGTATGTATTGAAC,sample,58461,58143,2077,56066,6930,49136,36399,3007,5062,556,41461,4112,3884,2833,7438,4436
CATAATGGTATTGAAC,sample,80483,79968,2901,77067,7892,69175,44932,5008,10982,906,55914,7347,4128,1440,8308,5160
CGTCGCCATATTGAAC,sample,183515,182524,5272,177252,12212,165040,119048,11157,19941,3009,138989,11885,5448,2742,15308,7129
TCATCGAATATTGAAC,sample,182915,181888,17072,164816,12484,152332,60313,4222,43763,4488,104076,39546,10513,2796,10532,5940
TCATACCATATTGAAC,sample,256193,254377,11186,243191,12550,230641,116312,8492,66486,7203,182798,32148,8504,2498,17136,6227
ATTCAAGGTATTGAAC,sample,281123,279337,10532,268805,13053,255752,189002,13152,26982,2619,215984,23997,7754,3118,17989,7340
GACTCAAGTATTGAAC,sample,64726,64358,2713,61645,4668,56977,45512,2747,4464,421,49976,3833,3697,3117,5957,3065
CCGTACGCTATTGAAC,sample,35214,34719,5148,29571,1759,27812,7753,463,10806,1059,18559,7731,4739,1346,1270,762
TCTCAGGATATTGAAC,sample,96092,95397,5076,90321,9460,80861,56265,3895,11106,1108,67371,8487,4633,2252,13139,6889
GATGCGTTTATTGAAC,sample,44848,44394,2658,41736,3335,38401,28137,1880,4226,471,32363,3687,2924,1890,4633,2261
GAGATTCTTATTGAAC,sample,35532,35270,1369,33901,3530,30371,23036,1713,3056,286,26092,2280,1944,1298,6229,2663
CTAACCGGTATTGAAC,sample,37034,36650,3018,33632,2424,31208,16392,1267,6965,746,23357,5838,3712,1512,3345,1385
GCCTATTCTATTGAAC,sample,52395,51876,2790,49086,3376,45710,34852,2282,4634,386,39486,3556,3060,2284,6084,2189
TTATGACGTATTGAAC,sample,80157,79370,4357,75013,5621,69392,41906,2939,13673,1680,55579,9194,4203,1566,10415,3615
TAACGCCATATTGAAC,sample,115569,114757,6450,108307,6597,101710,66029,5042,15619,1942,81648,13078,5772,2386,11270,3661
ATTCTACCTATTGAAC,sample,58032,57475,1708,55767,5558,50209,44954,3035,1192,121,46146,907,892,1131,12684,3700
GCGCAATATATTGAAC,sample,92478,91549,6027,85522,7330,78192,55544,3965,10127,1149,65671,7407,4132,2023,11456,4894
AACCGGTTGTTCAACT,sample,58573,58147,2853,55294,4056,51238,31789,2912,8822,747,40611,6968,3576,1300,8650,2280
AGAGTTCTGTTCAACT,sample,28765,28542,910,27632,2590,25042,22296,2005,540,18,22836,183,532,741,6396,1530
TATACGGAGTTCAACT,sample,70959,70441,3483,66958,4867,62091,39414,3583,10319,1073,49733,7702,4471,2137,4832,2539
TCGAACGAGTTCAACT,sample,101294,100361,9546,90815,3852,86963,30697,1866,33058,3399,63755,17943,7799,2274,4044,1339
CGTCGCCAGTTCAACT,sample,89025,88368,3577,84791,5758,79033,59750,5119,8706,811,68456,4647,3423,2445,8234,3532
TCATCGAAGTTCAACT,sample,26713,26388,3542,22846,1117,21729,5853,465,8210,846,14063,6355,3788,891,1439,417
ATACGTTCGTTCAACT,sample,8020,7905,453,7452,872,6580,4266,297,1222,150,5488,645,1434,1003,491,615
CCGTACGCGTTCAACT,sample,28765,28461,2125,26336,2470,23866,14342,1227,4634,482,18976,3181,2420,1136,4655,1510
GATGCGTTGTTCAACT,sample,28682,28365,1438,26927,2654,24273,14016,931,5783,531,19799,3012,1651,957,4743,1842
AGCGTCTTGTTCAACT,sample,59058,58535,2439,56096,4486,51610,41995,2560,3633,365,45628,3057,3533,3224,5132,3179
GCTCTTCTGTTCAACT,sample,28846,28532,1578,26954,3179,23775,14937,886,4603,325,19540,3024,1611,978,4668,2208
GAGATTCTGTTCAACT,sample,32854,32564,1367,31197,1813,29384,22484,1484,3402,424,25886,1590,3059,2726,2041,1122
CGCGAGACGTTCAACT,sample,25284,25056,1151,23905,2529,21376,16229,1085,2259,206,18488,1597,2449,1967,2459,1733
GCGCAATAGTTCAACT,Neg_Ctrl,302,186,55,131,6,125,84,4,20,0,104,17,57,37,19,9
TTAACTGAGTTCAACT,sample,20476,20260,1076,19184,1566,17618,12392,971,2392,265,14784,1598,2223,1671,2296,995
AACCGGTTCTGAGGTT,sample,32910,32397,610,31787,3512,28275,24794,2633,590,43,25384,215,753,969,5265,2307
CATAATGGCTGAGGTT,sample,235087,233520,8525,224995,13980,211015,141913,13420,33219,3860,175132,18603,6050,2309,21026,7744
CATACTCCCTGAGGTT,sample,231587,229979,17195,212784,15298,197486,93926,6963,49152,5200,143078,42245,10000,2827,17597,9183
TCATCGAACTGAGGTT,sample,207764,206623,6800,199823,14932,184891,136013,10066,27380,2910,163393,8522,4631,4476,15221,9743
TACGCGAGCTGAGGTT,sample,121272,120517,5880,114637,10627,104010,73017,5663,13463,1482,86480,10385,6309,4174,13770,6843
GACTCAAGCTGAGGTT,sample,78726,77976,3625,74351,8729,65622,40438,3133,12603,1879,53041,7569,3896,1544,8118,6109
CCGCAGTCCTGAGGTT,sample,154191,153067,10444,142623,15069,127554,72793,5717,30000,3559,102793,15485,5172,2489,16022,9490
CCATTCTTCTGAGGTT,sample,160980,159758,4494,155264,15753,139511,125295,9710,2715,231,128010,1560,1540,2296,23301,11886
CGGTTGGTCTGAGGTT,sample,32578,32167,3966,28201,3447,24754,11073,785,6706,776,17779,5414,4228,1766,3467,1923
GCTCTTCTCTGAGGTT,sample,124123,123148,5309,117839,17439,100400,81175,6329,7329,681,88504,4886,2910,2162,28847,11505
GAGATTCTCTGAGGTT,sample,123158,121978,8229,113749,9408,104341,54705,4633,25531,2734,80236,16738,6567,2751,12687,6072
CTAACCGGCTGAGGTT,sample,88131,87187,7031,80156,7561,72595,33891,2942,18002,1648,51893,16112,5502,1437,10757,4072
GGCGACGACTGAGGTT,sample,104439,103463,6660,96803,7890,88913,57275,4100,14398,1701,71673,11439,5145,2069,11515,4765
GCCTATTCCTGAGGTT,sample,9509,9304,1245,8059,907,7152,2514,172,2475,287,4989,1704,1559,482,825,464
GGCGTACCCTGAGGTT,sample,65757,65184,3242,61942,5409,56533,36815,2587,9735,1233,46550,6163,2966,1367,10407,3414
GTCGCGAACTGAGGTT,sample,117444,116409,5250,111159,5552,105607,56657,3559,30199,3817,86856,11375,4258,1797,8904,3115
ATGAATAGCTGAGGTT,sample,59316,58593,6604,51989,3349,48640,16317,907,16487,1784,32804,13145,5948,1330,4034,1653
CGTAGAACCTGAGGTT,sample,153113,151590,6492,145098,9230,135868,100982,7448,14643,1902,115625,10893,5413,3249,14775,5584
CCTAACTACTGAGGTT,sample,93358,92260,7243,85017,7567,77450,44031,2636,15724,1642,59755,13417,5558,1711,12543,4476
GCGCAATACTGAGGTT,sample,115701,114774,6685,108089,9868,98221,60267,4380,17416,1615,77683,14543,5999,2333,12545,6148
AACCGGTTAGACCGTT,sample,301282,298861,20235,278626,18099,260527,102284,8353,76656,8241,178940,64993,12584,2985,23305,8727
TCTAGGTTAGACCGTT,sample,175722,174524,3406,171118,13719,157399,144168,11105,685,60,144853,1381,911,1372,35893,8342
GACGTATGAGACCGTT,sample,263973,262113,10507,251606,19447,232159,171013,15335,23092,2624,194105,20095,7100,3521,26062,12188
CGTCGCCAAGACCGTT,sample,127571,126665,5125,121540,12342,109198,86667,7395,8617,747,95284,5772,3613,2690,16179,8211
GCAACTAGAGACCGTT,sample,16118,16012,489,15523,1881,13642,11283,926,809,82,12092,542,2922,3004,1195,1189
GACTCAAGAGACCGTT,sample,143494,142619,9206,133413,13238,120175,74788,5214,21801,2127,96589,16245,6663,2856,20888,7823
ATACGTTCAGACCGTT,sample,67861,67332,6370,60962,5255,55707,24246,1680,15697,1645,39943,12439,6421,2247,6249,2785
CCGTACGCAGACCGTT,sample,124157,123254,4298,118956,15444,103512,90511,6579,4404,468,94915,1550,1675,2045,21524,10827
GATGCGTTAGACCGTT,sample,15498,15342,1689,13653,945,12708,4631,298,4389,423,9020,2967,2426,886,1282,446
TGCGCGTTAGACCGTT,sample,229060,227630,10577,217053,15947,201106,153530,10922,18592,1502,172122,16560,5864,3112,21404,10558
CGGTTGGTAGACCGTT,sample,78696,78114,4417,73697,6753,66944,41283,2821,13193,1537,54476,8110,4738,2436,9146,3809
ACGCTTAAAGACCGTT,sample,152520,151716,4987,146729,16894,129835,103510,9747,10161,1767,113671,4650,2133,2051,28452,11282
GAGATTCTAGACCGTT,sample,107969,106903,7742,99161,11187,87974,52030,4547,15935,1667,67965,13795,5078,1501,17232,6052
CTAAGCATAGACCGTT,sample,96959,96244,3127,93117,10264,82853,67120,4740,6172,595,73292,4226,2413,2271,18601,6943
CCTAGCGGAGACCGTT,sample,17011,16776,2211,14565,1164,13401,6529,369,3442,400,9971,2661,2413,962,1594,643
GCTGCTTCAGACCGTT,sample,197177,194885,14466,180419,11557,168862,93113,6207,51059,5812,144172,12671,6726,4373,11799,6416
TCTAGGTTCTTGAGTT,sample,104903,104303,4542,99761,7574,92187,55127,5179,16331,1733,71458,13817,6176,2066,9734,4056
GTCGTTCTCTTGAGTT,sample,151923,150652,2975,147677,12629,135048,116365,12487,3510,571,119875,2115,1239,1442,15387,7684
TATACGGACTTGAGTT,sample,148119,146916,2874,144042,12991,131051,113958,13378,1451,870,115409,1394,1051,1426,25347,7378
GGAGAAGCCTTGAGTT,sample,206937,205385,5341,200044,15108,184936,148202,13180,12195,1626,160397,9733,4435,2379,20294,9635
CATACTCCCTTGAGTT,sample,235851,234124,11899,222225,13860,208365,115752,9545,44556,4688,160308,33824,10284,2993,18592,7876
TCGAACGACTTGAGTT,sample,336759,334772,12278,322494,17962,304532,215539,20613,34812,3601,250351,29967,9342,4178,17553,8831
TCATCGAACTTGAGTT,sample,177721,176470,8743,167727,11161,156566,92156,6911,34260,3719,126416,19520,7150,3355,21082,6622
ATTCAAGGCTTGAGTT,sample,219796,218372,6756,211616,22309,189307,153436,11716,15799,2397,169235,5959,3932,4376,20248,15958
TACGCGAGCTTGAGTT,sample,150530,149214,3206,146008,13790,132218,117812,10591,2005,520,119817,1290,1026,1338,31931,9493
CCGCAGTCCTTGAGTT,sample,254668,252657,9425,243232,19859,223373,173649,13091,19393,1887,193042,15353,5603,2944,22704,12665
TGGATCAACTTGAGTT,sample,94662,93633,15651,77982,5697,72285,16838,1204,28563,3254,45401,22426,8561,1850,3236,2580
GATGCGTTCTTGAGTT,sample,123719,122590,4157,118433,15966,102467,91462,7268,2293,79,93755,1365,1242,1603,23366,12019
CATTCGGTCTTGAGTT,sample,133351,132215,8629,123586,10423,113163,76749,6009,16048,1605,92797,12752,6085,3751,12347,6699
TAGCGAGTCTTGAGTT,sample,106361,105377,3525,101852,12424,89428,77651,6333,3010,317,80661,2117,1447,1520,22584,8898
ATGAATAGCTTGAGTT,sample,110431,109494,3186,106308,9030,97278,85390,7158,3098,246,88488,1386,1393,1535,19904,6060
AAGTAGAGCTTGAGTT,sample,123064,121675,9016,112659,7888,104771,49881,3055,27394,2711,77275,21730,7316,1916,13256,4966
CGCGAGACCTTGAGTT,sample,166804,165075,7652,157423,8479,148944,107213,8501,17222,1625,124435,14383,5611,2588,14901,4676
AGATACTACTTGAGTT,sample,209110,207275,11466,195809,11152,184657,116113,8464,36418,4217,152531,19445,7098,3256,14860,5964
CCTAACTACTTGAGTT,sample,106440,104329,4010,100319,9031,91288,81660,7195,1321,90,82981,1022,1178,1484,19601,6536
ATATGCAACTTGAGTT,sample,129107,128218,2821,125397,12277,113120,101478,8380,2050,145,103528,1067,1127,1665,26846,9162
AGAGTTCTTCGGAGTT,sample,99767,98974,5195,93779,6238,87541,50990,4399,16684,2157,67674,13311,5611,2142,9059,3746
CATAATGGTCGGAGTT,sample,52802,52284,4411,47873,3471,44402,17224,1067,15088,1542,32312,9481,4556,1124,4344,2166
TATACGGATCGGAGTT,sample,63601,63070,2535,60535,3525,57010,40502,2457,8711,1143,49213,4197,2454,1618,8588,2742
TCATACCATCGGAGTT,sample,40870,40371,2249,38122,4099,34023,22394,1668,4848,525,27242,4588,2490,1006,7116,2551
TGATTCCGTCGGAGTT,sample,38643,38388,920,37468,4775,32693,26263,2150,2703,312,28966,1265,2358,2328,5903,3190
ATACGTTCTCGGAGTT,sample,127178,126293,4691,121602,7455,114147,83686,6182,12759,1338,96445,10182,5205,3145,9313,4326
TCTCAGGATCGGAGTT,sample,94869,93882,6349,87533,6330,81203,43798,3075,17033,1693,60831,15604,5436,1332,12543,3150
GATGCGTTTCGGAGTT,sample,39164,38714,1301,37413,4516,32897,29039,2152,1064,17,30103,625,836,1140,6793,3204
ATGGCGTTTCGGAGTT,sample,62638,62143,3087,59056,3366,55690,32951,2671,12569,1393,45520,6106,3365,1681,6182,1926
TGCGCGTTTCGGAGTT,sample,83302,82725,2096,80629,8398,72231,64154,4950,1515,374,65669,1238,1837,2656,12099,6327
GCTCTTCTTCGGAGTT,sample,33554,33235,1815,31420,4087,27333,20350,1397,2972,313,23322,2301,2599,1902,5466,2744
GAGATTCTTCGGAGTT,sample,34293,33947,1712,32235,2324,29911,16668,1286,7776,944,24444,3237,1951,1191,3840,1531
CTAACCGGTCGGAGTT,sample,22589,22375,1042,21333,1717,19616,14489,997,2477,298,16966,1355,2334,1993,2221,1212
GGCGACGATCGGAGTT,sample,24773,24551,2250,22301,1434,20867,10920,696,5696,689,16616,2866,3278,1804,1097,845
GCGTTACCTCGGAGTT,sample,91178,90320,5636,84684,4523,80161,52146,4122,12543,1408,64689,9942,5238,2331,6680,2597
GTCGCGAATCGGAGTT,sample,34713,34361,999,33362,3141,30221,26610,2341,810,89,27420,371,835,1102,5645,2188
CGTCGAGGTCGGAGTT,Pos_Ctrl,11201,11033,658,10375,510,9865,8316,669,597,74,8913,209,2441,2145,639,219
CGCGGTCGTCGGAGTT,sample,31880,31546,1633,29913,2274,27639,17352,1739,4360,492,21712,3696,2813,1368,3971,1326
TCAATCAGTCGGAGTT,sample,56625,56181,2013,54168,3489,50679,35547,2741,9018,1344,44565,2029,1750,1510,7956,2559
TAACGCCATCGGAGTT,sample,36684,36289,2315,33974,2251,31723,19087,1243,5447,594,24534,5352,3227,1463,3620,1332
CGCGAGACTCGGAGTT,sample,28769,28403,761,27642,2386,25256,22251,1955,546,62,22797,442,724,950,6058,1596
CCTAACTATCGGAGTT,sample,88596,87391,6071,81320,4448,76872,37800,2305,25933,2921,63733,7913,5413,2858,3983,2167
TTAACTGATCGGAGTT,sample,19529,19158,1828,17330,1423,15907,5826,369,5342,626,11168,3744,2441,685,831,733
CTGGTCTTTGAACCTT,Pos_Ctrl,32358,31865,1933,29932,1696,28236,23481,2287,1769,185,25250,514,4263,4259,1982,875
GGTAGAGATGAACCTT,Pos_Ctrl,52540,51720,3076,48644,2303,46341,38390,3709,3046,232,41436,964,5168,6024,2419,1139
ATTCAAGGTGAACCTT,sample,90538,89916,3867,86049,7986,78063,57449,4067,9844,1104,67293,5599,4403,2970,16265,5761
CCGCAGTCTGAACCTT,sample,195616,194131,10288,183843,12546,171297,98590,7743,33543,3649,132133,27772,8908,2802,16421,6920
ATGGCGTTTGAACCTT,Pos_Ctrl,25839,25559,1744,23815,1286,22529,18914,1700,1276,177,20190,462,3820,3734,1702,743
TGCGCGTTTGAACCTT,sample,70137,69503,7759,61744,4730,57014,19145,1161,19406,2110,38551,15192,5792,1294,5756,2411
CATTCGGTTGAACCTT,sample,93331,92580,4878,87702,5235,82467,52584,3627,15621,1742,68205,8893,4868,2846,10063,3232
CCTAGCGGTGAACCTT,Pos_Ctrl,11236,11134,663,10471,692,9779,8275,696,513,93,8788,202,2421,2192,637,324
GGCGACGATGAACCTT,sample,68695,68203,2136,66067,6787,59280,50060,3967,3093,310,53153,1850,3333,3648,7500,4813
TAACGAAGTGAACCTT,sample,80493,79885,4787,75098,8024,67074,40345,2892,12195,1430,52540,10212,4308,1528,11400,5037
GCCTATTCTGAACCTT,sample,147775,146578,11990,134588,8061,126527,56859,3704,34338,3822,91197,27804,9295,2592,9576,4365
CGCGGTCGTGAACCTT,sample,79617,79114,1610,77504,8191,69313,62275,4698,1397,368,63672,575,941,1453,15751,5170
ATTCTACCTGAACCTT,Pos_Ctrl,21048,20893,967,19926,1085,18841,15720,1499,1110,175,16830,337,3510,3558,1111,493
CGCGAGACTGAACCTT,sample,92570,92051,2961,89090,4944,84146,60403,4192,12796,1659,73199,5096,4674,3588,11737,2919
AACCGGTTACCGAATT,sample,109279,108483,6388,102095,10334,91761,57390,4340,15591,1376,72981,13064,4840,1614,18924,6478
CTGGTCTTACCGAATT,sample,179260,178200,15326,162874,15527,147347,85440,6797,31432,3499,116872,20179,6524,2697,19004,9931
CATAATGGACCGAATT,sample,139165,138345,5118,133227,14047,119180,87175,5989,15287,2122,102462,8607,4639,3142,22341,9617
CATACTCCACCGAATT,sample,142688,141491,5936,135555,11990,123565,73106,6433,31522,3284,104628,9220,3087,1674,17895,8031
TCGAACGAACCGAATT,sample,139968,139087,7177,131910,12164,119746,74073,6110,21570,2102,95643,15891,6144,2329,17898,6789
TCATACCAACCGAATT,sample,187969,186262,14044,172218,14045,158173,86308,7669,32697,3406,119005,28093,8451,2665,17562,8193
GCAACTAGACCGAATT,sample,55782,54884,1572,53312,5904,47408,42515,3443,1002,161,43517,287,742,1060,10104,3773
CCGTACGCACCGAATT,sample,145115,143914,5607,138307,9695,128612,97927,7143,14028,1945,111955,7569,4755,3914,12188,6443
TGCGCGTTACCGAATT,sample,151352,150137,9615,140522,11523,128999,74713,5261,28879,3125,103592,17021,5047,1775,19003,8217
CATTCGGTACCGAATT,sample,207322,205661,9122,196539,11220,185319,101086,7800,47774,6313,148860,22346,5267,1841,15969,6171
CTAACCGGACCGAATT,sample,70937,70360,2626,67734,8823,58911,49402,4430,2738,382,52140,1959,1618,1672,16813,5991
GGCGACGAACCGAATT,sample,74970,74362,3469,70893,4038,66855,49591,3801,8447,1022,58038,3994,4735,4119,8671,2446
TGCGCTCCACCGAATT,sample,81482,80942,4893,76049,10570,65479,39634,3521,12368,1315,52002,8641,3687,1706,13617,7012
GTCGCGAAACCGAATT,sample,165641,164248,7061,157187,12388,144799,109149,7945,14424,1308,123573,11973,5715,2987,19323,8774
CAGCTTCGACCGAATT,Neg_Ctrl,1453,887,334,553,35,518,299,20,115,25,414,59,190,112,80,18
GTCGTTCTGGTCTGGT,Neg_Ctrl,1160,763,256,507,51,456,288,15,98,12,386,43,175,106,82,29
CATAATGGGGTCTGGT,sample,112068,111412,4249,107163,11812,95351,66438,5555,13338,1096,79776,8924,3733,1814,16907,7551
TCGAACGAGGTCTGGT,sample,62062,61768,7577,54191,6288,47903,20276,1684,13944,1535,34220,10464,5307,2106,5857,3674
GGTAGAGAGGTCTGGT,sample,105199,104501,3983,100518,6743,93775,55090,3552,24988,2588,80078,7557,3338,1719,9447,3938
CGTCGCCAGGTCTGGT,Neg_Ctrl,1279,850,331,519,62,457,296,24,66,8,362,63,160,104,71,41
ATACGTTCGGTCTGGT,sample,157761,156835,3471,153364,14395,138969,124523,11024,2030,139,126553,1253,1432,2301,28160,10575
TGCGCGTTGGTCTGGT,Neg_Ctrl,1121,658,399,259,16,243,164,10,33,12,197,24,92,64,28,9
CGGTTGGTGGTCTGGT,sample,109723,108941,5456,103485,8622,94863,65470,4916,14042,1242,79512,9193,3432,1685,19410,6042
AAGGTCTGGGTCTGGT,sample,82715,82060,4333,77727,7896,69831,44353,3218,12146,1255,56499,8859,3297,1253,11762,5670
CTAACCGGGGTCTGGT,Neg_Ctrl,769,439,202,237,27,210,143,2,30,8,173,27,95,58,33,7
GCTGCTTCGGTCTGGT,sample,95969,95327,3976,91351,6937,84414,61625,4383,10997,1007,72622,6402,2593,1558,16394,4929
GCGTTACCGGTCTGGT,sample,51019,50014,3099,46915,4066,42849,30444,2183,5296,566,35740,4360,3192,1709,6756,2630
CAGCTTCGGGTCTGGT,sample,140970,139743,8834,130909,6025,124884,62192,4769,39274,5789,101466,12860,5882,2764,7926,3883
CGCGGTCGGGTCTGGT,sample,46892,46543,1205,45338,4176,41162,36725,2794,891,229,37616,523,751,1035,9306,2691
ATGAATAGGGTCTGGT,sample,84453,83640,4325,79315,4363,74952,36699,2670,23375,2468,60074,9740,5083,1907,5685,2923
TAACGCCAGGTCTGGT,sample,58486,58030,2229,55801,5589,50212,37207,3251,4846,558,42053,4350,4234,3244,5379,3178
GACTAACCGGTCTGGT,Neg_Ctrl,866,630,181,449,32,417,254,14,64,11,318,74,150,102,61,38
CGTAGAACGGTCTGGT,sample,71132,70492,3317,67175,6182,60993,49195,3694,5303,267,54498,2534,1654,1223,12668,4232
ATATGCAAGGTCTGGT,sample,99274,98482,5463,93019,7757,85262,53730,4275,13729,1876,67459,11652,3095,1143,16132,4570
CTGGTCTTCGACGTTA,sample,233152,231515,27511,204004,16829,187175,92073,6513,46496,4438,138569,37655,10727,4183,12480,9882
AGAGTTCTCGACGTTA,sample,238502,236772,12930,223842,13239,210603,103117,6461,66300,8265,169417,26460,7569,2903,19540,7623
TATACGGACGACGTTA,sample,132034,130884,6221,124663,12767,111896,76016,6514,16046,1746,92062,11574,4800,1948,13608,9074
CATACTCCCGACGTTA,sample,175441,174018,11419,162599,14868,147731,85852,7165,28541,3352,114393,22821,6280,2130,22751,8583
CTAGCGACCGACGTTA,sample,113513,112841,5378,107463,16153,91310,70566,5450,8318,815,78884,6161,3100,2206,18026,11285
TCGAACGACGACGTTA,sample,164652,163540,6384,157156,14092,143064,102576,8878,19368,1992,121944,10250,4148,2225,21528,8254
TCATCGAACGACGTTA,sample,168711,167558,11992,155566,11212,144354,76252,5909,33355,3070,109607,25768,7895,3128,7796,6250
TCATACCACGACGTTA,sample,278590,276969,9336,267633,25236,242397,198248,16554,16685,1797,214933,9113,3869,3359,31258,18543
GACTCAAGCGACGTTA,sample,197423,195919,7154,188765,13624,175141,107449,8746,38913,4510,146362,15523,5397,2528,16178,7653
CCGCAGTCCGACGTTA,sample,175422,174238,11735,162503,13152,149351,81235,6507,30980,3451,112215,27178,9095,3649,14429,6586
ATGGCGTTCGACGTTA,sample,68209,67696,5568,62128,5890,56238,32980,2605,10903,1188,43883,8562,6003,3516,4182,3700
CCATTCTTCGACGTTA,sample,202152,200804,7576,193228,19188,174040,122189,9870,22327,2392,144516,17262,5903,2359,24863,12548
CATTCGGTCGACGTTA,sample,257851,256709,5762,250947,22241,228706,202027,19019,3956,708,205983,2996,1793,2497,34838,16398
GCCTATTCCGACGTTA,sample,119914,119095,2951,116144,10463,105681,93916,7390,2434,382,96350,1559,1445,1650,19947,6657
GCGTTACCCGACGTTA,sample,121428,120693,6314,114379,9534,104845,61749,5629,20981,1863,82730,14623,6056,2128,10480,4917
CGTCGAGGCGACGTTA,sample,52554,52221,1440,50781,5220,45561,35155,2928,4298,525,39453,2655,2573,1620,10719,3535
CAGCTTCGCGACGTTA,sample,54580,54242,1206,53036,6815,46221,41165,3622,752,119,41917,563,861,1152,11208,4672
TTAACTGACGACGTTA,sample,250331,248857,10297,238560,15769,222791,135495,11444,50557,5239,186052,20056,3924,2091,24367,10292
AACCGGTTTACTAAGT,sample,186911,185237,10024,175213,10238,164975,96468,6226,32152,3577,128620,26552,6234,2179,17474,5543
CTAGCGACTACTAAGT,sample,36300,35854,3209,32645,2172,30473,10847,963,10314,1068,21161,7281,3748,934,2675,853
TCGAACGATACTAAGT,sample,60736,60180,3263,56917,6607,50310,33072,2420,7818,732,40890,6268,3434,1430,8147,4145
ATTCAAGGTACTAAGT,sample,108502,107797,3681,104116,6600,97516,68787,6178,13581,1315,82368,7655,4209,2400,9047,3881
TGATTCCGTACTAAGT,sample,104272,103467,5675,97792,5515,92277,52135,4027,20906,2239,73041,12970,5709,2180,6700,2611
TCTCAGGATACTAAGT,sample,38089,37785,1422,36363,3947,32416,26338,2146,2115,214,28453,1603,1704,1612,6132,2726
TGGATCAATACTAAGT,sample,35212,34908,2134,32774,3174,29600,21222,1455,3775,351,24997,2797,2893,1998,4509,1758
CCATTCTTTACTAAGT,sample,43807,43478,3351,40127,3885,36242,22491,1522,6273,662,28764,5294,3698,2055,5200,2352
TAGCGAGTTACTAAGT,sample,35143,34718,1680,33038,3875,29163,22887,1817,2408,159,25295,1892,1272,956,7767,2630
GCTCTTCTTACTAAGT,sample,53429,53030,1967,51063,6212,44851,33247,2605,5340,706,38587,2953,2443,1919,6564,4350
TGCGCTCCTACTAAGT,sample,15522,15378,918,14460,991,13469,7296,498,3686,453,10982,1536,2135,1222,1155,584
GGCGTACCTACTAAGT,sample,44543,44205,3421,40784,3099,37685,26780,2133,4633,435,31413,3704,3436,2368,3756,2031
CGTCGAGGTACTAAGT,sample,41642,41415,1796,39619,3773,35846,24138,2108,5526,557,29664,3517,2765,1608,4954,2269
CAGCTTCGTACTAAGT,sample,17999,17895,674,17221,1606,15615,10886,1096,1759,219,12645,1655,1844,1441,1606,899
CGCGGTCGTACTAAGT,sample,28936,28611,2553,26058,2124,23934,9761,629,7183,689,16944,5672,3357,854,2212,1206
AAGTAGAGTACTAAGT,sample,62580,62055,3920,58135,4597,53538,35202,2910,7950,794,43152,6682,4096,2070,6029,2880
TCAATCAGTACTAAGT,sample,53851,53492,2633,50859,4348,46511,32180,2383,6782,868,38962,4298,3249,1571,6672,2697
ATTCTACCTACTAAGT,sample,72148,71480,3318,68162,4748,63414,49421,3628,5064,764,54485,4537,3505,2735,6062,3240
CGCGAGACTACTAAGT,sample,44463,44124,2396,41728,3515,38213,27900,2367,4792,376,32692,2778,2196,1421,6493,2315
CCTAACTATACTAAGT,sample,39002,38501,2965,35536,2593,32943,20300,1638,6010,465,26310,4530,2937,1363,4801,1818
AGCTGAATTTGCCGCT,sample,303962,302291,9546,292745,20973,271772,177239,18528,48314,5337,225553,22354,7022,3031,28645,10436
CATAATGGTTGCCGCT,sample,248009,246449,8872,237577,18726,218851,152341,16985,25117,3280,177458,21128,6780,2618,26886,9388
GCAACTAGTTGCCGCT,sample,39814,39487,2067,37420,4086,33334,22875,1404,4937,511,27812,3607,3461,2346,4113,2643
CCGCAGTCTTGCCGCT,sample,116746,116170,5639,110531,12019,98512,66951,5554,13890,1575,80841,10542,5558,2937,13054,8048
TCTCAGGATTGCCGCT,sample,133395,132310,8872,123438,11971,111467,63389,5203,21719,2471,85108,18685,6924,2601,15090,7512
GATGCGTTTTGCCGCT,sample,44792,44256,2311,41945,5383,36562,25531,1694,5183,640,30714,3514,2444,1346,7867,3743
TGCGCGTTTTGCCGCT,sample,121153,120276,5829,114447,12671,101776,73210,5151,12966,1754,86176,8695,4070,2171,23985,8854
CCATTCTTTTGCCGCT,sample,87044,86480,3505,82975,8709,74266,57694,4284,6980,647,64674,4661,3874,2753,18373,5733
CGGTTGGTTTGCCGCT,sample,116802,116025,4415,111610,15557,96053,79623,6841,4837,470,84460,4282,1669,1533,26183,11689
CATTCGGTTTGCCGCT,sample,79657,78937,7515,71422,7026,64396,31102,2196,17516,1676,48618,11906,5588,1741,10356,3915
GAGATTCTTTGCCGCT,sample,168261,167173,4120,163053,14628,148425,134100,10355,2213,304,136313,1453,2179,3287,24196,11413
TAACGAAGTTGCCGCT,sample,142557,141573,6587,134986,15033,119953,88737,6683,13516,1519,102253,9498,4922,2464,21435,10903
AGCAGAGCTTGCCGCT,sample,69716,68963,6915,62048,5410,56638,27772,2316,14021,1590,41793,10939,5227,1796,6727,3086
GGCGTACCTTGCCGCT,sample,127186,126375,4038,122337,11560,110777,83800,6171,14923,1305,98723,4578,2181,1808,15964,8097
GTCGCGAATTGCCGCT,sample,127385,126396,9066,117330,10124,107206,67201,6536,17807,2435,85008,13227,4199,1733,16344,7311
CGTCGAGGTTGCCGCT,sample,118623,117842,2920,114922,9621,105301,87636,6815,5585,587,93221,4678,3555,2904,12141,6096
CAGCTTCGTTGCCGCT,sample,84790,84040,6331,77709,4777,72932,35154,2478,23114,2611,58268,9575,6005,3171,4358,3201
TTATGACGTTGCCGCT,sample,138841,137842,6124,131718,8440,123278,86793,5569,17128,1483,103921,12305,4714,1876,17107,4684
ATTCTACCTTGCCGCT,sample,127426,126376,5263,121113,8572,112541,68646,5260,24111,2694,92757,11830,4711,1936,17144,5131
AGCTGAATTTCGACCT,sample,214991,213335,11170,202165,13900,188265,105562,9504,38503,3825,144065,30871,8382,2304,24268,7963
CTAGCGACTTCGACCT,sample,287108,285071,14549,270522,19615,250907,140310,10590,50301,5481,190611,44225,10576,2847,32481,9961
TGATTCCGTTCGACCT,sample,117565,116739,3236,113503,13702,99801,89989,6854,1576,307,91565,1075,2440,3694,11600,10179
CCGCAGTCTTCGACCT,sample,72644,72093,4193,67900,6977,60923,39755,3276,9564,1084,49319,7244,4150,1975,8699,4380
TCTCAGGATTCGACCT,sample,82088,81444,7543,73901,6243,67658,38376,2917,13533,1343,51909,11489,5007,2010,8254,4066
GGCAGGTTTTCGACCT,sample,86719,86051,4543,81508,7094,74414,45698,3957,17532,1652,63230,5575,2762,2098,8292,4814
AGCGTCTTTTCGACCT,sample,27877,27732,1566,26166,3925,22241,15429,1349,2554,351,17983,2558,2658,2040,2658,2791
GAGATTCTTTCGACCT,sample,104184,103132,7622,95510,5692,89818,40837,2561,29127,3082,69964,14211,5385,2152,6167,2928
AGCAGAGCTTCGACCT,sample,105550,104773,5805,98968,5593,93375,59321,3890,18770,2065,78091,9329,4707,2369,9069,2885
TGCGCTCCTTCGACCT,sample,87553,86747,5375,81372,7114,74258,46502,3276,12370,1189,58872,10921,4504,1534,12097,4618
ATACCGCCTTCGACCT,sample,40038,39783,8581,31202,2241,28961,7718,603,10885,1137,18603,8618,4445,1195,1510,1149
GGCGTACCTTCGACCT,sample,14908,14760,2149,12611,920,11691,3830,256,4087,481,7917,3037,2540,830,724,425
GTCGCGAATTCGACCT,sample,93171,92248,6356,85892,4030,81862,37148,2389,27263,2998,64411,12064,5829,2369,5781,2144
CGTCGAGGTTCGACCT,sample,113206,112572,5162,107410,13587,93823,67850,4693,10459,1101,78309,9720,4792,2480,12190,9935
CGCGGTCGTTCGACCT,sample,60193,59618,3763,55855,4440,51415,28857,1860,12564,1185,41421,6949,4258,1836,7403,2642
CGTAGAACTTCGACCT,sample,51762,51180,3999,47181,4625,42556,24235,1911,9012,897,33247,6501,4443,2191,5888,2893
CCTAACTATTCGACCT,sample,120616,119317,8516,110801,6933,103868,47837,2890,31766,3410,79603,17965,6263,2060,7324,3386
ATATGCAATTCGACCT,sample,105587,104419,11269,93150,5460,87690,32725,2305,27924,2872,60649,21864,8382,2228,8868,2981
TCGAACGATCCAGACT,sample,53478,53139,1759,51380,3386,47994,28892,2702,10759,1238,39651,4403,2781,1490,6212,1977
GGTAGAGATCCAGACT,sample,71031,70552,2055,68497,6839,61658,48558,4542,4501,475,53059,3582,2757,1842,7241,4235
TCATACCATCCAGACT,sample,38314,38034,837,37197,3954,33243,29681,2390,640,76,30321,456,767,1104,9115,2928
GACTCAAGTCCAGACT,sample,124733,123903,5214,118689,7432,111257,70622,6605,20509,2364,91131,11157,5345,2788,9595,4350
CCGCAGTCTCCAGACT,sample,106145,105285,5985,99300,4364,94936,47509,3492,26251,3560,73760,14124,5855,2173,5060,2107
TGGATCAATCCAGACT,sample,27110,26840,1379,25461,2179,23282,16273,1306,3607,410,19880,1686,2183,1631,3169,1396
CATTCGGTTCCAGACT,sample,27201,26927,1173,25754,2839,22915,16906,1378,2485,379,19391,1767,1309,1071,5577,2172
GCCTATTCTCCAGACT,sample,29797,29523,1597,27926,1797,26129,17918,1200,4295,489,22213,2227,3092,2271,2567,1089
AGCAGAGCTCCAGACT,sample,32982,32642,1499,31143,1819,29324,21637,1344,4454,408,26091,1481,2248,1977,3466,1055
TGCGCTCCTCCAGACT,Pos_Ctrl,14836,14565,998,13567,746,12821,10663,971,819,101,11482,267,2899,2626,765,371
CGTCGAGGTCCAGACT,Pos_Ctrl,7277,7116,514,6602,326,6276,5116,488,455,66,5571,151,1783,1482,388,191
TTAACTGATCCAGACT,sample,34576,34192,1742,32450,2622,29828,22600,1682,3038,268,25638,2240,2096,1526,4008,1548
ATATGCAATCCAGACT,sample,30413,30108,1499,28609,2213,26396,15940,1239,4699,453,20639,4065,2432,1106,3730,1428
GTCGTTCTACCATTAT,sample,197526,195987,7721,188266,20424,167842,141243,10297,9378,1055,150621,5869,2821,2102,31627,14988
AGCTGAATACCATTAT,sample,326371,323805,15570,308235,25991,282244,199847,14674,38676,4121,238523,24926,8321,4018,29751,17386
GACGTATGACCATTAT,sample,210098,208215,12919,195296,13255,182041,105971,8584,40612,4934,146583,21940,7931,3474,13904,8046
TATACGGAACCATTAT,sample,185913,184578,6926,177652,16697,160955,110276,8638,27065,2690,137341,12286,3395,1783,29791,10671
GGAGAAGCACCATTAT,sample,131580,130183,10656,119527,5916,113611,41560,3210,45264,5680,86824,17897,7040,2384,7424,3078
CTAGCGACACCATTAT,sample,295190,293449,10163,283286,28105,255181,206520,18748,15275,1968,221795,12670,4944,2858,40667,18117
GGTAGAGAACCATTAT,sample,273775,271574,16174,255400,17362,238038,139337,12027,43733,4429,183070,38512,8485,2373,27483,9402
GCAACTAGACCATTAT,sample,48233,47855,2133,45722,4694,41028,24170,1974,9708,1366,33878,3810,3646,2679,3303,2711
GACTCAAGACCATTAT,sample,207616,206062,6894,199168,14421,184747,152050,11858,12538,1411,164588,6890,4519,4538,13986,10604
TCTCAGGAACCATTAT,sample,298609,296369,20110,276259,17856,258403,128134,10176,59501,6277,187635,54315,11090,3449,18149,8294
GGCAGGTTACCATTAT,sample,117198,116493,3943,112550,17600,94950,78960,5803,5738,654,84698,3795,3352,3505,17233,12732
GATGCGTTACCATTAT,sample,212713,210997,18336,192661,11175,181486,81202,5428,60887,5766,142089,28203,8464,3179,14480,6243
CGGTTGGTACCATTAT,sample,149255,148104,9267,138837,14049,124788,78960,6875,19560,1955,98520,17438,5825,2131,22556,8672
GCTCTTCTACCATTAT,sample,184602,182971,10548,172423,12073,160350,103737,5633,30142,3101,133879,17737,6369,2535,16095,8129
CGTCGAGGACCATTAT,sample,122443,121561,6831,114730,9050,105680,68608,5624,16308,1876,84916,13264,4878,1799,15518,5505
TAACGCCAACCATTAT,sample,192604,191347,12411,178936,12990,165946,100986,7620,30419,3455,131405,23466,8866,3347,19214,7799
GACTAACCACCATTAT,sample,172999,171889,6390,165499,12856,152643,115230,8325,16079,1712,131309,11297,4465,2310,24677,9433
AGATACTAACCATTAT,sample,130745,129911,6329,123582,12134,111448,87934,7316,8707,786,96641,6705,2114,1423,21825,8949
GCGCAATAACCATTAT,sample,166163,164098,14125,149973,9269,140704,61057,4185,40362,4444,101419,30656,9553,2525,12791,5149
TTAACTGAACCATTAT,sample,143932,142744,6554,136190,13079,123111,88212,6370,14298,1381,102510,12850,5455,2563,17946,8506
AGCTGAATCAATGGAT,sample,101219,100198,7086,93112,8986,84126,50446,4369,15397,1977,65843,11937,5300,1766,16735,5384
CGTCGCCACAATGGAT,sample,206014,204600,4817,199783,15322,184461,162634,16148,3186,434,165820,2059,1876,2228,20641,10827
GGCAGGTTCAATGGAT,sample,117972,117056,3332,113724,16569,97155,86973,6408,2162,479,89135,1133,1193,1725,19434,12445
ACGCTTAACAATGGAT,sample,143641,142744,3496,139248,15280,123968,110223,7960,4004,293,114227,1488,1546,2059,28810,11206
CTAAGCATCAATGGAT,sample,162457,160932,9646,151286,10668,140618,107044,6877,14379,1670,121423,10648,6112,4349,11995,7537
CTAACCGGCAATGGAT,sample,70014,69448,6777,62671,6361,56310,32851,2376,11491,1197,44342,8395,3586,1445,9339,4341
GCCTATTCCAATGGAT,sample,205615,204253,9258,194995,11981,183014,144192,9456,15493,1624,159685,12249,6181,4058,15858,7521
ATACCGCCCAATGGAT,Neg_Ctrl,1337,794,380,414,36,378,257,24,44,8,301,45,134,91,45,15
GTCGCGAACAATGGAT,sample,158464,157131,15543,141588,8992,132596,49340,2626,40853,4651,90193,35126,9371,2374,12603,4243
CAGCTTCGCAATGGAT,Neg_Ctrl,1261,816,283,533,36,497,281,27,143,2,424,44,191,120,40,23
TCTCCTAGCAATGGAT,sample,155977,154690,14859,139831,7899,131932,49837,4199,47569,5100,97406,25227,9014,2336,7943,4274
GACTAACCCAATGGAT,sample,116620,115979,3896,112083,9217,102866,81517,8035,6892,756,88409,5666,2863,1844,18002,5503
CGCGAGACCAATGGAT,sample,90219,89547,5682,83865,2727,81138,35383,2060,32756,3720,68139,7219,5880,3749,1492,1208
CCTAACTACAATGGAT,Pos_Ctrl,33771,32946,2175,30771,1425,29346,24293,2208,2010,222,26303,613,4453,4587,1762,774
AGAGTTCTAGATTCAT,sample,127147,126134,8487,117647,9432,108215,62305,5025,22450,2170,84755,16265,6412,2565,11808,5724
AGCTGAATAGATTCAT,sample,173937,172866,4804,168062,16286,151776,124054,11192,10894,1257,134948,4379,3356,3562,19460,11868
CATAATGGAGATTCAT,sample,88218,87621,3027,84594,9257,75337,57832,4754,6645,846,64477,5260,3870,2478,10174,6418
TATACGGAAGATTCAT,sample,109638,108932,7408,101524,9505,92019,62486,4174,13901,1554,76387,9904,2549,1529,18971,5668
CTAGCGACAGATTCAT,sample,68566,67707,5784,61923,5090,56833,19821,1065,18832,1678,38653,15437,5366,1044,5128,2881
ATACGTTCAGATTCAT,sample,132420,131773,6090,125683,9491,116192,86993,8427,11485,1278,98478,8009,5235,3567,9395,5333
CCGCAGTCAGATTCAT,sample,17428,17343,3348,13995,1300,12695,4644,433,3791,420,8435,3407,2697,1181,691,609
GATGCGTTAGATTCAT,sample,194069,192956,4401,188555,16444,172111,151646,10575,6532,497,158178,2861,2424,3467,16229,13459
ATGGCGTTAGATTCAT,sample,26720,26550,1439,25111,2751,22360,15860,1043,2970,318,18830,2169,1575,1141,4927,1898
TGCGCGTTAGATTCAT,sample,121613,120944,2851,118093,10825,107268,98152,6307,1177,506,99329,1126,1356,2145,19841,7766
AGCGTCTTAGATTCAT,sample,84479,83936,4167,79769,6598,73171,55675,3949,7094,706,62769,5747,4001,3061,9045,4148
CTAAGCATAGATTCAT,sample,77134,76577,3328,73249,7597,65652,46967,3206,9360,928,56327,5191,2533,1410,14986,5212
AAGGTCTGAGATTCAT,sample,107728,106876,7643,99233,7562,91671,56895,3945,16204,1647,73099,12980,5939,2715,7639,5243
CCTAGCGGAGATTCAT,sample,12125,11990,1012,10978,1126,9852,5449,337,2415,285,7864,1366,1742,921,1440,759
GGCGACGAAGATTCAT,sample,24689,24473,1825,22648,3591,19057,11861,674,3457,381,15318,2684,2429,1379,3507,2382
TAACGAAGAGATTCAT,sample,71372,70742,3503,67239,4211,63028,37436,2420,15566,1566,53002,6040,3258,1818,8422,2684
GCCTATTCAGATTCAT,sample,105315,104453,4766,99687,8787,90900,63561,5980,10904,1325,74465,9130,4712,2433,12513,6035
GCGTTACCAGATTCAT,sample,90057,89415,5325,84090,6022,78068,45473,3595,16408,1884,61881,10708,5230,2010,10610,3536
GTCGCGAAAGATTCAT,sample,56030,55554,2431,53123,5078,48045,33918,2290,6706,729,40624,4402,2463,1150,8269,3560
TTATGACGAGATTCAT,sample,118329,117390,7279,110111,7091,103020,58490,3969,20830,2216,79320,17515,7081,2225,12082,4100
GACTAACCAGATTCAT,sample,76570,75906,5103,70803,5694,65109,37503,2471,12998,1442,50501,10695,5228,1530,11109,3672
CGCGAGACAGATTCAT,sample,52415,51858,3729,48129,3652,44477,26322,1674,9104,972,35426,6405,4463,2077,7094,2330
AACCGGTTCAATCTTG,sample,56106,55880,1494,54386,8262,46124,37947,3535,2681,426,40628,1535,2616,2842,7863,5078
CTGGTCTTCAATCTTG,sample,66844,66409,4761,61648,7321,54327,24252,2017,15614,1571,39866,10873,5478,1869,6109,4204
AGCTGAATCAATCTTG,sample,223485,221888,21721,200167,8822,191345,66998,4612,81748,10197,148746,27790,9597,3680,4869,3999
GGAGAAGCCAATCTTG,sample,150430,149512,4755,144757,19116,125641,107853,8389,5715,370,113568,3314,1511,1547,30218,13682
TCGAACGACAATCTTG,sample,97375,96749,2306,94443,10937,83506,75560,5036,1867,144,77427,899,1002,1368,22346,8058
GGTAGAGACAATCTTG,sample,173223,172163,11324,160839,14276,146563,87853,6783,26098,2676,113951,23153,7615,2539,18801,8867
CGTCGCCACAATCTTG,sample,138094,137207,6072,131135,14292,116843,82590,6365,14189,1676,96779,12023,5690,2784,17551,9884
TCATCGAACAATCTTG,sample,124987,124059,6952,117107,7964,109143,59976,4473,28889,3229,88865,12576,5436,2613,8418,5096
TCATACCACAATCTTG,sample,149220,148380,5901,142479,17083,125396,102922,7303,8137,884,111059,6150,2855,2075,31098,12251
GACTCAAGCAATCTTG,sample,149721,148943,3628,145315,22718,122597,111271,8223,1542,305,112813,1256,2144,3037,22901,17102
TCTCAGGACAATCTTG,sample,183778,182623,4704,177919,22334,155585,140363,9851,3193,184,143556,1994,1694,2399,38608,16445
GAGATTCTCAATCTTG,sample,166816,165546,8687,156859,10253,146606,104265,7882,18289,1817,122554,14353,5539,2874,12687,6421
GCTGCTTCCAATCTTG,sample,111848,110804,5181,105623,6363,99260,64814,5007,17386,2434,82200,9619,3998,2168,10981,4228
GCGTTACCCAATCTTG,sample,115992,114815,8213,106602,6488,100114,50886,3510,27865,2891,78751,14962,5545,1904,9237,3473
CGTCGAGGCAATCTTG,sample,78949,78147,4390,73757,4823,68934,39885,2602,16594,1919,56479,7934,4637,2391,6346,2950
CGCGGTCGCAATCTTG,sample,72829,72292,2196,70096,7341,62755,50269,4538,4370,554,54639,3024,2046,1694,12128,4857
TTATGACGCAATCTTG,sample,200151,197212,18154,179058,7552,171506,74122,4294,62031,9238,136153,21821,8153,3074,4548,3207
GCGCAATACAATCTTG,Neg_Ctrl,1533,1017,392,625,42,583,350,19,90,13,440,111,205,123,69,28
AACCGGTTCGTTCCGA,sample,119027,118449,2859,115590,23190,92400,77764,7617,3549,445,81313,3025,3484,3662,13849,15606
GACGTATGCGTTCCGA,sample,130886,130124,15987,114137,10768,103369,47574,3326,27142,2928,74716,22399,7703,3137,6665,5933
GGAGAAGCCGTTCCGA,sample,177463,175738,13719,162019,12349,149670,66109,5184,43597,5544,109706,29236,8296,2050,10669,7273
TCGAACGACGTTCCGA,sample,83069,82306,7295,75011,6272,68739,29643,2517,19222,1914,48865,15443,5869,1457,7092,3361
TGATTCCGCGTTCCGA,sample,222439,220903,9413,211490,14943,196547,113574,7272,49029,4984,162603,21688,6468,2275,24302,9080
TACGCGAGCGTTCCGA,sample,198472,197244,5902,191342,22779,168563,151660,11685,3879,235,155539,1104,1331,1877,37314,15423
GACTCAAGCGTTCCGA,sample,198286,196887,14369,182518,23516,159002,102141,8079,25599,2750,127740,20433,7510,2926,19319,16218
CCGCAGTCCGTTCCGA,sample,272179,270483,11870,258613,15791,242822,191968,12803,20877,1946,212845,15228,6966,4879,15071,9421
TCTCAGGACGTTCCGA,sample,207843,206127,17682,188445,17414,171031,75064,6563,45257,4735,120321,39412,9729,2325,21558,10039
ATGGCGTTCGTTCCGA,sample,223343,221654,15543,206111,19490,186621,95080,7636,43759,4840,138839,35306,9265,2492,25611,11309
CCATTCTTCGTTCCGA,sample,261391,259476,12516,246960,13877,233083,124758,8558,66997,7103,191755,25667,6796,2855,18555,7738
ACGCTTAACGTTCCGA,sample,222712,221273,11786,209487,19691,189796,138924,9355,21955,2598,160879,16964,6896,3043,32142,13646
GCTCTTCTCGTTCCGA,sample,265849,264386,9689,254697,16544,238153,196134,13011,14944,1669,211078,12395,6497,4952,16250,11312
ATACCGCCCGTTCCGA,sample,101090,99972,10307,89665,6253,83412,30529,2564,25072,2615,55601,22632,7287,1837,7521,2986
GCGTTACCCGTTCCGA,sample,159352,158348,4754,153594,17356,136238,113985,9621,7260,587,121245,4785,2804,2304,19955,11784
CAGCTTCGCGTTCCGA,sample,209918,208551,13958,194593,11601,182992,116280,8327,28916,3220,145196,26249,8106,3058,12847,6843
CGCGGTCGCGTTCCGA,sample,131962,131292,3387,127905,12623,115282,93788,7006,7943,780,101731,5765,2644,1994,18276,9141
CGCGAGACCGTTCCGA,sample,162577,161430,6538,154892,7814,147078,103482,8309,23177,2204,126659,9906,6337,4785,8883,4662
TTAACTGACGTTCCGA,sample,301918,300448,14146,286302,18950,267352,161988,14491,49156,5187,211144,36530,10393,3482,27478,11175
CTGGTCTTCAATTCGG,Pos_Ctrl,78514,77213,4311,72902,3584,69318,57866,5518,3955,527,61821,1452,5917,7401,3306,1531
GGAGAAGCCAATTCGG,sample,145986,144824,5125,139699,9856,129843,103711,8360,9772,1136,113483,6864,3378,2513,16753,6946
CATACTCCCAATTCGG,Pos_Ctrl,36334,35634,2211,33423,1848,31575,26273,2388,1969,227,28242,718,4723,4938,2354,959
GGTAGAGACAATTCGG,sample,146741,145466,9123,136343,10972,125371,78915,5745,22621,2359,101536,15731,5673,1893,20328,6970
CGTCGCCACAATTCGG,sample,133808,132695,3570,129125,11333,117792,107198,7749,1604,213,108802,1028,1159,1717,23220,8740
GACTCAAGCAATTCGG,Pos_Ctrl,28037,27666,1351,26315,1272,25043,20875,1917,1531,154,22406,566,4194,4343,1492,613
CCGTACGCCAATTCGG,sample,151675,150518,9222,141296,12649,128647,81475,5956,20352,2122,101827,18742,6819,3071,14938,6895
TGGATCAACAATTCGG,sample,150984,149968,4722,145246,14352,130894,114531,9079,3375,420,117906,3489,1444,1545,26713,10824
GGCAGGTTCAATTCGG,sample,119358,118492,4906,113586,10263,103323,68372,5203,18227,2085,86599,9436,4588,2753,16085,7222
ATGGCGTTCAATTCGG,Pos_Ctrl,13468,13251,1002,12249,769,11480,9558,848,738,110,10296,226,2709,2245,1027,461
AGCGTCTTCAATTCGG,sample,118839,118233,2757,115476,14928,100548,88909,7628,1964,234,90873,1813,1079,1675,27511,10276
ACGCTTAACAATTCGG,sample,69157,68839,1965,66874,8127,58747,41379,3147,9174,1097,50553,3950,3407,2474,10632,5633
GAGATTCTCAATTCGG,Pos_Ctrl,5719,5678,266,5412,420,4992,4060,392,331,40,4391,169,1564,1361,437,211
CTAACCGGCAATTCGG,sample,51685,51360,2289,49071,4219,44852,27585,2179,10541,1351,38126,3196,2990,2109,4400,2727
AGCAGAGCCAATTCGG,Pos_Ctrl,12226,12124,601,11523,666,10857,9057,918,582,80,9639,220,2668,2498,902,364
CGTCGAGGCAATTCGG,Pos_Ctrl,24731,24489,1239,23250,1183,22067,18512,1763,1298,134,19810,360,3931,3965,1591,571
CAGCTTCGCAATTCGG,sample,131114,130271,3372,126899,8544,118355,103088,6678,4584,470,107672,3535,4551,5107,9309,5610
TTATGACGCAATTCGG,sample,139525,138676,5743,132933,8648,124285,79391,5463,26333,3159,105724,9939,3916,1996,15444,5108
TCTCCTAGCAATTCGG,sample,104437,102723,10994,91729,8365,83364,42355,2772,20635,2182,62990,15420,5164,1321,10544,4409
ATGAATAGCAATTCGG,sample,142341,141518,3903,137615,11151,126464,106517,7974,6168,760,112685,5045,2091,1917,21633,7347
ATTCTACCCAATTCGG,sample,111764,110886,5746,105140,12474,92666,57950,4415,15668,1670,73618,12963,5284,1883,13015,8617
GACTAACCCAATTCGG,sample,113896,113092,4254,108838,12047,96791,79341,6680,5644,623,84985,4503,2387,1894,19854,8401
CCTAACTACAATTCGG,sample,124882,123610,8922,114688,10619,104069,54213,3606,24938,2639,79151,18673,7155,1775,16425,6785
AACCGGTTAACTCCGG,sample,314698,313115,8566,304549,26678,277871,212228,21545,24761,2650,236989,16687,6413,4804,20497,16311
AGAGTTCTAACTCCGG,sample,158415,156964,12631,144333,10866,133467,50556,5011,38404,3751,88960,35745,9025,1913,11384,5939
AGCTGAATAACTCCGG,sample,173162,171856,4651,167205,14367,152838,137104,11656,2533,159,139637,1386,1028,1499,25256,9246
TATACGGAAACTCCGG,sample,238079,236535,13100,223435,12280,211155,111489,8273,50849,5496,162338,35048,8886,2534,18019,6904
TGATTCCGAACTCCGG,sample,54644,54056,13243,40813,4600,36213,25145,1690,4611,410,29756,4357,1817,1189,8307,2549
GACTCAAGAACTCCGG,sample,76204,75484,2153,73331,11056,62275,55710,4639,1212,73,56922,641,1117,1535,20458,7690
CGGTTGGTAACTCCGG,sample,104150,103348,2540,100808,10252,90556,82485,5947,1193,117,83678,814,1154,1831,17524,7380
ACGCTTAAAACTCCGG,sample,144619,143518,5281,138237,9723,128514,103704,6237,9454,1061,113158,8058,5288,4100,10113,6515
CCTAGCGGAACTCCGG,sample,54538,54192,3784,50408,5326,45082,29377,1935,7082,796,36459,5892,4040,2271,6059,3358
GGCGACGAAACTCCGG,sample,100613,99822,7329,92493,4848,87645,42319,2959,27515,3374,69834,11478,6239,3054,7038,3076
AGCAGAGCAACTCCGG,sample,36571,36261,3133,33128,2721,30407,14845,1170,7977,1049,22822,5366,4083,1814,2889,1559
CGCGGTCGAACTCCGG,sample,85988,85401,3032,82369,6900,75469,57272,4841,9223,1233,66495,2900,2102,1646,12533,4679
TCAATCAGAACTCCGG,sample,140184,139420,3395,136025,12806,123219,100775,8501,6947,982,107722,6014,2981,2282,17309,9044
CGTAGAACAACTCCGG,sample,119011,118300,2545,115755,12262,103493,92747,7279,2468,162,95215,837,960,1423,23830,9956
ATATGCAAAACTCCGG,sample,115702,115180,4341,110839,8146,102693,67024,6466,18177,2613,85201,8413,3843,1920,15148,4117
CTGGTCTTCCTGAAGG,sample,198204,196463,9250,187213,15852,171361,117977,10441,21649,2573,139626,18721,6706,2621,18694,8379
GTCGTTCTCCTGAAGG,Neg_Ctrl,2402,1449,705,744,57,687,437,31,114,18,551,87,250,147,116,14
AGAGTTCTCCTGAAGG,sample,277848,275568,24197,251371,16297,235074,109013,6945,70687,7793,179700,40636,9944,2958,15491,7451
GAGCCTCCCCTGAAGG,sample,158140,156363,17982,138381,9781,128600,48469,3586,38992,4207,87461,33346,10628,2012,7494,4899
CTAGCGACCCTGAAGG,Neg_Ctrl,2119,1279,680,599,56,543,307,21,114,4,421,97,206,116,62,13
TCATACCACCTGAAGG,sample,79115,78450,4610,73840,5235,68605,40630,2520,15568,1924,56198,7963,5576,3193,10195,2655
GACTCAAGCCTGAAGG,sample,85595,84805,10277,74528,6428,68100,35038,2494,16901,1893,51939,11774,4888,2099,7733,3786
ATACGTTCCCTGAAGG,Neg_Ctrl,1631,1199,478,721,35,686,422,28,100,11,522,125,238,150,92,46
CCGTACGCCCTGAAGG,sample,65590,64816,2353,62463,7611,54852,47177,3495,2452,232,49629,1496,1440,1590,13267,5677
TCTCAGGACCTGAAGG,sample,95723,94626,6986,87640,6591,81049,53415,3230,12903,1226,66318,10275,5477,2903,7387,4603
ATGGCGTTCCTGAAGG,sample,123217,122177,6154,116023,6939,109084,69997,4910,21929,2286,91926,9962,4158,2287,10093,3807
TGCGCGTTCCTGAAGG,Neg_Ctrl,1858,1216,658,558,40,518,292,24,119,16,411,67,186,107,47,25
CATTCGGTCCTGAAGG,sample,111652,110924,7681,103243,6369,96874,53649,3873,24378,3091,78027,11883,6254,3357,8200,3409
TAGCGAGTCCTGAAGG,sample,121119,120403,3817,116586,19370,97216,74595,7000,10899,1450,85494,3272,1737,1938,17846,13328
GCTCTTCTCCTGAAGG,sample,126201,125246,11132,114114,9833,104281,54102,3584,24435,2456,78537,19704,7231,2782,10605,5579
GAGATTCTCCTGAAGG,sample,71648,71043,5419,65624,7063,58561,25180,1821,16852,1781,42032,12927,5734,1523,8289,4304
CTAAGCATCCTGAAGG,Neg_Ctrl,1942,1433,595,838,76,762,504,40,109,14,613,95,247,168,95,65
TAACGAAGCCTGAAGG,sample,144950,143695,11503,132192,10816,121376,55920,3853,32206,3740,88126,25657,7884,1956,13329,6469
GCTGCTTCCCTGAAGG,sample,150681,149484,11341,138143,11161,126982,60440,4247,32488,3450,92928,26357,8500,2644,14883,6844
TGCGCTCCCCTGAAGG,Neg_Ctrl,1423,969,484,485,52,433,249,17,99,7,348,61,170,101,38,24
CGTCGAGGCCTGAAGG,sample,95534,94713,5549,89164,8747,80417,53190,3948,11991,1148,65181,10140,4568,1671,14373,6143
CAGCTTCGCCTGAAGG,Neg_Ctrl,1572,1064,471,593,49,544,288,19,136,10,424,91,222,123,47,22
GACTAACCCCTGAAGG,sample,119162,118151,5409,112742,9125,103617,77831,6168,11102,1068,88933,7448,4777,2930,17946,5937
GCGCAATACCTGAAGG,sample,144615,142998,6968,136030,6396,129634,91793,7332,18533,2098,110326,9878,5284,3409,9719,3953
TCTAGGTTAATATTCG,sample,151696,150862,3408,147454,10186,137268,110950,9359,9162,819,120112,6978,3217,1926,19328,5627
GTCGTTCTAATATTCG,sample,116384,115302,2723,112579,9631,102948,93877,7133,1081,92,94958,765,965,1331,18276,5332
AGAGTTCTAATATTCG,sample,180793,179290,11244,168046,11788,156258,80755,6135,37909,3859,118664,27600,6709,1743,16622,6078
CATACTCCAATATTCG,sample,146276,145395,3076,142319,8877,133442,101235,11795,10891,1273,112126,8248,4441,2378,14833,4723
CTAGCGACAATATTCG,sample,204970,203129,13367,189762,10431,179331,85391,6659,45087,4762,130478,37432,9671,2782,11343,4734
GCAACTAGAATATTCG,sample,24134,23863,1870,21993,1513,20480,7455,641,7409,850,14864,4125,3373,1066,1754,704
ATACGTTCAATATTCG,sample,181034,179394,16454,162940,8621,154319,63213,5499,41739,4467,104952,39401,8584,1949,13734,4058
CCGTACGCAATATTCG,sample,55563,54631,4365,50266,4409,45857,19090,1230,13130,1370,32220,11037,4431,930,2482,2114
ATGGCGTTAATATTCG,sample,40093,39715,5433,34282,2402,31880,12756,759,10076,1096,22832,7193,5204,2115,2265,1099
GAGATTCTAATATTCG,sample,62976,62468,3889,58579,9820,48759,28546,2275,9207,1110,37753,7621,4368,2124,6538,6558
CCTAGCGGAATATTCG,sample,45102,44781,1212,43569,5306,38263,34232,2413,914,60,35146,644,886,1165,11882,3772
CTAACCGGAATATTCG,sample,86278,85609,2797,82812,7717,75095,52903,3705,12081,2014,64984,4392,2019,1469,13601,5466
GGCGACGAAATATTCG,sample,77350,76792,3194,73598,10220,63378,48432,3711,6975,498,55407,3762,2219,1770,13249,7580
GCTGCTTCAATATTCG,sample,184023,182873,8892,173981,13159,160822,104628,7722,27579,3220,132207,17673,6250,2612,17688,8620
TGCGCTCCAATATTCG,sample,131137,130005,7288,122717,9719,112998,70973,5151,19426,2019,90399,15429,6473,2526,11119,5118
TCTCCTAGAATATTCG,sample,122835,122062,5941,116121,12068,104053,81250,6121,10120,1122,91370,5440,3667,2545,19755,8105
AAGTAGAGAATATTCG,sample,145598,144667,7591,137076,10606,126470,80616,6345,19854,2258,100470,17397,6390,2260,18945,6513
TCAATCAGAATATTCG,sample,98797,98130,3067,95063,7759,87304,68660,6428,7005,585,75665,4626,2235,1568,16980,5002
TAACGCCAAATATTCG,sample,81789,81101,5523,75578,5951,69627,40809,3000,15461,1704,56270,8653,5008,2025,8946,3627
ATTCTACCAATATTCG,Pos_Ctrl,32918,32415,1854,30561,1499,29062,24062,2159,1926,201,25988,714,4550,4665,2017,755
GACTAACCAATATTCG,sample,170259,169050,4379,164671,10801,153870,131049,9264,6774,802,137823,5981,4210,3566,16022,6924
CTGGTCTTAGTCTCCG,sample,74094,73783,2512,71271,6453,64818,49256,3825,6096,702,55352,4939,3701,2707,6168,3863
TATACGGAAGTCTCCG,sample,192838,191950,6675,185275,13644,171631,109718,9578,36419,4101,146137,11815,4587,3058,13766,8409
GAGCCTCCAGTCTCCG,sample,41495,40912,2960,37952,3683,34269,13434,1872,9630,971,23064,8362,3565,775,2071,1925
TCGAACGAAGTCTCCG,sample,105429,105071,1904,103167,8986,94181,77942,7556,4859,584,82801,3240,4601,4543,15188,5566
TACGCGAGAGTCTCCG,sample,113280,112727,4277,108450,11067,97383,69117,5724,13634,1193,82751,7715,4114,2398,13576,6836
GACTCAAGAGTCTCCG,sample,84607,83978,5262,78716,9583,69133,42010,4499,11712,1212,53722,9700,4204,1380,12466,5807
TCTCAGGAAGTCTCCG,sample,198935,197778,9286,188492,12697,175795,112045,8709,31235,4586,143280,19220,5972,2444,16848,6574
GATGCGTTAGTCTCCG,sample,138388,137582,4509,133073,11797,121276,83317,6926,20583,1937,103900,8513,4516,3085,11203,7822
AGCGTCTTAGTCTCCG,sample,115029,114275,7191,107084,10424,96660,58542,4097,18016,1649,76558,14356,5655,2205,14433,7056
GGCGACGAAGTCTCCG,sample,106430,105756,3876,101880,8649,93231,70433,5438,8998,1027,79431,7335,3637,2646,11546,5873
ATACCGCCAGTCTCCG,sample,192923,191586,6703,184883,12042,172841,131587,12863,15677,1441,147264,11273,3903,2257,18440,7155
ATGAATAGAGTCTCCG,sample,123351,122524,7661,114863,8967,105896,68183,5362,17843,1940,86026,12568,4531,1790,13578,5845
AAGTAGAGAGTCTCCG,sample,83148,82643,3383,79260,7889,71371,48526,3856,10199,1309,58725,7481,4205,1646,15246,4760
AGATACTAAGTCTCCG,sample,142858,141386,8956,132430,9618,122812,72238,6162,23702,2550,95940,18160,6961,2502,9379,5686
AACCGGTTTGCCTACG,sample,54889,54549,4055,50494,5506,44988,19602,1505,12795,1369,32397,9717,5366,1734,7367,3185
AGAGTTCTTGCCTACG,sample,50173,49807,1042,48765,6189,42576,38765,2795,687,48,39452,281,856,1242,11092,4555
CATACTCCTGCCTACG,sample,195306,194079,9236,184843,8065,176778,113986,10662,26527,2839,140513,22764,8130,2979,12758,3411
TCATACCATGCCTACG,sample,1326,1314,79,1235,123,1112,717,74,178,19,895,124,393,286,138,67
CCGCAGTCTGCCTACG,sample,127928,126968,10521,116447,7252,109195,69132,5175,18813,2121,87945,13954,6702,3370,6774,4378
TCTCAGGATGCCTACG,sample,123071,122289,6100,116189,7845,108344,63333,4288,23907,2620,87240,14196,5505,2256,7801,4387
CCATTCTTTGCCTACG,sample,68101,67552,4803,62749,3784,58965,40798,2646,8540,1041,49338,5940,5097,3582,3880,2535
GCTGCTTCTGCCTACG,sample,37533,37181,3003,34178,1891,32287,13594,934,12104,1367,25698,4288,3968,1601,4254,939
GGCGTACCTGCCTACG,sample,49917,49462,3533,45929,2707,43222,24015,1716,8806,844,32821,7841,3814,1224,4265,1430
GTCGCGAATGCCTACG,sample,70036,69465,4374,65091,4822,60269,37497,2272,12181,1287,49678,7032,4829,2769,7056,2868
CGTCGAGGTGCCTACG,sample,57691,57275,1181,56094,3490,52604,46810,3320,1208,278,48018,988,2002,2527,4497,2198
CGCGGTCGTGCCTACG,sample,49569,49136,1616,47520,4099,43421,31444,2479,5941,700,37385,2857,2876,2214,4892,2648
TTATGACGTGCCTACG,sample,65439,64973,2250,62723,5615,57108,41330,3602,6288,754,47618,5134,3456,1879,8393,3483
GACTAACCTGCCTACG,Neg_Ctrl,736,505,183,322,12,310,180,11,66,6,246,47,139,76,39,7
CGTAGAACTGCCTACG,sample,70121,69737,2031,67706,4659,63047,42919,3925,11175,1044,54094,3984,2152,1517,8826,3032
TATACGGACTTAGTTC,sample,202838,201880,5968,195912,14772,181140,141576,11649,18360,2746,159936,6809,4910,4625,15835,10343
CGTCGCCACTTAGTTC,sample,160910,159691,8332,151359,9843,141516,68258,6518,37015,3596,105273,26129,7257,2140,15466,4797
ATTCAAGGCTTAGTTC,sample,119724,119029,2466,116563,15853,100710,89678,7555,1671,586,91349,1220,1291,1739,24693,11883
CCGTACGCCTTAGTTC,sample,107816,107169,2924,104245,12736,91509,78487,5305,4006,346,82493,3365,1331,1561,22662,8492
TCTCAGGACTTAGTTC,sample,119506,118831,3982,114849,12469,102380,80363,5971,8614,898,88977,6534,4659,3647,11649,8661
ATGGCGTTCTTAGTTC,sample,130176,129405,4022,125383,14371,111012,98360,7943,2651,277,101011,1781,1011,1353,29446,9769
AAGGTCTGCTTAGTTC,sample,77042,76248,9039,67209,5205,62004,15535,984,23966,2372,39501,19147,6801,1204,3954,2430
CTAACCGGCTTAGTTC,sample,80443,79956,2013,77943,11327,66616,59161,3993,2317,233,61478,912,2951,3860,12592,8793
TAACGAAGCTTAGTTC,sample,108743,107938,9674,98264,9256,89008,60676,4253,12901,1475,73577,9703,4180,2170,15054,5580
TGCGCTCCCTTAGTTC,sample,99294,98432,4059,94373,12403,81970,68610,5586,4513,326,73123,2935,2266,1387,20378,7975
CAGCTTCGCTTAGTTC,sample,179763,178356,8834,169522,9597,159925,102598,8114,25807,2730,128405,20676,7495,2964,12478,6045
TTATGACGCTTAGTTC,sample,158771,157944,9834,148110,9680,138430,95119,8454,18461,1947,113580,14449,5461,2583,12833,4955
CGTAGAACCTTAGTTC,sample,133231,132366,3365,129001,13355,115646,103242,8293,2177,381,105419,1553,2744,3868,18618,9679
GCGCAATACTTAGTTC,sample,127967,126954,3748,123206,10019,113187,91907,7179,8523,839,100430,4739,2087,1718,21388,7515
TTAACTGACTTAGTTC,sample,120113,119155,4214,114941,9312,105629,82500,6171,10543,1067,93043,5348,2074,1526,19726,5999
ATATGCAACTTAGTTC,sample,130200,129348,2539,126809,10363,116446,99622,7943,5054,613,104676,3214,3173,3230,13146,6707
TCTAGGTTCGAGCTTC,sample,133296,132515,3589,128926,14424,114502,102639,7063,2682,184,105321,1934,1178,1627,29377,9996
CTGGTCTTCGAGCTTC,sample,250031,248853,6428,242425,27935,214490,172869,16350,17018,1651,189887,6602,3290,3764,22847,20397
AGAGTTCTCGAGCTTC,sample,174482,173424,5887,167537,13089,154448,119584,9395,12739,1404,132323,11326,4614,2184,24066,8232
TCTCAGGACGAGCTTC,sample,231936,230291,9857,220434,14663,205771,153577,10631,23290,2499,176867,15774,7668,4647,15337,9835
TGGATCAACGAGCTTC,sample,210968,209848,6297,203551,18375,185176,146108,12545,16565,2208,162673,7750,3081,2410,24493,13425
GATGCGTTCGAGCTTC,sample,163993,162813,10314,152499,14784,137715,69107,5490,32286,3375,101393,27457,7644,1893,17042,7904
GCTCTTCTCGAGCTTC,sample,227583,226398,4834,221564,22240,199324,178206,15925,2769,599,180975,1825,1513,2452,27137,16205
GCCTATTCCGAGCTTC,sample,203387,202077,5867,196210,10136,186074,138371,11509,23178,2585,161549,10431,4407,3165,13636,6847
AGCAGAGCCGAGCTTC,sample,124287,122074,9534,112540,10355,102185,50134,4327,25690,2281,75824,19753,6725,1693,14886,5814
TGCGCTCCCGAGCTTC,sample,147557,146628,3469,143159,14510,128649,115376,9197,1975,467,117351,1634,2203,2990,19811,10381
GCGTTACCCGAGCTTC,sample,88309,87670,2892,84778,9206,75572,66523,5688,2026,203,68549,1132,957,1226,18144,6582
CGTCGAGGCGAGCTTC,sample,105019,104080,6027,98053,8610,89443,56321,5096,15345,1544,71666,11137,5037,1817,13921,4856
TTATGACGCGAGCTTC,sample,105168,104615,2287,102328,11436,90892,81557,6604,1720,165,83277,846,954,1310,19253,8462
TCAATCAGCGAGCTTC,sample,128431,127655,3558,124097,9967,114130,91819,7563,7894,770,99713,6084,3283,2046,22938,6505
ATTCTACCCGAGCTTC,sample,52378,51802,4405,47397,2853,44544,16953,1248,15101,1646,32054,9596,5162,1416,4104,1505
GACTAACCCGAGCTTC,sample,122800,122032,5383,116649,10199,106450,84400,6710,9152,954,93552,5234,1939,2025,13880,7643
GCGCAATACGAGCTTC,sample,174688,173535,7373,166162,15129,151033,98601,8080,21885,2290,120486,20177,6633,2333,18523,8744
CTGGTCTTGTAGAATG,Pos_Ctrl,46300,45754,2295,43459,2336,41123,34702,3131,2257,342,36959,691,4999,5513,3290,1176
AGAGTTCTGTAGAATG,sample,121925,121188,4392,116796,13107,103689,82750,6256,8881,940,91631,4862,3548,2938,19618,9207
TATACGGAGTAGAATG,sample,104054,102980,8161,94819,8245,86574,36168,3264,23736,2439,59904,20967,6730,1497,9711,4432
CATACTCCGTAGAATG,sample,124278,123442,4080,119362,13241,106121,79417,6709,11246,1247,90663,7502,3689,2269,17844,9582
GCAACTAGGTAGAATG,Pos_Ctrl,6031,5954,300,5654,399,5255,4227,449,399,38,4626,142,1844,1694,459,250
TACGCGAGGTAGAATG,sample,387378,384530,20416,364114,17235,346879,186501,14330,109041,14217,295542,22790,7523,4167,20712,7145
CCGTACGCGTAGAATG,sample,111054,110149,3031,107118,11129,95989,86591,6984,1208,80,87799,1126,1094,1588,27388,7861
TGGATCAAGTAGAATG,sample,64468,63930,5739,58191,4741,53450,22835,1930,16000,1632,38835,11053,5627,1729,5664,2335
GATGCGTTGTAGAATG,sample,203898,202618,6120,196498,21865,174633,148471,12171,7997,1331,156468,4663,2798,2903,24286,15664
AGCGTCTTGTAGAATG,sample,155617,154687,5671,149016,15676,133340,100562,7765,12711,1936,113273,10366,4916,2768,23522,10333
TAGCGAGTGTAGAATG,sample,156616,155312,12556,142756,8806,133950,61155,4284,34554,3544,95709,30413,8228,2625,5672,3830
GCTCTTCTGTAGAATG,Pos_Ctrl,29117,28760,1450,27310,1456,25854,21457,2033,1618,212,23075,534,4213,4296,2000,641
CTAAGCATGTAGAATG,sample,127907,126752,6418,120334,9764,110570,67190,5972,20290,2222,87480,14896,4902,1509,16396,5462
CTAACCGGGTAGAATG,sample,112735,111953,2726,109227,11763,97464,88040,6276,1776,390,89816,982,1019,1616,18575,8820
TAACGAAGGTAGAATG,sample,139066,138088,6834,131254,7632,123622,77529,5824,22491,2854,100020,14924,5908,2503,14832,4771
GCCTATTCGTAGAATG,sample,124270,123408,3176,120232,9299,110933,90288,6631,8523,909,98811,4582,2381,1910,20238,6655
TGCGCTCCGTAGAATG,sample,78855,78190,1813,76377,7279,69098,60900,5357,1719,275,62619,847,901,1155,14729,5071
GGCGTACCGTAGAATG,sample,116119,115370,2635,112735,9210,103525,92843,7867,1543,174,94386,1098,1256,1990,15842,6573
GTCGCGAAGTAGAATG,sample,30363,30172,5768,24404,1490,22914,7541,455,7871,869,15412,6178,4324,1463,1111,653
CAGCTTCGGTAGAATG,sample,118575,117500,7365,110135,4923,105212,50310,3172,33518,4010,83828,14202,6355,2443,9504,2724
CGCGGTCGGTAGAATG,Pos_Ctrl,11575,11422,550,10872,559,10313,8616,840,564,86,9180,207,2522,2354,857,227
ATGAATAGGTAGAATG,sample,150179,149099,9994,139105,9801,129304,64219,5640,31244,3140,95463,25061,8372,2545,12997,5417
ATTCTACCGTAGAATG,sample,131264,130359,7931,122428,8628,113800,57706,4807,26576,3136,84282,21575,7417,2135,6731,4335
GACTAACCGTAGAATG,sample,94145,93520,2732,90788,8948,81840,67371,5746,4930,863,72301,2930,1505,1423,16240,6211
CGTAGAACGTAGAATG,sample,185438,184090,9551,174539,13651,160888,110514,8866,23058,2295,133572,16155,5838,2407,20529,8639
TCTAGGTTCAATAGTC,sample,25091,24924,964,23960,2233,21727,13014,1422,3876,357,16890,3058,2887,1658,1864,916
CATAATGGCAATAGTC,sample,39777,39591,696,38895,6165,32730,28767,2760,707,70,29474,426,1260,1744,5518,4087
TCGAACGACAATAGTC,sample,15510,15420,543,14877,1185,13692,7848,736,3496,402,11344,1210,2119,1549,752,553
GGTAGAGACAATAGTC,sample,101629,101192,1943,99249,10675,88574,72024,6551,6439,640,78463,2920,2701,2766,18060,7555
TCATCGAACAATAGTC,sample,83741,83226,4189,79037,8310,70727,44961,3672,11009,1207,55970,9878,4399,1549,12449,5198
TACGCGAGCAATAGTC,sample,53326,53099,1019,52080,6441,45639,37564,3875,2324,244,39888,1632,2452,2390,7598,4436
CCGCAGTCCAATAGTC,sample,122614,121772,7333,114439,10822,103617,62144,4857,18387,2186,80531,16043,5904,1749,16892,6507
TGGATCAACAATAGTC,sample,73174,72645,2082,70563,8782,61781,54666,5253,1057,40,55723,765,861,1260,15652,6511
CCATTCTTCAATAGTC,sample,135000,134198,4513,129685,7209,122476,90743,6227,13526,1386,104269,10594,5554,2868,8620,4213
GAGATTCTCAATAGTC,sample,125485,124652,5065,119587,6125,113462,73258,6213,22858,2264,96116,8869,4006,1882,7406,3596
CTAAGCATCAATAGTC,sample,143478,142327,10922,131405,8003,123402,48581,2724,38127,3724,86708,30246,8583,1990,7757,3751
CCTAGCGGCAATAGTC,sample,49754,49292,3475,45817,3396,42421,22788,1845,8683,1005,31471,8100,3948,1102,5687,1785
GGCGACGACAATAGTC,sample,39027,38665,1599,37066,3778,33288,25811,1896,2845,315,28656,2421,2236,1566,6231,2410
TGCGCTCCCAATAGTC,sample,61889,61305,5244,56061,3076,52985,21819,1426,18205,1723,40024,9812,5454,2086,3288,1510
GGCGTACCCAATAGTC,sample,74759,74138,3034,71104,6754,64350,50203,4766,5503,960,55706,2918,2052,1753,10687,5353
ATTCTACCCAATAGTC,sample,92650,92023,2233,89790,8431,81359,73971,5231,1685,51,75656,421,928,1332,19271,6223
CGCGAGACCAATAGTC,sample,91750,90916,3635,87281,4883,82398,61446,4151,10925,1184,72371,4692,4111,3109,7797,3658
CGTAGAACCAATAGTC,sample,109090,107970,5260,102710,6653,96057,64154,4142,16733,1847,80887,9181,4438,2750,9921,4092
TTAACTGACAATAGTC,sample,89886,89354,3490,85864,8838,77026,52855,4592,10278,1078,63133,8223,4710,2608,10612,6008
CTGGTCTTCGTTACTC,sample,1963,1887,91,1796,189,1607,1215,154,160,14,1375,64,421,370,304,108
GTCGTTCTCGTTACTC,Neg_Ctrl,2276,1218,385,833,97,736,514,29,110,18,624,65,274,184,128,31
CATAATGGCGTTACTC,sample,258002,256147,13171,242976,15616,227360,114429,10002,60159,7125,174588,35645,8631,2416,27019,8184
TCATACCACGTTACTC,sample,194898,193415,13880,179535,18286,161249,78172,6301,40022,5159,118194,31595,8775,2329,25140,10723
TACGCGAGCGTTACTC,Neg_Ctrl,2215,1542,438,1104,67,1037,614,55,189,18,803,161,335,214,157,42
CCGCAGTCCGTTACTC,sample,130032,129048,3579,125469,15187,110282,99476,7240,1684,282,101160,1600,1141,1483,31667,10002
CCGTACGCCGTTACTC,sample,166374,165329,8562,156767,19050,137717,93049,8152,18663,1892,111712,15961,6353,2380,26615,12394
GATGCGTTCGTTACTC,sample,145377,144414,9304,135110,10960,124150,68691,5489,31952,4532,100643,13486,5255,2790,12393,6815
ATGGCGTTCGTTACTC,sample,110508,109502,9554,99948,10093,89855,49859,3457,19785,2463,69644,14291,5157,1917,13474,6343
TGCGCGTTCGTTACTC,sample,198159,197113,6650,190463,16264,174199,121378,8696,28523,3188,149901,12414,5322,3049,26385,10870
ACGCTTAACGTTACTC,sample,191494,189901,12445,177456,16795,160661,93099,6500,32247,3340,125346,25475,7800,2318,24849,10748
GAGATTCTCGTTACTC,Neg_Ctrl,2215,1610,470,1140,95,1045,632,69,216,17,848,111,325,227,137,90
CCTAGCGGCGTTACTC,sample,115817,115076,7202,107874,9063,98811,55912,4295,23111,2828,79023,12665,5906,3007,9634,5246
GCTGCTTCCGTTACTC,sample,81072,80305,6719,73586,9176,64410,27097,2039,17423,1757,44520,16094,5862,1311,8170,5925
GCGTTACCCGTTACTC,sample,221435,220335,6701,213634,14170,199464,147682,11666,25884,3243,173566,10989,5772,3711,22151,7579
TTATGACGCGTTACTC,Neg_Ctrl,1813,1341,465,876,79,797,471,49,146,33,617,98,309,185,98,50
TAACGCCACGTTACTC,sample,183250,182120,4777,177343,16652,160691,137974,10449,7543,1205,145517,3520,1939,1874,35402,11617
ATTCTACCCGTTACTC,sample,186194,184633,6950,177683,14881,162802,128268,9380,12824,1286,141092,11044,4524,2692,19673,9458
GACTAACCCGTTACTC,sample,168012,166816,4557,162259,15218,147041,131889,10634,2647,120,134536,1751,1221,1717,32814,11719
AGATACTACGTTACTC,sample,294006,291830,11228,280602,18080,262522,189099,15382,34481,3127,223580,20433,6745,3725,17902,11682
TCTAGGTTTGGACTGC,sample,148218,147067,3315,143752,15512,128240,106217,8239,7429,1160,113646,5195,3120,1912,23730,10220
GTCGTTCTTGGACTGC,sample,304574,302292,15432,286860,12208,274652,139764,8191,79521,9647,219285,37529,9731,3430,13639,5795
CATAATGGTGGACTGC,sample,206229,204848,9523,195325,15155,180170,123140,9068,25055,2983,148195,19924,8903,3701,37521,8107
TATACGGATGGACTGC,sample,121208,120297,3135,117162,10252,106910,92807,7217,3988,217,96795,2681,1891,1580,18120,7002
GAGCCTCCTGGACTGC,sample,196745,195406,7096,188310,10484,177826,104157,8740,40092,4867,144249,19970,6284,2514,16552,5903
TCGAACGATGGACTGC,sample,316501,314142,16157,297985,14457,283528,165735,13761,73444,10463,239179,20125,7155,3965,16291,4394
CGTCGCCATGGACTGC,sample,104120,103434,2430,101004,11695,89309,79017,6691,2329,191,81346,1081,1190,1643,16696,8171
TACGCGAGTGGACTGC,sample,85342,84607,4842,79765,8021,71744,43515,2455,16463,1736,59978,7575,4375,2465,9907,5488
GACTCAAGTGGACTGC,sample,52783,52243,5254,46989,3018,43971,15258,1059,16068,1639,31326,9947,5608,2026,2213,1508
ATACGTTCTGGACTGC,sample,55109,54612,4669,49943,3153,46790,28818,2188,8909,1096,37727,5779,5048,3146,3567,2035
TCTCAGGATGGACTGC,sample,100741,99898,6135,93763,5565,88198,52967,3960,19607,2080,72574,9584,5574,3068,10080,3360
TGGATCAATGGACTGC,sample,116224,115290,8200,107090,8017,99073,66353,4758,14612,1630,80965,11720,5967,3299,6682,4646
GGCAGGTTTGGACTGC,sample,44916,44514,4182,40332,3566,36766,20417,1523,7334,766,27751,6726,3290,1286,6284,2077
GATGCGTTTGGACTGC,sample,18788,18675,3791,14884,878,14006,2522,166,6005,631,8527,4682,3086,627,465,319
ATGGCGTTTGGACTGC,sample,115561,114924,3223,111701,7768,103933,83281,5955,9089,1061,92370,4547,4680,4315,11335,4926
CCATTCTTTGGACTGC,sample,114885,114109,3750,110359,9698,100661,79480,5884,9170,1013,88650,5114,4417,3635,14680,6381
CATTCGGTTGGACTGC,sample,48855,48528,2432,46096,6720,39376,28289,2042,4846,566,33135,3633,3381,2178,8562,4366
AGCAGAGCTGGACTGC,sample,76545,75980,2053,73927,7567,66360,57303,4546,2311,278,59614,1922,1718,1334,14587,5660
GCGTTACCTGGACTGC,sample,147605,146396,9643,136753,11255,125498,76409,5941,23767,2716,100176,16665,6891,2803,12235,7140
CGCGGTCGTGGACTGC,sample,88695,88240,1823,86417,9339,77078,69004,6429,914,82,69918,649,1535,2301,12615,6574
TCTCCTAGTGGACTGC,sample,122945,122084,7321,114763,11235,103528,63343,5114,18438,1673,81781,14960,5510,1526,17476,6884
AGCTGAATCCTTGAGC,sample,375523,373225,14734,358491,24218,334273,230471,23659,40465,4700,270936,34978,9449,3036,52235,13538
GAGCCTCCCCTTGAGC,Pos_Ctrl,77777,76816,4622,72194,3540,68654,56801,5577,4212,543,61013,1521,6172,7715,3867,1599
CATACTCCCCTTGAGC,sample,108166,107014,5654,101360,12178,89182,54021,5273,15832,1907,69853,12149,4735,1603,4539,7669
TCATCGAACCTTGAGC,sample,160148,159588,4136,155452,21568,133884,105867,8563,12708,1539,118575,5207,3507,2942,22212,15021
ATTCAAGGCCTTGAGC,sample,211996,210052,15019,195033,12078,182955,94672,6150,51298,6889,145970,23946,8243,3458,14471,7043
GACTCAAGCCTTGAGC,sample,188329,186787,14384,172403,13373,159030,72007,4479,44735,4998,116742,32811,8891,2295,16453,6711
CCGCAGTCCCTTGAGC,sample,187820,186368,5256,181112,17386,163726,143840,14315,3784,706,147624,1081,1209,1638,28865,12001
TGGATCAACCTTGAGC,sample,283644,282099,14539,267560,20995,246565,185051,12417,26924,2649,211975,19524,7792,4352,19713,13092
GGCAGGTTCCTTGAGC,Pos_Ctrl,43074,42775,2402,40373,2321,38052,31751,3235,2120,266,33871,680,5028,5564,3039,1198
ATGGCGTTCCTTGAGC,sample,145307,144318,9273,135045,12135,122910,71183,5915,24336,3016,95519,18460,6979,2824,16554,7546
ACGCTTAACCTTGAGC,sample,152265,151335,7696,143639,11680,131959,85840,6739,24925,3263,110765,11192,6685,4166,12232,7284
CTAACCGGCCTTGAGC,sample,126209,125232,5775,119457,15801,103656,67385,5868,17029,1931,84414,11443,5378,2144,16612,11329
GCTGCTTCCCTTGAGC,Pos_Ctrl,34731,34046,2560,31486,1694,29792,24743,2037,2000,264,26743,748,4732,4767,2191,828
TGCGCTCCCCTTGAGC,sample,230678,228809,14047,214762,11071,203691,93962,4988,67898,7146,161860,29697,8192,2422,15464,5907
ATACCGCCCCTTGAGC,sample,232540,230985,7618,223367,19196,204171,183499,12715,4172,327,187671,3458,1725,1963,39486,12699
GGCGTACCCCTTGAGC,sample,195928,194570,6697,187873,11723,176150,144403,12107,10220,837,154623,8583,5251,4304,14960,7134
CCTAACTACCTTGAGC,Pos_Ctrl,33383,32495,2445,30050,1704,28346,23480,2059,1949,255,25429,603,4472,4513,2061,861
AACCGGTTCGATATCC,sample,89874,89435,2064,87371,13539,73832,58196,5581,5348,451,63544,4256,2449,1825,13797,9280
TCTAGGTTCGATATCC,sample,135994,135425,2331,133094,17859,115235,99663,8818,4160,465,103823,2129,1702,1890,25551,12203
AGAGTTCTCGATATCC,sample,91549,91245,3064,88181,8340,79841,59261,4999,9212,1109,68473,5260,5337,4492,7293,5069
CATAATGGCGATATCC,sample,95456,94903,2957,91946,12510,79436,63327,4849,6907,452,70234,3901,1980,1629,16172,7927
GGTAGAGACGATATCC,sample,124616,123836,2650,121186,11145,110041,98820,8740,1136,66,99956,1279,864,1269,16803,6569
ATACGTTCCGATATCC,sample,227581,226491,3399,223092,17147,205945,183853,17974,2655,188,186508,1275,1489,2577,23846,10894
CCGCAGTCCGATATCC,sample,135002,133906,6962,126944,10098,116846,71746,7923,18702,1868,90448,16607,6062,2078,11509,5515
GGCAGGTTCGATATCC,sample,146063,145316,4399,140917,17731,123186,101137,8372,8207,605,109344,4865,2414,2090,26593,12367
ACGCTTAACGATATCC,sample,116346,115475,8853,106622,8562,98060,46853,2988,24826,2551,71679,20842,7449,2256,10520,4893
CATTCGGTCGATATCC,sample,130357,129654,3469,126185,16977,109208,98820,6670,2289,161,101109,1268,942,1342,30032,12449
CCTAGCGGCGATATCC,sample,72076,71511,4753,66758,7608,59150,42037,2647,7235,738,49272,6493,2454,1240,12714,4666
GCCTATTCCGATATCC,sample,209283,208042,5395,202647,12058,190589,153809,11769,15700,1399,169509,7912,4167,3760,14485,7528
AGCAGAGCCGATATCC,sample,111436,110688,6235,104453,8457,95996,54894,4869,22104,2095,76998,12034,5481,2149,12986,5481
CGCGGTCGCGATATCC,sample,80050,79469,2000,77469,7401,70068,64705,3339,871,90,65576,1063,859,1183,15628,5114
TCTCCTAGCGATATCC,sample,42659,42285,10656,31629,4089,27540,7978,500,9463,967,17441,8632,4543,1169,1876,1065
ATGAATAGCGATATCC,sample,150223,149130,6617,142513,13793,128720,90864,6787,16053,1432,106917,13584,5534,2260,15924,9460
GACTAACCCGATATCC,sample,143659,142130,9893,132237,9258,122979,67059,4969,26611,2732,93670,21608,7018,1800,16196,4956
CCTAACTACGATATCC,sample,126279,125342,3227,122115,11693,110422,99572,8118,1719,154,101291,859,1066,1558,22486,8127
ATATGCAACGATATCC,sample,7867,7748,358,7390,536,6854,5002,353,767,99,5769,633,1451,1151,866,338
GACGTATGATCTGACC,sample,90084,89245,7704,81541,3922,77619,26647,1663,29618,3248,56265,16443,6276,1642,2589,1785
GGAGAAGCATCTGACC,sample,107707,106898,5666,101232,8979,92253,62701,4440,13260,1303,75961,10549,5186,2292,10843,5406
GAGCCTCCATCTGACC,sample,87869,87253,2325,84928,10680,74248,66851,5045,1546,311,68397,495,914,1296,18785,7729
CATACTCCATCTGACC,Neg_Ctrl,1549,973,199,774,68,706,469,33,96,12,565,96,277,193,79,24
TCGAACGAATCTGACC,sample,185167,184067,6882,177185,11232,165953,119111,10737,18719,1876,137830,15510,6224,2699,16501,6887
GGTAGAGAATCTGACC,sample,151841,150938,2574,148364,12702,135662,120816,11602,1794,211,122610,1239,1498,2292,18978,8139
ATTCAAGGATCTGACC,sample,70381,69927,3209,66718,6932,59786,41225,2794,9819,1163,51044,4785,4036,2549,10078,4424
GCAACTAGATCTGACC,sample,31188,30773,940,29833,2990,26843,23855,2358,370,39,24225,221,590,885,5486,1734
GACTCAAGATCTGACC,sample,105154,104535,3290,101245,9956,91289,72534,5825,7658,983,80192,4289,4080,3754,12017,6782
GATGCGTTATCTGACC,Neg_Ctrl,1506,1095,203,892,70,822,593,71,109,13,702,36,292,206,145,36
CGGTTGGTATCTGACC,sample,7095,6993,1051,5942,526,5416,2454,121,1497,174,3951,1170,1405,568,810,331
GCTCTTCTATCTGACC,sample,114048,113170,8035,105135,6486,98649,48006,3628,29269,4628,77275,13118,3959,1848,9343,3590
GAGATTCTATCTGACC,sample,98370,97854,2890,94964,14168,80796,71865,5578,1729,434,73594,1190,1264,1639,17600,10681
TAACGAAGATCTGACC,sample,59983,59392,3202,56190,3385,52805,26383,1322,16908,2100,43291,6092,3473,1789,4004,2191
GCCTATTCATCTGACC,Neg_Ctrl,1285,867,271,596,44,552,360,33,88,7,448,64,229,150,54,19
AGCAGAGCATCTGACC,sample,97524,96793,5628,91165,6710,84455,57193,3953,12312,1275,69505,9722,6103,3313,11391,3792
TGCGCTCCATCTGACC,sample,129014,128264,4735,123529,12907,110622,85852,7080,9138,956,94990,7596,3753,2627,14411,9192
ATACCGCCATCTGACC,sample,74229,73661,3390,70271,6785,63486,40596,3016,10174,1272,50770,8428,4335,2226,5579,4196
TCTCCTAGATCTGACC,sample,93048,92241,6328,85913,6737,79176,42933,2685,18932,2093,61865,12533,5460,1797,8631,4117
CGTAGAACATCTGACC,sample,84683,84054,2819,81235,7157,74078,58743,3910,5572,738,64315,5115,2771,1659,12606,4837
GCGCAATAATCTGACC,Neg_Ctrl,597,403,75,328,20,308,211,15,45,3,256,34,135,90,34,8
TTAACTGAATCTGACC,sample,57446,57086,3051,54035,3331,50704,32699,2737,8706,991,41405,5571,4954,3360,4929,1921
TCTAGGTTCTTCTTAC,sample,184277,182775,12869,169906,14092,155814,95878,6521,27530,2702,123408,23183,8804,4666,9790,8912
CTGGTCTTCTTCTTAC,sample,121419,120315,8383,111932,6386,105546,60098,4302,20838,2171,80936,18137,6672,2663,6497,3345
TATACGGACTTCTTAC,sample,155350,154260,7081,147179,14103,133076,94563,7547,18998,2379,113561,9589,4914,2744,20407,9421
GAGCCTCCCTTCTTAC,sample,154021,152876,8581,144295,10598,133697,88328,6752,19816,1958,108144,16843,5773,2442,18230,6203
CTAGCGACCTTCTTAC,sample,159197,158065,6912,151153,15688,135465,96494,7483,16765,1771,113259,12952,6047,2749,19038,10322
GGTAGAGACTTCTTAC,sample,240892,239259,12914,226345,14901,211444,124889,12933,37643,4085,162532,31894,8852,2578,30131,7823
CGTCGCCACTTCTTAC,sample,181827,180759,5009,175750,10438,165312,138750,12656,7991,1027,146741,4888,2581,2181,21847,6281
GACTCAAGCTTCTTAC,sample,157453,156116,10460,145656,10736,134920,74667,5435,30127,3698,104794,20993,6301,2110,17302,6759
CCGTACGCCTTCTTAC,sample,127301,126151,7103,119048,10349,108699,68974,5654,18080,1889,87054,14102,5860,2401,14398,6402
GGCAGGTTCTTCTTAC,sample,161273,160337,4079,156258,18500,137758,122367,8066,3991,430,126358,2904,2696,2850,23889,13844
TGCGCGTTCTTCTTAC,sample,175951,174594,11973,162621,13063,149558,90565,7608,28077,3231,118642,20077,7105,2906,19224,7687
GCTCTTCTCTTCTTAC,sample,272974,271185,7188,263997,13370,250627,192132,13326,28566,3529,220698,13074,4706,3524,18116,7042
CTAAGCATCTTCTTAC,sample,117663,116826,3621,113205,12200,101005,88544,7016,3394,243,91938,1808,1442,1526,22167,8858
CCTAGCGGCTTCTTAC,sample,46214,45711,4418,41293,2564,38729,15174,990,14331,1775,29505,6459,4439,1718,2451,1436
AGCAGAGCCTTCTTAC,sample,161204,159738,12812,146926,8771,138155,72110,5373,33121,3918,105231,23633,8236,2853,13255,4973
ATACCGCCCTTCTTAC,sample,96972,96362,2300,94062,8689,85373,70956,6685,4570,640,75526,2522,1804,1890,14546,6129
GCGTTACCCTTCTTAC,sample,87862,87240,2990,84250,8235,76015,59490,4330,6669,699,66159,4827,3273,1967,17782,5739
GTCGCGAACTTCTTAC,sample,82803,82016,7030,74986,5514,69472,38613,2942,14986,1602,53599,11329,5672,2106,10468,3063
CGCGGTCGCTTCTTAC,sample,131039,130042,4338,125704,9889,115815,98412,6059,5777,730,104189,4837,3948,3174,12205,6450
CGCGAGACCTTCTTAC,sample,157125,155882,7682,148200,11088,137112,81948,6109,25873,2777,107821,20405,7576,2749,13667,6979
CCTAACTACTTCTTAC,sample,182021,180869,10331,170538,12260,158278,89615,7315,32383,3499,121998,25466,8458,2778,19030,6299
GCGCAATACTTCTTAC,sample,141412,140455,8348,132107,9734,122373,65903,5639,26525,2850,92428,21456,7718,2177,14304,5005
TTAACTGACTTCTTAC,sample,134061,133441,2376,131065,13141,117924,101456,9306,3882,554,105338,2726,1869,1967,27331,8124
AACCGGTTACTTCTAC,sample,78858,78197,4340,73857,8064,65793,38445,2378,13305,1903,51750,9762,3914,1277,9521,5217
TCTAGGTTACTTCTAC,sample,99044,98481,4833,93648,7469,86179,54554,3969,16936,1895,71490,8825,5677,3500,11402,4455
AGCTGAATACTTCTAC,sample,103459,102632,6454,96178,8325,87853,63315,4209,10535,1225,73850,8569,5157,3422,6725,5701
GGTAGAGAACTTCTAC,sample,89016,88466,4332,84134,6472,77662,43661,3620,18633,1939,62294,9809,4751,1883,9965,3673
CGTCGCCAACTTCTAC,sample,114756,113780,7681,106099,7425,98674,57959,4383,19631,2354,77590,14347,6183,2290,10848,4756
GACTCAAGACTTCTAC,sample,46708,46377,1731,44646,6339,38307,29406,2811,3223,395,32629,2472,3422,2964,4991,4650
CCGCAGTCACTTCTAC,sample,115042,114285,2554,111731,12189,99542,88433,8214,1237,710,89670,948,1152,1715,22898,9267
CCGTACGCACTTCTAC,sample,105851,105076,5019,100057,9093,90964,60975,5392,13101,1353,74076,10143,4582,1907,13902,6158
TCTCAGGAACTTCTAC,sample,125846,124966,6437,118529,10326,108203,75166,5389,13957,1605,89123,12086,5340,2296,17479,6362
ACGCTTAAACTTCTAC,sample,100392,99801,4119,95682,7418,88264,56527,3810,17047,2201,73574,8679,4920,2612,18010,4466
CTAAGCATACTTCTAC,sample,144390,143589,3073,140516,15899,124617,110796,9929,1982,326,112778,1584,1598,2339,24925,9907
TAACGAAGACTTCTAC,sample,105456,104642,5317,99325,8369,90956,70212,4620,8057,1029,78269,7038,4136,2752,10695,5639
GCCTATTCACTTCTAC,sample,60920,60500,5017,55483,2612,52871,18106,1230,21494,2401,39600,9640,5503,1889,3689,1353
CGTCGAGGACTTCTAC,sample,75365,74720,4949,69771,6474,63297,31362,2925,14504,1459,45866,13047,4882,1403,7577,4361
CAGCTTCGACTTCTAC,sample,89367,88714,3936,84778,6835,77943,56088,5389,9221,1211,65309,6034,2803,1791,8545,4676
TCTCCTAGACTTCTAC,sample,133484,131788,13042,118746,5747,112999,38971,1971,36293,3790,75264,31974,9248,2165,4897,2372
AAGTAGAGACTTCTAC,sample,94265,93472,3710,89762,7472,82290,60405,4553,9390,814,69795,7128,3460,1581,13052,5554
ATTCTACCACTTCTAC,sample,120469,119562,8549,111013,6158,104855,54516,4049,28402,3401,82918,14487,7432,3215,6183,3596
CGCGAGACACTTCTAC,sample,65278,64673,4765,59908,4175,55733,26014,2090,14637,1528,40651,11464,5202,1427,5857,2463
CCTAACTAACTTCTAC,sample,27960,27684,1874,25810,2336,23474,13428,1229,4693,469,18121,3655,2797,1182,3515,1312
GTCGTTCTAGAAGTAA,sample,165595,164405,10754,153651,14318,139333,61662,4513,38061,4113,99723,30984,8589,2033,14193,7732
AGAGTTCTAGAAGTAA,sample,203574,202442,9685,192757,20603,172154,114888,9241,24265,2710,139153,21050,6817,2483,25852,13307
CATAATGGAGAAGTAA,sample,35987,35799,1090,34709,4001,30708,22365,2076,3681,475,26046,2111,2681,2027,2579,2521
GGAGAAGCAGAAGTAA,sample,72808,71863,1690,70173,11833,58340,51888,4712,1104,185,52992,451,879,1295,15500,7864
GAGCCTCCAGAAGTAA,sample,26882,26604,1417,25187,3864,21323,12904,1209,3968,418,16872,2824,2219,1057,3885,2379
TCGAACGAAGAAGTAA,sample,133457,132997,2279,130718,19720,110998,98092,8314,2769,257,100861,1566,2762,3794,21285,12620
GGTAGAGAAGAAGTAA,sample,64967,64514,2042,62472,9116,53356,40180,2582,5660,715,45840,4219,2938,1657,9595,6066
TCATCGAAAGAAGTAA,sample,143173,142481,7251,135230,13279,121951,74379,6144,23469,2380,97848,15579,7038,3055,13909,8121
TCATACCAAGAAGTAA,sample,166422,165329,8891,156438,8179,148259,68618,4551,50490,5749,119108,18851,7023,3047,12126,4210
ATTCAAGGAGAAGTAA,sample,160666,159745,7111,152634,17261,135373,85579,8102,22745,2525,108324,16422,6520,2590,15505,10004
TACGCGAGAGAAGTAA,sample,150319,149501,6669,142832,20562,122270,93284,6577,12737,1798,106021,7874,3619,2209,26209,14476
CCGCAGTCAGAAGTAA,sample,189744,188611,6338,182273,14944,167329,128983,10136,15014,1599,143997,11597,5933,3431,22344,9772
TGGATCAAAGAAGTAA,sample,73078,72575,5683,66892,6050,60842,23363,1689,20483,2589,43846,12718,5446,1294,7592,3303
ACGCTTAAAGAAGTAA,sample,180455,178870,12796,166074,13084,152990,71636,7009,39073,4559,110709,30713,8659,2157,14034,8230
GCCTATTCAGAAGTAA,sample,92959,92334,4579,87755,6870,80885,55981,4470,10303,1111,66284,9020,4823,1930,15198,4149
ATACCGCCAGAAGTAA,sample,149818,148757,7882,140875,11518,129357,67255,4512,29314,2920,96569,25356,7477,1800,19111,6273
TAACGCCAAGAAGTAA,sample,78314,77784,3899,73885,4890,68995,46195,3952,10298,1211,56493,7339,5362,3388,6167,2704
AGATACTAAGAAGTAA,sample,5378,5301,303,4998,294,4704,3020,217,850,69,3870,548,1042,707,617,172
GCGCAATAAGAAGTAA,sample,53902,53489,2408,51081,4788,46293,27770,2033,9506,1112,37276,5872,3590,1458,6904,2717
Short,Non_sample,0,NA,NA,NA,NA,NA,NA,NA,NA,NA,NA,NA,NA,NA,NA,NA
Unselected,Non_sample,2380052,NA,NA,NA,NA,NA,NA,NA,NA,NA,NA,NA,NA,NA,NA,NA
Undetermined,Non_sample,169555549,NA,NA,NA,NA,NA,NA,NA,NA,NA,NA,NA,NA,NA,NA,NA
