Barcode,Sample,Barcoded_Reads,Trimmed_Reads,Unmapped_Reads,Mapped_Reads,Multimapped_Reads,Uniquely_Mapped_Reads,Exon_Reads,Ambiguous_Exon_Reads,Intron_Reads,Ambiguous_Intron_Reads,Gene_Reads,Intergenic_Reads,No_of_Genes,No_of_Transcripts,Mitochondrial_Reads,Ribosomal_Reads
ATTCTCTTCGTTGGTT,sample,376955,371929,31802,340127,35235,304892,75089,6997,115819,11169,190908,95818,14500,3601,19096,23232
AAGTTCGTCGTTGGTT,sample,147672,143420,5037,138383,39103,99280,73596,7144,12239,1672,85835,4629,2789,1488,16941,23866
TTCGTAATCGTTGGTT,sample,163628,161746,5089,156657,51116,105541,83548,6209,11775,1881,95323,2128,1870,1667,34272,32686
ACGTTATGCGTTGGTT,sample,168246,166681,6902,159779,40501,119278,84968,5623,18521,2084,103489,8082,5021,2713,21103,27338
TTCTAATGCGTTGGTT,sample,113333,112044,7728,104316,24621,79695,46015,3856,17701,1867,63716,10256,5486,2030,15503,16417
ATGCCTGGCGTTGGTT,sample,152834,151006,6424,144582,37814,106768,65519,4314,21756,2240,87275,12939,6134,1865,27898,26008
CAACCGCGCGTTGGTT,sample,119263,117457,5021,112436,29769,82667,50743,2967,18649,2168,69392,8140,4412,1572,23528,20352
TTCCGTCTCGTTGGTT,sample,88025,86651,8069,78582,15918,62664,21654,1554,21077,1925,42731,16454,6423,1317,8431,10540
GCCTTGCTCGTTGGTT,sample,62171,61293,3674,57619,22522,35097,15747,828,10871,1117,26618,6534,4247,1254,5110,12364
CATAACCTCGTTGGTT,sample,126249,124513,5360,119153,35953,83200,52512,3395,17370,2378,69882,7545,3125,1421,23182,23246
GGACGTAGCGTTGGTT,sample,248419,244424,17234,227190,29968,197222,63301,4321,68955,7312,132256,53333,11728,2856,16765,18933
GACGATAACGTTGGTT,sample,244317,240780,15032,225748,26191,199557,79760,6627,62973,7510,142733,42687,9594,2259,16511,16503
CGAGGCAGCGTTGGTT,sample,98605,96905,5237,91668,13663,78005,31793,2843,26271,2927,58064,14171,4856,1217,6560,9274
AATCCGTCCGTTGGTT,sample,175860,173941,13320,160621,22065,138556,38825,3205,49736,4764,88561,42026,10524,2330,8580,13093
CGGATTACCGTTGGTT,sample,125826,124314,4306,120008,26970,93038,57924,4312,21438,2256,79362,7108,3763,1819,13180,18784
ACGTATTACGTTGGTT,sample,278291,275704,21014,254690,30138,224552,58138,4519,83634,8166,141772,70095,13708,3428,9918,17941
AACTCGTACGTTGGTT,sample,107522,105921,4012,101909,19358,82551,41881,4942,22399,2708,64280,10621,4611,1469,8292,12844
TGCTTCGCCGTTGGTT,sample,675,650,54,596,121,475,233,9,148,15,381,70,206,92,71,86
TTGGTTAACGTTGGTT,sample,700,668,51,617,129,488,256,19,108,27,364,78,198,112,87,93
TCGCCTGACGTTGGTT,sample,486,463,45,418,90,328,158,16,91,7,249,56,145,76,44,62
AGGTCGGACGTTGGTT,sample,680,651,65,586,83,503,277,23,142,8,419,53,229,110,94,72
AAGTTCGTCTATCGTT,sample,54365,53259,2619,50640,7064,43576,22594,1605,13240,2011,35834,4126,3304,1604,5339,4967
GGTTGCGTCTATCGTT,sample,90717,89326,5491,83835,14200,69635,31613,2126,22014,2288,53627,11594,5173,1627,8331,9957
ACGTAAGTCTATCGTT,sample,38688,37836,2212,35624,7834,27790,15968,1193,6342,894,22310,3393,3100,1603,3661,5174
AGTACCATCTATCGTT,sample,71969,71063,5935,65128,8823,56305,22932,1496,19066,2273,41998,10538,5410,1779,6752,5951
GCCTTGCTCTATCGTT,sample,90757,89821,4316,85505,16508,68997,35352,1917,21173,2251,56525,8304,4915,1989,12613,11011
ACTATACTCTATCGTT,sample,53556,52942,3587,49355,11580,37775,14790,1068,12703,1536,27493,7678,4494,1219,6070,7555
GTTAGCCGCTATCGTT,sample,43393,42826,3191,39635,7659,31976,13837,853,9809,1079,23646,6398,4360,1353,5384,4997
GGAGGACGCTATCGTT,sample,34964,34415,2036,32379,9227,23152,15068,956,4500,495,19568,2133,1929,1017,7266,6132
GGACGTAGCTATCGTT,sample,57932,57113,2325,54788,17978,36810,29642,1629,4007,555,33649,977,1405,1254,12023,11547
CATGATTCCTATCGTT,sample,93185,91907,5183,86724,12073,74651,29886,2116,26104,2881,55990,13664,5584,1323,7866,8368
AACTCGTACTATCGTT,sample,50887,50142,3184,46958,7437,39521,19555,1545,10778,1209,30333,6434,4019,1553,4600,5276
CGTATGAACTATCGTT,sample,83222,81854,3838,78016,17575,60441,36329,3481,12917,1293,49246,6421,3034,1510,9943,12336
TTGGCCTCCTATCGTT,sample,62298,61602,4561,57041,9377,47664,19033,1401,15402,1632,34435,10196,5914,1614,4668,6553
AAGAGCGCCTATCGTT,sample,11648,11246,494,10752,2400,8352,4994,409,1855,227,6849,867,1661,972,1410,1628
TCGCCTGACTATCGTT,sample,199,185,18,167,45,122,54,2,40,7,94,19,61,25,18,25
TTATTCGACTATCGTT,sample,257,247,31,216,42,174,96,11,45,4,141,18,74,39,32,32
TATCAGTTGTCTTCTT,sample,75063,74496,3033,71463,23154,48309,24165,1777,13048,1462,37213,7857,4915,1547,9426,14260
ATTCTCTTGTCTTCTT,Pos_Ctrl,54447,53995,2417,51578,2950,48628,40516,4077,2804,402,43320,829,5529,6639,4285,1322
CCTCTAGAGTCTTCTT,Pos_Ctrl,33051,32672,1516,31156,1876,29280,24427,2474,1637,213,26064,529,4590,5058,2748,928
TTCGTAATGTCTTCTT,sample,71482,70791,6428,64363,10833,53530,20746,1740,17485,1944,38231,11615,6384,1774,7343,6750
TAGTACGGGTCTTCTT,sample,72022,71410,2439,68971,20927,48044,35342,2693,6338,735,41680,2936,2445,1960,11721,13452
AATGGTAAGTCTTCTT,sample,62285,61649,2104,59545,17844,41701,29096,2067,7255,902,36351,2381,2493,1573,11123,11459
TTCCGTCTGTCTTCTT,sample,56706,56091,1844,54247,14163,40084,29226,1918,6224,818,35450,1898,2428,1704,10766,9507
TCGCATCTGTCTTCTT,sample,49257,48699,1872,46827,13521,33306,23637,1746,5198,812,28835,1913,2540,1799,7349,9009
CATAACCTGTCTTCTT,sample,47547,46921,2240,44681,8871,35810,20525,1689,8701,1252,29226,3643,2775,1616,5883,5905
GACGGAGAGTCTTCTT,sample,60936,60187,2271,57916,15679,42237,29294,2260,6588,782,35882,3313,2672,1683,10006,10609
CATGATTCGTCTTCTT,sample,39953,39199,3678,35521,4836,30685,7923,711,12001,1400,19924,8650,4658,938,2189,3034
AATCCGTCGTCTTCTT,sample,41424,40816,2152,38664,8561,30103,19138,1427,5470,699,24608,3369,2542,1264,6344,5930
CTAGGACCGTCTTCTT,sample,58575,57746,3480,54266,7489,46777,22700,1286,14616,1743,37316,6432,4028,1430,4926,5384
AGGTCGGAGTCTTCTT,Pos_Ctrl,780,759,51,708,83,625,472,42,72,20,544,19,307,216,77,52
TTATTCGAGTCTTCTT,sample,226,215,19,196,33,163,81,8,44,3,125,27,78,40,19,28
GACCGGAAGTCTTCTT,sample,189,183,10,173,25,148,86,7,18,4,104,33,57,37,23,22
TATCAGTTTAGGCTCT,sample,152788,151236,11653,139583,24963,114620,45427,2346,38206,4333,83633,24308,8570,1941,19427,16894
AAGTTCGTTAGGCTCT,sample,190901,188908,10055,178853,53209,125644,64188,4336,35522,4013,99710,17585,7139,2078,24920,32893
TCCTCCGTTAGGCTCT,sample,264238,260939,16485,244454,52025,192429,85429,4708,56100,5701,141529,40491,9906,2381,35883,36407
AGTACCATTAGGCTCT,sample,224994,222821,11143,211678,43386,168292,91775,7043,43296,5891,135071,20287,6513,2269,27453,30006
ACGTTATGTAGGCTCT,sample,241924,239757,13841,225916,48644,177272,84609,4848,51371,5750,135980,30694,9528,2555,32675,32405
TTCTAATGTAGGCTCT,sample,215822,214478,9617,204861,50999,153862,76841,4927,41349,4426,118190,26319,9206,2825,28569,32772
TTAGAAGTTAGGCTCT,sample,150282,148591,5768,142823,36272,106551,74316,5559,16610,2695,90926,7371,4399,2338,23494,24282
CATGATTCTAGGCTCT,sample,137476,135486,6172,129314,18088,111226,53557,3052,36307,3972,89864,14338,4910,1866,8836,12468
CGTACGTCTAGGCTCT,sample,89547,87952,6751,81201,20195,61006,25016,2102,19182,1918,44198,12788,6336,1611,7871,13134
AGTCCGCATAGGCTCT,sample,130780,128890,10135,118755,25364,93391,41983,2641,27733,3291,69716,17743,7274,2001,15651,15923
TTGGTACCTAGGCTCT,sample,160876,158392,5593,152799,42358,110441,86485,6220,14170,1479,100655,2087,1584,1248,32484,28107
GTTAGGACTAGGCTCT,sample,200078,197317,12771,184546,26616,157930,80103,4959,41489,4527,121592,26852,8366,2324,16974,17861
GCCTGAACTAGGCTCT,sample,97172,95130,8039,87091,13553,73538,25169,2157,25757,2772,50926,17683,6714,1657,5940,9118
GAAGGCGCTAGGCTCT,sample,98550,96795,7281,89514,14878,74636,36044,1986,21543,2270,57587,12793,5851,1535,14176,10098
TTGGTTAATAGGCTCT,sample,158290,156050,6135,149915,36697,113218,77677,5241,21222,2292,98899,6786,3251,1626,29621,25643
GGCATATATAGGCTCT,sample,256682,253441,18592,234849,28129,206720,62500,5950,72347,7463,134847,58460,13466,3251,16129,17674
AGGTCGGATAGGCTCT,sample,23589,22766,2338,20428,2829,17599,6229,361,5803,617,12032,4589,3327,848,1685,1788
TTATTCGATAGGCTCT,sample,2250,2045,204,1841,425,1416,696,66,374,45,1070,235,492,272,232,242
GGAGAGTTTTGACTAT,sample,95821,94815,4570,90245,21621,68624,37003,2632,17041,2101,54044,9847,5121,1815,13210,14520
TCCAACTTTTGACTAT,Neg_Ctrl,5085,1853,1399,454,76,378,202,27,81,28,283,40,143,75,68,11
AAGTTCGTTTGACTAT,sample,39983,39007,1331,37676,11343,26333,19412,1423,3956,372,23368,1170,1550,1188,8704,7196
GGTTGCGTTTGACTAT,sample,73642,72611,3744,68867,17164,51703,33721,2459,9393,1097,43114,5033,3786,1864,12197,11633
AGTACCATTTGACTAT,Neg_Ctrl,10132,6795,6313,482,92,390,212,12,114,10,326,42,154,60,54,12
TTCGTAATTTGACTAT,sample,66816,65885,4468,61417,10940,50477,24674,2328,14442,1992,39116,7041,4469,1705,7827,6763
ACGTTATGTTGACTAT,sample,75117,73942,4022,69920,15438,54482,30592,2191,12774,1622,43366,7303,3894,1416,13258,10558
ATGCCTGGTTGACTAT,sample,64710,63678,3591,60087,14209,45878,24026,1613,11564,1572,35590,7103,3504,1301,9761,9730
TAGTACGGTTGACTAT,sample,56899,56186,2968,53218,9539,43679,22545,1441,12763,1290,35308,5640,3665,1654,6414,6254
TGAGCGCGTTGACTAT,sample,63075,61958,4684,57274,10813,46461,22549,1196,13439,1764,35988,7513,4635,1512,8350,7317
CAACCGCGTTGACTAT,sample,73323,72163,6970,65193,8311,56882,16189,1021,21197,2037,37386,16438,6824,1539,4783,5284
TTCCGTCTTTGACTAT,Pos_Ctrl,48742,48066,3014,45052,2748,42304,34913,3382,2728,369,37641,912,5305,6089,3385,1522
CAAGGCCTTTGACTAT,sample,63191,62240,3841,58399,11561,46838,24849,1975,12343,1496,37192,6175,3959,1766,6927,7920
CCGCAACGTTGACTAT,Pos_Ctrl,35548,34778,2430,32348,2126,30222,25212,2249,1845,288,27057,628,4700,5092,2639,1193
GGACGTAGTTGACTAT,sample,45034,44234,3877,40357,6201,34156,12150,875,12392,1416,24542,7323,4545,1200,4128,4054
ACGACTTCTTGACTAT,sample,71686,70324,4085,66239,18377,47862,30241,1953,9385,1070,39626,5213,3260,1436,12372,11903
AATCCGTCTTGACTAT,Pos_Ctrl,40945,40281,2658,37623,2269,35354,29040,2748,2488,276,31528,802,5028,5596,2714,1258
AGTCCGCATTGACTAT,sample,62512,61424,5042,56382,11264,45118,20494,1316,13395,1689,33889,8224,4938,1436,7302,7137
TTGGTACCTTGACTAT,sample,81880,80801,8047,72754,10363,62391,21927,1508,20589,2284,42516,16083,6637,1347,9028,7218
CGGATTACTTGACTAT,sample,107981,106176,10172,96004,11286,84718,21206,1232,32185,3271,53391,26824,8475,1515,5733,7184
GCCTGAACTTGACTAT,sample,79986,78587,6281,72306,10660,61646,24748,1296,19745,2304,44493,13553,5733,1389,7152,6922
TTGGCCTCTTGACTAT,Pos_Ctrl,34772,34185,2055,32130,1620,30510,24856,2502,2141,315,26997,696,4625,5146,1492,726
GAAGGCGCTTGACTAT,sample,70586,69344,6546,62798,8063,54735,17928,1164,19248,1960,37176,14435,6529,1441,6419,5385
TCGCCTGATTGACTAT,sample,56271,55218,2334,52884,11917,40967,28945,2019,6411,823,35356,2769,1761,1038,11980,8357
AGGTCGGATTGACTAT,sample,45239,44345,3202,41143,7897,33246,16436,1068,10001,957,26437,4784,3081,1144,4960,4887
TTATTCGATTGACTAT,Neg_Ctrl,1383,746,254,492,68,424,218,18,123,13,341,52,188,88,60,26
GGAGAGTTTGCAGTTG,sample,35154,34513,1462,33051,7311,25740,12849,1205,7721,850,20570,3115,2608,1245,3446,4882
TATCAGTTTGCAGTTG,sample,47739,47013,2145,44868,8779,36089,20371,1403,9569,1023,29940,3723,3014,1256,7818,5983
TCCTCCGTTGCAGTTG,sample,86944,85548,2880,82668,26404,56264,46169,2137,5929,970,52098,1059,1332,1091,22052,16957
TTCTAATGTGCAGTTG,sample,80941,79887,2717,77170,25870,51300,41519,2336,5725,758,47244,962,1349,1209,19368,15985
GGACCTCTTGCAGTTG,sample,50703,49737,2637,47100,11346,35754,18204,1449,9941,1299,28145,4861,3765,1332,5753,7215
CATAACCTTGCAGTTG,sample,38412,37401,2631,34770,7048,27722,13131,863,8024,972,21155,4732,3306,1187,5263,4687
ACTATACTTGCAGTTG,sample,68643,67857,4062,63795,15477,48318,26576,1972,11173,1282,37749,7315,4837,2002,8688,10199
GTTAGCCGTGCAGTTG,sample,51063,50181,2933,47248,6454,40794,15381,1292,15692,1918,31073,6511,4098,1332,3185,4540
GGAGGACGTGCAGTTG,sample,16277,15980,945,15035,3054,11981,6803,400,3076,374,9879,1328,1922,911,2953,2002
CTTGATAGTGCAGTTG,sample,62639,61772,3021,58751,10634,48117,27803,2131,11168,1501,38971,5514,3803,1816,8865,7799
ACCTCGAGTGCAGTTG,sample,36682,36043,2093,33950,6680,27270,15322,1015,6641,783,21963,3509,3223,1557,5095,4605
GACGATAATGCAGTTG,sample,56957,55963,3437,52526,11866,40660,21630,1515,10543,1358,32173,5614,3968,1238,10240,8079
GGCCAGAGTGCAGTTG,sample,24857,24247,2788,21459,2584,18875,3825,338,7942,832,11767,5938,3870,788,874,1513
CATGATTCTGCAGTTG,sample,75919,74742,4579,70163,14209,55954,30012,1904,13451,1567,43463,9020,5236,1602,11950,9976
AATCCGTCTGCAGTTG,sample,40427,39703,1670,38033,7549,30484,19227,1529,6327,983,25554,2418,2689,1480,5619,5304
AGTCCGCATGCAGTTG,sample,80594,79227,6144,73083,12883,60200,24334,1456,19294,2048,43628,13068,6305,1500,10819,8554
GTCCTGCCTGCAGTTG,sample,60992,59770,3338,56432,12084,44348,24237,1836,10236,1084,34473,6955,3906,1325,9174,8670
CTAGGACCTGCAGTTG,sample,29148,28530,1849,26681,5524,21157,11717,703,5545,676,17262,2516,2685,1165,4149,3933
CGGATTACTGCAGTTG,sample,59506,58342,3351,54991,9188,45803,25669,1581,11648,1289,37317,5616,3351,1423,8222,6494
ACGTATTATGCAGTTG,sample,65670,64101,3546,60555,11019,49536,25878,1467,13398,1840,39276,6953,4236,1372,7885,7658
CGTATGAATGCAGTTG,sample,45202,44258,2228,42030,6926,35104,20463,1294,8703,984,29166,3660,3200,1891,4397,4749
AATATATCTGCAGTTG,sample,68344,67273,4336,62937,11140,51797,25345,1737,14285,1566,39630,8864,4894,1451,9333,7303
ACCAATGCTGCAGTTG,sample,50715,49767,3630,46137,7815,38322,19097,1352,10148,1134,29245,6591,4268,1232,8197,5388
GAAGGCGCTGCAGTTG,sample,45954,45026,3116,41910,8116,33794,17378,943,8996,1246,26374,5231,3950,1179,6001,5457
AAGAGCGCTGCAGTTG,sample,40034,39044,2413,36631,6594,30037,12900,1087,10386,1174,23286,4490,3236,1209,3129,4193
TTGGTTAATGCAGTTG,sample,51482,50606,2475,48131,8580,39551,24149,1820,8918,1091,33067,3573,2660,1180,7962,6047
GTACCGTATGCAGTTG,sample,99132,97575,8110,89465,9080,80385,27380,2071,27301,2917,54681,20716,7771,1745,6148,5868
ATGACCGATGCAGTTG,sample,1027,951,88,863,143,720,293,19,224,19,517,165,274,117,80,100
GGAGAGTTTCATGCTG,sample,37995,37395,1674,35721,11175,24546,18116,894,3650,365,21766,1521,1443,928,8467,7196
TATCAGTTTCATGCTG,sample,43687,43056,1451,41605,12263,29342,22715,1571,3663,392,26378,1001,1511,1356,8680,8157
ATTCTCTTTCATGCTG,sample,51635,50882,2636,48246,14002,34244,22837,1617,6069,608,28906,3113,2932,1276,10928,9119
TAGTACGGTCATGCTG,sample,29552,28983,1764,27219,7064,20155,12098,795,4708,490,16806,2064,2461,1187,4356,4504
AATGGTAATCATGCTG,sample,54087,53357,5032,48325,7549,40776,16169,704,13263,1367,29432,9273,5384,1312,6659,5178
TTAGAAGTTCATGCTG,sample,21975,21561,1513,20048,3648,16400,8427,619,4553,476,12980,2325,2238,984,3318,2446
GGACCTCTTCATGCTG,Neg_Ctrl,2257,1097,810,287,67,220,84,7,49,4,133,76,80,38,28,14
TCGCATCTTCATGCTG,sample,31803,31345,1798,29547,4140,25407,12097,617,7826,865,19923,4002,3081,1287,2596,3051
GACGGAGATCATGCTG,sample,11787,11504,1367,10137,1880,8257,2323,121,3039,328,5362,2446,1994,462,968,1171
GGACGTAGTCATGCTG,Neg_Ctrl,1641,802,492,310,62,248,122,2,74,4,196,46,100,54,38,13
CTTGATAGTCATGCTG,sample,30049,29666,882,28784,8420,20364,15586,1113,2403,307,17989,955,1668,1311,5233,5357
ACGACTTCTCATGCTG,sample,40345,39559,3608,35951,5230,30721,10504,637,10614,1169,21118,7797,4654,1147,4079,3554
CGTACGTCTCATGCTG,Neg_Ctrl,2211,1130,920,210,36,174,76,2,41,2,117,53,63,29,29,9
GTCCTGCCTCATGCTG,sample,12675,12256,793,11463,2816,8647,5012,272,2042,229,7054,1092,1618,802,1694,1814
GTTAGGACTCATGCTG,sample,50540,49674,4873,44801,4043,40758,10356,598,15645,1627,26001,12532,6181,1050,3900,2518
GCCTGAACTCATGCTG,sample,22398,21751,1947,19804,3066,16738,6452,612,5428,570,11880,3676,3001,962,1598,1973
AACTCGTATCATGCTG,sample,46002,45188,5414,39774,4868,34906,11831,670,11993,1201,23824,9211,4780,1176,2942,2645
CGTATGAATCATGCTG,sample,28208,27676,1974,25702,4088,21614,12201,965,4858,589,17059,3001,2663,1208,3035,2764
TTGGCCTCTCATGCTG,sample,43046,42374,3479,38895,5015,33880,12178,868,11352,1270,23530,8212,4309,1051,3938,3476
AATATATCTCATGCTG,Neg_Ctrl,1735,835,500,335,50,285,98,9,61,11,159,106,88,49,33,16
ACCAATGCTCATGCTG,sample,26849,26308,1828,24480,5605,18875,10942,773,4004,516,14946,2640,2303,1037,3173,3582
TTGGTTAATCATGCTG,sample,47005,46298,2969,43329,7906,35423,20129,1567,8393,801,28522,4533,3541,1279,5782,5696
GGCATATATCATGCTG,sample,19759,19195,1479,17716,2237,15479,6493,509,5191,565,11684,2721,2275,791,1075,1425
TCAATATATCATGCTG,sample,44843,44012,4373,39639,4479,35160,10868,914,12484,1276,23352,9618,4997,1099,2855,2872
ATTCTCTTTTAGGCGG,Pos_Ctrl,81562,80476,4661,75815,4395,71420,58717,5933,4821,573,63538,1376,6306,7930,6224,2328
TCCAACTTTTAGGCGG,sample,168647,166346,13223,153123,24738,128385,42836,3044,43709,4582,86545,34214,9381,1931,18939,17563
AAGTTCGTTTAGGCGG,sample,78115,77068,4175,72893,20456,52437,34286,2345,10453,1011,44739,4342,3619,1667,13499,13486
CCTCTAGATTAGGCGG,Pos_Ctrl,58795,57426,3646,53780,3070,50710,42093,3897,3236,472,45329,1012,5668,6880,4184,1384
TTCGTAATTTAGGCGG,sample,97508,96120,6669,89451,19988,69463,38531,2486,16808,1676,55339,9962,5200,1817,12963,13371
CAACCGCGTTAGGCGG,sample,81107,80003,2339,77664,27029,50635,39046,2632,6483,749,45529,1725,1851,1300,16131,16390
TTCCGTCTTTAGGCGG,sample,125480,124091,5445,118646,23020,95626,55005,3896,24690,2688,79695,9347,4828,2279,14537,16007
GCCTTGCTTTAGGCGG,sample,120025,118697,6928,111769,27155,84614,47313,2819,20103,2326,67416,12053,5120,1600,23055,18285
GGACGTAGTTAGGCGG,sample,104454,103084,7045,96039,19454,76585,29495,2125,23473,2386,52968,19106,6856,1805,9977,12927
ACCTCGAGTTAGGCGG,sample,75722,74745,3667,71078,12706,58372,32367,2213,14779,1872,47146,7141,4621,1890,9056,9106
GGCCAGAGTTAGGCGG,sample,100668,99319,5511,93808,20837,72971,41775,3141,17775,1830,59550,8450,3405,1460,16519,14025
TTGGTACCTTAGGCGG,sample,93134,91955,7187,84768,17685,67083,30279,2012,19243,1976,49522,13573,6769,2120,9299,12162
CGGATTACTTAGGCGG,sample,141358,139228,7117,132111,18820,113291,63058,3843,28283,3624,91341,14483,5816,1899,14164,13051
CGTATGAATTAGGCGG,sample,103688,101493,5101,96392,26031,70361,52544,4122,10012,879,62556,2804,1469,1066,18326,17168
AATATATCTTAGGCGG,sample,104134,102964,3735,99229,29611,69618,56515,4558,5916,732,62431,1897,2169,2057,15173,19235
GAAGGCGCTTAGGCGG,sample,101169,99323,6478,92845,16084,76761,37366,1955,22381,2788,59747,12271,5732,1386,13053,10930
GTCTTAGCTTAGGCGG,sample,134961,132849,10870,121979,10703,111276,32120,2250,44990,4792,77110,27124,7962,1723,4892,6665
GTACCGTATTAGGCGG,sample,67720,66852,3184,63668,14307,49361,33645,2775,7785,953,41430,4203,3726,2069,8529,9536
GGCATATATTAGGCGG,sample,110171,108814,7303,101511,16334,85177,34922,2706,27046,2887,61968,17616,6256,1635,8871,11166
TCAATATATTAGGCGG,sample,75642,74208,6346,67862,9113,58749,25032,1439,18719,1992,43751,11567,5591,1366,7772,6162
AGGTCGGATTAGGCGG,sample,99161,97455,5816,91639,19623,72016,40162,3552,16163,1697,56325,10442,3793,1406,11857,13085
ATGACCGATTAGGCGG,sample,1817,1669,164,1505,191,1314,590,43,405,28,995,248,503,258,130,132
GACCGGAATTAGGCGG,sample,369,348,32,316,50,266,134,14,68,7,202,43,113,60,61,38
TATCAGTTTCAGATAC,sample,60174,59457,1747,57710,18268,39442,31059,1661,5009,937,36068,776,1117,929,16630,11414
AAGTTCGTTCAGATAC,sample,46944,46355,2764,43591,7194,36397,17669,1189,11273,1289,28942,4977,3563,1327,5918,4990
ACGTAAGTTCAGATAC,sample,88073,86918,7081,79837,14042,65795,26862,1636,20447,2092,47309,14758,6587,1339,11884,9454
AGTACCATTCAGATAC,sample,68274,67415,5256,62159,13822,48337,23387,1719,12387,1223,35774,9621,5212,1675,7858,9145
ACGTTATGTCAGATAC,sample,23874,23421,1506,21915,6524,15391,9142,440,3535,358,12677,1916,2005,812,4330,4195
TTCTAATGTCAGATAC,sample,28705,28212,2255,25957,4864,21093,9064,742,6755,692,15819,3840,3446,1148,3152,3233
CAACCGCGTCAGATAC,sample,43067,42378,1592,40786,10414,30372,22935,1474,3741,421,26676,1801,1864,1261,9598,7000
AATCCGTCTCAGATAC,sample,27699,27116,1807,25309,5868,19441,10139,621,5355,479,15494,2847,2415,853,4424,3884
CGTACGTCTCAGATAC,sample,25495,24920,2446,22474,4173,18301,6770,553,6160,689,12930,4129,3210,861,1996,2715
GTCCTGCCTCAGATAC,sample,41678,40870,3858,37012,5553,31459,11938,784,10469,1131,22407,7137,4412,1105,4333,3605
CTAGGACCTCAGATAC,sample,60092,59018,7179,51839,5763,46076,11188,832,17445,1931,28633,14680,6332,1363,2858,3529
ACCAATGCTCAGATAC,sample,44991,44045,3095,40950,8131,32819,18275,1396,7863,765,26138,4520,3021,1005,5788,5319
GTCTTAGCTCAGATAC,sample,14582,14215,599,13616,3028,10588,7660,449,1600,319,9260,560,1126,822,3079,2158
CCAATTCCTCAGATAC,sample,34973,34316,1914,32402,4544,27858,15227,996,7166,852,22393,3617,3237,1654,2469,3072
TCGCCTGATCAGATAC,sample,47202,46347,3924,42423,4407,38016,14452,1098,13225,1547,27677,7694,4366,1146,2388,2870
TTATTCGATCAGATAC,sample,31504,30943,1547,29396,5018,24378,12899,1045,6322,617,19221,3495,2823,900,4411,3347
TCCAACTTTCGCTAGG,Neg_Ctrl,2981,1209,979,230,50,180,88,5,37,3,125,47,75,35,28,20
AAGTTCGTTCGCTAGG,sample,44527,43701,2311,41390,11846,29544,18558,1260,5824,782,24382,3120,2544,1123,7455,7654
AGTACCATTCGCTAGG,Neg_Ctrl,6383,4229,3584,645,61,584,116,6,188,3,304,271,106,51,35,12
CAACCGCGTCGCTAGG,sample,17111,16602,1102,15500,3324,12176,6904,312,3035,399,9939,1526,1868,787,2987,2152
AATGGTAATCGCTAGG,sample,53417,52525,4362,48163,8955,39208,16534,1201,11621,1269,28155,8583,5031,1376,6247,5806
TTCCGTCTTCGCTAGG,sample,84163,82943,7664,75279,9670,65609,23152,1836,21205,2358,44357,17058,7506,1810,6859,6245
GGACCTCTTCGCTAGG,sample,14345,14003,1969,12034,1131,10903,2796,161,4389,523,7185,3034,2543,651,639,613
ACTATACTTCGCTAGG,sample,36170,35506,3301,32205,5888,26317,9252,746,8653,934,17905,6732,4011,958,3710,3787
GTTAGCCGTCGCTAGG,sample,44098,43288,3829,39459,7424,32035,13621,740,9945,1089,23566,6640,4352,1055,5792,5029
CCGCAACGTCGCTAGG,sample,30913,30210,1471,28739,7570,21169,13902,861,3824,397,17726,2185,1807,1035,5654,5095
TGGACGAGTCGCTAGG,sample,37787,37150,2465,34685,7106,27579,15651,1148,6671,714,22322,3395,2864,1156,5918,4831
GGCCAGAGTCGCTAGG,sample,102006,100168,7311,92857,11075,81782,32165,3105,24897,2431,57062,19184,6792,1574,7441,6984
CATTGCAGTCGCTAGG,sample,39561,38677,1899,36778,7645,29133,18607,1568,5621,540,24228,2797,2180,904,5435,5511
CATGATTCTCGCTAGG,sample,48083,47109,2320,44789,7180,37609,22086,1524,8124,807,30210,5068,3526,1156,6081,4723
GCCTGAACTCGCTAGG,sample,33062,32294,1922,30372,4222,26150,14676,1436,5902,683,20578,3453,2519,949,2936,2889
ACGTATTATCGCTAGG,sample,56949,55883,4066,51817,6621,45196,20893,1324,12712,1410,33605,8857,4582,1262,5105,4397
TTGGCCTCTCGCTAGG,sample,55739,54983,4328,50655,5115,45540,16296,989,15592,1581,31888,11082,5411,1245,3976,3096
GTCTTAGCTCGCTAGG,sample,62965,62130,4740,57390,9308,48082,23051,1230,13207,1383,36258,9211,4225,1226,7843,6668
GTACCGTATCGCTAGG,Pos_Ctrl,25041,24546,1567,22979,1226,21753,17929,1569,1563,196,19492,496,4065,4049,1630,700
CTTCATGATCGCTAGG,sample,21883,21496,1923,19573,2430,17143,6323,300,5972,570,12295,3978,2989,883,2350,1529
AGGTCGGATCGCTAGG,sample,58609,57757,4158,53599,10057,43542,24453,1691,11193,978,35646,5227,3113,1139,10485,6992
TCCTCCGTCCGTTGCG,sample,100105,98299,4175,94124,29171,64953,47136,4035,8342,1206,55478,4234,2856,1819,17897,18706
TGAGCGCGCCGTTGCG,sample,44263,43592,2621,40971,8166,32805,17345,1301,9006,1069,26351,4084,3409,1622,4693,5750
AATGGTAACCGTTGCG,sample,59501,58395,3345,55050,14772,40278,24810,1836,8323,868,33133,4441,2997,1435,11216,9642
TTCCGTCTCCGTTGCG,sample,53952,53037,2400,50637,14637,36000,26928,1266,5769,471,32697,1566,1709,1194,13126,9561
TCGCATCTCCGTTGCG,sample,34571,33893,3002,30891,6656,24235,12394,772,6186,826,18580,4057,3467,1371,5290,4548
GCCTTGCTCCGTTGCG,sample,28521,28031,1788,26243,4335,21908,12461,855,5444,693,17905,2455,3330,2018,2475,2997
CCAGAGCGCCGTTGCG,sample,14779,14394,669,13725,4083,9642,7193,371,1403,170,8596,505,1001,718,4026,2676
ACGACTTCCCGTTGCG,sample,56712,55435,4001,51434,7416,44018,19474,1592,14386,1473,33860,7093,3809,1265,4934,4965
AGTCCGCACCGTTGCG,sample,105589,103822,8794,95028,16889,78139,37172,1771,22404,2603,59576,14189,6061,1532,13286,11783
GTCCTGCCCCGTTGCG,sample,56325,55118,3126,51992,9289,42703,23471,1748,10951,1184,34422,5349,3900,1645,6115,6243
CTAGGACCCCGTTGCG,sample,70149,68900,4297,64603,8900,55703,26442,1848,16352,2126,42794,8935,4261,1511,5117,5999
GTTAGGACCCGTTGCG,sample,45545,44589,4594,39995,6112,33883,14507,1120,9953,1131,24460,7172,4232,1111,4296,3876
ACCAATGCCCGTTGCG,sample,61939,61081,5315,55766,7871,47895,21597,1454,15127,1790,36724,7927,5206,2046,4315,5129
TGCTTCGCCCGTTGCG,sample,114214,112665,16143,96522,9907,86615,17896,1063,35458,3711,53354,28487,10914,1977,4978,5517
GAAGGCGCCCGTTGCG,sample,60410,59387,5601,53786,7015,46771,16682,1374,16246,1647,32928,10822,5467,1287,5815,4181
CCAATTCCCCGTTGCG,sample,103394,100428,9309,91119,17733,73386,33843,2235,20892,2549,54735,13867,6493,1761,11566,12277
GGCATATACCGTTGCG,sample,57994,56964,6664,50300,6739,43561,14149,899,15349,1582,29498,11582,5778,1263,4896,4447
TCGCCTGACCGTTGCG,sample,38301,37742,1532,36210,8741,27469,21436,1659,3136,374,24572,864,1879,1614,6551,6029
AGGTCGGACCGTTGCG,sample,101925,100771,4392,96379,15063,81316,57668,4082,13848,1883,71516,3835,2797,1819,10756,10546
GGTTGCGTAGGCCAAG,sample,89785,89045,2840,86205,34150,52055,35335,2369,9723,1218,45058,3410,2970,2070,13333,19931
TTCGTAATAGGCCAAG,sample,47875,47225,1646,45579,12024,33555,24084,1799,5273,829,29357,1570,2583,2048,7950,7851
TGAGCGCGAGGCCAAG,sample,80628,79909,3296,76613,21370,55243,35936,2942,11272,1293,47208,3800,2160,1345,15261,14352
TTAGAAGTAGGCCAAG,sample,72990,72176,4284,67892,15795,52097,29956,1686,11827,1334,41783,7294,4583,1592,13554,10528
GGACCTCTAGGCCAAG,sample,46129,45498,2393,43105,9434,33671,20335,1337,8034,819,28369,3146,3325,2025,5909,6545
GCCTTGCTAGGCCAAG,sample,14726,14434,699,13735,4935,8800,5007,337,2197,221,7204,1038,1887,1070,1306,2828
GACGGAGAAGGCCAAG,sample,100893,99789,6799,92990,21582,71408,35691,2197,18880,2208,54571,12432,5839,1690,15065,14645
CCAGAGCGAGGCCAAG,sample,35863,35192,1700,33492,9798,23694,18240,1185,3333,249,21573,687,1183,945,9242,6480
GGAGGACGAGGCCAAG,sample,21293,20970,1246,19724,4277,15447,9084,614,3619,483,12703,1647,2096,1078,3846,3007
CCGCAACGAGGCCAAG,sample,8364,8117,1103,7014,1086,5928,1888,116,2096,209,3984,1619,1607,436,774,695
GACGATAAAGGCCAAG,sample,97732,96526,7165,89361,13110,76251,36298,2761,22790,2028,59088,12374,6252,2074,10334,9096
CATTGCAGAGGCCAAG,sample,59430,58583,2425,56158,13155,43003,29330,2416,7799,752,37129,2706,2967,1699,9783,9219
ACGACTTCAGGCCAAG,sample,30300,29758,1381,28377,8029,20348,13557,1221,3651,587,17208,1332,1915,1155,4724,5127
AATCCGTCAGGCCAAG,sample,145362,143547,11791,131756,20274,111482,39676,2785,36481,3531,76157,29009,9503,2052,14448,13422
CGTACGTCAGGCCAAG,sample,78154,76806,5045,71761,14392,57369,32055,1989,14614,1294,46669,7417,4226,1331,12151,10349
GCCTGAACAGGCCAAG,sample,37122,36373,3946,32427,4474,27953,9767,813,9538,977,19305,6858,4215,1053,2899,2873
ACGTATTAAGGCCAAG,sample,102987,101410,7951,93459,15443,78016,33925,2005,23230,2437,57155,16419,6666,1663,11469,10103
CGTATGAAAGGCCAAG,sample,91175,89220,8111,81109,11797,69312,24961,1519,23169,2161,48130,17502,6922,1383,7338,7451
TTGGCCTCAGGCCAAG,sample,64188,63324,5168,58156,8531,49625,20964,1231,15242,1619,36206,10569,5476,1391,6965,5999
ACCAATGCAGGCCAAG,sample,80567,78954,4674,74280,14179,60101,31625,2461,15165,1727,46790,9123,4249,1336,9680,10078
GTACCGTAAGGCCAAG,sample,84086,82882,5772,77110,14267,62843,31908,2066,16884,1807,48792,10178,5390,1643,10335,10023
GGCATATAAGGCCAAG,Neg_Ctrl,4688,2206,1641,565,90,475,237,13,111,16,348,98,187,89,64,58
TCAATATAAGGCCAAG,sample,102988,101474,9364,92110,12078,80032,26983,1792,27976,3239,54959,20042,8235,2078,8031,7875
CTTCATGAAGGCCAAG,sample,53882,52614,2492,50122,11087,39035,24880,1737,8067,1101,32947,3250,2762,1377,5642,7225
TTATTCGAAGGCCAAG,sample,66267,65203,3802,61401,10892,50509,25299,1888,14332,1718,39631,7272,3985,1431,6330,7480
ATGACCGAAGGCCAAG,sample,88115,86720,4852,81868,17667,64201,34512,2542,16033,1848,50545,9266,5155,1622,11118,12127
GACCGGAAAGGCCAAG,sample,873,801,76,725,119,606,264,16,205,36,469,85,255,105,80,72
GGTTGCGTAGAACCGC,sample,166161,164267,9049,155218,40790,114428,56964,4578,29708,2957,86672,20221,6689,1960,21689,26215
TCCTCCGTAGAACCGC,sample,88117,87145,7148,79997,14739,65258,27210,1111,20901,2143,48111,13893,6633,1596,12521,9906
TTCGTAATAGAACCGC,sample,120465,119156,7678,111478,21810,89668,40934,2563,25959,2973,66893,17239,6688,1680,15347,15010
TAGTACGGAGAACCGC,sample,127800,126784,3792,122992,47114,75878,60717,3890,7924,1394,68641,1953,1538,1385,29025,27004
TGAGCGCGAGAACCGC,sample,42799,42340,2765,39575,10872,28703,15808,783,6707,872,22515,4533,3260,970,8353,6834
GCCTTGCTAGAACCGC,sample,32456,31833,2180,29653,5507,24146,12101,845,7275,912,19376,3013,3216,1622,3285,3648
CATAACCTAGAACCGC,sample,98910,97467,7478,89989,18386,71603,31550,2011,21143,2292,52693,14607,6710,1640,12671,11893
GGAGGACGAGAACCGC,sample,42148,41551,3575,37976,6368,31608,13972,940,10005,1113,23977,5578,4308,1329,5542,4298
CATTGCAGAGAACCGC,sample,31045,30558,1632,28926,6337,22589,12932,886,5756,776,18688,2239,2559,1317,4009,4235
ACGACTTCAGAACCGC,sample,29778,29329,2728,26601,4223,22378,8884,591,7240,824,16124,4839,3565,929,3907,2633
AATCCGTCAGAACCGC,sample,134143,132453,9200,123253,26336,96917,49225,2974,25541,2728,74766,16449,5763,1752,18353,17968
CTAGGACCAGAACCGC,sample,86045,84864,4108,80756,12788,67968,40645,2775,16819,1776,57464,5953,3835,1687,11831,9433
GTTAGGACAGAACCGC,sample,110319,108375,5419,102956,21489,81467,50442,3212,17375,2464,67817,7974,3267,1406,18323,15405
GCCTGAACAGAACCGC,sample,45083,44227,4329,39898,5455,34443,13584,939,11450,1338,25034,7132,4529,1197,3655,3382
ACGTATTAAGAACCGC,sample,163211,160895,11385,149510,21810,127700,51480,4398,41817,3806,93297,26199,8496,2112,13715,15400
TTGGCCTCAGAACCGC,sample,48554,47825,2000,45825,9379,36446,24512,1608,7235,797,31747,2294,2840,1696,5608,6651
ACCAATGCAGAACCGC,sample,95311,93770,6397,87373,11347,76026,33257,1677,25948,3041,59205,12103,5782,1702,6344,7769
CCAATTCCAGAACCGC,sample,73667,72198,4025,68173,16320,51853,29286,2161,12671,1493,41957,6242,4220,1522,10625,11039
TTGGTTAAAGAACCGC,sample,139352,137652,8764,128888,20998,107890,62246,3958,24539,2913,86785,14234,6015,2157,14808,15083
GGCATATAAGAACCGC,sample,135176,133413,9423,123990,14742,109248,44395,3024,34916,4008,79311,22905,6939,1744,10256,9854
TATCAGTTCATCAAGC,sample,100327,98959,9120,89839,14248,75591,29997,1450,23448,2447,53445,18249,6995,1711,12891,8972
ACGTTATGCATCAAGC,sample,50973,50252,1747,48505,15883,32622,22320,1869,5814,651,28134,1968,2763,1875,6843,9718
TGAGCGCGCATCAAGC,sample,51949,51192,3200,47992,7808,40184,17391,1602,13485,1522,30876,6184,4001,1535,4092,5252
CAACCGCGCATCAAGC,sample,49159,48348,3015,45333,8615,36718,18144,1177,10837,1371,28981,5189,3550,1331,6989,5918
TTAGAAGTCATCAAGC,sample,145162,143450,11556,131894,23826,108068,43413,2701,33442,3649,76855,24863,8246,1795,19877,16610
ACTATACTCATCAAGC,sample,27782,27307,3202,24105,4271,19834,8152,467,6044,594,14196,4577,3636,1109,3695,2524
CCAGAGCGCATCAAGC,sample,15400,15074,1903,13171,2499,10672,3955,243,3623,379,7578,2472,2392,674,1636,1593
GGAGGACGCATCAAGC,sample,13242,12970,804,12166,2992,9174,6308,361,1631,253,7939,621,1537,979,2540,2074
CGTACGTCCATCAAGC,sample,88708,87393,6076,81317,14186,67131,32420,1861,19555,2411,51975,10884,5845,1655,12575,9613
TTGGTACCCATCAAGC,sample,89541,88356,6119,82237,13876,68361,30499,2408,20438,2667,50937,12349,5698,1470,10213,9317
ACGTATTACATCAAGC,sample,74422,73376,4210,69166,15256,53910,34306,2824,10554,1370,44860,4856,3207,1425,11005,10286
AACTCGTACATCAAGC,sample,76709,75589,3851,71738,12276,59462,32305,2275,15448,1569,47753,7865,4423,1436,10099,8390
TTGGCCTCCATCAAGC,Pos_Ctrl,43270,42725,2107,40618,1966,38652,32223,3151,2205,322,34428,751,4863,5915,2049,962
TGCTTCGCCATCAAGC,sample,82621,81687,4870,76817,13690,63127,31802,2396,16929,2163,48731,9837,5534,1569,11617,9620
GTACCGTACATCAAGC,sample,90782,89386,3864,85522,15620,69902,48748,3405,11267,1042,60015,5440,2958,1564,13695,11100
GGCATATACATCAAGC,sample,88108,86894,7307,79587,11897,67690,29082,2251,20248,2293,49330,13816,6348,1793,8489,7811
TCAATATACATCAAGC,sample,136763,135107,11708,123399,13665,109734,41601,2996,39317,4652,80918,21168,8230,2085,10361,7659
ATGACCGACATCAAGC,sample,86709,85417,3836,81581,14458,67123,42568,3256,13928,1724,56496,5647,3311,1516,11928,10310
AAGTTCGTAGAGAGCC,sample,39486,38873,1852,37021,8139,28882,17284,1379,6784,743,24068,2692,2842,1676,5638,5591
ACGTAAGTAGAGAGCC,sample,63751,62591,3471,59120,16443,42677,27429,1797,8256,892,35685,4303,3189,1231,12401,10536
TTCGTAATAGAGAGCC,sample,55962,55261,2821,52440,10133,42307,23982,1790,11080,1235,35062,4220,3278,1531,8009,7433
TGAGCGCGAGAGAGCC,sample,40453,39878,6973,32905,5062,27843,7935,498,10056,962,17991,8392,5229,1485,2173,2731
CAACCGCGAGAGAGCC,sample,24420,23930,2313,21617,4299,17318,7831,597,5294,578,13125,3018,2712,959,3090,2684
AATGGTAAAGAGAGCC,sample,29162,28699,3227,25472,4340,21132,7829,389,7062,843,14891,5009,3737,1027,2910,2559
TTAGAAGTAGAGAGCC,sample,38756,38177,2530,35647,6495,29152,14221,1042,8378,1043,22599,4468,3348,1345,5061,4227
GCCTTGCTAGAGAGCC,sample,25384,24848,1290,23558,5302,18256,12165,669,3519,481,15684,1422,2024,1100,5257,3636
GACGGAGAAGAGAGCC,sample,25269,24825,1288,23537,5631,17906,10971,720,4209,464,15180,1542,2025,1298,3898,4043
CCAGAGCGAGAGAGCC,sample,28150,27721,1580,26141,6173,19968,13678,784,3221,302,16899,1983,2379,1508,4960,4372
GGAGGACGAGAGAGCC,sample,24776,24400,1622,22778,3922,18856,9711,745,5399,607,15110,2394,2870,1413,2786,2766
ACCTCGAGAGAGAGCC,sample,11578,11361,591,10770,3123,7647,5223,367,1397,153,6620,507,1598,1064,1816,1963
CATTGCAGAGAGAGCC,sample,26244,25682,1255,24427,6024,18403,11747,651,4019,580,15766,1406,2065,1114,4753,3987
CGTATGAAAGAGAGCC,sample,57172,56102,5055,51047,10469,40578,19320,1285,11570,1251,30890,7152,4821,1312,7398,7133
TTGGCCTCAGAGAGCC,sample,50789,50191,2282,47909,7733,40176,23168,1445,10589,1238,33757,3736,3083,1496,6426,5423
TGCTTCGCAGAGAGCC,sample,44732,43985,2555,41430,8551,32879,18774,1457,7736,927,26510,3985,3345,1431,6878,5783
GAAGGCGCAGAGAGCC,sample,73337,72311,5230,67081,12076,55005,24304,1727,15942,1628,40246,11404,5822,1428,9253,8212
AAGAGCGCAGAGAGCC,sample,63749,62639,5620,57019,9394,47625,20099,1209,14726,1740,34825,9851,5497,1327,7296,6381
TTGGTTAAAGAGAGCC,sample,89647,88666,3838,84828,13849,70979,47431,4227,11934,1184,59365,6203,4415,1955,9850,9695
GTACCGTAAGAGAGCC,sample,60436,59687,3874,55813,11522,44291,27621,2411,8172,948,35793,5139,3451,1355,8375,7777
TCAATATAAGAGAGCC,sample,73554,72579,4319,68260,9581,58679,26453,2268,18334,2000,44787,9624,4612,1437,4566,6442
CTTCATGAAGAGAGCC,sample,66810,65939,3705,62234,7079,55155,30447,2035,14378,1814,44825,6481,3951,1464,6042,4969
TTATTCGAAGAGAGCC,sample,41077,40090,3008,37082,8956,28126,18190,1638,5401,642,23591,2255,2206,1250,4314,5796
ATGACCGAAGAGAGCC,sample,74864,74113,4706,69407,11740,57667,28511,2123,14846,1712,43357,10475,5443,1341,10124,8044
GACCGGAAAGAGAGCC,sample,54914,54164,3077,51087,6110,44977,22116,1619,13018,1506,35134,6718,4042,1439,6171,4029
GGTTGCGTAGCATTGA,sample,134561,133356,5762,127594,35325,92269,58665,4536,18030,1994,76695,9044,5367,2333,20786,23722
CCTCTAGAAGCATTGA,sample,104604,103092,6192,96900,21238,75662,38139,2368,20904,2176,59043,12075,5762,1625,16333,13800
TTCTAATGAGCATTGA,sample,170294,168879,7348,161531,45397,116134,70178,4960,23509,2208,93687,15279,6588,1896,30276,29683
ATGCCTGGAGCATTGA,sample,116344,115043,4503,110540,33997,76543,53729,3496,11514,1389,65243,6415,4071,1631,21951,21416
TAGTACGGAGCATTGA,sample,150055,148552,5655,142897,46361,96536,73950,4710,12486,1379,86436,4011,2833,1610,31610,28729
AATGGTAAAGCATTGA,sample,105854,104632,4446,100186,26321,73865,51719,3855,12288,1287,64007,4716,3512,1868,18695,17144
TTAGAAGTAGCATTGA,sample,76347,75490,3181,72309,18940,53369,34857,2576,10017,1292,44874,4627,3955,2084,11812,12616
GGACCTCTAGCATTGA,sample,99880,98658,4357,94301,30727,63574,40608,2407,12318,1378,52926,6863,3889,1413,19741,19351
CATAACCTAGCATTGA,sample,96896,95626,5019,90607,19468,71139,42248,2674,15455,2135,57703,8627,5057,2183,13886,13423
GTTAGCCGAGCATTGA,sample,107555,106390,4055,102335,26803,75532,52040,2994,13626,1798,65666,5074,3387,1761,20752,17666
GACGATAAAGCATTGA,sample,107839,106184,5937,100247,15044,85203,35772,2625,30066,3121,65838,13619,5881,1800,7842,10147
CATGATTCAGCATTGA,sample,123479,121977,9062,112915,21480,91435,43751,2822,26017,3072,69768,15773,7607,2522,11909,14437
CGTACGTCAGCATTGA,sample,113295,111767,5739,106028,19320,86708,47946,3234,23079,2706,71025,9743,5329,1906,15277,12772
CTAGGACCAGCATTGA,sample,83343,81990,3589,78401,19602,58799,41676,2258,9828,1403,51504,3634,2853,1541,14669,13153
GTTAGGACAGCATTGA,sample,86660,85176,3963,81213,15331,65882,35639,3523,16841,1647,52480,8232,4780,1827,5421,10442
AATATATCAGCATTGA,Neg_Ctrl,5237,2423,1711,712,123,589,326,26,140,4,466,93,228,102,116,63
TGCTTCGCAGCATTGA,sample,91396,89862,5131,84731,10449,74282,37563,3141,21569,2338,59132,9671,4506,1577,8580,7309
CCAATTCCAGCATTGA,sample,95220,92649,3498,89151,19892,69259,51982,2635,10890,1134,62872,2618,1458,1051,15615,13408
TTGGTTAAAGCATTGA,sample,122637,121121,5549,115572,16809,98763,61266,5468,20988,2730,82254,8311,4450,2004,11773,11871
TTATTCGAAGCATTGA,sample,88083,86644,6023,80621,15001,65620,30681,2476,18124,2345,48805,11994,5662,1527,8803,9803
ATGACCGAAGCATTGA,sample,173879,171437,17375,154062,12338,141724,27221,1889,60188,6226,87409,46200,12047,2406,4363,6136
TATCAGTTAATTACCA,sample,53692,52896,5818,47078,7280,39798,10273,464,14937,1581,25210,12543,5967,1141,3593,4672
ATTCTCTTAATTACCA,sample,73910,72973,5690,67283,14006,53277,27143,1762,13358,1436,40501,9578,4938,1365,12803,9094
TCCTCCGTAATTACCA,sample,85212,83844,2854,80990,15902,65088,44200,2574,11566,1529,55766,5219,2715,1085,13544,11071
CCTCTAGAAATTACCA,sample,51262,50611,3640,46971,9334,37637,18845,1315,9786,947,28631,6744,4378,1336,8217,6191
TTCGTAATAATTACCA,sample,41330,40834,2202,38632,7507,31125,16912,1215,8060,1089,24972,3849,3144,1421,5563,5204
ACGTTATGAATTACCA,sample,70379,69557,3834,65723,16873,48850,31938,1666,9666,1365,41604,4215,2970,1328,15505,10830
TTCTAATGAATTACCA,sample,30565,30187,2085,28102,5883,22219,12126,711,5712,704,17838,2966,2752,991,5470,3917
ATGCCTGGAATTACCA,sample,52192,51722,2398,49324,13385,35939,22110,1779,7247,969,29357,3834,3179,1374,8776,8858
CAACCGCGAATTACCA,sample,33243,32593,3389,29204,4601,24603,9694,583,7929,906,17623,5491,3887,1018,3638,2903
TTAGAAGTAATTACCA,sample,66809,65769,4495,61274,14493,46781,24481,1421,11440,1093,35921,8346,5200,1787,9384,9655
CCAGAGCGAATTACCA,sample,37241,36509,1697,34812,10066,24746,19677,1508,2713,297,22390,551,1464,1387,6754,6884
GGACGTAGAATTACCA,sample,36886,36300,3265,33035,5832,27203,12360,813,7768,819,20128,5443,3718,1032,5364,4107
GGCCAGAGAATTACCA,sample,49885,49024,3352,45672,7557,38115,21243,1402,9095,1026,30338,5349,3487,1281,9076,5332
CCATGAAGAATTACCA,sample,40902,40152,4144,36008,5603,30405,11595,615,10231,1001,21826,6963,4195,1012,4789,3739
ACGACTTCAATTACCA,sample,50930,50161,4076,46085,9496,36589,19009,1538,8824,878,27833,6340,4223,1733,5786,6081
CATGATTCAATTACCA,sample,54200,53491,2228,51263,12580,38683,28144,2399,5047,594,33191,2499,2425,1592,10143,8661
TTGGTACCAATTACCA,sample,84669,83639,5265,78374,16404,61970,34412,2546,14356,1789,48768,8867,4399,1377,14816,11489
CTAGGACCAATTACCA,sample,49973,49098,4470,44628,5221,39407,15412,1335,13186,1700,28598,7774,4713,1468,4444,3424
GCCTGAACAATTACCA,sample,65695,64448,6571,57877,7138,50739,16009,1039,17962,1915,33971,13814,5625,1221,4641,4713
ACGTATTAAATTACCA,sample,49519,48698,4103,44595,6122,38473,18153,1444,11739,1390,29892,5747,3672,1354,4694,4055
CGTATGAAAATTACCA,sample,85685,84033,5641,78392,13520,64872,31870,2440,17549,1850,49419,11163,4242,1292,10521,9555
GAAGGCGCAATTACCA,sample,99166,97757,9699,88058,9194,78864,19580,1275,30527,2949,50107,24533,8679,1604,5145,5575
AAGAGCGCAATTACCA,sample,38630,37981,2277,35704,7860,27844,16766,1202,6030,742,22796,3104,3062,1448,4326,5610
GTCTTAGCAATTACCA,sample,54303,53235,3798,49437,6252,43185,18458,1722,14086,1610,32544,7309,4284,1245,3457,4197
GTACCGTAAATTACCA,sample,61495,60482,3551,56931,10735,46196,31632,2168,7918,883,39550,3595,3127,1538,8471,7529
GGCATATAAATTACCA,sample,73683,72287,4524,67763,11336,56427,28684,1209,14349,1653,43033,10532,4818,1259,10077,7685
TCGCCTGAAATTACCA,sample,46245,45252,3228,42024,6597,35427,16515,1065,11011,1270,27526,5566,3310,1054,4460,4591
CTTCATGAAATTACCA,sample,46596,45326,4632,40694,5190,35504,11734,740,12828,1347,24562,8855,4768,1110,1782,3387
AGGTCGGAAATTACCA,sample,34325,33484,2797,30687,5646,25041,14334,1009,5426,662,19760,3610,2296,1037,4622,3921
ATTCTCTTTAGATGAC,Pos_Ctrl,13341,13234,516,12718,969,11749,9681,1157,589,77,10270,245,2701,2696,999,477
AAGTTCGTTAGATGAC,sample,47659,47172,2256,44916,6779,38137,21889,1503,10122,1032,32011,3591,3241,1734,7075,4599
ACGTTATGTAGATGAC,Pos_Ctrl,51140,50654,2710,47944,2968,44976,37770,3648,2462,333,40232,763,5489,6681,3803,1673
TTCCGTCTTAGATGAC,Pos_Ctrl,39872,39575,1909,37666,2147,35519,29737,2885,1958,237,31695,702,4898,5707,3080,1150
GGACCTCTTAGATGAC,sample,48387,47847,2808,45039,9779,35260,21217,1612,8052,1001,29269,3378,3220,1593,7351,6621
TCGCATCTTAGATGAC,sample,71748,70906,4851,66055,13849,52206,25693,2071,14707,1610,40400,8125,4991,1684,6303,9240
GACGGAGATAGATGAC,sample,76275,75544,3510,72034,13700,58334,39894,2399,9978,993,49872,5070,3722,1655,19208,9438
GGAGGACGTAGATGAC,sample,85394,84331,3373,80958,19884,61074,44017,2785,9542,1071,53559,3659,2017,1266,19455,13790
GGACGTAGTAGATGAC,sample,90477,89352,7943,81409,10788,70621,18275,1180,29343,3022,47618,18801,7382,1599,4209,6744
ACCTCGAGTAGATGAC,sample,37657,36924,2760,34164,7022,27142,12166,771,8645,853,20811,4707,3341,979,4051,4665
GACGATAATAGATGAC,sample,79170,77678,6257,71421,12055,59366,21749,1684,20279,2682,42028,12972,5858,1340,5656,7729
CATTGCAGTAGATGAC,sample,64885,63891,4252,59639,11945,47694,22560,952,13380,1361,35940,9441,5002,1268,9358,7926
CCATGAAGTAGATGAC,sample,113403,112141,8013,104128,14109,90019,36915,2986,27779,2955,64694,19384,8162,2034,12115,9569
ACGACTTCTAGATGAC,sample,50499,49625,4593,45032,7402,37630,16233,908,11514,1349,27747,7626,4527,1147,6954,5027
GTCCTGCCTAGATGAC,sample,47495,46878,2281,44597,9701,34896,21955,1666,7063,1170,29018,3042,3104,1772,6571,6766
GCCTGAACTAGATGAC,sample,72624,71385,4252,67133,10014,57119,30526,2155,15388,2080,45914,6970,3770,1358,8294,6785
TGCTTCGCTAGATGAC,sample,72321,71098,4706,66392,14051,52341,31004,1978,11673,1295,42677,6391,3785,1284,9647,9452
TTGGTTAATAGATGAC,sample,93432,92089,4282,87807,17170,70637,44265,3885,12936,1374,57201,8177,3409,1308,14619,11958
TTATTCGATAGATGAC,sample,114221,112512,7815,104697,15157,89540,38394,2511,25559,3449,63953,19627,7507,1672,12246,11013
GGAGAGTTGTTCAGAA,sample,41227,40751,2945,37806,7011,30795,12854,821,10312,1066,23166,5742,4007,1209,4544,4382
ATTCTCTTGTTCAGAA,sample,92979,92106,3666,88440,20106,68334,43275,3102,14162,1237,57437,6558,4414,1876,15981,13762
ACGTAAGTGTTCAGAA,sample,70631,69762,4621,65141,11198,53943,25648,1259,17328,1847,42976,7861,4616,1515,10596,7638
TTCTAATGGTTCAGAA,sample,57296,56698,3195,53503,10730,42773,26095,2014,8390,951,34485,5323,4581,2109,8164,6959
ATGCCTGGGTTCAGAA,sample,94264,93142,5385,87757,18265,69492,34854,1988,18035,1880,52889,12735,5496,1471,14207,11910
CAACCGCGGTTCAGAA,sample,77252,76353,4256,72097,17787,54310,28116,1965,13833,1361,41949,9035,4945,1359,11524,11725
AATGGTAAGTTCAGAA,sample,89904,88966,3094,85872,19340,66532,46181,3622,11423,1282,57604,4024,3640,2063,14378,13333
TTCCGTCTGTTCAGAA,sample,61564,60648,3135,57513,11194,46319,27622,2052,10764,1342,38386,4539,3438,1360,11167,7749
TCGCATCTGTTCAGAA,sample,79753,78948,4244,74704,14896,59808,33016,2120,16126,2077,49142,6469,3960,1592,10835,10275
CATAACCTGTTCAGAA,sample,62323,61481,4032,57449,10671,46778,21975,1647,13950,1539,35925,7667,4856,1624,7741,7100
GACGGAGAGTTCAGAA,sample,72079,71159,4422,66737,12038,54699,28923,1859,13205,1487,42128,9225,5038,1837,9604,7942
GGACGTAGGTTCAGAA,sample,112099,110545,9659,100886,9541,91345,26192,2272,34520,3763,60712,24598,9544,2192,5880,5544
ACCTCGAGGTTCAGAA,sample,70208,68853,4452,64401,8146,56255,25016,1587,17130,1767,42146,10755,4716,1260,5492,5046
TGGACGAGGTTCAGAA,sample,101007,99431,6625,92806,14520,78286,28818,2031,25756,2717,54574,18964,7573,1527,6687,9292
CGAGGCAGGTTCAGAA,sample,51003,49997,2829,47168,8704,38464,22024,1943,8461,880,30485,5156,3416,1378,4436,5773
GTCCTGCCGTTCAGAA,sample,53585,52326,4792,47534,6522,41012,19936,1471,10835,1153,30771,7617,4818,1623,3257,3818
CTAGGACCGTTCAGAA,sample,78446,77144,4539,72605,13571,59034,31393,2520,14077,1528,45470,9516,3962,1312,10612,9286
CGGATTACGTTCAGAA,sample,40270,39327,2129,37198,7852,29346,15781,1377,7632,1247,23413,3309,2663,1004,5052,5053
GTTAGGACGTTCAGAA,sample,74277,73054,4597,68457,10967,57490,27848,2206,16297,1952,44145,9187,5342,1551,7925,7611
ACGTATTAGTTCAGAA,sample,65853,64629,3130,61499,12984,48515,31362,2897,9613,948,40975,3695,2988,1371,6539,8756
CGTATGAAGTTCAGAA,sample,48376,47279,1699,45580,9369,36211,25974,1584,6787,645,32761,1221,1104,799,8204,6626
TTGGCCTCGTTCAGAA,sample,48861,48037,2396,45641,8660,36981,22339,2003,8126,814,30465,3699,2307,1035,3938,6157
GAAGGCGCGTTCAGAA,sample,49922,48956,4595,44361,7281,37080,11700,684,12957,1435,24657,10304,5405,1105,3677,4464
GTCTTAGCGTTCAGAA,sample,83804,82419,7003,75416,10892,64524,21594,1838,22350,2242,43944,16500,7332,1534,6295,6897
CTTCATGAGTTCAGAA,sample,40530,39729,1670,38059,5884,32175,18382,1611,8335,1210,26717,2637,2420,1360,3733,4128
AGGTCGGAGTTCAGAA,Pos_Ctrl,32588,31869,2054,29815,1619,28196,23049,2234,1985,276,25034,652,4596,4768,2069,735
TCCAACTTTTCTGGTT,Neg_Ctrl,6513,3112,2799,313,82,231,116,10,68,1,184,36,94,34,46,11
AAGTTCGTTTCTGGTT,sample,64431,62918,5140,57778,7956,49822,21156,1224,16606,1805,37762,9031,4759,1414,9110,5320
TCCTCCGTTTCTGGTT,sample,54474,53522,2754,50768,15564,35204,24650,1950,5603,653,30253,2348,2880,1807,8337,9821
TTCGTAATTTCTGGTT,sample,32933,32454,3094,29360,5375,23985,9976,517,7849,781,17825,4862,3383,1045,4395,3492
ACGTTATGTTCTGGTT,sample,43864,43138,3426,39712,6025,33687,14830,1004,9907,1047,24737,6899,4365,1586,3754,4173
TTCTAATGTTCTGGTT,Neg_Ctrl,2810,1447,928,519,80,439,166,4,164,8,330,97,135,59,49,32
ATGCCTGGTTCTGGTT,sample,37202,36655,2482,34173,7142,27031,12697,687,7972,890,20669,4785,3292,1138,5043,4814
AATGGTAATTCTGGTT,sample,53925,52967,5387,47580,6885,40695,15049,806,13483,1528,28532,9829,5586,1796,4492,4443
TTAGAAGTTTCTGGTT,sample,45516,44544,4719,39825,6968,32857,14522,1152,10678,1234,25200,5271,3763,1316,4583,4557
GGACCTCTTTCTGGTT,Neg_Ctrl,3713,2214,1692,522,47,475,114,4,151,35,265,171,105,48,49,71
TCGCATCTTTCTGGTT,sample,28152,26933,4460,22473,5535,16938,10470,822,3962,408,14432,1276,2178,1392,3647,3191
GCCTTGCTTTCTGGTT,sample,23342,22879,1352,21527,5453,16074,10004,768,3471,326,13475,1505,2235,1233,3469,3631
CAAGGCCTTTCTGGTT,sample,12130,11931,703,11228,3533,7695,5300,294,1265,146,6565,690,1098,642,2748,2174
ACTATACTTTCTGGTT,sample,25739,25220,2416,22804,3978,18826,8412,467,5927,603,14339,3417,3070,1171,3238,2688
GACGGAGATTCTGGTT,sample,19306,18907,2015,16892,2692,14200,5334,312,4765,492,10099,3297,2982,922,2023,1789
CCAGAGCGTTCTGGTT,sample,18169,17658,1990,15668,2979,12689,5760,307,3694,372,9454,2556,2360,759,2596,2017
GTTAGCCGTTCTGGTT,sample,10771,10497,1019,9478,1926,7552,3386,183,2246,241,5632,1496,1766,647,1418,1273
GGAGGACGTTCTGGTT,sample,9693,9456,1350,8106,953,7153,2077,148,2901,252,4978,1775,1993,538,635,626
GGACGTAGTTCTGGTT,sample,43131,42406,3267,39139,6891,32248,15533,1123,9329,908,24862,5355,3726,1263,6389,4508
CTTGATAGTTCTGGTT,sample,16328,16059,1220,14839,2322,12517,6579,409,3632,346,10211,1551,2040,937,2339,1634
AATCCGTCTTCTGGTT,sample,57158,56005,4443,51562,10100,41462,19104,1503,11956,1213,31060,7686,4538,1292,5318,6476
GTCCTGCCTTCTGGTT,sample,71747,70571,3994,66577,12017,54560,33089,2187,11811,1444,44900,6029,4243,1547,9253,8282
CTAGGACCTTCTGGTT,sample,61946,60839,7006,53833,5926,47907,12922,1061,18038,1884,30960,14002,6405,1323,3436,3391
AATATATCTTCTGGTT,sample,51229,50367,2166,48201,10061,38140,27311,1783,6243,833,33554,1970,2447,1542,7523,7418
TGCTTCGCTTCTGGTT,sample,77090,75745,3491,72254,17554,54700,35410,2954,10788,1135,46198,4413,2795,1215,11054,12143
AAGAGCGCTTCTGGTT,sample,86805,85524,8226,77298,8507,68791,20973,1449,25674,2676,46647,18019,7084,1612,6183,5290
GGAGAGTTGTTCGGTT,sample,93086,91576,7615,83961,15188,68773,29791,2242,21088,2590,50879,13062,6392,1792,9516,10212
TCCTCCGTGTTCGGTT,sample,66081,63998,3083,60915,17708,43207,33136,2142,6097,652,39233,1180,1416,1204,14871,11501
TTCGTAATGTTCGGTT,sample,85647,84577,3864,80713,19045,61668,42525,2625,11268,1066,53793,4184,3816,2130,14616,13203
TTAGAAGTGTTCGGTT,sample,68557,67547,5374,62173,11510,50663,21078,1407,16640,2249,37718,9289,5232,1452,8538,7923
TTCCGTCTGTTCGGTT,sample,48381,47767,3011,44756,8086,36670,18124,1361,11373,1428,29497,4384,4114,2027,4348,5489
GGACCTCTGTTCGGTT,sample,77006,75953,2688,73265,22364,50901,40995,2546,5242,691,46237,1427,1610,1494,15720,14486
CATAACCTGTTCGGTT,sample,14265,13934,1033,12901,4095,8806,5663,374,1748,236,7411,785,1511,926,2093,2492
GTTAGCCGGTTCGGTT,sample,17330,17018,1669,15349,3386,11963,5894,335,3589,404,9483,1741,2426,1038,2058,2104
GGAGGACGGTTCGGTT,sample,38655,37894,2564,35330,6230,29100,15239,1017,8306,874,23545,3664,3327,1409,5664,4298
CTTGATAGGTTCGGTT,sample,10708,10453,1022,9431,1925,7506,3164,258,2493,298,5657,1293,1834,665,1180,1248
CATGATTCGTTCGGTT,sample,89627,88355,5111,83244,14923,68321,34819,2665,20076,1926,54895,8835,4782,1726,10099,10760
TTGGTACCGTTCGGTT,sample,98321,96885,5804,91081,14318,76763,36681,2931,21814,2480,58495,12857,5166,1453,9018,10401
CTAGGACCGTTCGGTT,sample,54034,52825,5750,47075,6390,40685,14172,978,14241,1524,28413,9770,5360,1279,4399,3710
CGGATTACGTTCGGTT,sample,71184,69816,3256,66560,11495,55065,28692,2341,15905,1467,44597,6660,3605,1248,7135,7725
GTTAGGACGTTCGGTT,sample,98641,97156,3790,93366,19492,73874,53256,3802,11415,1101,64671,4300,2342,1302,18767,14013
ACGTATTAGTTCGGTT,sample,118582,116531,7620,108911,20189,88722,40213,2475,26296,2632,66509,17106,5357,1456,13476,13192
CGTATGAAGTTCGGTT,sample,191811,189317,16622,172695,16186,156509,44376,2820,62818,7862,107194,38633,11769,2602,8339,9390
TTGGCCTCGTTCGGTT,sample,86316,85233,5377,79856,12802,67054,34407,3280,17680,2063,52087,9624,5025,1883,7402,8844
ACCAATGCGTTCGGTT,sample,96449,94906,5401,89505,17428,72077,37248,2567,17852,1725,55100,12685,6268,1775,12744,12029
AAGAGCGCGTTCGGTT,sample,111800,110195,7218,102977,18376,84601,38336,2601,25327,2596,63663,15741,6844,1706,10471,12817
TTGGTTAAGTTCGGTT,sample,165316,161706,13070,148636,32811,115825,54831,4038,34402,3025,89233,19529,7135,1829,15452,20999
GGCATATAGTTCGGTT,sample,72203,71208,4443,66765,13259,53506,28811,2117,13579,1648,42390,7351,4435,1526,9559,9144
TCAATATAGTTCGGTT,sample,112431,110833,4127,106706,24990,81716,53120,4379,16043,1770,69163,6404,4179,1812,14206,17626
CTTCATGAGTTCGGTT,sample,128995,127420,8419,119001,17843,101158,40790,2979,31523,3679,72313,22187,8127,2256,10444,12169
AGGTCGGAGTTCGGTT,sample,108585,107169,6687,100482,17878,82604,48747,3157,18087,2383,66834,10230,5305,1760,16534,12927
TTATTCGAGTTCGGTT,Neg_Ctrl,4214,2034,1207,827,94,733,169,12,398,6,567,148,183,77,47,39
GGAGAGTTTGGCGGTT,sample,159304,157430,8466,148964,32678,116286,61230,4670,30012,3472,91242,16902,6916,2076,23871,22024
TCCAACTTTGGCGGTT,sample,153273,149989,13401,136588,33055,103533,60816,3522,23058,2409,83874,13728,5617,1985,23815,22549
GGTTGCGTTGGCGGTT,sample,37173,36463,3004,33459,7562,25897,13721,756,6918,750,20639,3752,3786,1758,5265,5093
TTCTAATGTGGCGGTT,sample,82151,80874,7141,73733,12700,61033,23250,1754,20751,2119,44001,13159,6430,1640,8882,8746
TAGTACGGTGGCGGTT,sample,90866,89737,4387,85350,14321,71029,35597,2041,22308,2620,57905,8463,4883,2072,11558,10121
CAACCGCGTGGCGGTT,sample,100659,99396,5466,93930,21823,72107,38683,2786,18642,1943,57325,10053,5988,2038,14570,14803
AATGGTAATGGCGGTT,sample,96969,95657,6582,89075,19047,70028,31649,1708,21523,2285,53172,12863,6213,1792,13507,13060
TTCCGTCTTGGCGGTT,sample,119508,118249,3825,114424,19020,95404,61676,4585,20836,2717,82512,5590,4169,2891,10679,13967
GGACCTCTTGGCGGTT,sample,115733,114100,4194,109906,34423,75483,57817,3475,10566,1537,68383,2088,1823,1482,26479,22856
CCAGAGCGTGGCGGTT,sample,109703,106840,6056,100784,13606,87178,40846,2994,28508,3443,69354,11387,5175,1876,11456,9598
GGAGGACGTGGCGGTT,sample,83740,82608,4413,78195,21856,56339,32837,1239,13088,1419,45925,7756,4583,1354,16203,14090
CCGCAACGTGGCGGTT,sample,87331,86309,3533,82776,16385,66391,35916,2509,19450,2029,55366,6487,4192,1734,12652,11412
CTTGATAGTGGCGGTT,sample,56245,55587,5684,49903,8521,41382,14361,1243,14216,1738,28577,9824,4941,1364,5663,5528
CGAGGCAGTGGCGGTT,sample,139924,137797,9401,128396,25159,103237,54298,3818,25410,2556,79708,17155,6652,1623,21731,17684
CCATGAAGTGGCGGTT,sample,167712,165456,7261,158195,32357,125838,76575,4290,29085,3558,105660,12330,4992,1905,26768,22462
CGTACGTCTGGCGGTT,sample,137895,135560,7133,128427,21275,107152,55836,4436,30488,4140,86324,12252,5032,1955,11733,13586
GTCCTGCCTGGCGGTT,sample,125532,123620,4444,119176,33513,85663,54670,3585,18403,2987,73073,6018,3661,1530,21087,22443
CGTATGAATGGCGGTT,sample,169266,166153,6260,159893,40981,118912,90129,6936,17348,1665,107477,2834,1879,1256,31783,27647
AAGAGCGCTGGCGGTT,sample,150595,148231,5884,142347,36076,106271,82237,6492,13623,956,95860,2963,2029,1492,29163,24963
GTCTTAGCTGGCGGTT,sample,145312,143174,8655,134519,20974,113545,57705,3874,31045,3968,88750,16953,7638,2187,14386,15078
CCAATTCCTGGCGGTT,sample,111516,109046,8529,100517,15967,84550,35698,2012,26291,2598,61989,17951,7247,1703,13837,11414
GGCATATATGGCGGTT,sample,146776,144272,6763,137509,29458,108051,71663,5489,20900,2062,92563,7937,3410,1343,23934,20086
TTATTCGATGGCGGTT,sample,160108,158078,7582,150496,40517,109979,58874,3213,27434,2589,86308,17869,6451,1776,16347,26087
ATGACCGATGGCGGTT,sample,118685,117080,4154,112926,16643,96283,56324,4527,23507,2959,79831,8966,4170,2008,10286,11688
ACGTAAGTTCCTTATT,sample,40892,40285,3420,36865,5783,31082,12044,725,10241,1043,22285,7029,4419,1093,5287,4031
ATGCCTGGTCCTTATT,sample,32092,31629,1816,29813,6938,22875,11926,767,5527,600,17453,4055,3029,942,6122,4689
TTCCGTCTTCCTTATT,sample,29709,29268,1557,27711,5721,21990,13864,920,4480,593,18344,2133,2244,1260,4504,4015
ACTATACTTCCTTATT,sample,11500,11200,1098,10102,2060,8042,3766,227,2226,267,5992,1556,1670,623,1641,1355
GACGGAGATCCTTATT,sample,35197,34574,1412,33162,9961,23201,18582,932,2884,292,21466,511,1241,1061,8434,6303
ACCTCGAGTCCTTATT,sample,32118,31572,2834,28738,4020,24718,10551,664,8128,908,18679,4467,3464,1237,3560,2649
TGGACGAGTCCTTATT,sample,29525,28979,1254,27725,6094,21631,15399,1402,3367,295,18766,1168,1933,1493,4428,4129
CCATGAAGTCCTTATT,sample,49887,49107,2913,46194,7938,38256,21261,1177,9368,976,30629,5474,3738,1367,8637,5818
AGTCCGCATCCTTATT,sample,40000,39259,3302,35957,7925,28032,15019,924,7226,725,22245,4138,3371,1245,5388,4986
TTGGCCTCTCCTTATT,Pos_Ctrl,18394,18159,925,17234,882,16352,13485,1433,1039,112,14524,283,3478,3619,775,376
GTACCGTATCCTTATT,sample,30540,29928,2039,27889,5662,22227,11432,749,5731,596,17163,3719,2596,948,3743,3840
TCAATATATCCTTATT,sample,36744,35930,2764,33166,5324,27842,13470,1036,7906,735,21376,4695,3059,988,3978,3530
TTATTCGATCCTTATT,sample,39903,39111,4318,34793,4223,30570,9983,642,10465,1110,20448,8370,4653,957,3085,2586
ATGACCGATCCTTATT,sample,26678,26192,2658,23534,3264,20270,7294,568,6809,625,14103,4974,3454,796,2466,2031
GACCGGAATCCTTATT,sample,8214,7789,367,7422,1633,5789,3649,312,1196,121,4845,511,1065,711,1001,966
GGAGAGTTAATAAGGT,sample,131260,129644,8863,120781,28288,92493,46804,2525,24042,2539,70846,16583,5967,1772,21195,19812
TCCAACTTAATAAGGT,sample,136143,133993,4599,129394,36729,92665,74739,4854,9971,872,84710,2229,1827,1530,31505,23963
AAGTTCGTAATAAGGT,sample,70869,69728,2541,67187,24061,43126,30931,2186,7190,716,38121,2103,2437,1648,12504,14563
TCCTCCGTAATAAGGT,sample,101837,100512,3053,97459,20378,77081,62766,4489,6779,951,69545,2096,2884,2792,13567,14552
TTCGTAATAATAAGGT,sample,136913,134927,9401,125526,22459,103067,50731,3073,28323,3410,79054,17530,6415,1802,19371,16078
TTCTAATGAATAAGGT,sample,110164,109037,6176,102861,17135,85726,44156,3410,25152,2985,69308,10023,4894,2005,12018,11881
TAGTACGGAATAAGGT,sample,74507,73477,6456,67021,7678,59343,19033,1449,24103,2676,43136,12082,5761,1741,2994,5234
TGAGCGCGAATAAGGT,sample,19948,19562,1556,18006,4365,13641,7246,535,3543,338,10789,1979,2391,1091,3014,2857
CAACCGCGAATAAGGT,sample,26959,26204,1917,24287,6112,18175,11218,576,3845,395,15063,2141,2077,887,6144,3971
AATGGTAAAATAAGGT,sample,163002,160324,15323,145001,28752,116249,57891,3459,29854,3751,87745,21294,7625,2306,22128,18867
TTCCGTCTAATAAGGT,sample,17771,17467,901,16566,5229,11337,7894,461,1949,154,9843,879,1457,881,3034,3180
CATAACCTAATAAGGT,sample,112185,110318,7092,103226,23345,79881,44349,2419,18261,1909,62610,12943,3818,1396,23106,16255
ACTATACTAATAAGGT,sample,133855,132014,11988,120026,23253,96773,34531,1749,32918,3453,67449,24122,8257,1690,15914,14564
GTTAGCCGAATAAGGT,sample,107029,105613,5443,100170,20403,79767,51991,3508,16422,1308,68413,6538,4349,2018,16952,14389
GGAGGACGAATAAGGT,sample,62394,61598,3495,58103,14525,43578,30592,1828,6658,704,37250,3796,3333,1845,11332,9617
CCGCAACGAATAAGGT,Pos_Ctrl,37156,36620,2015,34605,2068,32537,26929,2612,2113,267,29042,616,4889,5407,2861,976
TGGACGAGAATAAGGT,sample,114455,112700,3958,108742,28538,80204,61165,3547,11533,1721,72698,2238,1833,1364,26741,19994
GGCCAGAGAATAAGGT,sample,127242,125104,8302,116802,19532,97270,41507,1980,29252,3217,70759,21314,6825,1707,16085,13471
CATTGCAGAATAAGGT,sample,121366,119569,6547,113022,19075,93947,48219,3778,26720,3336,74939,11894,5080,2001,12261,12983
AATCCGTCAATAAGGT,Pos_Ctrl,58856,57956,3366,54590,3067,51523,42563,3957,3421,400,45984,1182,5688,6909,3735,1550
AGTCCGCAAATAAGGT,sample,114024,112153,6972,105181,22434,82747,48560,3374,19183,2201,67743,9429,5711,2107,16473,14853
GTTAGGACAATAAGGT,sample,111078,108818,4586,104232,25702,78530,59214,4204,10758,1406,69972,2948,1621,1124,25171,18258
AACTCGTAAATAAGGT,sample,98916,97252,4760,92492,19742,72750,48714,2941,13077,1875,61791,6143,2901,1371,19683,13851
ACCAATGCAATAAGGT,sample,229289,226159,19757,206402,28574,177828,54983,3758,63030,5844,118013,50213,13082,3010,18137,18049
GAAGGCGCAATAAGGT,sample,134207,132010,11383,120627,17839,102788,35649,2087,34465,3423,70114,27164,9070,1869,12230,12653
GGCATATAAATAAGGT,sample,104452,102291,6896,95395,14354,81041,39224,3293,22611,2939,61835,12974,5587,1489,10203,9376
TCAATATAAATAAGGT,sample,141635,139871,4583,135288,33136,102152,77814,5832,13873,1495,91687,3138,1603,1110,24104,22647
TCCAACTTCAGGACCA,sample,97262,95635,6341,89294,22337,66957,26574,2579,21321,2340,47895,14143,5877,1348,9966,14161
GGTTGCGTCAGGACCA,sample,88005,86587,6516,80071,15209,64862,28932,1996,20574,2414,49506,10946,5552,1838,10318,9988
TTCGTAATCAGGACCA,sample,136384,134436,6021,128415,30506,97909,55258,3751,24113,2638,79371,12149,4665,1631,24826,20365
TTCTAATGCAGGACCA,sample,132690,131405,5764,125641,21853,103788,57075,3836,29977,3018,87052,9882,5070,2289,17329,16222
AATGGTAACAGGACCA,sample,79633,78451,5112,73339,14391,58948,28577,2065,16862,1677,45439,9767,5216,1774,9036,9325
GGACCTCTCAGGACCA,sample,94272,92438,6634,85804,17068,68736,32460,2404,18961,1765,51421,13146,5672,1579,12086,11602
CATAACCTCAGGACCA,sample,83166,81395,6246,75149,22299,52850,40118,3104,7431,775,47549,1422,2237,1930,14210,13413
GACGGAGACAGGACCA,sample,132339,130362,8122,122240,22696,99544,53466,3225,26401,2842,79867,13610,5935,1799,20907,16623
CCAGAGCGCAGGACCA,sample,114754,113361,5276,108085,24584,83501,49644,2507,18402,2424,68046,10524,6054,2035,18313,16558
TGGACGAGCAGGACCA,sample,123761,122112,4889,117223,25870,91353,77006,5657,5987,740,82993,1963,2789,2907,19365,17567
ACGACTTCCAGGACCA,sample,116181,113939,7415,106524,24980,81544,50211,3344,17989,1968,68200,8032,3300,1441,20633,16626
CATGATTCCAGGACCA,sample,72299,70701,7156,63545,13808,49737,21248,1358,16193,1627,37441,9311,4788,1431,6506,8514
AATCCGTCCAGGACCA,sample,134153,132052,8270,123782,21098,102684,43893,2675,31735,4091,75628,20290,6954,1903,13154,14293
CGTACGTCCAGGACCA,sample,82179,79525,6441,73084,15700,57384,25054,2172,17674,2064,42728,10420,5717,1448,7700,10340
CTAGGACCCAGGACCA,sample,94143,92819,4926,87893,19412,68481,39925,3526,16571,1411,56496,7048,4847,2474,8269,13305
GTTAGGACCAGGACCA,sample,105747,103940,4719,99221,20134,79087,51353,3471,15556,1615,66909,7092,3000,1339,16367,14117
CGTATGAACAGGACCA,sample,93591,91637,7272,84365,11033,73332,33330,2144,23021,2415,56351,12422,5412,1520,6324,7135
AATATATCCAGGACCA,Neg_Ctrl,4455,2499,1850,649,119,530,287,21,123,19,410,80,209,102,95,19
TGCTTCGCCAGGACCA,sample,65273,63974,5510,58464,8543,49921,18733,1300,16403,1747,35136,11738,5591,1193,4262,5111
ATGACCGACAGGACCA,sample,91933,90435,6367,84068,10834,73234,31648,2126,22542,2385,54190,14533,6318,1431,9079,6847
GGAGAGTTCCTCGTTG,sample,40090,39412,2265,37147,10094,27053,16725,900,6432,611,23157,2385,2570,1204,7324,6552
TATCAGTTCCTCGTTG,sample,60497,59447,4320,55127,11722,43405,22618,1414,10956,1195,33574,7222,4128,1321,10433,8255
ATTCTCTTCCTCGTTG,sample,96633,88991,29651,59340,16555,42785,29858,1744,6671,781,36529,3731,2604,1405,11126,7324
TCCAACTTCCTCGTTG,sample,61833,60905,5040,55865,8812,47053,24727,1624,11706,1149,36433,7847,5459,2299,5212,6051
TTCGTAATCCTCGTTG,sample,65504,63483,3306,60177,18752,41425,32998,2633,4212,391,37210,1191,1720,1501,12799,11354
TAGTACGGCCTCGTTG,sample,34599,34062,1534,32528,9537,22991,18046,1156,2600,243,20646,946,1910,1616,7018,5998
AATGGTAACCTCGTTG,sample,88390,87237,5191,82046,14230,67816,38208,2484,16010,1870,54218,9244,5000,2019,10811,9955
TTCCGTCTCCTCGTTG,sample,75898,74039,4510,69529,16081,53448,33456,1908,11705,1281,45161,5098,3179,1247,14508,10652
TCGCATCTCCTCGTTG,sample,71126,70219,2844,67375,18483,48892,32581,2152,9287,1199,41868,3673,2362,1342,13861,12477
CAAGGCCTCCTCGTTG,sample,70664,68731,6999,61732,15587,46145,30398,1907,8614,915,39012,4311,2505,1215,13033,10756
CATAACCTCCTCGTTG,sample,50052,48678,5963,42715,9039,33676,14093,840,10122,1116,24215,7505,4666,1345,5780,5580
GACGGAGACCTCGTTG,sample,68662,67272,4714,62558,12398,50160,27742,2028,11427,1342,39169,7621,4890,1707,8977,8602
CCAGAGCGCCTCGTTG,sample,33008,32016,1944,30072,7086,22986,15638,899,4203,549,19841,1697,1605,913,7200,4999
GGACGTAGCCTCGTTG,Neg_Ctrl,5071,2462,1798,664,127,537,275,18,133,26,408,85,214,101,109,46
CCATGAAGCCTCGTTG,sample,44459,43530,1491,42039,10644,31395,24225,1731,3524,486,27749,1429,2129,1764,6983,7007
AATCCGTCCCTCGTTG,sample,75485,73907,7174,66733,9435,57298,24724,1764,19802,2416,44526,8592,4684,1533,7102,6497
CGTACGTCCCTCGTTG,Neg_Ctrl,4925,2006,1577,429,63,366,150,9,129,7,279,71,165,60,51,16
GTCCTGCCCCTCGTTG,sample,57198,55952,3107,52845,8949,43896,23503,1582,11907,1014,35410,5890,3718,1315,8084,6031
TTGGTACCCCTCGTTG,sample,93485,92009,6856,85153,14490,70663,35791,2786,17491,1723,53282,12872,5866,1807,11684,9808
AACTCGTACCTCGTTG,sample,45158,44033,2197,41836,8837,32999,20700,1408,7118,749,27818,3024,2561,988,7280,6114
AATATATCCCTCGTTG,sample,84952,83631,8138,75493,9190,66303,23660,1629,22211,2379,45871,16424,6924,1417,7638,5993
GTCTTAGCCCTCGTTG,sample,53666,52716,5690,47026,4605,42421,11081,904,16094,1570,27175,12772,5961,1205,3003,2621
GTACCGTACCTCGTTG,Pos_Ctrl,38329,37670,2386,35284,1840,33444,27270,2763,2354,272,29624,785,4721,5336,2017,1033
TCAATATACCTCGTTG,sample,84114,82558,5852,76706,14423,62283,37431,1990,13838,2210,51269,6814,3012,1238,12578,10438
TCGCCTGACCTCGTTG,sample,52271,50956,4198,46758,7129,39629,13899,1085,13453,1279,27352,9913,4792,1024,3869,4549
AGGTCGGACCTCGTTG,sample,63635,62157,4710,57447,9354,48093,25329,1652,13228,1527,38557,6357,3413,1171,9295,6843
ATGACCGACCTCGTTG,sample,98968,97863,7166,90697,11712,78985,28108,1961,26883,2654,54991,19379,8278,2208,6511,6792
TATCAGTTTTGCGGAC,sample,24089,23867,767,23100,7500,15600,10791,802,2677,204,13468,1126,1380,819,4965,4651
ATTCTCTTTTGCGGAC,sample,54174,53643,2364,51279,11847,39432,25867,1624,7410,936,33277,3595,2890,1415,11073,7775
TCCTCCGTTTGCGGAC,sample,59282,58758,1879,56879,13252,43627,31551,2602,6462,974,38013,2038,2516,1992,8093,9353
ATGCCTGGTTGCGGAC,sample,82341,81458,3367,78091,20964,57127,38735,2397,10409,1148,49144,4438,2957,1224,16321,14310
TAGTACGGTTGCGGAC,sample,93921,92927,3820,89107,25350,63757,45335,2890,10391,1608,55726,3533,2385,1432,17657,16251
TTCCGTCTTTGCGGAC,sample,70380,69629,2908,66721,16472,50249,34677,2091,8238,1061,42915,4182,3611,1782,13219,10989
GGACGTAGTTGCGGAC,sample,76865,76082,4594,71488,11896,59592,35322,2463,11883,1279,47205,8645,5323,2151,7792,8164
CTTGATAGTTGCGGAC,sample,103193,101879,4935,96944,19192,77752,44497,2860,18699,2120,63196,9576,4852,1582,16185,13443
TGGACGAGTTGCGGAC,sample,52525,51718,3439,48279,9417,38862,19553,1331,10693,1075,30246,6210,3893,1153,7663,6167
CGAGGCAGTTGCGGAC,sample,43984,43408,4522,38886,5069,33817,12485,1099,10911,1186,23396,8136,5408,2009,2686,3053
ACGACTTCTTGCGGAC,sample,55884,53604,3471,50133,10624,39509,22576,1547,9590,1055,32166,4741,3634,1506,7337,7000
GTCCTGCCTTGCGGAC,sample,80531,79508,3248,76260,16659,59601,36629,2537,12343,1906,48972,6186,3510,1361,14698,11467
TTGGTACCTTGCGGAC,sample,113792,112572,7931,104641,16501,88140,32061,2053,28966,3075,61027,21985,8643,1758,12383,11273
ACGTATTATTGCGGAC,sample,83253,82101,3215,78886,14817,64069,44402,3024,11004,1628,55406,4011,2004,1256,12119,10795
CGTATGAATTGCGGAC,sample,93208,91775,5628,86147,14784,71363,39067,3497,16825,1474,55892,10500,4974,1306,11728,9890
GAAGGCGCTTGCGGAC,sample,27986,27533,2600,24933,3736,21197,10477,774,5613,703,16090,3630,3014,1311,2171,2384
AAGAGCGCTTGCGGAC,sample,69679,68723,2926,65797,15244,50553,36552,3273,6802,950,43354,2976,3003,1657,8650,10833
GTCTTAGCTTGCGGAC,sample,56426,55208,3759,51449,7447,44002,18745,1645,13719,1528,32464,8365,3837,1177,3050,4989
GTACCGTATTGCGGAC,sample,84433,83148,5382,77766,13577,64189,32282,2624,17585,1722,49867,9976,4670,1212,10467,8806
GGCATATATTGCGGAC,sample,60008,59009,4022,54987,6861,48126,22163,1704,15134,1790,37297,7335,4107,1204,5088,4422
ATGACCGATTGCGGAC,sample,92629,91531,7551,83980,15167,68813,32054,2326,17981,2246,50035,14206,5877,1581,12414,9902
ATTCTCTTTCCATTGG,sample,99057,96602,8405,88197,11867,76330,26105,2004,27130,2683,53235,18408,6412,1458,6404,7182
CCTCTAGATCCATTGG,sample,30558,30164,2050,28114,6482,21632,12350,756,4764,552,17114,3210,2790,1429,5047,4198
AGTACCATTCCATTGG,sample,27475,27099,1754,25345,7654,17691,11154,844,3225,337,14379,2131,2138,1149,4303,4574
ATGCCTGGTCCATTGG,sample,20989,20662,1781,18881,3094,15787,6026,318,5465,568,11491,3410,2836,777,2680,1907
GCCTTGCTTCCATTGG,sample,10325,10136,417,9719,2679,7040,5103,253,1125,110,6228,449,907,613,2608,1757
CATAACCTTCCATTGG,sample,5869,5749,524,5225,1055,4170,2127,111,1096,102,3223,734,1132,518,808,697
ACTATACTTCCATTGG,sample,7019,6885,818,6067,1056,5011,1802,98,1687,178,3489,1246,1422,440,700,661
GGAGGACGTCCATTGG,sample,2070,2008,272,1736,257,1479,515,27,489,47,1004,401,521,190,161,160
GGACGTAGTCCATTGG,sample,85315,84007,5969,78038,9872,68166,29203,2372,20360,2027,49563,14204,6116,1466,7781,6612
GACGATAATCCATTGG,sample,68400,66927,4343,62584,10481,52103,29715,1453,11451,1218,41166,8266,4207,1072,10756,7013
GGCCAGAGTCCATTGG,sample,53132,51852,2475,49377,8650,40727,26792,2051,7788,1186,34580,2910,2521,1266,5586,6198
AGTCCGCATCCATTGG,sample,50003,49112,5011,44101,4796,39305,16192,880,12019,1418,28211,8796,4584,1100,3646,3136
CTAGGACCTCCATTGG,sample,22770,22230,1110,21120,6279,14841,11288,811,1737,278,13025,727,1445,1122,4219,3943
CGGATTACTCCATTGG,sample,38024,37301,2901,34400,4526,29874,12795,961,8293,919,21088,6906,4124,999,5405,3151
GTTAGGACTCCATTGG,sample,35315,34622,3595,31027,4747,26280,8968,423,9508,928,18476,6453,4550,1000,2520,2940
TTGGCCTCTCCATTGG,sample,20669,20275,2312,17963,2070,15893,5193,315,5411,612,10604,4362,3012,714,1604,1182
AATATATCTCCATTGG,sample,39951,39350,4395,34955,3287,31668,8805,786,11970,1239,20775,8868,5205,1163,1920,1979
GAAGGCGCTCCATTGG,sample,19326,18949,1820,17129,2977,14152,6973,489,3796,447,10769,2447,2477,950,2297,1877
GTCTTAGCTCCATTGG,sample,17142,16814,1360,15454,1830,13624,6464,455,4023,446,10487,2236,2546,1132,1595,1275
TTGGTTAATCCATTGG,sample,42553,41883,3661,38222,5200,33022,14850,834,10041,1075,24891,6222,3826,1240,3930,3543
GGCATATATCCATTGG,Neg_Ctrl,2222,1235,948,287,41,246,113,14,69,1,182,49,108,49,32,50
ATGACCGATCCATTGG,sample,25052,24606,2905,21701,2775,18926,6578,393,6504,664,13082,4787,3524,881,2323,1603
ACGTAAGTCATAGGCG,sample,158265,156123,9954,146169,32042,114127,56188,3297,31036,3234,87224,20372,8002,2065,21331,21547
TTCGTAATCATAGGCG,sample,34463,33910,2988,30922,8239,22683,8719,643,7893,852,16612,4576,3773,1471,1973,4799
TAGTACGGCATAGGCG,sample,54683,54113,4911,49202,8049,41153,17111,1399,13073,1540,30184,8030,5124,1717,5461,5119
TTCCGTCTCATAGGCG,sample,154913,153538,15454,138084,12270,125814,39576,3033,54726,7049,94302,21430,9065,2477,8457,7322
TCGCATCTCATAGGCG,sample,34952,34510,1330,33180,8105,25075,15607,1240,5913,578,21520,1737,2360,1437,5547,5451
GACGGAGACATAGGCG,sample,19625,19212,2129,17083,2714,14369,5354,400,4797,494,10151,3324,3307,1170,1420,1704
CCGCAACGCATAGGCG,sample,33515,32844,1897,30947,7264,23683,12333,1064,6589,826,18922,2871,2428,998,3623,4648
GGCCAGAGCATAGGCG,sample,147289,144825,9558,135267,21494,113773,67853,5862,24309,2478,92162,13271,6227,1959,15159,14324
AATCCGTCCATAGGCG,sample,85060,83778,4867,78911,12228,66683,37155,2461,15405,2196,52560,9466,4805,1782,8322,8542
CGTACGTCCATAGGCG,sample,12527,12276,607,11669,2251,9418,4852,383,2641,434,7493,1108,1620,818,1025,1391
GCCTGAACCATAGGCG,sample,57965,56926,3086,53840,9291,44549,26726,1856,9890,1295,36616,4782,3767,1620,7736,6397
ACGTATTACATAGGCG,sample,95781,94065,4092,89973,20992,68981,54954,3023,8266,861,63220,1877,1608,1226,21795,14506
CGTATGAACATAGGCG,sample,72835,71630,3598,68032,10455,57577,35899,2983,12508,1578,48407,4609,3355,1784,7586,7381
TTGGCCTCCATAGGCG,sample,72988,72013,3686,68327,12800,55527,34317,1778,12014,1400,46331,6018,3407,1345,12748,8795
GAAGGCGCCATAGGCG,sample,61511,60248,3596,56652,9067,47585,25937,2078,12116,1744,38053,5710,3547,1326,7385,6519
CCAATTCCCATAGGCG,sample,48200,47245,4522,42723,4716,38007,14278,1359,12727,1336,27005,8307,5057,1593,3403,2858
TTGGTTAACATAGGCG,sample,84838,83528,3674,79854,19054,60800,45793,3633,8541,1120,54334,1713,1425,1120,18914,13382
TCGCCTGACATAGGCG,sample,45689,44739,2502,42237,9754,32483,20274,1559,6949,815,27223,2886,2843,1402,5933,6428
GACCGGAACATAGGCG,sample,1337,1236,120,1116,277,839,454,31,200,42,654,112,296,160,173,159
ATTCTCTTTTGGAGAG,Pos_Ctrl,57626,56870,3430,53440,3207,50233,41778,4010,3113,333,44891,999,5619,6638,4164,1883
ACGTAAGTTTGGAGAG,sample,150530,148775,12686,136089,22381,113708,45858,2785,38300,4476,84158,22289,8415,2371,12859,14884
TTCCGTCTTTGGAGAG,Pos_Ctrl,36866,36409,2394,34015,2232,31783,26266,2504,1945,316,28211,752,4763,5190,2911,1252
CAAGGCCTTTGGAGAG,sample,37685,37025,3163,33862,6860,27002,12719,720,8086,940,20805,4537,3485,1254,4566,4471
CATAACCTTTGGAGAG,sample,50908,50190,2778,47412,11301,36111,23622,1434,6985,1014,30607,3056,2577,1382,9796,7630
CCAGAGCGTTGGAGAG,sample,59961,58983,3864,55119,10780,44339,23116,1088,12056,1307,35172,6772,3577,1346,9170,7120
CCGCAACGTTGGAGAG,sample,59704,58856,3151,55705,14034,41671,25508,1408,9055,815,34563,4885,3380,1286,12783,9392
GACGATAATTGGAGAG,sample,106232,104817,9379,95438,14064,81374,27930,1647,28689,3008,56619,20100,7896,1620,11118,9325
GGCCAGAGTTGGAGAG,sample,54859,53901,3353,50548,8249,42299,22867,1483,11115,1348,33982,5486,4154,1503,8000,5706
CCATGAAGTTGGAGAG,sample,99143,97447,4901,92546,16493,76053,45923,2241,17950,1791,63873,8148,3876,1340,17641,12077
AATCCGTCTTGGAGAG,sample,101286,100031,7261,92770,11892,80878,32900,2650,25176,2918,58076,17234,7344,1898,8354,7707
GTCCTGCCTTGGAGAG,sample,85845,84336,5179,79157,12540,66617,36733,2818,16211,1696,52944,9159,5104,1715,9643,8100
AATATATCTTGGAGAG,sample,94659,93202,5058,88144,14955,73189,40539,4170,17269,2007,57808,9204,4588,1661,7695,10502
TCGCCTGATTGGAGAG,sample,84635,83479,4236,79243,12937,66306,35724,2752,17234,2506,52958,8090,4121,1742,9158,8692
GGAGAGTTTTCAAGCC,sample,58152,57409,2369,55040,16764,38276,29852,1955,4200,511,34052,1758,2664,2216,8089,10694
TATCAGTTTTCAAGCC,sample,70741,69857,2579,67278,20436,46842,35827,2170,6021,400,41848,2424,2158,1558,14472,13218
AAGTTCGTTTCAAGCC,sample,89689,88068,6013,82055,18166,63889,33752,1667,15770,1728,49522,10972,5223,1440,17219,11685
TCCTCCGTTTCAAGCC,sample,7375,7239,338,6901,2465,4436,2944,219,872,105,3816,296,1304,863,732,1465
ACGTAAGTTTCAAGCC,sample,65212,64445,4054,60391,15550,44841,22493,1201,11734,1196,34227,8217,4496,1573,9521,10273
ACGTTATGTTCAAGCC,sample,54962,53985,3056,50929,13506,37423,24770,1181,6977,717,31747,3778,3107,1480,9505,8734
TGAGCGCGTTCAAGCC,sample,35199,34770,1471,33299,6311,26988,18276,1362,4920,738,23196,1692,2480,1929,4136,4512
TTAGAAGTTTCAAGCC,sample,55815,54798,5429,49369,8558,40811,14814,1043,14035,1447,28849,9472,4992,1248,5830,5497
CAAGGCCTTTCAAGCC,sample,15512,15156,2263,12893,1510,11383,2830,174,4450,466,7280,3463,2625,529,1218,875
ACTATACTTTCAAGCC,sample,50413,49633,3935,45698,7606,38092,17212,1113,11974,1503,29186,6290,3933,1394,6165,5226
GGAGGACGTTCAAGCC,sample,37702,37183,2434,34749,5293,29456,14242,922,9364,946,23606,3982,3193,1223,5304,3628
GACGATAATTCAAGCC,sample,53180,52257,3174,49083,11147,37936,25241,1796,6986,881,32227,3032,3078,1488,9093,7556
CATTGCAGTTCAAGCC,sample,50669,49783,1983,47800,12215,35585,27699,2242,3938,343,31637,1363,1688,1425,8454,8540
AGTCCGCATTCAAGCC,sample,60602,59435,4075,55360,12292,43068,28867,2195,7759,1089,36626,3158,2851,1613,9622,8635
CTAGGACCTTCAAGCC,sample,49575,48579,3447,45132,8139,36993,19796,1546,8958,1099,28754,5594,3858,1407,5814,5363
GCCTGAACTTCAAGCC,sample,63667,62739,5065,57674,8170,49504,22362,1892,13493,1540,35855,10217,5806,1737,5850,5356
ACGTATTATTCAAGCC,sample,93178,91853,7177,84676,11714,72962,29458,2326,23121,2456,52579,15601,7476,1851,7993,8113
AACTCGTATTCAAGCC,sample,47899,47061,3223,43838,5355,38483,17111,1249,12293,1470,29404,6360,4317,1469,2802,3490
TTGGCCTCTTCAAGCC,Pos_Ctrl,26335,25932,1684,24248,1399,22849,18781,1802,1597,176,20378,493,4144,4229,1491,669
TGCTTCGCTTCAAGCC,sample,37733,36886,1569,35317,8967,26350,20027,1521,3532,367,23559,903,1331,1136,7531,6295
TTATTCGATTCAAGCC,sample,27772,27298,1917,25381,7190,18191,9201,930,4572,398,13773,3090,2585,948,1956,4465
GGAGAGTTAACTTAAC,sample,67651,66780,4023,62757,13889,48868,28104,1785,10939,1357,39043,6683,3227,1321,11702,9118
ATTCTCTTAACTTAAC,sample,87117,85969,8114,77855,12131,65724,22617,1586,22771,2672,45388,16078,6903,1562,9279,7926
TCCAACTTAACTTAAC,Neg_Ctrl,4453,2319,1573,746,116,630,261,13,73,14,334,269,127,56,50,89
AAGTTCGTAACTTAAC,sample,77028,75863,5824,70039,12334,57705,22086,1407,18595,1948,40681,13669,6371,1579,8224,8246
CCTCTAGAAACTTAAC,sample,29233,28695,2665,26030,6018,20012,9271,636,5942,723,15213,3440,3273,1260,3756,3672
ACGTTATGAACTTAAC,sample,33123,32500,2655,29845,6814,23031,11403,918,6361,764,17764,3585,3547,1565,3078,4362
TTCTAATGAACTTAAC,sample,53166,52400,3192,49208,12088,37120,22881,1129,7558,832,30439,4720,3345,1208,9973,8329
ATGCCTGGAACTTAAC,sample,56114,55215,4638,50577,8435,42142,15864,1455,14001,1443,29865,9379,4988,1347,4972,5335
TTCCGTCTAACTTAAC,sample,67292,66516,3535,62981,16015,46966,28738,2228,9325,988,38063,5687,4001,1837,9186,10309
GGACCTCTAACTTAAC,Neg_Ctrl,3437,1795,1278,517,96,421,196,16,131,12,327,66,155,63,81,41
CAAGGCCTAACTTAAC,sample,90400,89376,5464,83912,16870,67042,33553,2226,18254,1900,51807,11109,5635,1658,10877,11323
GTTAGCCGAACTTAAC,sample,21447,21163,3018,18145,2093,16052,4123,321,6036,672,10159,4900,3848,1024,898,1218
CCGCAACGAACTTAAC,sample,28109,27568,1975,25593,4532,21061,9772,912,5990,853,15762,3534,3089,1400,1222,2931
GGACGTAGAACTTAAC,sample,54067,53334,3376,49958,8936,41022,18662,1089,11772,1203,30434,8296,4701,1296,7662,6042
CTTGATAGAACTTAAC,sample,74124,73111,6403,66708,11931,54777,19324,1199,18311,2007,37635,13936,6382,1343,6808,7712
CATTGCAGAACTTAAC,sample,46257,45491,1850,43641,10636,33005,23819,1396,5334,617,29153,1839,2239,1313,9029,7175
CGAGGCAGAACTTAAC,sample,54936,54189,3339,50850,7031,43819,22140,1455,12380,1322,34520,6522,3967,1704,4938,4811
ACGACTTCAACTTAAC,sample,82330,81090,5340,75750,15249,60501,31502,2023,15941,1892,47443,9143,5313,1478,12896,11313
CATGATTCAACTTAAC,sample,66626,65714,2728,62986,13387,49599,36857,2810,5779,757,42636,3396,2480,1868,8517,9756
TTGGTACCAACTTAAC,sample,57273,56371,3801,52570,9287,43283,20238,1357,12430,1737,32668,7521,4162,1112,7385,6219
CGGATTACAACTTAAC,sample,74702,73438,5462,67976,11144,56832,26706,1696,15123,1776,41829,11531,5571,1454,8521,7473
GCCTGAACAACTTAAC,sample,71111,69776,3088,66688,13594,53094,34463,1796,11202,894,45665,4739,2820,1146,11242,9939
ACCAATGCAACTTAAC,sample,62572,61511,3721,57790,12286,45504,27704,1339,9606,1180,37310,5675,3226,1158,11831,8486
TGCTTCGCAACTTAAC,sample,46931,46103,4004,42099,4687,37412,14750,899,12894,1373,27644,7496,4544,1383,4752,3108
AAGAGCGCAACTTAAC,sample,52627,51800,3839,47961,6623,41338,20987,1150,11982,1259,32969,5960,3661,1294,6678,4559
TTGGTTAAAACTTAAC,sample,56936,55882,2806,53076,11827,41249,26898,2123,7992,915,34890,3321,2094,1123,10133,8146
GGCATATAAACTTAAC,sample,44477,43664,2171,41493,8003,33490,24312,1607,5598,680,29910,1293,1928,1327,7301,5629
TCAATATAAACTTAAC,sample,49601,48800,4851,43949,5999,37950,13846,1024,12658,1362,26504,9060,4856,1215,4095,3738
CTTCATGAAACTTAAC,sample,66419,65291,5737,59554,6259,53295,20855,1552,18287,1765,39142,10836,5198,1496,4159,4114
TCCAACTTATACTTGA,sample,6750,6608,358,6250,1840,4410,2132,137,1345,128,3477,668,1108,540,660,1105
AAGTTCGTATACTTGA,sample,97383,96234,7500,88734,10754,77980,26067,1659,29415,3209,55482,17630,7594,2076,6904,6573
GGTTGCGTATACTTGA,sample,115818,114624,8692,105932,12850,93082,35585,2752,33252,4381,68837,17112,6554,2065,9085,8889
AGTACCATATACTTGA,sample,19153,18812,1908,16904,4276,12628,5571,360,3923,453,9494,2321,2395,972,2070,2658
ACGTTATGATACTTGA,sample,39485,38820,3182,35638,5439,30199,12523,1052,9816,1284,22339,5524,3805,1149,4949,3699
TTCTAATGATACTTGA,sample,101877,100734,7479,93255,13164,80091,35835,1980,25526,2596,61361,14154,6062,1772,11887,8986
TGAGCGCGATACTTGA,sample,54862,54121,2971,51150,8925,42225,22402,1434,11678,1494,34080,5217,3547,1533,7037,6042
TTAGAAGTATACTTGA,sample,104800,103580,6299,97281,20988,76293,48513,3649,14329,1924,62842,7878,4490,1959,15499,14724
GGACCTCTATACTTGA,sample,34248,33672,2024,31648,7532,24116,14160,1121,5881,628,20041,2326,2725,1402,4120,4803
GGAGGACGATACTTGA,sample,24104,23807,1663,22144,4301,17843,9917,717,4373,454,14290,2382,2826,1566,2671,2854
CTTGATAGATACTTGA,sample,80654,79460,9017,70443,10296,60147,18098,859,21289,2127,39387,17774,7228,1371,6689,6159
ACCTCGAGATACTTGA,sample,70399,69396,5205,64191,12782,51409,23780,1365,14633,1432,38413,10199,5110,1323,11398,8518
GACGATAAATACTTGA,sample,34299,33647,3629,30018,4273,25745,9475,721,8669,1067,18144,5813,3744,1196,2426,2698
CCATGAAGATACTTGA,sample,73905,72611,4693,67918,10820,57098,29094,2651,14501,1634,43595,9218,4624,1706,8337,7314
CGGATTACATACTTGA,sample,82291,80925,5280,75645,13271,62374,31499,1841,17066,2122,48565,9846,4476,1393,11434,9586
GCCTGAACATACTTGA,sample,67607,66450,3879,62571,12775,49796,28281,1473,13102,1115,41383,5825,3930,1264,11698,8380
AATATATCATACTTGA,Neg_Ctrl,4450,2146,1636,510,78,432,233,5,116,11,349,67,189,79,69,39
GAAGGCGCATACTTGA,sample,78511,77222,5309,71913,12696,59217,30010,1891,15240,1734,45250,10342,4795,1392,12296,9160
GTACCGTAATACTTGA,sample,89448,88028,6338,81690,10559,71131,33254,2909,21295,2353,54549,11320,4013,1290,8944,7831
GGCATATAATACTTGA,sample,63033,61877,4123,57754,9074,48680,24957,2823,12587,1565,37544,6748,3571,1153,7673,5851
CTTCATGAATACTTGA,sample,103016,101334,4491,96843,19424,77419,51288,4044,13844,1500,65132,6743,2768,1236,14480,13408
TTATTCGAATACTTGA,sample,66907,65692,5720,59972,8866,51106,18544,1383,16799,1960,35343,12420,5833,1369,4922,5212
GGAGAGTTATCCGCGA,sample,71100,69985,6020,63965,10612,53353,23609,1314,16255,1885,39864,10290,5380,1392,10119,7063
ACGTAAGTATCCGCGA,sample,79786,78593,4218,74375,19825,54550,36043,2446,10538,1256,46581,4267,3299,1500,14858,13184
TTCGTAATATCCGCGA,sample,77197,76332,11103,65229,7971,57258,13597,916,22184,2455,35781,18106,8038,2088,2864,4626
ACGTTATGATCCGCGA,sample,137590,135870,11796,124074,25122,98952,38870,2559,31126,2904,69996,23493,8168,1911,14406,16426
AATGGTAAATCCGCGA,sample,90144,88984,7876,81108,10653,70455,25662,1470,26708,3153,52370,13462,6162,1654,6814,6735
TTAGAAGTATCCGCGA,sample,105013,103762,4833,98929,22888,76041,46247,2590,16485,2134,62732,8585,3553,1331,20411,16424
GGACCTCTATCCGCGA,sample,25104,24704,2599,22105,4095,18010,7800,531,5392,599,13192,3688,3109,1241,2398,2514
TCGCATCTATCCGCGA,sample,44487,43857,3591,40266,8535,31731,16797,1310,7766,979,24563,4879,3814,1634,5342,5502
GTTAGCCGATCCGCGA,sample,75093,74127,6894,67233,11282,55951,22056,1313,18620,2005,40676,11957,6286,1440,7569,7223
CTTGATAGATCCGCGA,sample,73811,72865,6074,66791,8185,58606,24466,2023,19626,2345,44092,10146,5482,1940,6313,5339
GGCCAGAGATCCGCGA,sample,105406,104131,8395,95736,12383,83353,35068,2018,27715,3232,62783,15320,6315,1834,9421,8460
CATTGCAGATCCGCGA,sample,105115,103731,7819,95912,13919,81993,37030,2800,23649,2555,60679,15959,6796,1836,13421,9609
ACGACTTCATCCGCGA,sample,89995,88597,4408,84189,16600,67589,41624,3096,15445,1693,57069,5731,3530,1520,14539,11821
AGTCCGCAATCCGCGA,sample,82285,81057,9066,71991,10075,61916,21068,1351,21235,2387,42303,15875,6640,1429,7196,6253
GTTAGGACATCCGCGA,sample,119163,117256,8126,109130,16460,92670,38873,3781,28060,3372,66933,18584,6338,1515,11974,11602
GCCTGAACATCCGCGA,sample,101279,99970,6030,93940,13807,80133,46780,3232,17570,1907,64350,10644,4739,1473,13574,9720
TGCTTCGCATCCGCGA,sample,93513,92316,5936,86380,10714,75666,42388,2863,17455,1565,59843,11395,5691,1922,9746,7218
GAAGGCGCATCCGCGA,sample,114982,113356,7079,106277,16938,89339,44783,3567,23324,2175,68107,15490,6473,1671,11795,11623
CCAATTCCATCCGCGA,sample,75767,74717,6612,68105,8656,59449,20874,1842,19939,2294,40813,14500,6349,1512,6348,5261
AGGTCGGAATCCGCGA,sample,90590,89106,6463,82643,13203,69440,37037,3353,16850,2588,53887,9612,4161,1311,13746,9478
AAGTTCGTAGGACTCA,sample,79983,78743,4776,73967,12949,61018,30888,1901,17608,2008,48496,8613,4383,1610,10326,8701
CCTCTAGAAGGACTCA,sample,75940,74684,4364,70320,17383,52937,32460,1711,11372,1283,43832,6111,3457,1279,14408,11561
AGTACCATAGGACTCA,sample,108953,107378,9490,97888,16657,81231,31353,2377,26337,3012,57690,18152,7020,1623,11163,11193
ACGTTATGAGGACTCA,sample,97017,95637,3917,91720,25709,66011,51466,3172,8087,1342,59553,1944,1717,1243,21864,16912
AATGGTAAAGGACTCA,sample,144182,142397,10875,131522,21185,110337,46789,3395,34395,3214,81184,22544,7726,1863,17026,15038
TTCCGTCTAGGACTCA,sample,163741,161882,16458,145424,18054,127370,36388,2159,47496,5056,83884,36271,11765,2432,13359,11042
CAAGGCCTAGGACTCA,sample,47302,46554,2766,43788,8138,35650,19244,1089,10218,1214,29462,3885,3432,1553,6678,5646
CATAACCTAGGACTCA,sample,75132,73835,3876,69959,17126,52833,32448,1835,11432,1457,43880,5661,3197,1278,15718,11744
ACTATACTAGGACTCA,sample,90645,89547,5963,83584,15436,68148,34887,2214,18700,1869,53587,10478,5266,1594,14036,10610
CCGCAACGAGGACTCA,sample,55308,54390,3545,50845,10408,40437,21802,1286,10635,1169,32437,5545,3986,1640,6462,7234
GACGATAAAGGACTCA,sample,72846,71581,5550,66031,11496,54535,24192,1406,17134,1939,41326,9864,5268,1501,8583,8289
CATTGCAGAGGACTCA,sample,83054,81805,3860,77945,17808,60137,35797,2183,13620,1867,49417,6670,3014,1276,14119,12285
CATGATTCAGGACTCA,sample,58197,57272,3177,54095,8705,45390,22940,2069,13373,1637,36313,5371,3835,1592,5242,6014
CTAGGACCAGGACTCA,sample,42190,41341,5039,36302,4701,31601,8792,612,11381,1288,20173,9528,4777,935,3683,2603
GTTAGGACAGGACTCA,sample,64643,63488,4326,59162,10911,48251,22759,1660,13582,1519,36341,8731,4664,1108,8100,7478
AACTCGTAAGGACTCA,sample,117606,115945,7587,108358,15107,93251,45917,3872,26027,2734,71944,14701,5915,1720,13480,11003
AATATATCAGGACTCA,sample,75710,74624,3471,71153,15818,55335,39368,2922,8666,877,48034,3502,1989,1193,11949,11493
CCAATTCCAGGACTCA,sample,74663,73068,4659,68409,12132,56277,29488,2775,14663,1723,44151,7628,4456,1334,9237,8160
GTACCGTAAGGACTCA,sample,66818,65582,5300,60282,8239,52043,18463,1514,17958,1933,36421,12175,5686,1300,4222,4985
GGCATATAAGGACTCA,sample,91451,89845,7554,82291,12066,70225,25157,1687,23562,2493,48719,17326,6424,1391,7085,8539
AGGTCGGAAGGACTCA,Pos_Ctrl,37409,36654,2242,34412,1813,32599,26633,2576,2324,292,28957,774,4739,5244,2189,899
TATCAGTTTATTGAAC,sample,38673,38355,2047,36308,8224,28084,14292,1222,7179,731,21471,4660,3552,1356,5358,5291
GGTTGCGTTATTGAAC,sample,57739,57092,2630,54462,18349,36113,24259,1490,6584,679,30843,3101,2621,1129,12590,10938
TCCTCCGTTATTGAAC,sample,59255,58445,3220,55225,14166,41059,24261,1639,9354,730,33615,5075,3412,1242,11231,9402
ACGTAAGTTATTGAAC,sample,116989,115713,6761,108952,24331,84621,45944,2982,20779,2239,66723,12677,5354,1622,19955,16636
TTCGTAATTATTGAAC,sample,102583,101482,4787,96695,22565,74130,49257,3098,13905,1288,63162,6582,3792,1486,21577,15278
GGAGGACGTATTGAAC,sample,30226,29720,1486,28234,7640,20594,12934,836,4749,602,17683,1473,2357,1334,4263,5055
CTTGATAGTATTGAAC,sample,144540,142877,12561,130316,21582,108734,45459,3539,31338,3110,76797,25288,8707,2131,19094,14526
TGGACGAGTATTGAAC,sample,36324,35858,3118,32740,5675,27065,11988,630,7776,806,19764,5865,4317,1346,4975,3477
CATTGCAGTATTGAAC,sample,62560,61430,3792,57638,11555,46083,24928,2255,11741,1542,36669,5617,3774,1269,8647,8004
CGAGGCAGTATTGAAC,sample,27551,27084,1405,25679,6624,19055,11136,982,4564,621,15700,1752,2255,1353,2688,4357
CCATGAAGTATTGAAC,sample,64100,63099,2362,60737,9966,50771,31213,1910,11921,2036,43134,3691,2900,1539,8389,7168
ACGACTTCTATTGAAC,sample,82856,81649,4804,76845,14815,62030,31572,2604,15613,1727,47185,10514,5540,1818,10666,10017
AATCCGTCTATTGAAC,sample,62901,61996,3735,58261,11611,46650,27919,2076,10308,1298,38227,5049,3315,1405,8722,7832
TTGGTACCTATTGAAC,sample,63043,62073,3959,58114,9615,48499,23076,1763,15004,1649,38080,7007,4062,1453,4883,6542
ACCAATGCTATTGAAC,sample,84817,83350,10106,73244,6919,66325,14888,1322,25963,2732,40851,21420,8173,1469,4162,3813
TTGGTTAATATTGAAC,sample,73318,72230,3662,68568,15927,52641,35956,2531,8615,1253,44571,4286,3258,1530,11476,10880
GTACCGTATATTGAAC,sample,150579,148606,17323,131283,14036,117247,31825,1929,44010,4622,75835,34861,11524,2140,8721,8688
GGCATATATATTGAAC,sample,112274,110613,8083,102530,14148,88382,31211,2636,28491,3337,59702,22707,7212,1604,7991,9085
TCAATATATATTGAAC,sample,91714,90436,7824,82612,9089,73523,25437,1489,25095,2544,50532,18958,6775,1300,8477,5800
TCGCCTGATATTGAAC,sample,65618,64441,3901,60540,8916,51624,27127,2116,13405,1563,40532,7413,3851,1192,7447,6112
CTTCATGATATTGAAC,sample,42257,41310,3178,38132,6370,31762,15232,1448,9332,1105,24564,4645,3559,1070,3608,4246
GGAGAGTTGTTCAACT,sample,40970,40484,2470,38014,8901,29113,17000,1222,6531,739,23531,3621,3275,1478,5671,5726
AAGTTCGTGTTCAACT,sample,21049,20745,2463,18282,2016,16266,3781,271,6826,744,10607,4644,3456,761,878,1179
GGTTGCGTGTTCAACT,sample,66089,65303,4914,60389,7770,52619,19116,1149,19600,2192,38716,10562,5722,1548,5393,5282
AGTACCATGTTCAACT,sample,47847,47249,2134,45115,12607,32508,25394,1514,4030,532,29424,1038,1368,1099,9948,8244
TTCGTAATGTTCAACT,sample,41129,40572,2435,38137,6417,31720,16927,931,8807,1252,25734,3803,3098,1402,5332,4187
TTCCGTCTGTTCAACT,sample,27096,26754,1105,25649,3910,21739,11869,985,6257,733,18126,1895,2122,1234,2639,2680
GACGGAGAGTTCAACT,sample,25170,24743,842,23901,5397,18504,14277,1154,2292,229,16569,552,1536,1420,4324,3822
CCAGAGCGGTTCAACT,sample,24528,24155,1031,23124,5641,17483,10927,758,3530,265,14457,2003,1833,819,4694,3839
CCGCAACGGTTCAACT,sample,7282,7109,623,6486,917,5569,2211,180,2013,231,4224,934,1473,540,731,630
ACCTCGAGGTTCAACT,sample,28668,28229,1881,26348,3085,23263,8983,709,7978,842,16961,4751,3983,1131,3490,2172
TGGACGAGGTTCAACT,sample,29300,28927,1158,27769,8651,19118,13905,923,2612,309,16517,1369,1700,1279,5930,5509
GACGATAAGTTCAACT,sample,44195,43473,2726,40747,7989,32758,17401,1105,8713,1107,26114,4432,3601,1407,6627,5319
CATTGCAGGTTCAACT,sample,29134,28657,1380,27277,3764,23513,11275,867,8041,1003,19316,2327,2783,1499,2772,2553
CGAGGCAGGTTCAACT,sample,39956,39386,2339,37047,8949,28098,17861,1022,5734,714,23595,2767,2347,1143,7468,5987
CCATGAAGGTTCAACT,sample,32034,31480,3557,27923,6563,21360,13451,777,4609,439,18060,2084,1654,878,6575,4227
AGTCCGCAGTTCAACT,sample,34010,33462,2105,31357,5330,26027,16206,1105,6187,668,22393,1861,2367,1423,5322,3586
GTCCTGCCGTTCAACT,sample,29290,28827,2334,26493,5324,21169,12032,642,5630,465,17662,2400,1882,938,5350,3687
CTAGGACCGTTCAACT,sample,35374,34869,2201,32668,5956,26712,15517,1024,5699,640,21216,3832,2797,1103,6391,4089
AATATATCGTTCAACT,sample,41560,40875,2681,38194,5057,33137,16003,1166,9804,1061,25807,5103,3040,1118,5611,3611
ACCAATGCGTTCAACT,sample,30474,29552,1403,28149,4887,23262,13807,1096,5086,682,18893,2591,2309,1059,3500,3189
GTCTTAGCGTTCAACT,sample,20460,19865,1068,18797,2460,16337,8619,603,4143,462,12762,2510,1914,754,2937,1774
CCAATTCCGTTCAACT,sample,23052,22230,1336,20894,3878,17016,10120,689,3605,509,13725,2093,1689,761,2878,2669
TTATTCGAGTTCAACT,Neg_Ctrl,1517,733,510,223,27,196,81,5,66,6,147,38,78,25,28,16
TATCAGTTCTGAGGTT,sample,104097,102760,9988,92772,11285,81487,26720,1754,29980,3662,56700,19371,8116,1963,9708,7716
AAGTTCGTCTGAGGTT,sample,58439,57400,4559,52841,8689,44152,19358,1239,13399,1746,32757,8410,4685,1377,8356,5629
GGTTGCGTCTGAGGTT,sample,128129,126190,5850,120340,33280,87060,68250,5024,10342,1027,78592,2417,1781,1392,28077,21799
TTCTAATGCTGAGGTT,sample,151070,149487,11381,138106,23041,115065,68706,4724,22718,2485,91424,16432,6607,2766,19683,15568
AATGGTAACTGAGGTT,sample,144494,142786,7976,134810,30969,103841,63735,4195,21607,2411,85342,11893,4894,1780,27337,20467
TTAGAAGTCTGAGGTT,sample,106774,105593,5724,99869,24402,75467,48215,3206,15995,1538,64210,6513,3655,1671,20339,16655
TTCCGTCTCTGAGGTT,sample,163664,162002,12079,149923,27536,122387,46335,2748,39346,3819,85681,30139,8997,2056,20510,19214
CAAGGCCTCTGAGGTT,sample,88961,87776,4292,83484,19063,64421,38159,2110,14805,1812,52964,7535,3882,1624,17002,13071
GACGGAGACTGAGGTT,sample,138340,136711,4350,132361,35350,97011,79308,5311,8082,1383,87390,2927,2188,1893,29357,23787
GTTAGCCGCTGAGGTT,sample,56551,55829,4683,51146,8564,42582,16482,1431,14225,1591,30707,8853,5567,2017,4186,5608
CTTGATAGCTGAGGTT,sample,105604,104692,5628,99064,15606,83458,40471,2996,24759,3359,65230,11873,5837,2070,14031,11016
CATTGCAGCTGAGGTT,sample,78971,77098,4176,72922,16418,56504,33800,2072,11750,1850,45550,7032,3402,1315,15183,11057
CGAGGCAGCTGAGGTT,sample,82715,81028,4697,76331,8738,67593,30328,2257,24060,2802,54388,8146,4382,1743,6324,6211
CGTACGTCCTGAGGTT,sample,87350,86022,7067,78955,5248,73707,19553,1489,32433,3932,51986,16300,6441,1690,1296,3007
GTCCTGCCCTGAGGTT,sample,29839,29167,2537,26630,3251,23379,7803,657,9141,1038,16944,4740,3815,1262,1260,1956
GTTAGGACCTGAGGTT,sample,114078,112370,5966,106404,25655,80749,48918,2620,16482,2204,65400,10525,4371,1682,22014,17740
ACGTATTACTGAGGTT,sample,110964,109430,7147,102283,6139,96144,38080,2875,36008,4275,74088,14906,5808,2267,3172,3057
CGTATGAACTGAGGTT,sample,98091,96095,5430,90665,10725,79940,41051,3608,23116,2753,64167,9412,4142,1732,9110,6986
AATATATCCTGAGGTT,sample,78684,77097,3884,73213,15893,57320,32822,2307,14091,1878,46913,6222,3974,1600,8195,10781
GAAGGCGCCTGAGGTT,sample,109577,107511,8448,99063,13235,85828,36763,2951,27206,2465,63969,16443,6521,1710,10922,8754
AAGAGCGCCTGAGGTT,sample,102410,100145,5808,94337,9027,85310,36642,2832,28403,3317,65045,14116,5312,1546,3829,6125
GTACCGTACTGAGGTT,sample,88687,86819,5221,81598,13639,67959,37872,2514,16684,1923,54556,8966,4654,1390,11487,8705
GGAGAGTTAGACCGTT,sample,154442,152698,12318,140380,25789,114591,51000,2822,32452,3399,83452,24918,7666,1811,24027,16890
GGTTGCGTAGACCGTT,sample,108473,106632,5210,101422,25963,75459,49472,3530,13529,1880,63001,7048,4165,1732,21612,18079
ACGTAAGTAGACCGTT,sample,125442,123499,7592,115907,27179,88728,54266,3115,18933,2012,73199,10402,3996,1354,24213,18029
TTCGTAATAGACCGTT,sample,129690,128148,7305,120843,29968,90875,57771,2996,18260,2179,76031,9669,3301,1376,27910,20192
ACGTTATGAGACCGTT,sample,126719,125309,9863,115446,14012,101434,37138,2249,35038,3794,72176,23215,9306,2329,13399,8987
TGAGCGCGAGACCGTT,sample,77649,76654,3188,73466,18288,55178,43403,3421,5744,699,49147,1911,1475,1344,19527,12657
GACGGAGAAGACCGTT,sample,114614,113290,6019,107271,20204,87067,45395,2647,22316,2558,67711,14151,6541,1864,18135,13660
GGAGGACGAGACCGTT,sample,69287,68606,5084,63522,11388,52134,21076,1754,15993,1621,37069,11690,5154,1699,7112,7674
GGACGTAGAGACCGTT,sample,129504,128046,12908,115138,17885,97253,28155,1671,36045,3666,64200,27716,10026,2059,11065,11563
AGTCCGCAAGACCGTT,sample,75233,74006,5178,68828,10433,58395,29415,1920,17817,1931,47232,7312,4156,1588,9464,6989
GTCCTGCCAGACCGTT,sample,39091,38279,3768,34511,5026,29485,6928,415,12221,1423,19149,8498,4852,1100,1210,3402
GTTAGGACAGACCGTT,sample,48712,47969,2804,45165,8583,36582,22048,1956,7342,802,29390,4434,3854,2060,6135,6149
ACGTATTAAGACCGTT,sample,89146,87401,4352,83049,19610,63439,49452,2705,8272,1398,57724,1612,1640,1153,19542,13664
TTGGCCTCAGACCGTT,sample,90880,89723,5218,84505,7785,76720,43733,3162,18065,2147,61798,9613,5726,2414,8234,5577
TGCTTCGCAGACCGTT,sample,100960,99115,7394,91721,12629,79092,36156,2581,23011,2248,59167,15096,6046,1565,11593,8621
AAGAGCGCAGACCGTT,sample,83713,81221,3841,77380,14505,62875,42669,3272,10788,1504,53457,4642,2772,1187,12901,10317
TTGGTTAAAGACCGTT,sample,76432,74622,6651,67971,7906,60065,18628,1592,22176,2468,40804,15201,6053,1250,5092,5021
GTACCGTAAGACCGTT,sample,76154,74239,3288,70951,14094,56857,42782,3013,8644,884,51426,1534,1618,1081,16731,10319
TTATTCGAAGACCGTT,sample,139295,137285,9417,127868,15365,112503,44426,3013,35276,4215,79702,25573,8748,2235,12403,10035
ATTCTCTTCTTGAGTT,sample,113776,112828,5436,107392,18194,89198,50233,3939,20147,2467,70380,12412,7211,3375,13193,12452
GGTTGCGTCTTGAGTT,sample,180503,177996,7645,170351,30743,139608,87210,8302,27915,3853,115125,12328,5109,2102,26912,21066
ACGTTATGCTTGAGTT,sample,156243,154639,5656,148983,34537,114446,83093,5539,17259,2215,100352,6340,3891,2216,29723,23964
CAACCGCGCTTGAGTT,sample,179578,175982,12813,163169,15986,147183,35605,3050,57799,6514,93404,44215,10903,2376,5613,8286
AATGGTAACTTGAGTT,sample,190909,186219,8364,177855,37740,140115,107483,11859,15644,717,123127,4412,1907,1311,31640,24604
TTAGAAGTCTTGAGTT,sample,166261,162075,8903,153172,24149,129023,83034,5138,27342,3319,110376,10190,3952,1474,28374,16605
TTCCGTCTCTTGAGTT,sample,232804,230313,14949,215364,29713,185651,76071,7454,56107,6195,132178,39824,10888,3315,16086,17989
GGACCTCTCTTGAGTT,sample,295655,290961,18419,272542,39652,232890,98257,7195,69435,7281,167692,50722,9891,2871,31932,27457
CATAACCTCTTGAGTT,sample,115920,114304,6304,108000,21330,86670,51456,3334,19281,1832,70737,10767,5629,1988,21494,14265
CATGATTCCTTGAGTT,sample,143158,140695,13505,127190,14745,112445,34966,1957,43151,4683,78117,27688,9459,1936,12365,8860
CGTACGTCCTTGAGTT,sample,104828,103201,6993,96208,14401,81807,34798,2594,28214,2997,63012,13204,5710,1903,8918,9718
AGTCCGCACTTGAGTT,sample,67838,64884,6697,58187,10030,48157,24426,1795,13255,1617,37681,7064,4790,1825,6634,6144
TTGGTACCCTTGAGTT,sample,137842,135598,9169,126429,23679,102750,53748,3393,26930,3093,80678,15586,5542,1754,19527,17077
CGGATTACCTTGAGTT,sample,133063,131020,6386,124634,21502,103132,70483,5581,17029,1678,87512,8361,4839,2714,16908,13871
AAGAGCGCCTTGAGTT,sample,115506,112302,6564,105738,19694,86044,63657,5863,12000,894,75657,3630,2198,1238,18042,13964
GTCTTAGCCTTGAGTT,sample,132749,129451,7973,121478,15361,106117,51375,3988,30595,3962,81970,16197,6187,1669,14121,10664
CCAATTCCCTTGAGTT,sample,124178,119913,6911,113002,15611,97391,60702,6512,18208,2209,78910,9760,5574,2331,10113,10800
TCGCCTGACTTGAGTT,sample,157511,155388,15206,140182,12629,127553,33402,2343,47296,4941,80698,39571,11018,2292,9656,7487
ATGACCGACTTGAGTT,sample,164250,161668,11173,150495,18514,131981,61028,3962,36578,3772,97606,26641,8623,1976,18412,12459
GACCGGAACTTGAGTT,sample,83981,81940,3567,78373,11140,67233,34469,2903,19593,2852,54062,7416,3537,1396,6079,7402
TATCAGTTTCGGAGTT,sample,51770,50935,1926,49009,10297,38712,28807,1926,5466,504,34273,2009,2658,1972,9052,6894
AAGTTCGTTCGGAGTT,sample,45233,44379,3052,41327,4041,37286,14856,1138,13494,1597,28350,6201,4001,1399,3818,2610
GGTTGCGTTCGGAGTT,sample,58128,57213,3666,53547,11236,42311,20944,1137,11380,1230,32324,7620,4460,1421,8294,7721
TCCTCCGTTCGGAGTT,sample,50672,49914,3620,46294,5352,40942,16650,1148,13321,1439,29971,8384,4740,1432,4952,3357
ACGTAAGTTCGGAGTT,sample,38861,37888,2345,35543,7799,27744,17798,943,5341,444,23139,3218,2512,989,7464,5423
TTCGTAATTCGGAGTT,sample,53180,52347,2160,50187,13900,36287,26537,1884,5069,668,31606,2129,2086,1519,9614,9133
ACGTTATGTCGGAGTT,sample,32894,32148,2436,29712,5631,24081,12226,935,6555,678,18781,3687,2901,1258,3429,3629
TTCTAATGTCGGAGTT,sample,48543,47616,3780,43836,7966,35870,12983,1019,11949,1218,24932,8701,4859,1075,4848,5237
TAGTACGGTCGGAGTT,sample,43123,42283,3369,38914,4390,34524,12098,704,13606,1358,25704,6758,4425,1275,2547,2796
TGAGCGCGTCGGAGTT,sample,27585,27137,1074,26063,6636,19427,13356,898,3931,434,17287,808,1686,1237,4810,4685
CAACCGCGTCGGAGTT,sample,45533,44664,4201,40463,6665,33798,14418,844,9818,1124,24236,7594,4258,1117,6891,4265
TTAGAAGTTCGGAGTT,sample,48094,47144,3746,43398,7720,35678,16165,929,10442,1060,26607,7082,4125,1196,7168,5076
GGACCTCTTCGGAGTT,sample,28747,28253,1878,26375,5784,20591,10897,570,5240,568,16137,3316,2853,1145,3995,3881
GCCTTGCTTCGGAGTT,sample,42411,41352,3002,38350,6656,31694,13982,522,9226,950,23208,7014,4048,1085,6430,4548
CAAGGCCTTCGGAGTT,sample,39852,38701,2159,36542,6908,29634,17794,1375,6399,811,24193,3255,3019,1628,3756,4655
CATAACCTTCGGAGTT,sample,42334,41492,3568,37924,5740,32184,13178,698,9809,971,22987,7528,4387,1036,6130,3926
GACGGAGATCGGAGTT,sample,36806,35925,2068,33857,5513,28344,16155,1286,6702,840,22857,3361,2957,1406,5439,3834
CCGCAACGTCGGAGTT,sample,37832,36645,1690,34955,8788,26167,20841,1436,2958,249,23799,683,1075,926,9410,5984
ACCTCGAGTCGGAGTT,sample,33850,32904,1531,31373,5371,26002,18324,1144,4437,451,22761,1646,2004,1224,6318,3871
CGTACGTCTCGGAGTT,sample,24342,23541,1702,21839,1884,19955,7671,420,7632,901,15303,3331,2953,1131,1024,1243
CTAGGACCTCGGAGTT,sample,35920,35349,2765,32584,2775,29809,10844,899,11372,1337,22216,5357,3612,1349,2621,1889
CGGATTACTCGGAGTT,sample,34522,33489,2146,31343,3580,27763,12089,916,7703,901,19792,6154,3790,1001,3278,2345
ACGTATTATCGGAGTT,sample,33663,32800,2758,30042,4029,26013,12383,834,7355,897,19738,4544,3300,1058,4645,2900
TTGGCCTCTCGGAGTT,Pos_Ctrl,26600,26193,1294,24899,1215,23684,19533,1856,1564,191,21097,540,4201,4379,1699,490
ACCAATGCTCGGAGTT,sample,41741,40373,4127,36246,3910,32336,8275,556,13054,1374,21329,9077,4972,990,1796,2418
GAAGGCGCTCGGAGTT,sample,41270,39848,3924,35924,5340,30584,18110,1344,6451,839,24561,3840,3354,1572,4500,3758
CTTCATGATCGGAGTT,sample,44350,43291,2724,40567,6083,34484,20883,1595,7212,742,28095,4052,2707,1048,7767,4703
AGGTCGGATCGGAGTT,sample,26014,25155,1912,23243,4360,18883,13406,590,3603,375,17009,909,1453,807,5035,3304
ATGACCGATCGGAGTT,sample,55288,54237,5436,48801,6319,42482,14913,827,13828,1498,28741,11416,4942,1113,5683,4277
ATTCTCTTTGAACCTT,Pos_Ctrl,70945,70286,3163,67123,3736,63387,53195,5070,3534,545,56729,1043,5962,7529,5348,1667
AGTACCATTGAACCTT,sample,116280,114856,10271,104585,12405,92180,32372,2071,32756,3453,65128,21528,8204,2132,9972,7715
TTCGTAATTGAACCTT,sample,117546,116043,5487,110556,20597,89959,57385,3430,18381,1706,75766,9057,4893,1900,18085,14438
TAGTACGGTGAACCTT,Pos_Ctrl,54035,53483,2634,50849,2725,48124,40182,3784,2799,368,42981,991,5599,6653,4027,1405
CAACCGCGTGAACCTT,sample,44685,44069,2041,42028,9801,32227,21679,1719,5475,628,27154,2726,3013,1818,6927,6957
TTAGAAGTTGAACCTT,sample,128224,126823,8138,118685,21315,97370,51694,4123,25688,2782,77382,13083,4988,1821,18264,15803
GGACCTCTTGAACCTT,sample,91419,90086,4932,85154,17851,67303,38748,2479,15747,1836,54495,8493,4190,1531,15261,11730
GCCTTGCTTGAACCTT,sample,92549,91123,6846,84277,11024,73253,24565,1606,25771,2569,50336,18742,7189,1546,9394,7464
CATAACCTTGAACCTT,sample,135462,134028,10238,123790,20599,103191,42962,3134,30376,3462,73338,23257,8680,2565,13654,14106
GTTAGCCGTGAACCTT,sample,126513,124937,9088,115849,21372,94477,45753,3122,25622,2917,71375,17063,6594,1834,19456,14766
CCGCAACGTGAACCTT,Pos_Ctrl,42781,42202,2020,40182,2180,38002,31659,3133,2236,305,33895,669,5103,5892,3281,953
GGACGTAGTGAACCTT,sample,80579,79458,4608,74850,8260,66590,28181,2094,21386,2460,49567,12469,4995,1626,5244,5027
ACCTCGAGTGAACCTT,sample,97131,95668,4730,90938,17893,73045,50965,2918,11532,1267,62497,6363,3964,1793,15581,12045
CCATGAAGTGAACCTT,sample,52515,50530,2435,48095,7261,40834,25085,1776,9689,1029,34774,3255,2765,1580,8610,5124
CATGATTCTGAACCTT,sample,70512,69607,4498,65109,13508,51601,28975,1814,12018,1157,40993,7637,4407,1691,10772,9510
AATCCGTCTGAACCTT,Pos_Ctrl,42678,42130,2280,39850,2352,37498,31021,2986,2414,304,33435,773,5159,5745,3350,1278
CGGATTACTGAACCTT,sample,69541,68453,3819,64634,12105,52529,32477,2124,11344,1088,43821,5496,3780,1670,12577,8562
GTTAGGACTGAACCTT,sample,86137,84691,5411,79280,10924,68356,31227,2519,20605,2514,51832,11491,5251,1550,10030,7259
GCCTGAACTGAACCTT,sample,97450,95707,5746,89961,16193,73768,48013,3922,13334,1709,61347,6790,3147,1209,22106,11529
ACGTATTATGAACCTT,sample,104802,103262,7098,96164,11574,84590,38950,2953,25692,3346,64642,13649,5235,1840,8481,7570
CGTATGAATGAACCTT,sample,130093,127875,10408,117467,18484,98983,50739,4334,24941,3043,75680,15926,7181,2097,13604,12551
ACCAATGCTGAACCTT,sample,88020,86389,5349,81040,10933,70107,38351,2719,17845,2244,56196,8948,4773,1555,11517,7873
CCAATTCCTGAACCTT,sample,95118,93109,9012,84097,7234,76863,21337,1608,28250,2709,49587,22959,7876,1601,5995,4081
GTACCGTATGAACCTT,Pos_Ctrl,57411,56367,3008,53359,2583,50776,41772,3970,3387,410,45159,1237,5500,6537,3331,995
TCGCCTGATGAACCTT,sample,76554,75010,4021,70989,12370,58619,33076,2553,14736,1366,47812,6888,3777,1319,9256,8734
GGAGAGTTACCGAATT,sample,107246,105747,6134,99613,21792,77821,46730,3388,15717,1669,62447,10317,5279,1971,18260,14428
ATTCTCTTACCGAATT,sample,175862,173424,13918,159506,27159,132347,65656,4303,33772,3718,99428,24898,7120,2052,27676,18740
CAACCGCGACCGAATT,sample,121212,119420,9840,109580,13475,96105,29250,1845,35223,4035,64473,25752,8837,1745,10704,8418
AATGGTAAACCGAATT,sample,54221,53228,3895,49333,9401,39932,18788,1739,11964,1316,30752,6125,4511,1647,5341,6257
TCGCATCTACCGAATT,sample,104168,102531,4900,97631,18255,79376,50362,2647,16380,2404,66742,7583,4177,1699,18817,12208
GGACGTAGACCGAATT,sample,92362,90904,5308,85596,17253,68343,43666,2619,13731,1357,57397,6970,3819,1634,16095,11932
CTTGATAGACCGAATT,sample,38010,37257,4847,32410,4774,27636,8929,718,10027,1125,18956,6837,4605,1635,814,2550
GACGATAAACCGAATT,sample,97342,95811,5583,90228,17416,72812,40081,2387,17502,1971,57583,10871,5551,1544,17391,11664
CCATGAAGACCGAATT,sample,82520,79964,4753,75211,12913,62298,30263,1804,17403,1712,47666,11116,4691,1374,12784,8684
ACGACTTCACCGAATT,sample,79619,78026,6298,71728,8207,63521,25621,1537,20752,2328,46373,13283,6425,2191,6539,5653
GTCCTGCCACCGAATT,sample,95352,93851,5146,88705,14132,74573,43877,3014,18547,1920,62424,7215,4245,1858,14577,10671
TTGGTACCACCGAATT,sample,111744,109987,8659,101328,15376,85952,28799,1907,29170,3200,57969,22876,7331,1657,9567,10649
CGGATTACACCGAATT,sample,68917,67495,4569,62926,10167,52759,26924,2029,16110,1713,43034,5983,3953,1622,9643,7133
GTTAGGACACCGAATT,sample,107355,105750,7139,98611,15418,83193,40089,2434,23459,2576,63548,14635,6424,1770,15877,11538
AACTCGTAACCGAATT,sample,159501,157910,11276,146634,11128,135506,49919,3774,52322,6572,102241,22919,7734,2354,7959,6639
AATATATCACCGAATT,Neg_Ctrl,6136,3313,2204,1109,452,657,231,10,301,18,532,97,191,85,67,31
GTCTTAGCACCGAATT,sample,114897,113068,5880,107188,17425,89763,59000,4814,17319,2153,76319,6477,3592,1660,14694,12333
TTGGTTAAACCGAATT,sample,177463,175431,9931,165500,21716,143784,74420,5761,40632,5259,115052,17712,6464,1911,26261,14809
TCAATATAACCGAATT,sample,150365,148287,10281,138006,16723,121283,42956,2743,42471,5329,85427,27784,7969,1894,12453,10490
TCGCCTGAACCGAATT,sample,155811,153790,8445,145345,20489,124856,68810,4296,31757,3932,100567,16061,6245,1782,25487,14358
ATTCTCTTGGTCTGGT,sample,95280,94548,4505,90043,17922,72121,42279,2835,15052,2098,57331,9857,5304,2087,14415,12202
TCCAACTTGGTCTGGT,Neg_Ctrl,4991,3043,2437,606,65,541,185,22,224,2,409,108,152,72,63,59
AAGTTCGTGGTCTGGT,sample,134035,132755,9085,123670,19797,103873,40677,2706,31898,3500,72575,25092,8779,2010,17772,13316
ACGTTATGGGTCTGGT,sample,88439,87443,3164,84279,23070,61209,49422,3097,6442,828,55864,1420,1643,1389,20995,15742
TGAGCGCGGGTCTGGT,Neg_Ctrl,2912,1461,1054,407,59,348,179,16,94,8,273,51,149,70,58,25
AATGGTAAGGTCTGGT,sample,133948,132533,4437,128096,34865,93231,70308,4685,12574,1670,82882,3994,2336,1443,29574,24100
TTAGAAGTGGTCTGGT,sample,95747,94673,3077,91596,22859,68737,48367,3530,11744,1380,60111,3716,3405,2084,13955,15830
TCGCATCTGGTCTGGT,sample,140309,138730,6632,132098,23354,108744,62019,4256,24951,2711,86970,14807,6658,2140,20444,16322
CCAGAGCGGGTCTGGT,sample,149238,147569,11768,135801,16389,119412,31814,2162,44655,4624,76469,36157,10632,2169,11684,9851
GGACGTAGGGTCTGGT,Neg_Ctrl,3741,2357,1417,940,107,833,290,19,404,22,694,98,238,114,109,43
TGGACGAGGGTCTGGT,sample,88387,87447,3523,83924,18608,65316,46248,3354,10161,1393,56409,4160,2686,1320,18553,13148
CGAGGCAGGGTCTGGT,sample,78013,76976,5937,71039,8625,62414,22385,1493,21591,2263,43976,14682,7214,1742,8352,5579
ACGACTTCGGTCTGGT,sample,110972,109640,4660,104980,13558,91422,48701,3832,26552,3153,75253,9184,3937,1713,15658,10184
CGTACGTCGGTCTGGT,Neg_Ctrl,4613,2497,1886,611,85,526,189,13,104,11,293,209,177,82,65,42
GTTAGGACGGTCTGGT,sample,95774,94337,4955,89382,7918,81464,32324,2813,29111,3502,61435,13714,5137,1526,3726,4838
ACGTATTAGGTCTGGT,sample,101433,99989,5128,94861,16713,78148,48425,2855,17932,1446,66357,7490,4149,1569,19391,12230
AATATATCGGTCTGGT,sample,78783,77588,5029,72559,10445,62114,26398,1765,20194,2538,46592,11219,5487,1441,9882,7031
TGCTTCGCGGTCTGGT,sample,129875,128316,10177,118139,15016,103123,34022,2759,35465,3246,69487,27631,9175,1822,11414,10415
GAAGGCGCGGTCTGGT,sample,99708,98464,4441,94023,14221,79802,45611,3501,20560,2176,66171,7954,4125,1712,11795,10789
AAGAGCGCGGTCTGGT,sample,100865,99392,4719,94673,9845,84828,46291,2852,23712,2812,70003,9161,4100,1810,7521,6879
TTGGTTAAGGTCTGGT,sample,116457,114482,4996,109486,16380,93106,53764,4623,21708,2404,75472,10607,5423,1878,10962,11461
GTACCGTAGGTCTGGT,sample,84910,83332,3812,79520,13195,66325,44162,3969,11515,1179,55677,5500,3610,1604,10163,9146
GGCATATAGGTCTGGT,Neg_Ctrl,4398,2025,1256,769,104,665,321,12,246,8,567,78,263,126,101,39
AGGTCGGAGGTCTGGT,sample,141000,138878,9929,128949,13639,115310,56570,3156,31816,4459,88386,19309,6548,1755,18142,8890
ATGACCGAGGTCTGGT,sample,143613,141510,9272,132238,16123,116115,48307,4069,34906,3523,83213,25310,8083,1868,16541,11483
GACCGGAAGGTCTGGT,sample,129627,128090,5642,122448,15709,106739,58676,5298,25745,2751,84421,14269,5866,2010,12868,9873
TCCTCCGTCGACGTTA,sample,182637,180418,7186,173232,42234,130998,96566,5972,18769,2270,115335,7421,3772,1595,49224,28623
ACGTAAGTCGACGTTA,sample,118061,116051,6803,109248,22277,86971,43861,3415,25405,3132,69266,11158,4991,1639,14201,15263
AGTACCATCGACGTTA,sample,148429,146746,8618,138128,19333,118795,59822,4187,37087,4844,96909,12855,4833,2100,15904,14100
TAGTACGGCGACGTTA,sample,199269,197013,9763,187250,35654,151596,95044,6175,30737,3363,125781,16277,6587,2296,28358,24315
TTCCGTCTCGACGTTA,sample,212689,210106,16982,193124,29839,163285,65692,4352,50178,5034,115870,38029,9869,2315,26966,20590
GGACCTCTCGACGTTA,sample,232959,230181,15606,214575,40709,173866,100470,7780,36390,4206,136860,25020,6982,2005,46350,28757
GCCTTGCTCGACGTTA,sample,167380,165140,8308,156832,29922,126910,79581,5811,25714,2473,105295,13331,6171,2396,24403,20051
ACCTCGAGCGACGTTA,sample,90650,89572,8469,81103,7457,73646,22891,1823,27906,3179,50797,17847,7347,1864,5506,4183
GACGATAACGACGTTA,sample,119385,117718,4740,112978,19845,93133,56597,5118,21605,2959,78202,6854,3800,1886,15788,14016
GGCCAGAGCGACGTTA,sample,142351,140704,6215,134489,29761,104728,75195,4392,16300,2358,91495,6483,4421,2075,24559,20495
CCATGAAGCGACGTTA,sample,178505,176531,7580,168951,35765,133186,93129,5417,21314,3052,114443,10274,5199,2208,28926,25438
CATGATTCCGACGTTA,sample,212216,209468,11344,198124,35725,162399,82794,5541,43916,4537,126710,25611,7680,2278,26688,25642
AGTCCGCACGACGTTA,sample,201456,198899,15989,182910,25415,157495,56010,4289,51350,5095,107360,40751,11007,2408,21087,17261
GTCCTGCCCGACGTTA,sample,172551,170385,9868,160517,27985,132532,77314,4731,30019,3940,107333,16528,6862,2053,33272,19389
CTAGGACCCGACGTTA,sample,247607,244209,17301,226908,28763,198145,72078,4071,63976,6781,136054,51239,12335,2839,26074,18764
GTTAGGACCGACGTTA,sample,99724,98621,8200,90421,13556,76865,30461,1742,23528,2418,53989,18716,8129,2080,11172,8539
ACGTATTACGACGTTA,sample,154808,152284,7789,144495,20465,124030,65112,4613,36399,3832,101511,14074,5504,1863,15614,14722
TTGGCCTCCGACGTTA,sample,186675,184589,10982,173607,24138,149469,63865,4135,45511,5132,109376,30826,8850,2265,22703,17398
TGCTTCGCCGACGTTA,sample,128939,126277,5192,121085,25881,95204,75461,5133,10874,1453,86335,2283,1418,1094,26163,18412
AAGAGCGCCGACGTTA,sample,146916,143877,5528,138349,29610,108739,83610,6286,13746,1294,97356,3803,1698,1279,28564,20442
GTCTTAGCCGACGTTA,sample,195515,192811,12689,180122,25391,154731,63052,3702,47563,4533,110615,35881,9585,2400,22007,15550
CCAATTCCCGACGTTA,sample,136919,134128,5957,128171,15871,112300,66303,4181,26668,3298,92971,11850,4896,1705,14419,10174
TCGCCTGACGACGTTA,sample,208406,205504,10884,194620,32498,162122,88997,10779,36584,4313,125581,21449,7437,2109,24472,22178
GGTTGCGTTACTAAGT,sample,89062,87435,4002,83433,24508,58925,42198,2461,9639,936,51837,3691,2407,1276,19653,16057
TCCTCCGTTACTAAGT,sample,78791,77695,6722,70973,11318,59655,25706,1497,17892,1924,43598,12636,5891,1720,9096,7409
CCTCTAGATACTAAGT,sample,42834,41976,2911,39065,7167,31898,17976,1038,7323,854,25299,4707,3334,1136,9033,4730
ATGCCTGGTACTAAGT,sample,81543,80418,6442,73976,12644,61332,23421,1509,19029,1888,42450,15485,7184,1786,9169,8623
TTAGAAGTTACTAAGT,sample,48757,47967,3844,44123,3569,40554,12498,1033,14601,1444,27099,10978,5339,994,3920,2125
TCGCATCTTACTAAGT,sample,29022,28628,1513,27115,7731,19384,12219,752,3754,450,15973,2209,2199,1118,5143,5078
GACGGAGATACTAAGT,sample,23251,22803,1444,21359,4604,16755,10631,734,3307,357,13938,1726,2325,1309,4067,3248
TGGACGAGTACTAAGT,sample,16340,15992,1690,14302,1656,12646,4516,267,4493,506,9009,2864,2625,738,1383,1045
CATTGCAGTACTAAGT,sample,37170,36536,1688,34848,8141,26707,19831,1573,3746,551,23577,1006,1733,1367,7353,5982
CGTACGTCTACTAAGT,sample,35315,34415,2203,32212,4109,28103,13144,1051,8722,1062,21866,4124,3123,1229,3949,2925
CTAGGACCTACTAAGT,sample,23718,23161,2655,20506,2587,17919,3933,239,7094,722,11027,5931,3760,725,1469,1544
GTTAGGACTACTAAGT,sample,31293,30578,1420,29158,7106,22052,17133,962,2923,307,20056,727,1262,1059,8136,4899
AACTCGTATACTAAGT,sample,43186,42451,3287,39164,6170,32994,16364,1179,8195,889,24559,6367,3952,1248,5223,4243
AATATATCTACTAAGT,sample,38275,37654,3270,34384,4278,30106,13053,900,8945,944,21998,6264,3792,1009,5031,2757
ACCAATGCTACTAAGT,sample,41899,41027,2616,38411,6128,32283,18529,1051,7714,719,26243,4270,2856,904,6370,4290
TGCTTCGCTACTAAGT,sample,36110,35236,1587,33649,5913,27736,20740,1556,3962,511,24702,967,1141,879,6598,4060
TCGCCTGATACTAAGT,sample,43888,42884,3540,39344,6488,32856,21163,1573,5976,592,27139,3552,2180,941,8300,4524
AGGTCGGATACTAAGT,sample,57464,56427,4523,51904,6859,45045,21680,1666,13017,1449,34697,7233,3900,1171,6664,4986
ATTCTCTTTTGCCGCT,sample,164991,163520,9808,153712,28578,125134,66364,3911,31674,3325,98038,19860,7215,2361,21482,19721
TCCAACTTTTGCCGCT,sample,122197,120586,4913,115673,34367,81306,61072,3813,10760,1451,71832,4210,2766,1739,24031,22001
ATGCCTGGTTGCCGCT,sample,124709,123290,6359,116931,20769,96162,53568,3169,25042,3133,78610,11250,4927,2017,18077,14443
TTAGAAGTTTGCCGCT,sample,82714,81623,4166,77457,16321,61136,37474,2751,13094,1518,50568,6299,3743,1723,13434,11365
GCCTTGCTTTGCCGCT,sample,46874,46103,2125,43978,9628,34350,22519,1509,6535,907,29054,2880,2931,1651,8698,6639
CAAGGCCTTTGCCGCT,sample,59274,58420,2683,55737,15280,40457,26919,1480,7785,842,34704,3431,2751,1334,13952,10247
GGAGGACGTTGCCGCT,sample,36135,35587,3792,31795,6508,25287,11718,888,7390,752,19108,4539,3459,1329,4709,4356
TGGACGAGTTGCCGCT,sample,26469,26142,1336,24806,5396,19410,13051,889,3671,452,16722,1347,2096,1279,4797,3839
ACGACTTCTTGCCGCT,sample,96117,94614,4361,90253,20652,69601,50903,3505,10375,1362,61278,3456,2330,1532,21423,15214
CTAGGACCTTGCCGCT,sample,91859,90723,4716,86007,15523,70484,33735,2693,22679,2792,56414,8585,4366,1700,11029,10833
GTTAGGACTTGCCGCT,sample,133425,131900,11853,120047,16254,103793,38488,1810,36804,4484,75292,22207,8143,2135,15414,10690
AATATATCTTGCCGCT,sample,171795,169791,9866,159925,21204,138721,59996,4853,41341,4795,101337,27736,9128,2305,18229,14482
ACCAATGCTTGCCGCT,sample,130094,127923,6401,121522,23588,97934,65880,5160,17475,1916,83355,7503,3222,1493,21287,16903
TGCTTCGCTTGCCGCT,sample,84716,83686,5005,78681,10340,68341,34664,2281,18674,2042,53338,10680,5452,1657,11433,6881
CCAATTCCTTGCCGCT,sample,233572,230681,18832,211849,24639,187210,59193,3208,65066,7457,124259,52286,14078,3164,16479,15276
GTACCGTATTGCCGCT,sample,168634,166799,8039,158760,22668,136092,84472,5804,27409,3102,111881,15305,6601,1986,28370,16494
CTTCATGATTGCCGCT,sample,205445,203615,11430,192185,27182,165003,82734,6099,42650,4440,125384,29080,8802,2769,20386,17275
ATTCTCTTTTCGACCT,sample,107563,106535,7873,98662,17000,81662,29144,1979,27373,3106,56517,20060,7535,1795,11064,11220
TCCAACTTTTCGACCT,sample,63198,62612,2510,60102,14201,45901,26704,2112,11277,1498,37981,4310,3480,1911,8069,9391
AAGTTCGTTTCGACCT,sample,64021,63280,2202,61078,16718,44360,33885,2096,5874,490,39759,2015,1909,1392,15561,10606
GGTTGCGTTTCGACCT,sample,102936,101457,6403,95054,14019,81035,35215,2557,27555,3002,62770,12706,6262,2221,9274,9732
TTCTAATGTTCGACCT,sample,130178,128949,8106,120843,30492,90351,47751,2541,21916,2452,69667,15691,5722,1889,21179,20039
ATGCCTGGTTCGACCT,sample,90081,89284,3013,86271,16526,69745,54968,3860,7189,1066,62157,2662,3396,2805,11719,12198
CAACCGCGTTCGACCT,sample,61827,60933,2238,58695,17797,40898,32377,1730,5293,581,37670,917,1307,1097,17501,11696
TTAGAAGTTTCGACCT,sample,57064,56267,2676,53591,9818,43773,27863,2460,8014,1060,35877,4376,3354,1604,5392,6671
GCCTTGCTTTCGACCT,sample,51844,51063,2711,48352,8776,39576,20519,1594,11376,1162,31895,4925,3656,1332,8123,6051
CAAGGCCTTTCGACCT,sample,87361,86530,4663,81867,14830,67037,44339,3349,11615,1539,55954,6195,4600,2640,13066,10591
ACTATACTTTCGACCT,sample,163961,162121,17900,144221,21562,122659,41093,2378,43059,4025,84152,32104,10796,2229,16383,14167
GGAGGACGTTCGACCT,sample,65345,64514,4082,60432,10879,49553,28242,2163,11049,1341,39291,6758,4534,1787,8992,7318
TGGACGAGTTCGACCT,sample,43366,42672,3210,39462,7373,32089,14234,1119,9602,970,23836,6164,4068,1270,4745,4704
GACGATAATTCGACCT,sample,99774,98341,8689,89652,10506,79146,21725,1648,31584,3249,53309,20940,7099,1747,4014,6846
CATTGCAGTTCGACCT,sample,69473,68345,6460,61885,8674,53211,17054,1284,18135,2021,35189,14717,6311,1412,5592,5581
CATGATTCTTCGACCT,sample,55503,53856,2945,50911,5848,45063,21101,1171,15778,1754,36879,5259,3437,1509,4156,3879
AGTCCGCATTCGACCT,sample,58983,57726,7672,50054,8384,41670,18159,1146,12380,1260,30539,8725,4939,1361,7614,5342
GTCCTGCCTTCGACCT,sample,82637,80542,5985,74557,9470,65087,29359,1768,18914,2303,48273,12743,6487,2169,7238,6254
CTAGGACCTTCGACCT,sample,68872,67654,5976,61678,6910,54768,22740,1815,18809,2107,41549,9297,4807,1802,4748,4178
CGGATTACTTCGACCT,sample,51403,50507,4063,46444,7849,38595,17658,1189,10765,1158,28423,7825,4365,1371,6784,4971
ACGTATTATTCGACCT,sample,132251,130499,8740,121759,10997,110762,38933,2468,40992,4479,79925,23890,7945,2106,7977,7465
AACTCGTATTCGACCT,sample,120432,118891,11279,107612,9481,98131,20827,1197,40865,4145,61692,31097,9236,1802,4462,5387
TTGGCCTCTTCGACCT,sample,124851,123253,11508,111745,9917,101828,32694,1810,37382,3460,70076,26482,9089,2122,7053,6496
ACCAATGCTTCGACCT,sample,119810,117686,8297,109389,18265,91124,51064,3603,21731,1910,72795,12816,4824,1480,18254,12502
AAGAGCGCTTCGACCT,sample,112964,111121,7237,103884,11278,92606,44075,3600,27450,3188,71525,14293,5825,1855,8935,7427
CCAATTCCTTCGACCT,sample,97931,95831,6131,89700,15620,74080,43051,3340,15391,1879,58442,10419,3430,1403,15199,11371
TTGGTTAATTCGACCT,sample,113848,112174,6426,105748,12949,92799,50872,3302,24552,2411,75424,11662,4942,1659,14051,8899
GTACCGTATTCGACCT,sample,121414,119664,10552,109112,12176,96936,36003,2946,31780,3222,67783,22985,9222,2406,8004,8152
AGGTCGGATTCGACCT,sample,142389,140390,11405,128985,16608,112377,51250,2916,31843,3512,83093,22856,8637,2039,20804,10406
TTATTCGATTCGACCT,sample,99811,98117,7689,90428,9056,81372,28276,1640,28552,2744,56828,20160,7226,1465,8969,5647
ATTCTCTTTCCAGACT,sample,31231,30826,1534,29292,7288,22004,11415,1167,5402,639,16817,3381,3008,1221,3655,4601
AAGTTCGTTCCAGACT,sample,42757,41373,3637,37736,6687,31049,18125,1221,7108,904,25233,3691,2757,1255,7661,4275
ATGCCTGGTCCAGACT,sample,21482,21121,2048,19073,3082,15991,6265,351,5077,489,11342,3809,2945,826,2947,2014
TGAGCGCGTCCAGACT,sample,47803,46713,1531,45182,7351,37831,29362,2796,4095,393,33457,1185,1680,1444,5379,5126
CAACCGCGTCCAGACT,sample,77317,75808,4346,71462,10428,61034,32328,2906,14609,1295,46937,9896,4792,1473,8768,7208
TTAGAAGTTCCAGACT,sample,84803,83060,7133,75927,8056,67871,26296,1872,21283,2261,47579,16159,6123,1399,6981,4560
TCGCATCTTCCAGACT,sample,157042,154686,13258,141428,13635,127793,35563,1952,45707,5018,81270,39553,10575,2086,10292,7859
ACCTCGAGTCCAGACT,sample,36925,36171,3012,33159,3710,29449,9703,778,10830,1110,20533,7028,4032,1158,2213,2311
GGCCAGAGTCCAGACT,sample,34091,33401,2192,31209,5406,25803,14897,643,5927,597,20824,3739,2767,1038,6878,3852
CATTGCAGTCCAGACT,sample,24793,24284,1339,22945,2635,20310,9771,617,6559,760,16330,2603,2595,1157,2688,1801
AGTCCGCATCCAGACT,sample,25633,25039,2056,22983,4195,18788,11802,737,3966,422,15768,1861,1987,934,4974,3015
TTGGTACCTCCAGACT,sample,42586,41961,3705,38256,6015,32241,14386,865,9787,939,24173,6264,3925,1123,6282,4188
GTTAGGACTCCAGACT,Pos_Ctrl,20568,20301,1032,19269,953,18316,15234,1359,1198,161,16432,364,3722,3700,1654,421
ACGTATTATCCAGACT,sample,30834,30047,1443,28604,5620,22984,13469,1553,5172,568,18641,2222,2194,1076,4142,3606
TTGGCCTCTCCAGACT,Pos_Ctrl,26934,26589,1363,25226,1203,24023,19893,1942,1504,221,21397,463,4114,4393,1676,521
GAAGGCGCTCCAGACT,sample,27511,26874,2159,24715,2027,22688,9114,592,7859,975,16973,4148,2914,959,1298,1313
TCGCCTGATCCAGACT,sample,36358,35395,3360,32035,3257,28778,10170,561,9769,974,19939,7304,4038,870,2931,2028
ATTCTCTTACCATTAT,sample,187302,183319,9460,173859,45126,128733,93087,7087,19973,1984,113060,6602,3335,1872,42842,29145
TCCAACTTACCATTAT,sample,188083,184802,7648,177154,46649,130505,96551,5390,17946,2653,114497,7965,2927,1561,41383,31099
AAGTTCGTACCATTAT,sample,215581,211497,15669,195828,48396,147432,91034,5056,30667,3311,121701,17364,5882,2077,39288,31388
ACGTAAGTACCATTAT,sample,170120,167782,9336,158446,20624,137822,62963,4796,44902,5374,107865,19787,6448,2149,16172,13947
ACGTTATGACCATTAT,sample,161685,160042,14993,145049,20985,124064,53078,4274,37891,4445,90969,24376,8369,2639,17472,13125
TTCTAATGACCATTAT,sample,89826,88593,6206,82387,13466,68921,32329,1652,21011,2520,53340,11409,5948,1672,12864,9104
AATGGTAAACCATTAT,sample,148006,146233,6993,139240,35210,104030,71627,4550,17197,2116,88824,8540,3969,1814,33886,24280
GGACCTCTACCATTAT,sample,158325,156137,9725,146412,34981,111431,68313,3293,24952,2998,93265,11875,4431,1662,31016,24135
GCCTTGCTACCATTAT,sample,78051,77155,9652,67503,9482,58021,17774,1130,21327,2129,39101,15661,7510,2020,5102,5976
CAAGGCCTACCATTAT,sample,116840,115059,9256,105803,20482,85321,40579,2627,23363,2533,63942,16219,6482,1570,16730,13472
CATAACCTACCATTAT,sample,105947,104618,5002,99616,24295,75321,52190,3386,14052,1474,66242,4219,3551,1860,22210,16984
ACTATACTACCATTAT,sample,227715,225044,16254,208790,41949,166841,87786,5425,41355,4286,129141,27989,7973,2120,35856,28563
CCAGAGCGACCATTAT,sample,95386,93956,5094,88862,19091,69771,43044,2222,15054,1654,58098,7797,4286,1543,17465,13340
GGAGGACGACCATTAT,sample,149979,147678,5890,141788,34873,106915,84145,5851,12832,1752,96977,2335,1689,1326,34792,24130
GGCCAGAGACCATTAT,sample,101449,99924,5320,94604,22238,72366,50239,3293,11353,1216,61592,6265,3066,1565,22432,15211
CATTGCAGACCATTAT,sample,102748,101298,4609,96689,22064,74625,51835,3371,13421,1154,65256,4844,3434,1882,19244,15245
CATGATTCACCATTAT,sample,146610,144838,12103,132735,16727,116008,46155,2389,40966,4208,87121,22290,8452,2145,18308,11670
AATCCGTCACCATTAT,sample,107806,106303,6838,99465,15611,83854,44152,2706,24013,3482,68165,9501,4878,1852,16239,10733
GTCCTGCCACCATTAT,sample,115715,114245,6579,107666,18943,88723,54911,4024,18491,1659,73402,9638,5117,2284,16455,13814
ACGTATTAACCATTAT,sample,150571,148457,6677,141780,29327,112453,88904,5763,13124,1451,102028,3211,3277,2190,27840,21332
AACTCGTAACCATTAT,sample,74660,73439,5528,67911,8203,59708,24986,2237,19456,2255,44442,10774,5150,1607,7593,5218
CGTATGAAACCATTAT,sample,96002,93990,6599,87391,11688,75703,34284,2742,23200,2865,57484,12612,5248,1442,13126,7759
GTCTTAGCACCATTAT,sample,99897,97774,6421,91353,14867,76486,38611,2999,20355,2405,58966,12116,5521,1399,14371,10654
GGCATATAACCATTAT,sample,149103,146814,7417,139397,17437,121960,70932,5477,30215,3098,101147,12238,4759,2019,18421,11403
GACCGGAAACCATTAT,sample,186583,184290,14077,170213,20318,149895,58013,4147,49471,5289,107484,32975,10220,2418,18523,14299
TATCAGTTCAATGGAT,sample,51613,50666,1663,49003,15640,33363,25361,1964,4124,651,29485,1263,2079,1857,8090,9645
ATGCCTGGCAATGGAT,sample,102298,99881,4431,95450,23494,71956,54678,3861,9784,1214,64462,2419,1916,1424,23077,15513
TGAGCGCGCAATGGAT,sample,93284,91279,3570,87709,21299,66410,52319,3907,7705,814,60024,1665,1513,1297,23263,14663
AATGGTAACAATGGAT,sample,130155,127735,6002,121733,26864,94869,65808,4562,15833,1926,81641,6740,3191,1409,28094,18176
TTCCGTCTCAATGGAT,sample,135779,133940,7348,126592,19667,106925,55635,4362,29877,3565,85512,13486,4929,2174,14119,13440
ACTATACTCAATGGAT,sample,154203,152326,8568,143758,31715,112043,73743,5384,20394,2643,94137,9879,4214,1634,36809,21926
CCAGAGCGCAATGGAT,sample,107279,105793,6915,98878,15891,82987,40966,2624,23979,2504,64945,12914,5672,1775,15089,11593
GGAGGACGCAATGGAT,sample,67923,67056,4736,62320,9293,53027,25884,1704,16103,1862,41987,7474,4270,1468,10909,6458
CTTGATAGCAATGGAT,sample,214561,211961,10964,200997,36706,164291,92826,5556,39193,3253,132019,23463,7717,2097,37631,26237
GACGATAACAATGGAT,sample,91474,90002,4892,85110,10317,74793,35439,2563,24781,2848,60220,9162,4532,1672,5974,6910
CATTGCAGCAATGGAT,sample,79991,78774,5296,73478,13771,59707,34863,1897,13258,1088,48121,8601,4046,1315,17252,9427
CGGATTACCAATGGAT,sample,92222,90806,5674,85132,17421,67711,39840,2943,15519,1706,55359,7703,4873,1833,14850,11544
GCCTGAACCAATGGAT,Neg_Ctrl,6270,2552,1986,566,109,457,190,15,170,12,360,70,179,75,60,14
ACGTATTACAATGGAT,sample,138054,136159,6817,129342,15931,113411,57713,4770,31994,3661,89707,15273,5832,1857,13732,10944
AATATATCCAATGGAT,Neg_Ctrl,6226,3674,2826,848,100,748,299,8,248,18,547,175,227,117,107,141
AAGAGCGCCAATGGAT,sample,117195,115027,9881,105146,13337,91809,32380,2881,30938,3376,63318,22234,7527,1577,8667,8097
GGCATATACAATGGAT,sample,118224,116134,5686,110448,11913,98535,57521,3374,23584,2799,81105,11257,4774,1767,12748,8611
AGGTCGGACAATGGAT,Pos_Ctrl,63650,62482,3511,58971,2721,56250,46522,4619,3478,453,50000,1178,5574,7122,3359,1198
GGTTGCGTAGATTCAT,sample,50999,49846,4790,45056,9595,35461,18885,1365,8174,1175,27059,5862,3686,1446,6675,6134
TCCTCCGTAGATTCAT,sample,125387,121496,15870,105626,13687,91939,41307,2407,29132,2767,70439,16326,6696,1693,16847,8403
TTCGTAATAGATTCAT,sample,111888,110627,7505,103122,12872,90250,42440,3136,28743,3311,71183,12620,5986,2366,8730,9106
TTCTAATGAGATTCAT,sample,21126,20826,1908,18918,1822,17096,6902,620,6030,763,12932,2781,3858,1836,854,1213
AATGGTAAAGATTCAT,sample,103727,101701,5869,95832,22659,73173,51006,3275,13786,1460,64792,3646,2730,1423,21779,14261
TTCCGTCTAGATTCAT,sample,143782,141423,10175,131248,25782,105466,68566,4914,18965,2209,87531,10812,4270,1787,23863,16621
GCCTTGCTAGATTCAT,sample,108118,106690,8686,98004,18731,79273,33878,1628,23963,2538,57841,17266,7166,1690,14648,12239
GACGGAGAAGATTCAT,sample,138280,136438,8395,128043,14877,113166,72939,4549,19907,2333,92846,13438,5982,2800,16654,10218
CCAGAGCGAGATTCAT,sample,95107,92599,6523,86076,19614,66462,39850,2366,13789,1435,53639,9022,3708,1308,16706,12036
GTTAGCCGAGATTCAT,sample,84942,83744,3679,80065,10441,69624,32712,2213,23687,2697,56399,8315,4096,1478,3868,7303
TGGACGAGAGATTCAT,sample,58465,57850,1959,55891,11145,44746,30784,2439,8004,903,38788,2616,2740,1636,10445,7503
CTAGGACCAGATTCAT,sample,58967,58049,4008,54041,10327,43714,23899,1507,10626,1362,34525,6320,4027,1298,9910,7317
AACTCGTAAGATTCAT,sample,102547,101222,3924,97298,14045,83253,59165,4227,13602,1618,72767,4641,2690,1574,19372,10165
TGCTTCGCAGATTCAT,sample,48559,47621,4656,42965,3843,39122,7922,753,17081,1867,25003,11499,5775,1036,1223,2198
AAGAGCGCAGATTCAT,sample,104731,103135,7278,95857,13897,81960,40601,2996,23057,2757,63658,12549,5630,1648,10915,9589
TTGGTTAAAGATTCAT,sample,97829,96388,10608,85780,6939,78841,15277,934,33101,3725,48378,25804,8351,1590,2563,3469
TCAATATAAGATTCAT,sample,116352,114664,7711,106953,14984,91969,52392,3125,19143,2434,71535,14875,5968,1857,12948,9969
AGGTCGGAAGATTCAT,sample,114923,113442,10388,103054,12690,90364,34712,2070,28961,2429,63673,22192,7823,1631,11093,8521
TTATTCGAAGATTCAT,sample,88822,87656,4853,82803,14184,68619,36887,2898,17171,2224,54058,9439,5258,1638,11422,9791
GACCGGAAAGATTCAT,sample,94441,93241,3736,89505,14332,75173,47158,3491,15804,2325,62962,6395,3504,1409,18115,10178
TCCAACTTCAATCTTG,sample,120144,118304,4997,113307,30909,82398,51982,4447,15023,1944,67005,9002,4270,1752,19999,19816
AGTACCATCAATCTTG,sample,125116,123453,9446,114007,15203,98804,46303,3198,28021,2805,74324,18477,6733,1981,17577,10236
TTCGTAATCAATCTTG,sample,132876,131084,8933,122151,18322,103829,48725,3621,27424,3131,76149,20928,7872,1953,18080,13113
ACGTTATGCAATCTTG,sample,146728,145035,7458,137577,23769,113808,69907,5294,23134,2560,93041,12913,6198,2330,22536,15751
TGAGCGCGCAATCTTG,sample,123231,120986,6054,114932,22640,92292,56326,4883,18482,2027,74808,10574,5625,2064,17620,15145
TCGCATCTCAATCTTG,sample,96518,95126,3627,91499,18002,73497,54124,4594,10262,1380,64386,3137,3707,2954,12344,12398
GTTAGCCGCAATCTTG,sample,152258,150299,8120,142179,30311,111868,80007,4996,17354,1980,97361,7531,4263,2047,28988,20158
CTTGATAGCAATCTTG,sample,125230,123020,11030,111990,16588,95402,37097,2711,31343,3498,68440,20753,7440,1695,13307,10074
TTGGTACCCAATCTTG,sample,52592,51114,3343,47771,6316,41455,22963,1711,11141,1299,34104,4341,3282,1500,6752,4584
GCCTGAACCAATCTTG,sample,87410,85054,5851,79203,11101,68102,30904,1706,19719,2169,50623,13604,5606,1429,12479,8056
ACCAATGCCAATCTTG,sample,79125,77580,3751,73829,14406,59423,41257,2964,9389,1820,50646,3993,2860,1636,12477,10208
TTGGTTAACAATCTTG,sample,90709,88963,4761,84202,19955,64247,50866,3536,6925,1156,57791,1764,1540,1079,14400,13613
TCAATATACAATCTTG,sample,224606,221615,20191,201424,19805,181619,49873,3255,67117,6708,116990,54666,12409,2590,13310,13131
CTTCATGACAATCTTG,sample,74547,73409,4742,68667,9878,58789,33706,3125,13232,1424,46938,7302,4637,1874,7370,6678
TTATTCGACAATCTTG,Neg_Ctrl,4214,1963,1524,439,51,388,181,15,108,12,289,72,169,75,59,34
GACCGGAACAATCTTG,sample,169410,167085,12117,154968,19207,135761,58518,4073,38583,4404,97101,30183,9570,2148,16231,12625
AAGTTCGTCGTTCCGA,sample,137406,135481,8481,127000,31231,95769,57059,4633,19631,2138,76690,12308,6689,2495,22521,21203
TTCTAATGCGTTCCGA,sample,161295,158139,10001,148138,32122,116016,90838,7168,12205,1453,103043,4352,3577,2820,24936,19583
ATGCCTGGCGTTCCGA,sample,117756,116093,17063,99030,15373,83657,33340,2926,25749,2642,59089,19000,7833,2440,8257,8817
TAGTACGGCGTTCCGA,sample,235240,233379,10768,222611,39324,183287,102766,7066,48042,4920,150808,20493,6928,2438,32891,27034
TCGCATCTCGTTCCGA,sample,181785,179311,12655,166656,23205,143451,80150,5220,34471,3797,114621,19813,8036,3084,15364,15277
CAAGGCCTCGTTCCGA,sample,89721,88113,4812,83301,19492,63809,33456,2188,15927,1772,49383,10466,4979,1437,12305,12378
GACGGAGACGTTCCGA,sample,166747,164198,7991,156207,25866,130341,84922,6105,25288,3408,110210,10618,4383,1948,29324,17765
CTTGATAGCGTTCCGA,sample,189690,187329,9940,177389,34000,143389,81985,6285,32875,3822,114860,18422,6875,2212,24966,23673
TGGACGAGCGTTCCGA,sample,169196,167362,6697,160665,38025,122640,96608,7036,12744,1784,109352,4468,3272,2309,23828,26330
GGCCAGAGCGTTCCGA,sample,130315,128499,8367,120132,24986,95146,57516,4174,19032,2223,76548,12201,5837,1894,20006,17183
CATTGCAGCGTTCCGA,sample,149563,147787,13089,134698,17931,116767,42869,2684,38724,3820,81593,28670,9586,2245,13340,11454
CCATGAAGCGTTCCGA,sample,91374,89280,4605,84675,14988,69687,36157,3058,20974,2463,57131,7035,4792,1955,5736,9393
ACGACTTCCGTTCCGA,sample,185229,183276,12627,170649,25974,144675,78761,5104,34768,3870,113529,22172,7764,2412,20459,16652
AATCCGTCCGTTCCGA,sample,210130,207094,11397,195697,39611,156086,93076,5039,35593,3502,128669,18876,6927,2001,40020,27845
GTCCTGCCCGTTCCGA,sample,149253,146571,8132,138439,23857,114582,65222,5715,27768,2330,92990,13547,4560,1644,25335,17576
TTGGTACCCGTTCCGA,sample,47020,45680,4988,40692,9163,31529,6021,568,13742,1432,19763,9766,5222,1060,808,5290
GTTAGGACCGTTCCGA,sample,175754,172906,10913,161993,22955,139038,65715,4659,41713,4149,107428,22802,7957,2464,21912,16086
ACGTATTACGTTCCGA,sample,202981,199938,7530,192408,27280,165128,118338,8382,26823,2697,145161,8888,4370,2371,26140,20046
AACTCGTACGTTCCGA,sample,221272,218566,11941,206625,32804,173821,95955,6705,38241,4551,134196,28369,7824,2176,36089,23883
CGTATGAACGTTCCGA,sample,160359,157280,7903,149377,29418,119959,78445,6440,22636,3045,101081,9393,4630,1972,21458,20069
TGCTTCGCCGTTCCGA,sample,144249,142632,4995,137637,23257,114380,90600,4773,12600,1628,103200,4779,3121,1933,16726,17065
CCAATTCCCGTTCCGA,sample,191950,189173,10307,178866,23032,155834,69692,5400,44521,4421,114213,31800,9569,2481,18754,14087
GGCATATACGTTCCGA,sample,138280,136170,9976,126194,20356,105838,53097,5674,26817,3726,79914,16524,5757,1515,18685,13600
TCGCCTGACGTTCCGA,sample,112076,110909,7033,103876,13386,90490,25705,2118,33533,3818,59238,25316,8930,2051,5824,8225
ATTCTCTTCAATTCGG,Pos_Ctrl,93538,92607,4044,88563,4915,83648,69777,6879,4818,611,74595,1563,6489,8690,7210,2074
AGTACCATCAATTCGG,sample,223725,219183,18451,200732,21533,179199,60704,4596,59344,6487,120048,48068,10838,2533,15164,14138
ACGTTATGCAATTCGG,Pos_Ctrl,119249,117700,5098,112602,5519,107083,89095,9224,5872,796,94967,2096,6426,9480,6180,2034
TTCTAATGCAATTCGG,sample,216076,213033,9299,203734,36125,167609,97988,7675,35498,3493,133486,22955,8360,2250,24208,24923
GCCTTGCTCAATTCGG,Pos_Ctrl,72874,71722,3353,68369,3673,64696,54037,5461,3486,423,57523,1289,6036,7944,4947,1565
GACGGAGACAATTCGG,sample,122957,120933,5930,115003,15910,99093,53950,3251,26260,3671,80210,11961,4985,1882,15064,11375
GGAGGACGCAATTCGG,sample,98729,97665,4906,92759,13692,79067,42966,2949,20573,2204,63539,10375,5707,1907,14705,9235
CCGCAACGCAATTCGG,Pos_Ctrl,54973,54283,2400,51883,2851,49032,40688,4227,2767,397,43455,953,5497,6817,3843,1230
GGACGTAGCAATTCGG,sample,131563,130245,7615,122630,22014,100616,46346,2599,27936,2597,74282,21138,7476,1886,19243,15424
CCATGAAGCAATTCGG,Pos_Ctrl,59696,58719,2474,56245,2887,53358,44575,4638,2689,444,47264,1012,5548,7185,4208,1125
CGTACGTCCAATTCGG,sample,114548,113260,4992,108268,15353,92915,50485,3698,26230,3114,76715,9388,4502,1932,13147,10871
TTGGTACCCAATTCGG,sample,103687,102343,5964,96379,14329,82050,35160,2478,27890,2749,63050,13773,6295,1867,10931,9673
CGGATTACCAATTCGG,Pos_Ctrl,70924,69947,2812,67135,3749,63386,52839,5251,3707,435,56546,1154,5821,7698,5119,1489
GCCTGAACCAATTCGG,sample,172724,170787,12173,158614,22671,135943,47102,3185,44871,4771,91973,36014,10937,2466,16848,13567
ACGTATTACAATTCGG,sample,198878,196918,13394,183524,28695,154829,79571,5541,38575,4199,118146,26943,8081,2293,30436,18951
TTGGCCTCCAATTCGG,Pos_Ctrl,66295,65309,3293,62016,2974,59042,48624,4683,3872,535,52496,1328,5783,7320,3942,1080
GAAGGCGCCAATTCGG,sample,103357,101248,7661,93587,15455,78132,40274,2667,19225,2197,59499,13769,6149,1540,11978,10586
CTTCATGACAATTCGG,sample,82961,80887,4183,76704,13728,62976,47575,3502,9034,869,56609,1996,1475,1087,15190,10082
TTATTCGACAATTCGG,sample,164607,162460,12060,150400,14124,136276,47995,3819,45646,4701,93641,34115,10441,2514,12352,8176
AGTACCATAACTCCGG,sample,122593,120736,8284,112452,23598,88854,45587,2901,21789,2208,67376,16369,5583,1543,20502,15087
TTCGTAATAACTCCGG,sample,85585,84444,4088,80356,20064,60292,41415,2377,10128,1165,51543,5207,3531,1742,17204,13698
TTCCGTCTAACTCCGG,sample,39365,38780,2158,36622,4818,31804,16318,1212,9363,1202,25681,3709,3493,1742,3425,3320
CATAACCTAACTCCGG,sample,40588,39926,2188,37738,7415,30323,16040,879,8744,867,24784,3793,3045,1303,6220,5230
CCGCAACGAACTCCGG,sample,16834,16528,1275,15253,2718,12535,5893,358,3559,351,9452,2374,2495,976,2262,1805
ACCTCGAGAACTCCGG,sample,42241,41660,2470,39190,4736,34454,17379,1149,9750,943,27129,5233,3748,1631,4834,3214
TGGACGAGAACTCCGG,sample,15340,15030,1157,13873,2073,11800,5157,423,3649,451,8806,2120,2064,794,1482,1371
CCATGAAGAACTCCGG,sample,1880,1822,130,1692,354,1338,560,49,431,46,991,252,479,208,238,227
ACGACTTCAACTCCGG,sample,50728,49847,3182,46665,7869,38796,19684,1095,10436,1062,30120,6519,3960,1238,8665,5272
GTCCTGCCAACTCCGG,sample,31952,31309,1736,29573,6047,23526,14983,963,4833,601,19816,2146,2302,1173,6661,4392
TTGGTACCAACTCCGG,sample,60975,60080,3163,56917,8767,48150,23775,2158,15272,1986,39047,4959,3525,1401,5498,6086
CTAGGACCAACTCCGG,sample,17844,17492,1255,16237,3714,12523,7773,447,2837,312,10610,1154,1707,1003,3281,2534
CGGATTACAACTCCGG,sample,18745,18389,2476,15913,1683,14230,3964,287,5279,586,9243,4114,3311,917,888,1020
GTTAGGACAACTCCGG,sample,41675,40922,2242,38680,6832,31848,17155,912,9434,1062,26589,3285,2827,1373,5783,4557
ACGTATTAAACTCCGG,sample,90515,87996,9698,78298,9080,69218,22330,1464,26002,2680,48332,16742,6174,1255,3956,5101
AACTCGTAAACTCCGG,sample,94289,92869,4319,88550,17885,70665,44346,3062,14132,1101,58478,8024,3233,1372,17345,13051
TTGGTTAAAACTCCGG,sample,64674,63454,3745,59709,10778,48931,30967,2498,9471,1392,40438,4603,3368,1351,9300,7457
GGCATATAAACTCCGG,sample,65642,63668,3513,60155,11443,48712,35523,2727,7848,803,43371,1811,1435,1002,10290,8207
TCGCCTGAAACTCCGG,sample,22167,21472,1537,19935,3213,16722,9528,703,4066,461,13594,1964,2214,968,2831,2070
TTATTCGAAACTCCGG,sample,89011,87675,3448,84227,16127,68100,48818,3308,11048,1144,59866,3782,3406,1734,12881,11536
GACCGGAAAACTCCGG,sample,104444,102975,5950,97025,9182,87843,45011,3600,25097,2248,70108,11887,5231,1622,7183,5402
TCCAACTTCCTGAAGG,Neg_Ctrl,6966,4183,3475,708,115,593,149,11,358,12,507,63,125,65,56,26
TCCTCCGTCCTGAAGG,sample,69099,68025,4007,64018,12529,51489,29044,2361,12654,1507,41698,5923,4143,2020,8427,8670
AGTACCATCCTGAAGG,sample,101694,100254,8740,91514,15562,75952,32825,2379,21657,2224,54482,16867,7209,2259,10609,9516
ACGTTATGCCTGAAGG,sample,84100,82776,6437,76339,18814,57525,30176,2042,14508,1429,44684,9370,5694,2130,10534,11982
TTCTAATGCCTGAAGG,Neg_Ctrl,6853,4474,3167,1307,149,1158,226,13,149,14,375,756,181,79,65,61
ATGCCTGGCCTGAAGG,sample,73683,72595,7645,64950,12163,52787,17497,848,17884,1722,35381,14836,6694,1489,7114,7907
CAAGGCCTCCTGAAGG,Neg_Ctrl,6303,3276,2751,525,128,397,124,15,180,11,304,67,123,49,46,41
CCAGAGCGCCTGAAGG,sample,8964,8768,608,8160,1871,6289,4106,346,1175,167,5281,495,1633,1092,1182,1248
GGACGTAGCCTGAAGG,Neg_Ctrl,4333,2852,2253,599,80,519,176,15,128,9,304,191,178,79,44,52
CTTGATAGCCTGAAGG,sample,69243,67953,6567,61386,9731,51655,18781,1419,16836,1835,35617,12784,6324,1544,6988,6704
ACCTCGAGCCTGAAGG,sample,56120,55082,4350,50732,7940,42792,17867,1066,13404,1271,31271,9184,5153,1287,6366,5126
TGGACGAGCCTGAAGG,sample,88046,86720,5823,80897,12129,68768,29341,1442,23520,2650,52861,11815,5047,1549,10502,8114
CGAGGCAGCCTGAAGG,sample,18228,17689,1471,16218,3883,12335,7637,557,2393,251,10030,1497,1869,1017,3112,2663
ACGACTTCCCTGAAGG,Neg_Ctrl,5647,3236,2716,520,54,466,186,9,157,14,343,100,171,65,72,28
AATCCGTCCCTGAAGG,sample,87242,85940,6266,79674,10630,69044,31708,2198,22002,2684,53710,10452,5456,2032,8812,7270
CGTACGTCCCTGAAGG,sample,49712,48658,4829,43829,7299,36530,13508,906,12010,1287,25518,8819,5104,1311,5635,4734
AGTCCGCACCTGAAGG,sample,82867,81229,5474,75755,20594,55161,43068,2768,6998,570,50066,1757,1515,1172,20361,14016
GTTAGGACCCTGAAGG,Neg_Ctrl,5409,3277,2496,781,79,702,215,40,332,15,547,100,199,71,85,58
AACTCGTACCTGAAGG,sample,87121,85574,4282,81292,8682,72610,40924,3023,19216,2604,60140,6843,3925,1789,6496,5605
CGTATGAACCTGAAGG,sample,122764,120176,10753,109423,13363,96060,40693,2216,29653,2726,70346,20772,7201,1453,16511,9039
AATATATCCCTGAAGG,Neg_Ctrl,6837,4127,3535,592,103,489,229,18,159,11,388,72,208,100,74,20
CCAATTCCCCTGAAGG,sample,68263,66287,4204,62083,9097,52986,29288,2189,12319,1360,41607,7830,4715,1411,8475,6066
TTGGTTAACCTGAAGG,sample,141407,138929,10706,128223,14731,113492,39544,3158,38409,4933,77953,27448,8712,1906,11125,9987
GTACCGTACCTGAAGG,sample,86537,84758,6462,78296,9367,68929,30419,2165,20770,2433,51189,13142,6273,1817,7357,6279
AGGTCGGACCTGAAGG,sample,115595,113275,8645,104630,16161,88469,52975,5211,18037,1465,71012,10781,4493,1393,14209,11049
CCTCTAGAAATATTCG,sample,83525,78120,7722,70398,10970,59428,26802,1925,17758,2059,44560,10884,5050,1316,10648,6804
ACGTTATGAATATTCG,sample,60012,59262,5600,53662,9159,44503,16364,1010,14634,1685,30998,10810,6135,1628,5895,6212
TTCTAATGAATATTCG,sample,35699,35084,2509,32575,4897,27678,10753,700,9873,1438,20626,4914,3644,1234,2111,3310
ACTATACTAATATTCG,sample,73994,73086,4281,68805,9670,59135,27517,1611,19779,2408,47296,7820,4669,1894,9139,7019
GACGGAGAAATATTCG,sample,97164,96098,6161,89937,12588,77349,34816,2367,25029,3057,59845,12080,5958,1963,11711,8446
CCAGAGCGAATATTCG,sample,69345,68446,4487,63959,9065,54894,22336,1365,17379,1824,39715,11990,5716,1745,5440,5659
GTTAGCCGAATATTCG,sample,117663,116125,7435,108690,12246,96444,39283,2869,34067,3841,73350,16384,6287,1653,11624,8236
GGCCAGAGAATATTCG,sample,62497,61608,3023,58585,11790,46795,28571,1804,10159,1370,38730,4891,3730,1452,10961,8357
CATTGCAGAATATTCG,sample,59437,58633,3536,55097,10275,44822,23593,1391,10940,1280,34533,7618,4582,1411,10148,7126
ACGACTTCAATATTCG,sample,99702,98384,8729,89655,11760,77895,26564,1460,27888,2995,54452,18988,7818,1850,10033,7680
CATGATTCAATATTCG,sample,55436,54702,3677,51025,7840,43185,21401,1085,11866,1277,33267,7556,4559,1343,10060,5346
GTCCTGCCAATATTCG,sample,60007,59140,4474,54666,8990,45676,20276,1335,13590,1370,33866,9105,5028,1469,8197,6271
GCCTGAACAATATTCG,sample,65322,64064,3424,60640,14566,46074,34897,2082,6957,732,41854,1406,1324,1075,15104,10297
AATATATCAATATTCG,sample,124716,122858,6772,116086,23398,92688,63490,4781,14447,1796,77937,8174,3310,1573,21424,16776
GAAGGCGCAATATTCG,sample,64618,63311,2856,60455,11619,48836,33093,2771,8188,1199,41281,3585,2686,1299,8917,7628
CCAATTCCAATATTCG,sample,130178,127957,8343,119614,15002,104612,39356,3076,33187,3576,72543,25417,9212,2087,10073,9624
GTACCGTAAATATTCG,Pos_Ctrl,62794,61703,3036,58667,2651,56016,46256,4296,3769,470,50025,1225,5570,6893,3208,980
CTTCATGAAATATTCG,sample,111964,110312,7573,102739,10643,92096,39758,2908,29586,3303,69344,16541,6775,1756,10216,7579
ATGACCGAAATATTCG,sample,82086,80632,3642,76990,9561,67429,39989,3336,15958,1279,55947,6867,3616,1307,7963,6655
GGAGAGTTAGTCTCCG,sample,47002,45836,3736,42100,7830,34270,16168,970,9611,876,25779,6645,4215,1054,8067,4962
TATCAGTTAGTCTCCG,sample,193325,191532,11312,180220,33272,146948,70683,5298,39429,4401,110112,27137,8600,2122,26730,23614
TCCAACTTAGTCTCCG,sample,76550,75560,4734,70826,16261,54565,31742,2417,11359,1350,43101,7697,4117,1346,15207,11054
AAGTTCGTAGTCTCCG,sample,104407,103012,7349,95663,15632,80031,32635,1837,24934,2715,57569,17910,7135,1644,14827,10380
ACGTAAGTAGTCTCCG,sample,98298,96788,3855,92933,23113,69820,48607,3375,11875,955,60482,5008,2892,1274,22492,16170
ACGTTATGAGTCTCCG,sample,35128,34660,3388,31272,4124,27148,8634,573,9749,924,18383,7268,4891,1374,2920,2492
TAGTACGGAGTCTCCG,sample,73289,72479,4050,68429,16342,52087,31590,1901,11434,1333,43024,5829,4283,1688,11905,11032
CAACCGCGAGTCTCCG,sample,66645,65901,3601,62300,18071,44229,28772,1934,7779,1207,36551,4537,3303,1511,11299,11366
AATGGTAAAGTCTCCG,sample,73825,73051,3318,69733,15600,54133,33312,2598,11527,1486,44839,5210,3725,2075,10977,10566
TTAGAAGTAGTCTCCG,sample,66548,65865,3011,62854,13090,49764,34006,2545,8840,1020,42846,3353,3254,2060,9055,9440
TTCCGTCTAGTCTCCG,sample,61923,61088,4086,57002,8900,48102,21867,1160,14048,1391,35915,9636,5181,1463,8913,5906
TCGCATCTAGTCTCCG,sample,84132,83266,2851,80415,23120,57295,45577,2731,7106,560,52683,1321,1608,1448,20123,15125
GACGGAGAAGTCTCCG,sample,28447,27965,1706,26259,6071,20188,11988,737,4600,475,16588,2388,2450,1018,5426,4015
GGACGTAGAGTCTCCG,sample,107633,106283,5845,100438,11799,88639,43777,3286,26294,3080,70071,12202,4754,1717,10481,7685
ACCTCGAGAGTCTCCG,sample,122351,121087,7917,113170,10845,102325,33731,2779,39910,4500,73641,21405,8160,2073,7434,6436
CCATGAAGAGTCTCCG,sample,75852,74621,4218,70403,14950,55453,33067,2497,11660,1415,44727,6814,4315,1622,13478,9837
ACGACTTCAGTCTCCG,sample,79376,77787,3787,74000,14926,59074,35010,2129,13249,1636,48259,7050,4389,1396,15026,10414
GTCCTGCCAGTCTCCG,sample,53822,53200,2028,51172,13175,37997,25966,2110,6548,880,32514,2493,2843,1688,9463,8773
TTGGTACCAGTCTCCG,sample,58904,58077,3185,54892,12198,42694,25063,1636,9693,1123,34756,5179,3794,1212,11608,8325
CTAGGACCAGTCTCCG,sample,53781,53134,3987,49147,8043,41104,19702,1200,12651,1470,32353,6081,4160,1471,7219,5368
TTGGCCTCAGTCTCCG,sample,93661,92466,4603,87863,12950,74913,38949,3794,18978,2243,57927,10949,5301,1778,7890,8817
AATATATCAGTCTCCG,sample,122692,121269,4802,116467,18790,97677,59957,5110,19995,1817,79952,10798,4118,1627,19085,12551
TGCTTCGCAGTCTCCG,sample,84745,83130,4643,78487,13230,65257,34101,1936,16336,1709,50437,11175,4332,1233,12090,9318
AAGAGCGCAGTCTCCG,sample,123878,121954,6749,115205,14576,100629,48296,4937,26601,3487,74897,17308,6592,1653,14314,9539
TCAATATAAGTCTCCG,sample,79246,77502,6535,70967,8481,62486,17321,1094,25079,3115,42400,15877,6288,1294,3749,5536
TTATTCGAAGTCTCCG,sample,82460,81275,4589,76686,10971,65715,31695,2280,18113,2246,49808,11381,5286,1823,5896,7038
ATGACCGAAGTCTCCG,sample,132583,130844,11151,119693,11560,108133,29131,1999,40811,4509,69942,31683,9662,2102,6954,6931
TATCAGTTTGCCTACG,sample,98296,97275,3418,93857,21072,72785,47540,3320,13422,1457,60962,7046,4278,1752,14091,14003
ATTCTCTTTGCCTACG,sample,25430,24652,3129,21523,3814,17709,6836,532,5518,572,12354,4251,2964,785,3236,2279
TCCAACTTTGCCTACG,sample,57540,56805,2327,54478,9059,45419,27309,2175,11279,1164,38588,3492,2920,1445,10111,6190
ACGTTATGTGCCTACG,sample,88474,86646,7212,79434,10416,69018,22367,1853,24356,2332,46723,18110,6698,1312,5011,6680
TAGTACGGTGCCTACG,sample,59129,58362,3086,55276,10613,44663,27766,1681,9496,1011,37262,4709,3269,1381,10251,7445
TGAGCGCGTGCCTACG,sample,22881,22538,1679,20859,3730,17129,9458,736,3853,541,13311,2541,2325,899,4335,2581
CAACCGCGTGCCTACG,sample,41172,40539,2590,37949,6715,31234,17455,966,7641,867,25096,4305,3672,1449,6391,4613
TCGCATCTTGCCTACG,sample,47076,46283,1830,44453,11783,32670,26115,1294,3688,545,29803,1028,1382,1094,11188,7863
CATAACCTTGCCTACG,sample,28126,27605,1795,25810,2420,23390,10329,717,8070,807,18399,3467,2983,1263,1221,1920
CCAGAGCGTGCCTACG,sample,29142,28550,1588,26962,5391,21571,14025,866,4279,560,18304,1841,2202,1177,5401,3751
GTTAGCCGTGCCTACG,sample,15193,14938,1179,13759,2107,11652,4945,456,4206,447,9151,1598,2381,1032,1127,1470
GGAGGACGTGCCTACG,sample,21400,21091,2957,18134,1505,16629,3255,214,6882,704,10137,5574,3784,754,798,633
GACGATAATGCCTACG,sample,44739,43975,4496,39479,5629,33850,11024,726,11916,1356,22940,8828,5328,1327,3448,3337
GTCCTGCCTGCCTACG,sample,31962,31472,3014,28458,3341,25117,7526,466,9102,1046,16628,6977,4476,997,2977,2205
CTAGGACCTGCCTACG,sample,8246,8075,828,7247,1157,6090,2695,181,1951,220,4646,1043,1583,614,981,768
CGGATTACTGCCTACG,sample,21569,21150,1775,19375,3069,16306,9078,588,3622,487,12700,2531,2893,1584,2077,1956
ACGTATTATGCCTACG,sample,54434,53423,3899,49524,8094,41430,24473,1597,8649,960,33122,5751,3376,1149,8004,5762
CCAATTCCTGCCTACG,sample,24267,23635,1766,21869,3186,18683,8868,868,5459,630,14327,2858,2625,852,2881,2206
GGCATATATGCCTACG,Neg_Ctrl,1053,573,300,273,58,215,91,6,71,7,162,40,90,41,28,21
AAGTTCGTCTTAGTTC,sample,168829,166628,8340,158288,33005,125283,74093,4502,28703,3034,102796,14951,5490,1914,30007,23189
GGTTGCGTCTTAGTTC,sample,124456,122808,7866,114942,18459,96483,39261,2666,30244,3303,69505,21009,7916,2016,11604,11664
CCTCTAGACTTAGTTC,sample,97903,95634,4964,90670,20930,69740,46761,3176,12877,957,59638,5969,3443,1345,22124,14101
TTCGTAATCTTAGTTC,sample,126842,125629,8793,116836,24649,92187,36538,2123,29265,2846,65803,21415,7850,2016,14798,16049
ACGTTATGCTTAGTTC,sample,163758,161667,9321,152346,31354,120992,67187,4350,27631,2872,94818,18952,7357,2093,29018,22093
TTCTAATGCTTAGTTC,sample,143959,142522,6865,135657,30931,104726,68222,4762,18946,2403,87168,10393,5042,1958,24737,21385
ATGCCTGGCTTAGTTC,sample,78391,77378,6463,70915,10673,60242,18710,1299,21269,1973,39979,16991,6799,1451,6604,7078
CAACCGCGCTTAGTTC,sample,116136,113976,6274,107702,11182,96520,38778,2498,34008,4480,72786,16756,6232,1650,4571,7055
AATGGTAACTTAGTTC,sample,140611,138925,8221,130704,21500,109204,60680,3874,25538,3321,86218,15791,5665,2037,23054,14283
GCCTTGCTCTTAGTTC,sample,138363,135332,5580,129752,29847,99905,78797,5529,10165,1959,88962,3455,1736,1366,33766,20770
CTTGATAGCTTAGTTC,sample,55845,54984,3271,51713,13307,38406,24975,1673,7185,922,32160,3651,3079,1846,8303,8176
CATGATTCCTTAGTTC,sample,19396,19017,1590,17427,2209,15218,6830,486,4962,558,11792,2382,2669,1109,2344,1467
AATCCGTCCTTAGTTC,sample,87104,86099,5594,80505,14847,65658,33321,2450,17281,2213,50602,10393,5942,1993,14341,9520
TTGGTACCCTTAGTTC,sample,51390,50685,2458,48227,12949,35278,26993,1606,4572,362,31565,1745,1998,1649,9130,8875
ACGTATTACTTAGTTC,sample,122304,120663,6907,113756,15914,97842,42764,3438,30542,4095,73306,17003,6420,2337,6509,9970
TTGGCCTCCTTAGTTC,sample,122513,120306,9381,110925,13455,97470,33607,2312,32218,3683,65825,25650,8487,1726,9539,8957
TGCTTCGCCTTAGTTC,sample,53663,52206,2269,49937,8758,41179,30117,2704,5865,653,35982,1840,1878,1263,6717,5419
AAGAGCGCCTTAGTTC,sample,140849,138618,8093,130525,16423,114102,57817,4241,30192,3208,88009,18644,6748,2000,14045,12083
GTCTTAGCCTTAGTTC,sample,68513,66451,5222,61229,8194,53035,27187,1469,14130,1616,41317,8633,4539,1253,9551,5218
GGCATATACTTAGTTC,sample,105630,103367,4729,98638,15688,82950,55363,3144,14855,1504,70218,8084,4039,1856,13377,10708
TCAATATACTTAGTTC,sample,155275,152609,7879,144730,27593,117137,83680,7996,16569,2198,100249,6694,3371,1562,23198,19925
ATTCTCTTCGAGCTTC,sample,143947,142277,7119,135158,24613,110545,62955,5249,27268,2458,90223,12615,5448,2093,20854,17399
ACGTAAGTCGAGCTTC,sample,154759,152831,7174,145657,19859,125798,67112,4555,35320,4560,102432,14251,5614,2126,20554,14479
TAGTACGGCGAGCTTC,sample,99990,98600,3840,94760,28015,66745,53270,3963,7611,809,60881,1092,1452,1264,22622,18374
TTAGAAGTCGAGCTTC,sample,112483,109329,5038,104291,14485,89806,54320,3970,22120,2102,76440,7294,3831,1652,10610,9501
TCGCATCTCGAGCTTC,sample,191620,189528,11029,178499,25580,152919,71084,4176,43962,4219,115046,29478,9186,2395,23377,16729
CATAACCTCGAGCTTC,sample,123929,121761,7341,114420,21005,93415,42997,2934,28784,3200,71781,15500,5960,1759,13543,14161
GTTAGCCGCGAGCTTC,sample,110623,109309,5232,104077,24973,79104,49948,3493,17463,1780,67411,6420,4430,1642,17658,17252
ACCTCGAGCGAGCTTC,sample,42514,41657,2223,39434,6215,33219,21110,1813,6657,1004,27767,2635,2485,1196,7469,4600
GACGATAACGAGCTTC,sample,120809,118683,6022,112661,24168,88493,60152,3268,16593,1957,76745,6523,2803,1359,24852,17300
AGTCCGCACGAGCTTC,sample,85700,84319,5770,78549,12585,65964,34676,2171,16839,1731,51515,10547,5525,1867,9757,8153
CTAGGACCCGAGCTTC,sample,152044,150015,12399,137616,17651,119965,48803,3311,36996,4106,85799,26749,8786,2025,16967,11576
CGGATTACCGAGCTTC,sample,119314,115117,5603,109514,17109,92405,56579,4453,20267,2631,76846,8475,4424,2054,10671,11726
ACGTATTACGAGCTTC,sample,112172,110254,6812,103442,12831,90611,47958,2878,24468,3076,72426,12231,5348,1704,10516,9187
GAAGGCGCCGAGCTTC,sample,60256,59171,3165,56006,8221,47785,24501,2179,13424,1631,37925,6050,3896,1307,8457,5719
GTACCGTACGAGCTTC,sample,64513,63604,3492,60112,5481,54631,24131,1766,18564,2430,42695,7740,3924,1482,5037,3594
CTTCATGACGAGCTTC,sample,106764,104836,4945,99891,12357,87534,50930,3744,21365,2778,72295,8717,2900,1231,12480,8963
AGGTCGGACGAGCTTC,sample,100203,98894,6193,92701,10112,82589,37242,3357,24164,2684,61406,15142,5204,1804,7240,6095
ATGACCGACGAGCTTC,sample,103742,102377,6410,95967,10081,85886,30504,2146,28661,3117,59165,21458,8104,1829,6757,6372
ATTCTCTTGTAGAATG,Pos_Ctrl,62981,62311,2830,59481,3453,56028,46513,4293,3435,417,49948,1370,5913,7233,5308,1759
ACGTAAGTGTAGAATG,sample,115529,113738,6243,107495,23916,83579,51541,3443,17693,1944,69234,8958,5045,1998,19431,16080
CCTCTAGAGTAGAATG,sample,81001,79149,4200,74949,12422,62527,35672,1993,16075,2044,51747,6743,3590,1371,12118,8641
AGTACCATGTAGAATG,sample,84937,83582,5952,77630,9550,68080,33026,1876,21366,2668,54392,9144,4748,1669,10892,6596
TTCGTAATGTAGAATG,sample,82319,80899,4854,76045,7547,68498,31567,2251,22183,2748,53750,9749,4737,1886,2778,4664
TAGTACGGGTAGAATG,sample,100859,98905,5283,93622,15354,78268,48729,3816,16798,1914,65527,7011,4985,2193,13774,10503
TGAGCGCGGTAGAATG,sample,102735,100947,5084,95863,21399,74464,52153,3233,12046,1323,64199,5709,2793,1330,19489,15548
AATGGTAAGTAGAATG,sample,160002,157443,7090,150353,40575,109778,77327,5364,17294,1638,94621,8155,3557,1628,28185,26061
GGACCTCTGTAGAATG,Pos_Ctrl,51728,51031,2418,48613,2668,45945,38304,3741,2659,313,40963,928,5525,6423,4291,1075
GCCTTGCTGTAGAATG,sample,70862,69615,2689,66926,13771,53155,36806,3106,8985,1233,45791,3025,2735,1716,14279,9163
CAAGGCCTGTAGAATG,sample,115668,113551,6032,107519,26327,81192,50696,3468,16719,1817,67415,8492,3885,1477,20491,17894
ACTATACTGTAGAATG,sample,130295,127381,6832,120549,29139,91410,66914,3038,13850,1820,80764,5788,2365,1342,24718,19552
CCAGAGCGGTAGAATG,sample,118942,117245,7772,109473,16258,93215,46013,2784,24523,3278,70536,16617,6414,1809,16263,11092
GTTAGCCGGTAGAATG,sample,116848,115102,6259,108843,25296,83547,62303,4485,10731,2016,73034,4012,2075,1141,25119,17544
CCGCAACGGTAGAATG,sample,69061,67769,4302,63467,9612,53855,27291,1608,15789,1481,43080,7686,4329,1556,7252,6414
CTTGATAGGTAGAATG,sample,99560,98363,4783,93580,13832,79748,46473,3487,18223,2489,64696,9076,4717,1928,11490,9601
TGGACGAGGTAGAATG,sample,102364,100836,4332,96504,23055,73449,56605,3407,9061,1594,65666,2782,2182,1248,19899,15416
GACGATAAGTAGAATG,sample,63795,62597,5407,57190,8701,48489,19582,1024,15881,1887,35463,10115,5200,1210,7205,5784
CATTGCAGGTAGAATG,sample,91352,90058,3819,86239,20415,65824,51188,3300,8075,842,59263,2419,2238,1754,18185,14020
CGAGGCAGGTAGAATG,Pos_Ctrl,59173,58487,2320,56167,2768,53399,44094,4616,3132,445,47226,1112,5688,7079,3902,1190
CATGATTCGTAGAATG,sample,107865,106372,4842,101530,13395,88135,52044,4947,21465,2542,73509,7137,4669,2164,10952,9421
GTCCTGCCGTAGAATG,sample,94705,93180,3128,90052,19148,70904,54547,3795,9142,1226,63689,2194,1964,1390,19171,13812
ACGTATTAGTAGAATG,sample,126821,124478,11111,113367,14424,98943,37213,2127,32750,3340,69963,23513,8382,1985,13921,9181
TTGGCCTCGTAGAATG,sample,53045,51882,5073,46809,6125,40684,13048,885,15052,1536,28100,10163,5158,1129,2362,3531
ACCAATGCGTAGAATG,Pos_Ctrl,93674,92361,3913,88448,3747,84701,70127,7155,5076,658,75203,1685,5951,8323,3953,1245
GAAGGCGCGTAGAATG,sample,167658,165506,14325,151181,14872,136309,37478,2499,49486,5545,86964,41301,11244,2350,10690,8751
GTCTTAGCGTAGAATG,sample,97149,95643,4606,91037,10018,81019,43930,3949,20812,2745,64742,9583,4607,2037,6711,6756
CCAATTCCGTAGAATG,sample,122030,120183,8629,111554,12942,98612,49841,3851,28120,3386,77961,13414,5503,1806,10483,8806
TCAATATAGTAGAATG,sample,97660,95708,6483,89225,11792,77433,35684,2533,22416,2236,58100,14564,6330,1397,7991,7526
AGGTCGGAGTAGAATG,sample,121213,119392,8652,110740,15866,94874,46592,4273,24445,2565,71037,16999,6123,1682,15352,9496
ATGACCGAGTAGAATG,sample,171795,169692,8360,161332,19121,142211,76268,5374,39802,4382,116070,16385,6304,1954,20886,12685
GGTTGCGTCAATAGTC,sample,111512,110503,2859,107644,29663,77981,62653,4604,7120,696,69773,2908,2337,1987,18189,18941
TCCTCCGTCAATAGTC,sample,55682,55012,2116,52896,11678,41218,28284,2211,7129,956,35413,2638,2770,1575,10117,7992
AGTACCATCAATAGTC,sample,89891,88089,4398,83691,12850,70841,52702,5278,8392,1212,61094,3257,2581,1861,8415,8670
TTAGAAGTCAATAGTC,sample,15706,13388,2717,10671,651,10020,702,46,4212,458,4914,4602,2247,232,137,156
GGACCTCTCAATAGTC,sample,85158,83802,4946,78856,15109,63747,31483,1949,15828,1490,47311,12997,5630,1485,12348,9746
GCCTTGCTCAATAGTC,sample,109807,108095,6187,101908,17936,83972,42319,3050,21094,2209,63413,15300,7122,2042,12251,11974
CAAGGCCTCAATAGTC,sample,69087,68132,3869,64263,10447,53816,22901,1420,16325,1909,39226,11261,5444,1424,6013,6716
CCAGAGCGCAATAGTC,sample,66508,65526,4026,61500,8529,52971,31426,1888,11277,1220,42703,7160,4676,1723,8672,5678
CGAGGCAGCAATAGTC,sample,78978,77804,4732,73072,11511,61561,26230,1640,17814,2075,44044,13802,5901,1400,8974,7196
CCATGAAGCAATAGTC,sample,62616,60580,3046,57534,10722,46812,32459,2275,8448,965,40907,2665,2125,1409,9846,7560
AATCCGTCCAATAGTC,sample,70105,69425,4462,64963,8027,56936,27366,1983,16784,2120,44150,8683,4848,1778,8169,5391
CGTACGTCCAATAGTC,sample,68015,67028,4055,62973,13642,49331,29157,1813,10765,1024,39922,6572,3043,1107,12817,8993
AGTCCGCACAATAGTC,sample,70753,69900,4590,65310,10820,54490,29629,2337,14188,1721,43817,6615,3384,1534,8323,7585
GTCCTGCCCAATAGTC,sample,41576,41052,3418,37634,5401,32233,13049,699,10315,1257,23364,6913,4490,1235,5446,3539
CGGATTACCAATAGTC,sample,23676,23264,1984,21280,3407,17873,8095,549,5685,637,13780,2907,2735,1058,3036,2291
TTGGCCTCCAATAGTC,sample,51952,51187,3035,48152,8656,39496,21897,2102,9237,959,31134,5301,3799,1424,7105,5703
TGCTTCGCCAATAGTC,sample,47223,46303,3615,42688,6546,36142,18231,1307,9266,1046,27497,6292,3781,1137,5902,4188
AAGAGCGCCAATAGTC,sample,54490,53487,5500,47987,4999,42988,11702,789,16676,1522,28378,12299,5980,1150,3053,2794
GGCATATACAATAGTC,sample,57382,56253,3825,52428,7560,44868,23353,1426,11275,1403,34628,7411,4712,1503,6257,5007
GACCGGAACAATAGTC,sample,78944,77827,5779,72048,9157,62891,25828,1593,19430,1940,45258,14100,6274,1345,7941,5943
TCCAACTTCGTTACTC,Neg_Ctrl,716,623,82,541,99,442,281,18,83,8,364,52,168,94,107,69
AAGTTCGTCGTTACTC,sample,153360,151904,5094,146810,44131,102679,73668,4349,16138,1802,89806,6722,3758,1781,31763,27877
GGTTGCGTCGTTACTC,sample,212706,210631,9206,201425,52740,148685,89237,5204,31726,3608,120963,18910,6561,2198,36952,34673
ACGTTATGCGTTACTC,sample,197749,195471,9032,186439,46957,139482,85760,5433,29570,3504,115330,15215,4848,1848,37887,30476
ATGCCTGGCGTTACTC,sample,134714,133094,5840,127254,26594,100660,65179,3766,20350,2469,85529,8896,4800,1817,26488,18672
CAACCGCGCGTTACTC,sample,72605,71725,4357,67368,12776,54592,27673,2172,15115,1584,42788,8048,5192,2148,9205,8237
AATGGTAACGTTACTC,sample,85421,84417,7122,77295,10584,66711,24659,1745,23505,2398,48164,14404,6351,1880,6776,6757
TTAGAAGTCGTTACTC,sample,135740,134341,8758,125583,26341,99242,53124,4388,25507,2502,78631,13721,6072,2281,18543,18498
TCGCATCTCGTTACTC,Neg_Ctrl,6533,4440,3488,952,147,805,352,28,192,39,544,194,260,133,110,71
GCCTTGCTCGTTACTC,sample,31416,30888,2474,28414,5403,23011,10887,650,7091,776,17978,3607,3103,1185,4638,3711
CATAACCTCGTTACTC,sample,65876,64805,3602,61203,10399,50804,23717,2029,16893,1707,40610,6458,3910,1711,6277,7290
GACGGAGACGTTACTC,sample,45602,44953,3812,41141,4685,36456,13669,1189,13124,1392,26793,7082,4892,1820,2687,2967
CCAGAGCGCGTTACTC,sample,66690,65785,5343,60442,15781,44661,26339,1328,9792,1015,36131,6187,3605,1339,12557,10334
CCGCAACGCGTTACTC,sample,21764,21438,1907,19531,4426,15105,6711,516,4597,474,11308,2807,3041,1217,2142,2786
GGACGTAGCGTTACTC,sample,76459,75529,6555,68974,11835,57139,22249,1760,19297,2045,41546,11788,6789,2297,6129,7353
CTTGATAGCGTTACTC,sample,120479,119158,5370,113788,28383,85405,60095,3617,13990,1719,74085,5984,3232,1769,24061,18900
CCATGAAGCGTTACTC,Neg_Ctrl,6060,3112,2333,779,139,640,347,26,184,17,531,66,209,103,124,45
ACGACTTCCGTTACTC,sample,81318,80072,3445,76627,17487,59140,43159,2617,9581,1166,52740,2617,2586,1730,18212,11674
AATCCGTCCGTTACTC,sample,94867,93918,5122,88796,19557,69239,42726,3289,14118,1755,56844,7351,4989,2455,13367,13446
AGTCCGCACGTTACTC,sample,122284,120657,7393,113264,29839,83425,58047,3884,13742,1816,71789,5936,3941,2007,19800,19888
ACGTATTACGTTACTC,sample,142040,140059,5858,134201,15381,118820,65820,3750,34971,3692,100791,10587,3826,2089,12222,9172
AATATATCCGTTACTC,sample,100812,99136,6059,93077,18796,74281,41529,2881,18990,2399,60519,8482,4908,1580,14976,12984
TGCTTCGCCGTTACTC,Neg_Ctrl,5946,3234,2364,870,90,780,297,23,236,12,533,212,244,115,70,98
AAGAGCGCCGTTACTC,sample,135292,132920,5579,127341,26202,101139,75950,5734,12712,2043,88662,4700,2382,1480,28617,19165
GTACCGTACGTTACTC,sample,155608,153017,11161,141856,20415,121441,58571,4883,32903,3032,91474,22052,7487,2033,18815,14293
GGCATATACGTTACTC,sample,109989,108113,6494,101619,16536,85083,43761,3216,22125,2107,65886,13874,5109,1618,15947,11971
AGGTCGGACGTTACTC,sample,131617,128961,8161,120800,21960,98840,65345,4051,18544,3928,83889,6972,2681,1273,22043,15666
TTATTCGACGTTACTC,sample,206732,203982,15323,188659,22097,166562,61431,3684,54589,5303,116020,41555,10651,2546,14905,14607
ATGACCGACGTTACTC,sample,128997,126441,9930,116511,13360,103151,31205,2198,38598,4456,69803,26694,8068,1628,4818,8148
GACCGGAACGTTACTC,sample,155891,153933,7887,146046,22970,123076,57023,5049,33884,3621,90907,23499,7883,1998,15138,16024
TATCAGTTTGGACTGC,sample,95139,94378,2915,91463,21339,70124,54321,3558,8461,910,62782,2874,3241,2371,19925,14515
AAGTTCGTTGGACTGC,sample,73977,73249,2371,70878,16980,53898,38498,3256,7827,871,46325,3446,4127,3070,8991,11685
ACGTAAGTTGGACTGC,sample,68802,67776,3525,64251,14014,50237,29071,2408,12078,1311,41149,5369,3924,1520,10735,9459
CCTCTAGATGGACTGC,sample,91370,90241,3076,87165,19141,68024,45543,2960,13365,1710,58908,4446,3208,1940,16467,13149
TTCTAATGTGGACTGC,sample,104790,103607,3933,99674,34374,65300,51027,2320,9006,1170,60033,1777,1677,1348,23275,21118
TAGTACGGTGGACTGC,sample,63937,63138,2544,60594,15196,45398,31576,1879,7516,1409,39092,3018,2898,1856,11049,10178
CATAACCTTGGACTGC,sample,69011,68059,3439,64620,14067,50553,31189,1943,11086,1051,42275,5284,3841,1459,13918,9655
ACCTCGAGTGGACTGC,sample,48406,47734,2628,45106,8926,36180,19842,1355,8439,920,28281,5624,3864,1494,8967,6002
CATTGCAGTGGACTGC,sample,67737,66840,3934,62906,11114,51792,25266,1545,15548,1391,40814,8042,4394,1489,8719,7680
CCATGAAGTGGACTGC,sample,44385,43741,2944,40797,7846,32951,17591,1001,8342,971,25933,5046,3791,1250,7671,5347
AATCCGTCTGGACTGC,sample,68193,67276,5676,61600,10207,51393,19126,1208,16605,1745,35731,12709,6378,1492,8303,6907
CTAGGACCTGGACTGC,sample,59864,59191,3534,55657,11495,44162,27885,1736,8659,1014,36544,4868,3248,1578,12930,7980
GTTAGGACTGGACTGC,sample,65119,64123,5072,59051,7193,51858,21852,985,17672,1706,39524,9643,5078,1539,7919,4553
CGTATGAATGGACTGC,sample,93999,92404,7365,85039,11735,73304,30459,2256,22992,2448,53451,15149,6167,1497,9861,7880
AATATATCTGGACTGC,sample,121638,120240,6590,113650,17991,95659,48653,3490,25430,2810,74083,15276,6004,1713,17841,12215
ACCAATGCTGGACTGC,sample,85324,83912,4368,79544,10433,69111,38415,2721,18192,2433,56607,7350,3955,1560,10807,7298
CCAATTCCTGGACTGC,sample,61613,60141,4783,55358,8344,47014,19201,1102,15267,1604,34468,9840,5080,1197,5563,5152
TTGGTTAATGGACTGC,sample,99391,98006,6470,91536,14242,77294,36284,2476,20994,1965,57278,15575,5526,1720,11542,9669
TTATTCGATGGACTGC,sample,123050,121697,8546,113151,11095,102056,34607,3045,36918,4230,71525,23256,8619,2165,7852,6756
GACCGGAATGGACTGC,sample,50148,49484,2162,47322,6668,40654,22786,2005,10424,1370,33210,4069,2589,1116,6697,4597
AAGTTCGTCCTTGAGC,sample,136625,134512,7549,126963,29418,97545,55849,3690,22401,2873,78250,12732,6042,1802,22356,19704
TCCTCCGTCCTTGAGC,sample,167260,165178,10788,154390,21600,132790,66679,4604,36997,4128,103676,20382,8006,2356,20105,14885
CCTCTAGACCTTGAGC,sample,146651,144496,8818,135678,18129,117549,54441,3903,36931,4026,91372,18248,6574,1959,15548,12565
TTCGTAATCCTTGAGC,Pos_Ctrl,61830,61201,3342,57859,3479,54380,45074,4378,3392,389,48466,1147,5842,7111,5264,1723
TTCTAATGCCTTGAGC,sample,60536,59741,5780,53961,7857,46104,17087,1128,15115,1625,32202,11149,5863,1618,6472,5029
ATGCCTGGCCTTGAGC,sample,91234,90093,6482,83611,13714,69897,33792,2167,21145,2256,54937,10537,5151,1807,9283,9296
AATGGTAACCTTGAGC,sample,149797,146534,8506,138028,16311,121717,67794,5658,29978,4048,97772,14239,4928,1551,15897,10394
TTAGAAGTCCTTGAGC,sample,158469,155649,6749,148900,12997,135903,64708,4948,43282,5132,107990,17833,4614,1662,6228,7909
TCGCATCTCCTTGAGC,sample,197819,194992,11554,183438,26537,156901,76182,5958,43822,5697,120004,25242,9213,2612,16952,16898
CAAGGCCTCCTTGAGC,sample,127029,125604,12025,113579,18097,95482,39841,2565,28047,2991,67888,22038,8742,2594,16098,11725
GTTAGCCGCCTTGAGC,Pos_Ctrl,71560,70835,3442,67393,3781,63612,53033,5199,3705,444,56738,1231,6011,8015,5228,1672
CTTGATAGCCTTGAGC,sample,109692,108271,3659,104612,25003,79609,61628,4968,8823,1273,70451,2917,3261,2714,13767,16487
TGGACGAGCCTTGAGC,sample,77926,76904,3475,73429,12770,60659,40117,2664,12181,1241,52298,4456,2893,1395,13977,9735
ACGACTTCCCTTGAGC,sample,76673,75537,7243,68294,9099,59195,25331,1255,17485,2010,42816,13114,6701,1777,12096,5706
CATGATTCCCTTGAGC,sample,46593,45678,3808,41870,5949,35921,13801,869,13453,1475,27254,6323,4341,1248,4058,3710
AGTCCGCACCTTGAGC,sample,73428,72300,3745,68555,14841,53714,38630,2761,9027,971,47657,2325,2962,2293,9624,9673
GTCCTGCCCCTTGAGC,sample,21257,20812,1963,18849,2732,16117,5685,463,6010,721,11695,3238,3462,1193,1787,1651
TTGGTACCCCTTGAGC,Pos_Ctrl,55259,54573,3017,51556,2962,48594,40235,3894,3035,387,43270,1043,5625,6698,4402,1540
CTAGGACCCCTTGAGC,sample,106880,105496,5145,100351,28869,71482,54578,3744,9323,881,63901,2956,2673,1897,19564,18899
CGGATTACCCTTGAGC,sample,70886,69635,4427,65208,8836,56372,25524,1905,18618,2612,44142,7713,4477,1750,4926,6071
GCCTGAACCCTTGAGC,sample,107019,104896,7136,97760,16524,81236,47285,2927,18168,2144,65453,10712,5246,1482,19875,11909
CGTATGAACCTTGAGC,sample,121479,119410,5920,113490,19678,93812,61807,4303,18177,2322,79984,7203,4485,1831,17939,13874
TTGGCCTCCCTTGAGC,sample,31644,31050,1337,29713,6048,23665,13681,1289,5681,684,19362,2330,2924,1824,1297,4146
AATATATCCCTTGAGC,sample,138750,136901,10704,126197,19494,106703,43175,3135,32966,3637,76141,23790,8039,1763,16835,13017
ACCAATGCCCTTGAGC,sample,146032,143903,8235,135668,21392,114276,60192,3317,29276,3455,89468,18036,6387,1926,22258,16090
GTCTTAGCCCTTGAGC,sample,111445,109371,5374,103997,14311,89686,44218,4245,26598,3118,70816,11507,4737,1552,13051,10735
CCAATTCCCCTTGAGC,sample,152959,150526,11013,139513,16770,122743,49437,3622,36353,4034,85790,29297,10052,2451,12787,10911
GGCATATACCTTGAGC,sample,116807,115111,6687,108424,17881,90543,64942,4791,13046,1689,77988,6075,3883,1956,17298,12730
CTTCATGACCTTGAGC,sample,121008,119052,7203,111849,13521,98328,49053,3671,28506,3343,77559,13755,5966,1876,11876,8898
AGGTCGGACCTTGAGC,Pos_Ctrl,58864,57844,3279,54565,2698,51867,42798,4222,3280,401,46078,1166,5549,6806,3486,1146
TTATTCGACCTTGAGC,sample,145724,144235,4608,139627,26708,112919,88828,6499,10987,1761,99815,4844,3456,2222,19227,17942
GGTTGCGTCGATATCC,sample,49108,48613,2182,46431,11920,34511,21515,1291,7234,705,28749,3766,3013,1469,7726,7909
ACGTTATGCGATATCC,sample,100225,99390,3907,95483,29684,65799,45310,2603,11332,1399,56642,5155,3202,1448,21899,19101
ATGCCTGGCGATATCC,sample,79855,79244,2882,76362,14754,61608,37919,3227,14442,1658,52361,4362,3592,1962,13169,10017
TAGTACGGCGATATCC,sample,72656,71985,2671,69314,16460,52854,33368,2915,10754,1334,44122,4483,4159,2501,5695,10861
ACTATACTCGATATCC,sample,132228,131168,5515,125653,34622,91031,61501,4197,16028,1928,77529,7377,4098,1692,27380,22211
GGACGTAGCGATATCC,sample,103780,102560,4715,97845,22100,75745,43141,2819,17117,1967,60258,10701,4684,1508,17874,14505
ACCTCGAGCGATATCC,sample,66703,65665,4019,61646,11031,50615,25246,1815,13691,1542,38937,8321,5002,1327,9154,7607
AATCCGTCCGATATCC,sample,106710,105641,6685,98956,20693,78263,43567,3014,17220,1676,60787,12786,5162,1724,18758,13617
AATATATCCGATATCC,sample,136967,135516,7308,128208,26610,101598,65934,3165,19946,1909,85880,10644,3951,1590,24345,18013
GTCTTAGCCGATATCC,sample,84373,81833,5995,75838,10829,65009,30363,1613,18831,2221,49194,11981,5411,1255,8026,8509
TCGCCTGACGATATCC,sample,99216,97948,3992,93956,18674,75282,55941,3956,10912,1078,66853,3395,2669,1818,15574,13467
GACCGGAACGATATCC,sample,19987,19331,868,18463,3730,14733,7808,582,3942,497,11750,1904,2214,1024,1729,2363
ACGTAAGTATCTGACC,sample,31341,30905,2745,28160,5073,23087,8552,554,7841,854,16393,5286,4206,1299,2992,3342
ACGTTATGATCTGACC,Neg_Ctrl,2725,1470,1006,464,77,387,180,17,120,6,300,64,161,63,79,27
ATGCCTGGATCTGACC,sample,52857,52352,2850,49502,8996,40506,20266,1394,10669,1247,30935,6930,4617,1551,6781,5950
CAACCGCGATCTGACC,sample,36876,36350,2158,34192,5180,29012,13142,976,9317,1252,22459,4325,3435,1362,3115,3432
GGACCTCTATCTGACC,sample,78463,77581,5718,71863,8587,63276,27013,2002,19496,2588,46509,12177,6101,1864,7760,5808
GCCTTGCTATCTGACC,sample,40149,39648,2627,37021,5655,31366,14362,1064,9365,1074,23727,5501,3591,1164,5584,3795
CAAGGCCTATCTGACC,sample,68459,67771,3230,64541,14363,50178,28072,1980,12512,1164,40584,6450,3326,1355,11258,9619
CATAACCTATCTGACC,sample,50196,49628,2917,46711,9347,37364,21576,1292,8278,982,29854,5236,3468,1293,9899,6549
GACGGAGAATCTGACC,sample,61834,61165,3693,57472,8154,49318,23147,1757,15195,1804,38342,7415,4781,1719,6211,5429
GGAGGACGATCTGACC,Neg_Ctrl,1471,778,522,256,40,216,88,14,65,11,153,38,82,38,44,23
CCGCAACGATCTGACC,sample,283,265,21,244,59,185,107,18,35,4,142,21,69,45,28,39
GGACGTAGATCTGACC,sample,70779,69932,3987,65945,11004,54941,27634,1714,15335,1636,42969,8622,4832,1582,9704,7510
CCATGAAGATCTGACC,sample,33738,33249,2195,31054,5046,26008,13132,913,7449,830,20581,3684,3012,1109,4874,3477
CTAGGACCATCTGACC,Neg_Ctrl,2573,1585,976,609,81,528,167,14,156,12,323,179,164,66,60,76
GTTAGGACATCTGACC,sample,30495,29956,1791,28165,3959,24206,11736,908,7566,1056,19302,2940,2617,1171,3275,2655
GCCTGAACATCTGACC,sample,48742,47804,2226,45578,10356,35222,26509,1610,4724,405,31233,1974,1856,1347,8440,7181
AACTCGTAATCTGACC,sample,75466,74491,5818,68673,8713,59960,24247,1806,19342,2171,43589,12394,6117,1577,6841,6037
ACCAATGCATCTGACC,sample,42921,42024,2467,39557,8583,30974,21256,1444,5235,541,26491,2498,1925,1174,6351,5953
AAGAGCGCATCTGACC,sample,40978,40304,3567,36737,3888,32849,11032,1224,11867,1493,22899,7233,4211,1251,1468,2371
GTACCGTAATCTGACC,sample,78486,77403,5395,72008,9998,62010,28912,1923,16868,1597,45780,12710,5303,1430,8389,6480
TCAATATAATCTGACC,sample,109402,108057,10568,97489,13080,84409,35816,2677,24754,2482,60570,18680,5505,1524,13484,8905
TCGCCTGAATCTGACC,sample,35573,34791,1785,33006,4397,28609,16028,1520,7432,895,23460,2734,2245,1148,3663,2983
TTATTCGAATCTGACC,Neg_Ctrl,2203,1117,789,328,48,280,124,16,75,5,199,60,115,52,42,19
GACCGGAAATCTGACC,sample,2923,2593,226,2367,376,1991,990,79,500,49,1490,373,583,303,349,228
ATTCTCTTCTTCTTAC,sample,108595,107457,4442,103015,13257,89758,41216,3147,28558,4396,69774,12441,4792,1786,9388,8652
TCCAACTTCTTCTTAC,sample,162732,160799,6181,154618,44239,110379,77820,4765,17611,2462,95431,7721,3690,1567,32612,28510
AAGTTCGTCTTCTTAC,sample,131623,129943,5626,124317,27805,96512,60063,4358,19205,1797,79268,11089,4610,1767,25399,19186
TGAGCGCGCTTCTTAC,sample,114207,112791,6216,106575,17291,89284,40642,2451,25528,2800,66170,17863,6725,1601,15997,12428
TTAGAAGTCTTCTTAC,sample,232381,230179,15206,214973,31611,183362,66184,4164,60736,6458,126920,45820,11786,3043,25087,22315
GCCTTGCTCTTCTTAC,sample,112472,111036,6302,104734,21831,82903,52985,3382,15988,2790,68973,7758,2730,1494,20370,15022
CAAGGCCTCTTCTTAC,sample,128883,127356,5081,122275,22496,99779,60606,4332,22984,3088,83590,8769,4010,1627,20917,15864
ACTATACTCTTCTTAC,sample,205395,203496,10429,193067,37093,155974,80273,5540,40223,4406,120496,25532,8277,2345,28170,26718
CCGCAACGCTTCTTAC,sample,57114,56459,2533,53926,11102,42824,29502,2440,6751,809,36253,3322,4015,2611,7562,7755
GGACGTAGCTTCTTAC,sample,25419,25048,1799,23249,5991,17258,8715,620,4618,505,13333,2800,2992,1360,3062,3644
ACCTCGAGCTTCTTAC,sample,119388,117859,8861,108998,17011,91987,38990,1893,27038,2993,66028,21073,7626,1646,18296,11820
CGTACGTCCTTCTTAC,sample,67670,66641,3591,63050,16132,46918,29287,1658,9916,1135,39203,4922,2377,1178,14309,11166
AGTCCGCACTTCTTAC,sample,31664,30999,2712,28287,4937,23350,11273,747,7110,817,18383,3403,2928,1136,4336,3355
CTAGGACCCTTCTTAC,sample,60516,59697,2602,57095,16715,40380,30556,1811,5382,509,35938,2122,2104,1396,13779,10720
CGGATTACCTTCTTAC,sample,40073,39470,1440,38030,6091,31939,21451,1576,6281,715,27732,1916,2784,2079,5588,4308
TTGGCCTCCTTCTTAC,sample,126804,125337,10098,115239,16406,98833,34612,2417,32556,3293,67168,25955,9244,2101,10545,10673
ACCAATGCCTTCTTAC,sample,32589,31913,3403,28510,3322,25188,6449,476,10121,1014,16570,7128,4354,1000,1447,1811
AAGAGCGCCTTCTTAC,sample,68337,67328,3734,63594,9897,53697,30531,2328,12072,1433,42603,7333,4327,1848,6909,6304
GTCTTAGCCTTCTTAC,sample,96029,94768,7718,87050,11179,75871,22338,1365,27480,2801,49818,21887,8281,1626,7466,7162
CCAATTCCCTTCTTAC,sample,70733,68956,2673,66283,14640,51643,40019,2064,7272,690,47291,1598,1463,1032,18151,10178
TTGGTTAACTTCTTAC,sample,77741,76573,3034,73539,14065,59474,39404,3069,11604,1416,51008,3981,3187,1532,11278,9961
GTACCGTACTTCTTAC,sample,95909,94508,3684,90824,18033,72791,54478,3851,10111,812,64589,3539,2375,1483,17932,12651
TCAATATACTTCTTAC,sample,116570,114656,5630,109026,21410,87616,57191,3670,16955,2121,74146,7679,3621,1574,19128,15104
CTTCATGACTTCTTAC,sample,91318,89860,6198,83662,9778,73884,29767,1758,26450,4017,56217,11892,5328,1547,6862,6036
AGGTCGGACTTCTTAC,sample,81646,80585,5097,75488,9580,65908,32634,2788,19590,2677,52224,8219,3874,1495,9925,6590
ATGACCGACTTCTTAC,sample,75157,74099,4141,69958,12572,57386,36160,2508,11724,1449,47884,5545,4031,1801,10994,8544
ATTCTCTTACTTCTAC,sample,149206,147666,13098,134568,15320,119248,31983,2063,43993,4840,75976,36369,10986,2253,11675,9706
GGTTGCGTACTTCTAC,sample,91163,90366,4947,85419,19550,65869,39678,2862,13817,1771,53495,7741,5118,2409,15784,12673
ACGTAAGTACTTCTAC,sample,83150,82169,4693,77476,11963,65513,34756,2658,17547,1947,52303,8605,4204,1573,10996,7848
CCTCTAGAACTTCTAC,sample,54820,53951,5040,48911,6506,42405,9885,756,17560,1893,27445,12311,6167,1302,1806,3969
TTCGTAATACTTCTAC,sample,97652,96599,4645,91954,16301,75653,38379,2538,18141,2153,56520,14442,5680,1522,18683,11234
ACGTTATGACTTCTAC,sample,77677,76683,5674,71009,11938,59071,28866,1611,16060,1808,44926,10726,5547,1557,12472,7891
CAACCGCGACTTCTAC,sample,53264,52468,1844,50624,13875,36749,29574,1566,4176,486,33750,947,1186,1056,13309,9323
TTAGAAGTACTTCTAC,sample,80255,79347,3702,75645,15961,59684,38301,3012,12176,1205,50477,4990,3521,1619,13064,11405
CATAACCTACTTCTAC,sample,84842,83780,4390,79390,10352,69038,34672,2338,20357,2608,55029,9063,4791,1693,10245,7062
GGACGTAGACTTCTAC,sample,75798,74874,4374,70500,11741,58759,30267,1606,15316,1873,45583,9697,5260,1523,12785,8373
ACCTCGAGACTTCTAC,sample,22768,22438,956,21482,4701,16781,10839,775,3548,367,14387,1252,1967,1278,3560,3232
TGGACGAGACTTCTAC,sample,59199,58546,3782,54764,8994,45770,19274,1242,14219,1704,33493,9331,5402,1580,6164,6078
GGCCAGAGACTTCTAC,sample,47870,47201,2504,44697,5704,38993,24218,1570,7835,985,32053,4385,3512,1839,3619,3723
CATTGCAGACTTCTAC,sample,87327,86173,6839,79334,9790,69544,26649,2127,22881,2691,49530,15196,6830,1617,9700,6557
ACGACTTCACTTCTAC,sample,65465,64620,3892,60728,10292,50436,26409,1315,13836,1552,40245,7324,4706,1362,10000,7419
CGTACGTCACTTCTAC,sample,73884,72720,4525,68195,9913,58282,30171,2267,16360,1992,46531,7492,4629,1629,7897,6737
TTGGTACCACTTCTAC,sample,77092,76048,3980,72068,13194,58874,31818,2281,13988,1533,45806,9254,4336,1319,12993,9160
CTAGGACCACTTCTAC,sample,97398,96193,4127,92066,18494,73572,48627,2805,13345,1873,61972,6922,3617,1432,18725,13912
CGGATTACACTTCTAC,sample,88741,87592,5658,81934,7922,74012,30506,2113,23070,2968,53576,15355,6103,1700,6785,4958
AACTCGTAACTTCTAC,sample,75281,74305,3870,70435,8110,62325,30799,2222,18535,1897,49334,8872,4576,1663,6122,5353
CGTATGAAACTTCTAC,sample,76813,75750,3161,72589,13262,59327,37352,3133,11889,1796,49241,5157,3719,1502,14722,9486
TTGGCCTCACTTCTAC,sample,23426,22909,1421,21488,2751,18737,6942,696,7255,804,14197,3040,2890,1084,1137,1712
GAAGGCGCACTTCTAC,sample,4120,3721,279,3442,409,3033,1220,83,1064,124,2284,542,991,443,116,242
TTGGTTAAACTTCTAC,sample,3955,3750,221,3529,620,2909,1892,148,559,59,2451,251,761,525,534,420
GTACCGTAACTTCTAC,sample,3265,2978,250,2728,486,2242,1425,90,448,44,1873,235,588,376,562,284
TCGCCTGAACTTCTAC,sample,3220,2980,209,2771,410,2361,1364,89,576,82,1940,250,623,370,443,258
CTTCATGAACTTCTAC,sample,13441,12924,726,12198,1610,10588,4983,394,3361,401,8344,1449,1724,840,774,942
GACCGGAAACTTCTAC,sample,65264,64549,3615,60934,6102,54832,23122,1583,17694,2295,40816,10138,5585,1749,3705,3860
GGAGAGTTAGAAGTAA,sample,173417,171772,9848,161924,28481,133443,69892,4254,37449,4597,107341,17251,7049,1947,31868,19389
CCTCTAGAAGAAGTAA,sample,33632,33322,1313,32009,9402,22607,15421,1557,3805,395,19226,1429,2317,1817,3912,5886
TTCGTAATAGAAGTAA,sample,140103,138942,12781,126161,12992,113169,26182,1757,45414,4932,71596,34884,10649,2424,6078,7457
TGAGCGCGAGAAGTAA,sample,146842,145182,8977,136205,26492,109713,52478,3948,28715,3157,81193,21415,8140,1936,17006,17521
CAACCGCGAGAAGTAA,sample,71019,70249,3822,66427,8529,57898,23171,1745,21346,2992,44517,8644,5001,1814,4172,5818
TTAGAAGTAGAAGTAA,sample,118635,117523,10597,106926,18073,88853,35277,1930,27205,3204,62482,21237,7533,1719,15036,11515
GGACCTCTAGAAGTAA,sample,104721,103557,5048,98509,22753,75756,49567,3124,13628,1385,63195,8052,4501,1836,17529,15333
CATAACCTAGAAGTAA,sample,140039,138830,4786,134044,24979,109065,75535,5815,19479,2053,95014,6183,3776,2287,19686,17624
ACTATACTAGAAGTAA,sample,140850,139369,6037,133332,24803,108529,59026,5525,28616,3330,87642,12032,5082,1824,17092,17353
GTTAGCCGAGAAGTAA,sample,99963,98914,4008,94906,20131,74775,48073,2619,14041,1879,62114,8163,4580,1367,23097,13766
GGACGTAGAGAAGTAA,sample,149072,147555,10182,137373,20102,117271,46956,3648,37535,3978,84491,25154,8671,2052,17247,13110
GGCCAGAGAGAAGTAA,sample,69180,67956,4236,63720,12343,51377,25725,1675,14673,1255,40398,8049,4476,1197,8923,7912
CGAGGCAGAGAAGTAA,sample,155925,154308,8506,145802,26349,119453,61965,2930,31548,3628,93513,19382,7681,1826,28765,19148
AATCCGTCAGAAGTAA,sample,94426,93285,4669,88616,19580,69036,43075,2375,15166,1563,58241,6857,3836,1441,18448,13241
GCCTGAACAGAAGTAA,sample,91298,90177,4665,85512,12377,73135,37674,2479,21592,2426,59266,8964,5081,1872,10763,8498
TTGGCCTCAGAAGTAA,sample,519,497,62,435,57,378,182,12,101,16,283,67,168,73,49,43
TTGGTTAAAGAAGTAA,sample,581,552,54,498,69,429,223,14,116,7,339,69,192,99,54,65
AGGTCGGAAGAAGTAA,sample,1365,1272,148,1124,212,912,460,33,278,17,738,124,357,184,146,137
Short,Non_sample,0,NA,NA,NA,NA,NA,NA,NA,NA,NA,NA,NA,NA,NA,NA,NA
Unselected,Non_sample,0,NA,NA,NA,NA,NA,NA,NA,NA,NA,NA,NA,NA,NA,NA,NA
Undetermined,Non_sample,140876650,NA,NA,NA,NA,NA,NA,NA,NA,NA,NA,NA,NA,NA,NA,NA
