Barcode,Sample,Barcoded_Reads,Trimmed_Reads,Unmapped_Reads,Mapped_Reads,Multimapped_Reads,Uniquely_Mapped_Reads,Exon_Reads,Ambiguous_Exon_Reads,Intron_Reads,Ambiguous_Intron_Reads,Gene_Reads,Intergenic_Reads,No_of_Genes,No_of_Transcripts,Mitochondrial_Reads,Ribosomal_Reads
AAGTTCGTCGTTGGTT,sample,80143,79510,4537,74973,21150,53823,24523,1611,19371,2488,43894,5830,3005,1038,10718,13993
TCCTCCGTCGTTGGTT,sample,180058,178248,5025,173223,48093,125130,92945,7081,17436,1956,110381,5712,3411,2239,13920,32321
CCTCTAGACGTTGGTT,sample,224943,222961,21810,201151,31233,169918,64099,3555,58151,6021,122250,38092,9671,2214,15011,19404
ACGTTATGCGTTGGTT,sample,103640,102533,6385,96148,32818,63330,27256,1377,21219,2543,48475,10935,3956,723,13896,19676
ATGCCTGGCGTTGGTT,sample,101487,100599,10089,90510,14635,75875,16186,1918,35102,3796,51288,18873,6552,1050,1654,9385
CAACCGCGCGTTGGTT,sample,3213,3088,191,2897,897,2000,686,50,813,90,1499,361,592,194,177,522
AATGGTAACGTTGGTT,sample,394,380,46,334,85,249,102,3,80,8,182,56,82,19,59,56
TTAGAAGTCGTTGGTT,sample,297,283,54,229,56,173,61,1,56,11,117,44,63,19,25,37
TTCCGTCTCGTTGGTT,sample,281,264,42,222,38,184,60,3,65,6,125,50,64,21,25,27
CAAGGCCTCGTTGGTT,sample,330,318,43,275,70,205,64,3,100,5,164,33,94,27,20,50
CCGCAACGCGTTGGTT,sample,203,198,25,173,47,126,59,5,43,4,102,15,52,30,16,26
CTTGATAGCGTTGGTT,sample,37300,37070,2325,34745,10091,24654,9026,595,10500,1111,19526,3422,2493,765,2749,6417
GACGATAACGTTGGTT,sample,85155,84499,9001,75498,23506,51992,14761,766,21750,2289,36511,12426,5142,854,5926,14162
GGCCAGAGCGTTGGTT,sample,11752,11696,836,10860,3384,7476,2859,218,2721,390,5580,1288,1677,629,910,2030
AATCCGTCCGTTGGTT,sample,41764,41280,6698,34582,3299,31283,7223,513,14935,1387,22158,7225,4369,992,590,1786
CTAGGACCCGTTGGTT,sample,227021,224874,25665,199209,44015,155194,41244,2029,61541,6702,102785,43678,11049,1798,19441,27453
GCCTGAACCGTTGGTT,sample,124924,123846,11002,112844,22458,90386,39223,2651,31279,3387,70502,13846,6019,1586,11461,15230
TTGGCCTCCGTTGGTT,sample,75876,75362,4275,71087,20673,50414,28953,1652,13626,1227,42579,4956,3490,1425,8021,12790
GAAGGCGCCGTTGGTT,sample,54244,53703,4868,48835,15449,33386,13103,753,11894,1262,24997,6374,3806,987,4860,9177
AAGAGCGCCGTTGGTT,sample,108497,107414,13665,93749,16136,77613,12508,794,35553,3417,48061,25341,7555,1029,2275,10485
GGCATATACGTTGGTT,sample,274262,271979,32691,239288,36944,202344,40351,2034,85984,8712,126335,65263,13466,2256,16302,24665
AGGTCGGACGTTGGTT,sample,216472,214926,19254,195672,34487,161185,57058,2261,55727,5706,112785,40433,7029,1317,28445,23387
ATGACCGACGTTGGTT,sample,134775,133969,9861,124108,34838,89270,31167,1417,34355,3626,65522,18705,6348,1061,13375,22237
TATCAGTTCTATCGTT,sample,111105,110045,13564,96481,25497,70984,28410,1285,23893,2537,52303,14859,4433,1008,13529,16084
TCCAACTTCTATCGTT,sample,81073,80478,4205,76273,32005,44268,30867,1708,8841,1063,39708,1789,1334,818,16664,17888
TCCTCCGTCTATCGTT,sample,35689,35358,2993,32365,12753,19612,10229,658,5496,587,15725,2642,2226,869,4480,7185
CCTCTAGACTATCGTT,sample,52491,51942,4062,47880,15762,32118,15866,414,9799,680,25665,5359,2002,520,9286,9529
ATGCCTGGCTATCGTT,sample,26698,26284,4077,22207,3573,18634,3936,272,8233,1138,12169,5055,2948,462,1169,2211
AATGGTAACTATCGTT,sample,64444,64012,3838,60174,22650,37524,21700,605,10088,851,31788,4280,1565,470,14863,13268
TTCCGTCTCTATCGTT,sample,57900,57541,2676,54865,19811,35054,17091,807,11033,1684,28124,4439,2150,601,9656,11536
GGACCTCTCTATCGTT,sample,30816,30549,3241,27308,6792,20516,7925,346,7513,704,15438,4028,2488,467,4562,4497
TCGCATCTCTATCGTT,sample,71407,70795,4894,65901,22855,43046,19797,584,13413,1728,33210,7524,2682,601,10797,13705
CAAGGCCTCTATCGTT,sample,33083,32796,2814,29982,6788,23194,9915,402,8529,976,18444,3372,2467,677,4038,4392
ACTATACTCTATCGTT,sample,28943,28704,2410,26294,3775,22519,7621,526,9562,1051,17183,3759,2795,942,1315,2519
GACGGAGACTATCGTT,sample,34723,34422,1526,32896,12406,20490,10402,358,6334,606,16736,2790,1733,447,6174,7019
CCAGAGCGCTATCGTT,sample,41928,41453,5751,35702,11049,24653,8347,319,8575,1066,16922,6346,2591,440,5271,6084
GGAGGACGCTATCGTT,sample,46806,46328,6229,40099,9922,30177,8528,383,11812,1305,20340,8149,3930,589,4487,6201
GACGATAACTATCGTT,sample,44359,43848,6830,37018,8185,28833,8565,301,10484,1311,19049,8172,3914,608,4309,5143
GGCCAGAGCTATCGTT,sample,29713,29310,5473,23837,2715,21122,2768,216,9505,1099,12273,7534,3594,432,446,1596
CGAGGCAGCTATCGTT,sample,29252,28855,3951,24904,3826,21078,5240,232,9492,983,14732,5131,2900,618,686,2322
AATCCGTCCTATCGTT,sample,143786,141953,28506,113447,16009,97438,14360,795,41175,4374,55535,36734,9358,1067,6036,8730
TTGGTACCCTATCGTT,sample,83298,82627,5061,77566,25941,51625,25310,983,14820,1690,40130,8822,3008,620,15253,16561
CTAGGACCCTATCGTT,sample,58737,58148,8186,49962,9280,40682,9665,507,16617,1798,26282,12095,4627,715,3384,5671
GCCTGAACCTATCGTT,sample,39320,39087,2372,36715,16348,20367,11559,884,5029,647,16588,2248,2159,741,5784,8452
TTGGCCTCCTATCGTT,sample,37845,37521,5437,32084,6661,25423,6211,226,10762,1077,16973,7147,3634,544,2922,4065
AAGAGCGCCTATCGTT,sample,79812,79357,2844,76513,34126,42387,30005,1251,9015,481,39020,1635,815,465,15726,17938
TTGGTTAACTATCGTT,sample,85905,85521,3605,81916,31438,50478,31016,1571,11162,968,42178,5761,2367,562,17742,18212
GGCATATACTATCGTT,sample,62176,61904,2759,59145,25717,33428,18070,1158,9592,1088,27662,3520,2273,654,9205,13715
TTATTCGACTATCGTT,sample,16694,16603,1009,15594,6265,9329,4296,297,2943,408,7239,1385,1108,340,1630,3448
GGAGAGTTGTCTTCTT,sample,43751,43585,1865,41720,19816,21904,14477,735,4963,350,19440,1379,1154,589,7290,9999
ATTCTCTTGTCTTCTT,Pos_Ctrl,50304,49842,4006,45836,2499,43337,35983,3482,2580,332,38563,960,5276,5621,3352,1425
AAGTTCGTGTCTTCTT,sample,72300,71774,3814,67960,20932,47028,24829,1808,14534,1249,39363,4608,3040,1183,8691,13139
CCTCTAGAGTCTTCTT,Pos_Ctrl,45618,44559,3993,40566,2230,38336,31876,2736,2583,353,34459,788,5306,5383,3257,1299
TAGTACGGGTCTTCTT,sample,52850,52507,4119,48388,20089,28299,15790,513,7727,1029,23517,3240,988,397,9992,11019
CAACCGCGGTCTTCTT,sample,36000,35706,3127,32579,10913,21666,9969,228,6464,933,16433,4072,2426,437,6380,6458
TTAGAAGTGTCTTCTT,sample,88485,87586,9896,77690,13976,63714,18895,1183,28050,3049,46945,12537,5511,1169,5094,9104
TTCCGTCTGTCTTCTT,sample,53531,53206,3035,50171,24181,25990,14786,525,6715,702,21501,3262,1855,639,8516,11945
GGACCTCTGTCTTCTT,sample,42352,41974,2704,39270,13507,25763,13757,397,7409,1021,21166,3179,1536,548,7737,8135
CAAGGCCTGTCTTCTT,sample,21381,21116,1571,19545,3725,15820,5557,636,6724,651,12281,2252,2015,659,640,2713
CATAACCTGTCTTCTT,sample,91516,90466,15041,75425,14265,61160,13069,443,25372,2516,38441,19760,6934,804,6798,8739
GTTAGCCGGTCTTCTT,sample,38331,37745,5673,32072,7612,24460,6505,307,9262,966,15767,7420,3901,614,2320,4556
GGAGGACGGTCTTCTT,sample,66831,66133,7795,58338,13552,44786,13108,447,17685,1977,30793,11569,5140,825,6769,8769
CCGCAACGGTCTTCTT,sample,31736,31470,2063,29407,13657,15750,9121,349,4000,429,13121,1851,1052,412,5733,6937
TGGACGAGGTCTTCTT,sample,47334,46946,4980,41966,11054,30912,12645,754,10071,1069,22716,6373,2758,572,7343,7205
GACGATAAGTCTTCTT,sample,44018,43589,4145,39444,9659,29785,12225,494,10408,1328,22633,5330,2555,676,5708,6582
CATGATTCGTCTTCTT,sample,25383,25074,3808,21266,4313,16953,4761,177,6722,856,11483,4437,2606,440,2074,2629
CGTACGTCGTCTTCTT,sample,48335,47829,5814,42015,10496,31519,11397,559,11787,1189,23184,6587,3694,683,5702,6609
CGGATTACGTCTTCTT,sample,59042,58477,6128,52349,13801,38548,12336,525,14463,1780,26799,9444,4113,680,6237,8842
GCCTGAACGTCTTCTT,sample,36486,36122,2473,33649,11623,22026,10596,517,6747,846,17343,3320,2227,639,5090,6865
AACTCGTAGTCTTCTT,sample,48227,47687,5249,42438,9705,32733,7882,435,13210,1453,21092,9753,4688,843,2335,6179
GTCTTAGCGTCTTCTT,sample,25591,25318,2276,23042,7350,15692,4443,463,6529,717,10972,3540,2445,559,1220,4257
AGGTCGGAGTCTTCTT,Pos_Ctrl,35294,34775,2830,31945,1583,30362,25147,2292,2018,241,27165,664,4723,4717,1678,850
GACCGGAAGTCTTCTT,sample,42840,42557,1760,40797,15134,25663,14770,843,7401,622,22171,2027,1141,379,8415,9189
TATCAGTTTAGGCTCT,sample,70133,69447,5680,63767,9406,54361,19146,1096,22937,2965,42083,8217,4083,1145,1799,6496
TCCAACTTTAGGCTCT,sample,196027,194389,20068,174321,41965,132356,44429,2309,50513,5415,94942,29690,7659,1365,22458,26206
TCCTCCGTTAGGCTCT,sample,132682,131665,8897,122768,37040,85728,41690,1725,27880,2616,69570,11817,4211,1156,18606,23223
TTCTAATGTAGGCTCT,sample,202723,200750,16485,184265,54294,129971,49555,1912,43798,4791,93353,29915,7275,1231,27754,34676
TGAGCGCGTAGGCTCT,sample,141147,140426,5635,134791,58282,76509,52062,2556,16582,1829,68644,3480,988,493,36907,32225
CAACCGCGTAGGCTCT,sample,136482,135581,7748,127833,39570,88263,39572,1377,27352,3149,66924,16813,4545,1063,21977,25137
CAAGGCCTTAGGCTCT,sample,111047,109736,11925,97811,18565,79246,25488,1271,31927,3577,57415,16983,5856,1367,6463,12544
CATAACCTTAGGCTCT,sample,154109,152637,13183,139454,39945,99509,41146,2365,35242,4292,76388,16464,4381,1023,20517,26121
ACTATACTTAGGCTCT,sample,120622,119394,14485,104909,25717,79192,20375,1031,33228,3794,53603,20764,6368,1073,7423,14729
GACGGAGATAGGCTCT,sample,126804,125354,8596,116758,38807,77951,37131,1158,25376,2151,62507,12135,3836,809,20879,24001
TGGACGAGTAGGCTCT,sample,136435,135442,8207,127235,35721,91514,43878,2543,30518,3320,74396,11255,3856,979,24269,23985
GACGATAATAGGCTCT,sample,145857,144502,13581,130921,36721,94200,26289,1520,36061,4571,62350,25759,6789,1012,11054,22551
CCATGAAGTAGGCTCT,sample,84239,83328,5871,77457,34187,43270,18853,1198,13603,1276,32456,8340,4068,1025,5413,17567
CTAGGACCTAGGCTCT,sample,181910,180109,15096,165013,55267,109746,43118,2867,36498,3873,79616,23390,5309,1049,23109,31683
ACGTATTATAGGCTCT,sample,143362,142149,9867,132282,47142,85140,44100,2547,24529,2546,68629,11418,5198,1525,13871,27806
GTCTTAGCTAGGCTCT,sample,195364,193940,15593,178347,48296,130051,38983,1771,49371,6140,88354,33786,8947,1601,17198,30431
TATCAGTTTTGACTAT,sample,67285,66762,4224,62538,21595,40943,21879,579,11471,1460,33350,5554,1796,478,15618,13150
TCCAACTTTTGACTAT,Neg_Ctrl,1009,521,363,158,20,138,40,1,75,4,115,18,46,16,20,8
AGTACCATTTGACTAT,Neg_Ctrl,1721,1219,882,337,32,305,55,4,166,0,221,80,45,11,23,35
ACGTTATGTTGACTAT,sample,74472,73498,10136,63362,10858,52504,17131,662,19734,2465,36865,12512,5038,862,7710,7355
TGAGCGCGTTGACTAT,sample,12822,12631,2384,10247,1590,8657,1635,85,3881,492,5516,2564,1744,296,337,911
TTCCGTCTTTGACTAT,Pos_Ctrl,41761,40930,4523,36407,2035,34372,28364,2378,2447,371,30811,812,4930,4705,2338,1251
GCCTTGCTTTGACTAT,sample,114539,112896,20559,92337,12325,80012,10049,409,36057,3596,46106,29901,8410,888,2749,7433
CATAACCTTTGACTAT,sample,72569,71502,9942,61560,13042,48518,11274,452,19792,1826,31066,15174,5041,678,5298,8170
ACTATACTTTGACTAT,sample,61000,60394,5025,55369,19052,36317,17401,710,10330,1324,27731,6552,2583,654,8870,11251
CCGCAACGTTGACTAT,Pos_Ctrl,36274,35130,4148,30982,1898,29084,24299,2001,1914,241,26213,629,4624,4424,2075,1151
TGGACGAGTTGACTAT,sample,63274,62186,16051,46135,3775,42360,3810,141,19511,2138,23321,16760,6792,487,846,1846
GACGATAATTGACTAT,sample,21278,21012,2554,18458,4160,14298,5065,231,5606,653,10671,2743,2042,497,2427,2562
CATGATTCTTGACTAT,sample,63563,62749,9396,53353,9594,43759,9861,334,18150,1693,28011,13721,5350,648,4408,5946
AATCCGTCTTGACTAT,Pos_Ctrl,38254,37586,3976,33610,1836,31774,26622,2245,2025,286,28647,596,4812,4723,1938,1051
AGTCCGCATTGACTAT,sample,70600,69662,14338,55324,7038,48286,8050,325,20601,2094,28651,17216,6121,648,3526,4142
CTAGGACCTTGACTAT,sample,39168,38661,4925,33736,8468,25268,8099,509,9773,924,17872,5963,3463,582,3842,5207
TTGGCCTCTTGACTAT,Pos_Ctrl,35212,34729,3366,31363,1797,29566,24675,2260,1872,224,26547,535,4663,4619,1924,954
AATATATCTTGACTAT,sample,69518,68333,20897,47436,3212,44224,3792,182,20850,2187,24642,17213,7419,515,574,1353
GTACCGTATTGACTAT,sample,36332,35878,7625,28253,3086,25167,3884,112,11242,1137,15126,8792,4183,403,1327,1673
TTATTCGATTGACTAT,Neg_Ctrl,666,433,239,194,25,169,70,4,61,3,131,31,49,22,22,7
ATTCTCTTTGCAGTTG,sample,19139,18911,1336,17575,10792,6783,3881,183,1920,103,5801,696,525,222,2191,3959
TCCAACTTTGCAGTTG,sample,34724,34298,3880,30418,8158,22260,5446,272,9433,1212,14879,5897,3226,466,2240,5166
AAGTTCGTTGCAGTTG,sample,39265,38767,2218,36549,13529,23020,11552,699,7725,563,19277,2481,2052,793,3738,7852
CCTCTAGATGCAGTTG,sample,40624,40249,3756,36493,10208,26285,9812,515,10103,943,19915,4912,2947,612,5118,6605
TTCTAATGTGCAGTTG,sample,80154,79184,8260,70924,14314,56610,17123,430,20049,2418,37172,16590,6024,754,9700,9318
TAGTACGGTGCAGTTG,sample,39103,38655,4074,34581,7097,27484,10237,435,10286,1079,20523,5447,3369,801,4238,4809
CAACCGCGTGCAGTTG,sample,28587,28083,3145,24938,6073,18865,6289,301,7208,826,13497,4241,2977,659,2345,3806
TCGCATCTTGCAGTTG,sample,12336,12156,1267,10889,1594,9295,2964,198,4025,334,6989,1774,1755,536,371,1046
GCCTTGCTTGCAGTTG,sample,37006,36544,2739,33805,12655,21150,11029,768,6270,564,17299,2519,2068,731,4881,7051
ACTATACTTGCAGTTG,sample,41198,40677,4253,36424,8416,28008,8849,542,11186,1160,20035,6271,3156,616,3902,5514
GACGGAGATGCAGTTG,sample,54408,53763,6905,46858,13021,33837,9696,315,12662,1446,22358,9718,4257,591,5255,7921
CCAGAGCGTGCAGTTG,sample,18286,18042,2110,15932,4982,10950,4636,160,3519,328,8155,2307,1859,377,2506,2997
GGACGTAGTGCAGTTG,sample,37327,36885,4901,31984,4541,27443,6879,331,11788,1438,18667,7007,3931,748,1744,2749
CTTGATAGTGCAGTTG,sample,39491,39124,2852,36272,11460,24812,13556,818,6908,713,20464,2817,2063,664,7030,7168
AGTCCGCATGCAGTTG,sample,26896,26535,3933,22602,5063,17539,3957,217,7417,691,11374,5257,2936,362,1789,2979
CTAGGACCTGCAGTTG,sample,37907,37521,2957,34564,10344,24220,10684,646,7451,867,18135,4572,2721,685,4396,6386
GTTAGGACTGCAGTTG,sample,52312,51768,6767,45001,9685,35316,6973,532,14582,1737,21555,11492,4896,561,2453,6039
GCCTGAACTGCAGTTG,sample,35626,35283,2654,32629,9399,23230,10216,561,7840,613,18056,4000,2485,858,3465,5958
CGTATGAATGCAGTTG,sample,24673,24417,1822,22595,2203,20392,6788,587,8894,1311,15682,2812,2328,772,749,1555
ACCAATGCTGCAGTTG,sample,32739,32303,3968,28335,3016,25319,7161,305,10656,1074,17817,6123,3271,698,900,1893
TGCTTCGCTGCAGTTG,sample,55199,54893,1845,53048,10105,42943,33366,2616,4392,525,37758,2044,2571,1915,10416,7218
GTCTTAGCTGCAGTTG,sample,46346,45841,6558,39283,5599,33684,8930,475,14546,1975,23476,7758,4081,705,1665,3459
CCAATTCCTGCAGTTG,sample,32197,31886,2382,29504,5777,23727,9462,633,9352,1185,18814,3095,2302,606,2724,4180
TTGGTTAATGCAGTTG,sample,58379,57851,4392,53459,14499,38960,16853,951,12561,1387,29414,7208,3684,771,6022,9046
TCGCCTGATGCAGTTG,sample,48126,47543,5247,42296,9503,32793,8480,332,13671,1293,22151,9017,3908,581,1727,6047
AGGTCGGATGCAGTTG,sample,18478,18242,2455,15787,1872,13915,3256,299,5961,713,9217,3686,2564,583,226,1092
TTATTCGATGCAGTTG,sample,49562,49064,4725,44339,9244,35095,9490,603,14187,1304,23677,9511,4634,753,1773,5709
ATTCTCTTTCATGCTG,sample,61689,60889,10569,50320,7504,42816,10093,426,17677,1815,27770,12805,5402,691,5195,4632
TCCAACTTTCATGCTG,sample,28325,27960,3644,24316,6114,18202,6066,210,6608,723,12674,4595,2379,424,3206,3818
AGTACCATTCATGCTG,sample,17156,16865,2491,14374,3595,10779,3302,200,4488,445,7790,2344,1937,476,644,2194
TTCGTAATTCATGCTG,sample,29955,29487,3935,25552,6158,19394,6734,378,6864,701,13598,4717,2476,468,3374,3760
TAGTACGGTCATGCTG,sample,27961,27447,5601,21846,3424,18422,2439,117,8211,825,10650,6830,3460,288,967,1934
TTAGAAGTTCATGCTG,sample,11653,11436,1687,9749,3095,6654,1827,93,2731,228,4558,1775,1329,267,722,1777
TTCCGTCTTCATGCTG,sample,15353,15139,1966,13173,1746,11427,3814,179,4657,668,8471,2109,1814,501,1072,1143
GGACCTCTTCATGCTG,Neg_Ctrl,474,298,202,96,8,88,35,1,30,0,65,22,36,12,14,5
TCGCATCTTCATGCTG,sample,32806,32327,4993,27334,4591,22743,6484,336,8422,1018,14906,6483,3283,346,4524,3017
ACTATACTTCATGCTG,sample,56071,55029,10747,44282,5491,38791,4955,190,17446,1933,22401,14267,5821,528,1551,3033
CCGCAACGTCATGCTG,sample,17846,17564,2892,14672,2557,12115,3428,84,4491,516,7919,3596,2320,327,1914,1515
GGACGTAGTCATGCTG,Neg_Ctrl,663,415,309,106,21,85,14,2,45,5,59,19,27,8,5,8
GACGATAATCATGCTG,sample,25393,24894,5753,19141,2289,16852,2155,106,7565,833,9720,6193,3496,350,502,1150
CGAGGCAGTCATGCTG,sample,22450,22202,1558,20644,6692,13952,6322,196,4860,438,11182,2136,1118,355,3384,4193
AATCCGTCTCATGCTG,sample,12361,12178,2173,10005,918,9087,2047,121,3793,412,5840,2714,1973,476,118,476
CGTACGTCTCATGCTG,Neg_Ctrl,399,239,126,113,22,91,39,3,27,4,66,18,19,9,21,14
GTTAGGACTCATGCTG,sample,39542,39115,5671,33444,6063,27381,6716,215,10926,1185,17642,8339,4019,423,3404,3718
GCCTGAACTCATGCTG,sample,28275,27998,2074,25924,8450,17474,8643,220,5255,597,13898,2759,1890,375,5325,5434
AACTCGTATCATGCTG,sample,30680,30405,2597,27808,8085,19723,8499,286,6590,496,15089,3852,1656,359,5129,5291
AATATATCTCATGCTG,Neg_Ctrl,453,334,234,100,25,75,16,0,25,1,41,33,22,8,8,24
ACCAATGCTCATGCTG,sample,35351,35013,4116,30897,6965,23932,7974,337,9133,966,17107,5522,2954,468,3674,4604
AAGAGCGCTCATGCTG,sample,11909,11798,1636,10162,1381,8781,2588,109,3459,435,6047,2190,1737,414,689,899
TTGGTTAATCATGCTG,sample,24278,24112,1741,22371,7504,14867,6845,413,5040,363,11885,2206,1180,312,3644,4550
GTACCGTATCATGCTG,sample,34418,34141,3255,30886,7943,22943,6468,383,8754,1090,15222,6248,3204,520,3093,5072
GGCATATATCATGCTG,sample,21649,21493,682,20811,8621,12190,8116,541,2879,363,10995,291,467,274,4456,4891
TCAATATATCATGCTG,sample,19817,19636,1562,18074,6068,12006,5348,318,4154,344,9502,1842,1502,431,2094,3509
CTTCATGATCATGCTG,sample,22421,22227,2806,19421,2752,16669,4536,200,7048,918,11584,3967,2783,536,1202,1830
TTATTCGATCATGCTG,sample,11809,11738,490,11248,3326,7922,3405,314,2870,324,6275,1009,972,414,729,2113
ATTCTCTTTTAGGCGG,Pos_Ctrl,23687,23311,2435,20876,1193,19683,16053,1397,1541,218,17594,474,3819,3253,1549,667
TCCAACTTTTAGGCGG,sample,50284,49523,8563,40960,7660,33300,7319,289,13665,1532,20984,10495,5066,621,3393,4475
AAGTTCGTTTAGGCGG,sample,14267,13950,1843,12107,3965,8142,2697,186,3167,312,5864,1780,1532,341,1167,2299
TCCTCCGTTTAGGCGG,sample,60449,59571,7717,51854,11559,40295,11879,659,16779,1803,28658,9175,3946,735,4701,7172
CCTCTAGATTAGGCGG,Pos_Ctrl,41692,40041,4689,35352,2101,33251,27266,2308,2602,332,29868,743,5085,4823,2334,1340
AATGGTAATTAGGCGG,sample,86823,86299,4881,81418,35152,46266,23651,1148,12118,1288,35769,8061,2996,826,13829,19140
TTAGAAGTTTAGGCGG,sample,109166,108386,7935,100451,30708,69743,31186,1205,21013,3051,52199,13288,4126,884,18513,19165
CATAACCTTTAGGCGG,sample,55447,54871,6761,48110,10335,37775,11276,513,14713,1756,25989,9517,4269,788,5439,6410
GTTAGCCGTTAGGCGG,sample,97044,96011,11158,84853,17836,67017,21550,1316,25576,2543,47126,16032,6382,1055,9332,11714
CCGCAACGTTAGGCGG,sample,88346,87582,5444,82138,24004,58134,22555,976,20512,1786,43067,12305,3490,723,13080,16056
GGACGTAGTTAGGCGG,sample,151028,149443,24325,125118,24210,100908,21156,1355,41233,3838,62389,33326,10193,1335,8831,15136
CTTGATAGTTAGGCGG,sample,119913,118504,14663,103841,23646,80195,20801,899,31710,3297,52511,23488,8031,1129,9615,15237
CATGATTCTTAGGCGG,sample,70664,69945,8377,61568,12297,49271,15920,812,17946,1937,33866,12656,4480,780,7549,8134
CTAGGACCTTAGGCGG,sample,84442,83652,5510,78142,24331,53811,28456,1023,15846,2010,44302,6476,1932,597,15793,15928
GTTAGGACTTAGGCGG,sample,100404,99552,9264,90288,21668,68620,27581,1072,22246,2362,49827,15359,5134,1068,13895,14705
AACTCGTATTAGGCGG,sample,37016,36652,3745,32907,6069,26838,8124,592,11564,1555,19688,5003,2829,686,1859,3918
AATATATCTTAGGCGG,sample,108450,107432,10474,96958,24284,72674,21172,1585,28919,2310,50091,18688,5553,962,9854,16431
AAGAGCGCTTAGGCGG,sample,86268,85523,9241,76282,18649,57633,18437,877,20834,1998,39271,15487,5892,849,6640,11699
TTGGTTAATTAGGCGG,sample,80215,79456,7862,71594,7699,63895,20904,975,27467,2855,48371,11694,4835,1083,5491,4862
GTACCGTATTAGGCGG,sample,92592,91822,9549,82273,21598,60675,22322,1741,19949,2089,42271,14574,5850,1152,8025,13651
GGCATATATTAGGCGG,sample,70573,70011,2668,67343,26834,40509,27757,970,10041,773,37798,968,733,364,15634,15685
CTTCATGATTAGGCGG,sample,58418,57787,4159,53628,6052,47576,17144,1191,18918,2540,36062,7783,3327,875,1296,4029
AGGTCGGATTAGGCGG,sample,118861,117757,11669,106088,22989,83099,24375,904,31230,2989,55605,23601,5892,941,11035,14176
ATGACCGATTAGGCGG,sample,86143,85308,5996,79312,24949,54363,24573,1379,16080,1904,40653,10427,1976,570,8523,15906
TATCAGTTTCAGATAC,sample,11201,11079,1114,9965,3212,6753,3136,175,1946,203,5082,1293,933,283,1734,1925
TCCAACTTTCAGATAC,sample,13605,13455,1163,12292,3657,8635,4151,55,2431,262,6582,1736,1045,236,2760,2265
TCCTCCGTTCAGATAC,sample,2612,2553,263,2290,922,1368,628,38,413,23,1041,266,404,183,211,475
AGTACCATTCAGATAC,sample,33110,32813,4999,27814,5472,22342,5728,299,9130,895,14858,6290,3407,666,2068,3592
TTCGTAATTCAGATAC,sample,53183,52701,5365,47336,14822,32514,16093,521,9721,901,25814,5278,2162,581,8543,9064
ACGTTATGTCAGATAC,sample,23556,23093,4190,18903,4272,14631,2603,121,6224,631,8827,5052,2622,286,913,2572
TAGTACGGTCAGATAC,sample,82740,81524,16359,65165,8156,57009,9665,384,24259,2677,33924,20024,7656,890,3921,4612
TTAGAAGTTCAGATAC,sample,70620,69830,11184,58646,9669,48977,12687,466,20246,1961,32933,13617,4852,599,7575,6479
GCCTTGCTTCAGATAC,sample,35807,35421,2661,32760,13569,19191,9470,402,6303,692,15773,2324,1814,472,4975,7572
ACTATACTTCAGATAC,sample,14463,14237,2862,11375,1741,9634,2642,141,3755,411,6397,2685,1862,421,975,1149
CCAGAGCGTCAGATAC,sample,26692,26317,3962,22355,5118,17237,6041,233,5801,550,11842,4612,2741,518,2941,3164
GTTAGCCGTCAGATAC,sample,24625,24380,2107,22273,6941,15332,7400,300,4537,588,11937,2507,1710,413,4026,4400
GGAGGACGTCAGATAC,sample,28899,28608,2787,25821,7062,18759,7937,448,6515,408,14452,3451,1997,381,4873,4567
ACCTCGAGTCAGATAC,sample,22463,22198,3043,19155,4618,14537,5028,198,5400,550,10428,3361,2366,434,2540,2727
GACGATAATCAGATAC,sample,39370,38929,4752,34177,8800,25377,9206,387,9051,942,18257,5791,3409,472,5407,5397
GGCCAGAGTCAGATAC,sample,15453,15185,3851,11334,1045,10289,1064,79,4675,472,5739,3999,2267,238,74,374
GTCCTGCCTCAGATAC,sample,40813,40475,3041,37434,11388,26046,11014,527,8684,707,19698,5114,2493,486,6524,7381
GTTAGGACTCAGATAC,sample,27808,27480,4845,22635,4420,18215,3637,251,7614,760,11251,5953,3083,384,795,2602
ACGTATTATCAGATAC,sample,73237,72519,7012,65507,17513,47994,17908,791,17885,1943,35793,9467,4094,674,8672,10952
AACTCGTATCAGATAC,sample,29757,29369,2964,26405,7334,19071,6110,408,7462,752,13572,4339,2664,517,1512,4556
TTGGCCTCTCAGATAC,sample,12445,12338,917,11421,4702,6719,2817,96,2296,308,5113,1202,1161,342,1213,2498
AATATATCTCAGATAC,sample,69013,68584,4926,63658,21293,42365,23235,1052,11046,1414,34281,5618,2013,525,11847,13374
GAAGGCGCTCAGATAC,sample,62521,61856,8036,53820,8197,45623,11625,659,17709,2123,29334,13507,5272,816,3697,5342
TTGGTTAATCAGATAC,sample,65196,64644,7087,57557,14658,42899,11909,597,16713,1790,28622,11890,3991,577,5486,8820
GGCATATATCAGATAC,sample,28440,28211,2742,25469,7539,17930,7416,529,5967,862,13383,3156,1798,352,3476,4624
TCCAACTTTCGCTAGG,Neg_Ctrl,885,497,300,197,38,159,58,3,50,2,108,46,59,21,19,9
AAGTTCGTTCGCTAGG,sample,33262,32629,4826,27803,3909,23894,6508,418,10345,1111,16853,5512,3350,734,1485,2676
GGTTGCGTTCGCTAGG,sample,40152,39632,6049,33583,7440,26143,8197,294,10028,1190,18225,6434,3735,726,3542,4624
TCCTCCGTTCGCTAGG,sample,138701,136990,21756,115234,14733,100501,13727,585,43759,4678,57486,37752,10100,1174,4585,8532
CCTCTAGATCGCTAGG,sample,62971,61988,11307,50681,2689,47992,11098,501,21063,2271,32161,13059,5644,1142,451,1415
AGTACCATTCGCTAGG,Neg_Ctrl,1817,1178,933,245,60,185,52,3,74,10,126,46,49,17,19,31
TTCGTAATTCGCTAGG,sample,54282,53736,3549,50187,18997,31190,20731,1038,6499,1090,27230,1832,859,390,12945,11502
ATGCCTGGTCGCTAGG,sample,30131,29673,3289,26384,7371,19013,6304,311,7632,971,13936,3795,2380,481,1896,4836
CAACCGCGTCGCTAGG,sample,9656,9466,1880,7586,831,6755,1619,84,2963,355,4582,1734,1681,345,210,474
TTAGAAGTTCGCTAGG,sample,68030,66886,11810,55076,6164,48912,9989,403,20220,2164,30209,16136,5783,638,5244,3927
GGACCTCTTCGCTAGG,sample,30871,30255,6860,23395,2774,20621,3903,266,9150,1011,13053,6291,3632,619,774,1503
CATAACCTTCGCTAGG,sample,34478,33985,4688,29297,5744,23553,7625,328,9125,1167,16750,5308,2945,607,3074,3700
ACTATACTTCGCTAGG,sample,44765,43961,9788,34173,4591,29582,3657,153,13051,1376,16708,11345,5481,529,788,2712
ACCTCGAGTCGCTAGG,sample,15112,14788,3022,11766,1762,10004,1628,76,4374,513,6002,3413,2270,225,525,1026
GACGATAATCGCTAGG,sample,19312,18964,3637,15327,2248,13079,2745,87,5555,584,8300,4108,2473,324,1271,1348
GGCCAGAGTCGCTAGG,sample,1207,1178,96,1082,457,625,315,18,201,15,516,76,200,89,113,229
CCATGAAGTCGCTAGG,sample,28539,28051,4244,23807,5564,18243,4527,160,7814,764,12341,4978,2850,409,1865,3322
ACGACTTCTCGCTAGG,sample,25725,25366,4015,21351,1603,19748,4533,362,8668,1025,13201,5160,3044,702,170,805
AATCCGTCTCGCTAGG,sample,31434,31055,3690,27365,4606,22759,8078,497,8419,1104,16497,4661,2811,709,2675,2933
CGTACGTCTCGCTAGG,sample,33388,32944,4028,28916,6521,22395,7796,348,8052,925,15848,5274,2655,425,4304,4031
AGTCCGCATCGCTAGG,sample,26934,26540,4388,22152,2883,19269,4042,172,8431,837,12473,5787,3205,546,477,1653
GTCCTGCCTCGCTAGG,sample,44783,44147,7477,36670,2887,33783,4698,255,15464,1589,20162,11777,5213,670,733,1695
TTGGTACCTCGCTAGG,sample,36930,36475,5932,30543,5158,25385,6510,310,10225,916,16735,7424,3801,496,3092,3127
CTAGGACCTCGCTAGG,sample,21866,21539,2997,18542,3012,15530,3924,163,6766,609,10690,4068,2348,457,723,1936
GTTAGGACTCGCTAGG,sample,33467,33083,2945,30138,4431,25707,10747,764,9002,1309,19749,3885,2799,1009,1991,3012
AACTCGTATCGCTAGG,sample,25464,25083,4476,20607,2331,18276,4496,168,7827,875,12323,4910,3149,525,1481,1387
TGCTTCGCTCGCTAGG,sample,24943,24711,1847,22864,5448,17416,8502,286,5578,792,14080,2258,1492,459,3730,3753
GTCTTAGCTCGCTAGG,sample,46364,45835,6418,39417,4936,34481,6142,225,15115,1741,21257,11258,4999,578,2210,2958
CCAATTCCTCGCTAGG,sample,25473,25186,3424,21762,2362,19400,6527,368,7311,861,13838,4333,2856,544,2098,1515
TTGGTTAATCGCTAGG,sample,37659,37315,3646,33669,5274,28395,10796,400,10167,1167,20963,5865,2937,568,4071,3552
GTACCGTATCGCTAGG,Pos_Ctrl,24333,24019,1842,22177,1122,21055,17491,1672,1326,172,18817,394,3931,3763,1176,587
AGGTCGGATCGCTAGG,sample,55521,55056,7004,48052,7268,40784,6913,346,18214,1792,25127,13519,5628,652,2310,4686
ATGACCGATCGCTAGG,sample,11241,11093,1536,9557,1096,8461,1942,149,3654,403,5596,2313,1685,351,290,604
GGAGAGTTCCGTTGCG,sample,44114,43623,1734,41889,16083,25806,15609,929,6913,782,22522,1573,1912,1114,5592,9561
TCCAACTTCCGTTGCG,sample,117812,116614,11344,105270,21551,83719,35316,1556,32179,3512,67495,11156,4223,1111,13519,15379
TCCTCCGTCCGTTGCG,sample,33957,33360,6645,26715,5186,21529,3603,197,9346,1031,12949,7352,3745,629,541,3018
AGTACCATCCGTTGCG,sample,86691,85661,10262,75399,25389,50010,20270,751,16749,2196,37019,10044,2444,592,11955,14952
ACGTTATGCCGTTGCG,sample,103279,102082,10745,91337,22685,68652,26183,1100,23392,2440,49575,15537,4229,918,14327,15426
TTCCGTCTCCGTTGCG,sample,59010,58342,4976,53366,13516,39850,20796,625,11804,1380,32600,5245,2904,813,11102,9137
GCCTTGCTCCGTTGCG,sample,95079,94272,11775,82497,21820,60677,23821,1084,22101,2070,45922,11601,3488,824,12299,13864
CAAGGCCTCCGTTGCG,sample,56635,55816,7373,48443,11696,36747,9959,571,13965,1372,23924,10880,4134,531,4981,7375
CATAACCTCCGTTGCG,sample,75793,74702,10223,64479,7995,56484,15883,780,23980,2984,39863,12857,5296,1017,4467,5060
GGACGTAGCCGTTGCG,sample,22585,21976,3719,18257,4364,13893,3712,252,5712,623,9424,3594,2327,471,1611,2589
CTTGATAGCCGTTGCG,sample,52869,51798,9724,42074,7743,34331,4950,121,15051,1703,20001,12506,5070,487,1811,4747
ACCTCGAGCCGTTGCG,sample,19100,18738,4103,14635,2948,11687,2431,108,4951,527,7382,3670,2569,311,1212,1635
TGGACGAGCCGTTGCG,sample,52496,51833,5145,46688,17961,28727,13977,703,8558,851,22535,4638,2711,610,8438,10063
GGCCAGAGCCGTTGCG,sample,26667,26252,2830,23422,8844,14578,6237,308,5068,562,11305,2403,2059,633,2533,4745
CGAGGCAGCCGTTGCG,sample,63470,62597,8823,53774,9856,43918,10961,724,18709,1754,29670,11770,4842,728,3335,6280
CCATGAAGCCGTTGCG,sample,66236,65528,7188,58340,9052,49288,19331,818,17987,1717,37318,9435,4132,959,6891,6279
CATGATTCCCGTTGCG,sample,54587,54006,5505,48501,14780,33721,13462,840,12129,1863,25591,5427,3533,928,3120,8861
CTAGGACCCCGTTGCG,sample,85902,84957,9957,75000,13850,61150,21641,765,22999,2113,44640,13632,5064,841,11475,8982
GTTAGGACCCGTTGCG,sample,44913,44348,6783,37565,5054,32511,7536,450,13979,1776,21515,8770,3984,696,1153,2981
TTGGCCTCCCGTTGCG,sample,96193,95255,10649,84606,17208,67398,24299,1338,24709,2756,49008,14296,5551,901,12899,11700
AAGAGCGCCCGTTGCG,sample,64087,63712,5014,58698,14083,44615,16139,1208,16110,2072,32249,9086,4545,1041,2953,8940
TTGGTTAACCGTTGCG,sample,55522,55160,5149,50011,7492,42519,12872,953,18393,2346,31265,7955,3849,862,1114,4664
GGCATATACCGTTGCG,sample,70844,70385,7289,63096,17969,45127,14540,730,16785,2190,31325,10882,4787,846,5367,10677
TCGCCTGACCGTTGCG,sample,85345,84614,11426,73188,12095,61093,13248,403,25591,2518,38839,19333,6893,721,6683,7606
CTTCATGACCGTTGCG,sample,91680,90928,9619,81309,18181,63128,17789,1205,25690,2503,43479,15941,5911,866,7152,12335
TCCAACTTAGGCCAAG,sample,178796,177635,13239,164396,34480,129916,55858,2310,48617,5475,104475,17656,4907,1198,24916,23566
TCCTCCGTAGGCCAAG,sample,52211,51559,5591,45968,9805,36163,9439,589,15623,1707,25062,8805,3955,787,2109,6198
ACGTAAGTAGGCCAAG,sample,77445,76618,8655,67963,20175,47788,15805,578,17388,1981,33193,12036,4802,627,8402,11937
AGTACCATAGGCCAAG,sample,34275,33786,4365,29421,4312,25109,6558,471,10995,1234,17553,5851,3175,714,1397,2897
TTCTAATGAGGCCAAG,sample,53140,52389,4360,48029,13389,34640,13697,586,14050,1541,27747,4766,3094,806,5749,8587
AATGGTAAAGGCCAAG,sample,77105,76184,7604,68580,17949,50631,21341,622,17433,1876,38774,9359,4050,716,13702,11143
TTAGAAGTAGGCCAAG,sample,75550,74822,8184,66638,15869,50769,18269,744,18708,1899,36977,11149,4713,732,11613,10021
GGACCTCTAGGCCAAG,sample,75035,73916,9642,64274,16850,47424,11342,461,20104,1772,31446,13745,4558,647,5517,10215
GACGGAGAAGGCCAAG,sample,43302,42849,3992,38857,11634,27223,10832,582,9290,1063,20122,5456,3049,811,5057,7135
GTTAGCCGAGGCCAAG,sample,27372,26963,3955,23008,3319,19689,5387,445,8594,982,13981,4281,3019,728,1263,2035
GGAGGACGAGGCCAAG,sample,41100,40580,4873,35707,8129,27578,7481,433,10956,1317,18437,7391,3680,716,1875,5057
GTCCTGCCAGGCCAAG,sample,96861,95842,8292,87550,22125,65425,24901,1081,23076,2004,47977,14363,5153,739,14764,15309
TTGGTACCAGGCCAAG,sample,123041,121511,16499,105012,20257,84755,21580,700,33836,3566,55416,25073,7526,916,11717,12857
GTTAGGACAGGCCAAG,sample,118665,117257,16607,100650,18217,82433,19798,831,34199,3905,53997,23700,8087,931,8816,11318
GTCTTAGCAGGCCAAG,sample,33520,33053,3330,29723,5520,24203,8674,621,9414,1206,18088,4288,2495,682,1872,3690
CCAATTCCAGGCCAAG,sample,25148,24867,1022,23845,7728,16117,8781,601,4724,747,13505,1264,1469,747,2665,4897
GGCATATAAGGCCAAG,Neg_Ctrl,857,539,285,254,38,216,51,2,106,7,157,50,61,10,30,9
CTTCATGAAGGCCAAG,sample,114697,113501,13198,100303,16238,84065,23284,1205,30647,3844,53931,25085,6038,940,11645,11197
AGGTCGGAAGGCCAAG,sample,76321,75341,8622,66719,13015,53704,16340,620,20852,1998,37192,13894,5156,696,7682,8898
TTATTCGAAGGCCAAG,sample,94458,93546,10260,83286,14826,68460,15851,645,29484,2409,45335,20071,5677,884,5750,9967
GACCGGAAAGGCCAAG,sample,269660,267208,38845,228363,23349,205014,31674,1378,89059,9633,120733,73270,15108,2493,10495,12813
GGAGAGTTAGAACCGC,sample,38736,38335,7802,30533,5484,25049,3816,172,11152,1162,14968,8747,4231,436,1398,3156
TCCAACTTAGAACCGC,sample,86439,85840,3848,81992,34806,47186,32331,1199,9286,1321,41617,3049,1894,946,16972,18879
AGTACCATAGAACCGC,sample,124807,123742,10067,113675,31246,82429,34462,1577,29331,3451,63793,13608,4940,957,15950,19997
TTCGTAATAGAACCGC,sample,165397,164383,9578,154805,57740,97065,49178,2118,25815,2347,74993,17607,3168,717,33416,32943
TTAGAAGTAGAACCGC,sample,67831,66886,8748,58138,10983,47155,10946,633,20716,2208,31662,12652,4621,686,2672,6799
GCCTTGCTAGAACCGC,sample,192866,188682,53274,135408,11480,123928,12762,546,56831,5970,69593,47819,12685,1427,2853,4969
CAAGGCCTAGAACCGC,sample,95125,93271,15406,77865,16923,60942,17289,624,24275,2891,41564,15863,5657,853,8823,10183
CATAACCTAGAACCGC,sample,68924,68122,7287,60835,23989,36846,13814,980,13624,1565,27438,6863,3930,907,6027,12675
ACTATACTAGAACCGC,sample,79530,78654,7994,70660,14599,56061,18801,1213,22662,2811,41463,10574,4515,911,5719,9306
GTTAGCCGAGAACCGC,sample,44471,43902,7339,36563,4078,32485,7017,285,15347,1553,22364,8283,4480,852,803,2520
GGAGGACGAGAACCGC,sample,93085,92207,8321,83886,21091,62795,22486,909,23188,2536,45674,13676,5096,896,12234,13482
ACCTCGAGAGAACCGC,sample,98943,97913,14488,83425,17983,65442,20772,1027,23643,2729,44415,17271,6367,1140,8936,11511
TGGACGAGAGAACCGC,sample,8258,8058,2172,5886,732,5154,532,32,2443,256,2975,1891,1326,111,124,383
CCATGAAGAGAACCGC,sample,53316,52553,7748,44805,6824,37981,9592,668,16545,1787,26137,9389,4528,841,2228,4269
AATCCGTCAGAACCGC,sample,36248,35774,3334,32440,6536,25904,10561,880,9169,1007,19730,4287,2989,1053,1045,4362
CGTACGTCAGAACCGC,sample,72398,71469,10456,61013,13895,47118,12110,622,18803,2152,30913,13431,5532,727,5538,8363
AGTCCGCAAGAACCGC,sample,96126,95444,4911,90533,31741,58792,34570,1680,16293,1715,50863,4534,1603,575,19894,19883
GTCCTGCCAGAACCGC,sample,77831,76851,13289,63562,11179,52383,9278,942,23714,2590,32992,15859,5886,868,1871,6474
CTAGGACCAGAACCGC,sample,43689,43083,5618,37465,9163,28302,10730,344,10048,1163,20778,6017,3151,511,5842,5479
GTTAGGACAGAACCGC,sample,85459,84551,13631,70920,14118,56802,17570,903,21639,2224,39209,14466,5695,1033,7992,8497
ACGTATTAAGAACCGC,sample,198172,195986,31198,164788,26586,138202,29979,1287,57180,6711,87159,43045,10835,1417,14541,16763
CGTATGAAAGAACCGC,sample,53079,52278,9531,42747,8309,34438,5008,163,15640,1517,20648,12110,4860,564,1168,4852
ACCAATGCAGAACCGC,sample,61185,60659,3296,57363,21291,36072,21205,1236,9177,1102,30382,3352,2428,1032,9142,12397
TGCTTCGCAGAACCGC,sample,25610,25252,4906,20346,2240,18106,3919,233,8209,845,12128,4900,3314,619,534,1216
GTCTTAGCAGAACCGC,sample,184978,183160,22614,160546,24695,135851,33413,1372,54103,5114,87516,41849,10068,1524,14673,16927
TCAATATAAGAACCGC,sample,71454,70855,6695,64160,10338,53822,20062,1396,21363,1756,41425,9245,3771,843,5555,7174
TCGCCTGAAGAACCGC,sample,30810,30474,2586,27888,7405,20483,8679,687,6949,871,15628,3297,2221,693,1558,4453
ATGACCGAAGAACCGC,sample,99822,99091,9656,89435,27417,62018,27570,1793,20284,2818,47854,9553,3258,806,11850,17104
GGAGAGTTCATCAAGC,sample,107219,106309,12080,94229,24744,69485,25482,758,26167,2582,51649,14496,4800,821,13809,15946
ATTCTCTTCATCAAGC,sample,82042,81011,10458,70553,16044,54509,18306,918,19927,2390,38233,12968,5168,1070,8309,9969
AAGTTCGTCATCAAGC,sample,69189,68297,10646,57651,11618,46033,13157,511,17915,1927,31072,12523,4734,579,7243,7590
CCTCTAGACATCAAGC,sample,64685,63401,10015,53386,9015,44371,8358,413,20074,2180,28432,13346,4897,669,2343,5759
AGTACCATCATCAAGC,sample,42190,41663,4898,36765,9477,27288,9516,649,10661,1271,20177,5191,3089,868,2111,5790
TAGTACGGCATCAAGC,sample,75127,74356,8730,65626,17759,47867,15498,402,17191,2344,32689,12432,4868,559,10070,10937
AATGGTAACATCAAGC,sample,53708,52957,7460,45497,5732,39765,10323,482,18148,1926,28471,8886,4306,802,1463,3650
GGACCTCTCATCAAGC,sample,51582,50715,8625,42090,8251,33839,5942,250,14492,1574,20434,11581,4663,538,2049,4842
GTTAGCCGCATCAAGC,sample,16674,16397,1940,14457,3403,11054,3508,247,4424,469,7932,2406,2163,673,465,2081
GGCCAGAGCATCAAGC,sample,22130,21833,1343,20490,7180,13310,6716,646,4385,524,11101,1039,1463,679,1185,4166
TTGGTACCCATCAAGC,sample,189064,187157,31879,155278,26466,128812,24668,1084,54859,5523,79527,42678,11748,1571,10364,16204
CTAGGACCCATCAAGC,sample,51138,50547,8131,42416,4693,37723,7823,629,16804,1914,24627,10553,4747,806,1196,2670
CGGATTACCATCAAGC,sample,77060,76385,7906,68479,19635,48844,20920,1390,15784,1900,36704,8850,3675,761,8735,11957
AACTCGTACATCAAGC,sample,115252,114280,11830,102450,20796,81654,26946,570,30985,3573,57931,19580,5752,897,15504,15391
TTGGCCTCCATCAAGC,Pos_Ctrl,48608,48136,4163,43973,2444,41529,34302,3268,2721,380,37023,858,5343,5690,2832,1424
ACCAATGCCATCAAGC,sample,84983,84357,5695,78662,28554,50108,26075,1137,15099,1671,41174,6126,1981,569,14593,16425
TGCTTCGCCATCAAGC,sample,32048,31679,5357,26322,3583,22739,5110,291,10176,1009,15286,6153,3827,763,576,2030
GAAGGCGCCATCAAGC,sample,24085,23784,4506,19278,2882,16396,3850,190,7219,669,11069,4468,2919,482,1629,1703
GTACCGTACATCAAGC,sample,43643,43175,5482,37693,4938,32755,9506,529,13736,1682,23242,7302,3721,624,3045,3232
GGCATATACATCAAGC,sample,50599,50240,2746,47494,15052,32442,18006,976,9250,1385,27256,2825,1474,430,10379,9651
TTATTCGACATCAAGC,sample,119208,117950,17266,100684,16750,83934,19120,869,34087,3749,53207,26109,7397,995,8819,9887
GGAGAGTTAGAGAGCC,sample,15904,15745,1772,13973,1699,12274,3870,277,5234,633,9104,2260,2069,635,778,1092
TATCAGTTAGAGAGCC,sample,63914,63272,7008,56264,14459,41805,14469,690,14818,1554,29287,10274,3277,611,8170,9084
AAGTTCGTAGAGAGCC,sample,34188,33756,3644,30112,5442,24670,9503,533,9610,959,19113,4065,2587,782,3286,3794
TCCTCCGTAGAGAGCC,sample,22449,21960,3033,18927,3926,15001,3526,181,6521,804,10047,3969,2413,415,1342,2434
TTCGTAATAGAGAGCC,sample,13481,13261,2206,11055,1951,9104,2627,99,3525,357,6152,2496,1729,319,1183,1190
TTCTAATGAGAGAGCC,sample,60250,59427,6773,52654,13038,39616,12873,523,15164,1627,28037,9429,4282,722,5620,8414
GGACCTCTAGAGAGCC,sample,43688,42996,5520,37476,9312,28164,8449,301,10402,1225,18851,7787,3406,449,4458,5829
GGAGGACGAGAGAGCC,sample,54836,54455,4439,50016,16873,33143,16883,1032,9267,1128,26150,4833,2504,660,8897,10214
GGACGTAGAGAGAGCC,sample,52406,52083,3429,48654,18109,30545,18536,1035,7331,1079,25867,2564,1246,410,12379,10348
ACCTCGAGAGAGAGCC,sample,30381,30067,3734,26333,4820,21513,5442,275,9200,994,14642,5602,3022,527,1786,3218
GACGATAAAGAGAGCC,sample,63816,63435,4559,58876,17217,41659,23060,813,12222,1341,35282,4223,2158,510,15483,11010
ACGACTTCAGAGAGCC,sample,28382,28072,2804,25268,3763,21505,6392,359,9956,915,16348,3883,2670,644,605,2507
CATGATTCAGAGAGCC,sample,39100,38559,5833,32726,5767,26959,5694,280,11297,1142,16991,8546,3669,495,1900,3431
CGTACGTCAGAGAGCC,sample,60800,60324,4648,55676,14573,41103,15708,780,14864,1595,30572,8156,3713,723,6351,9585
CGTATGAAAGAGAGCC,sample,51918,51253,9668,41585,6844,34741,7706,360,14740,1631,22446,10304,5255,798,2591,3970
TTGGCCTCAGAGAGCC,sample,81071,80462,9550,70912,13611,57301,18217,1040,22526,2205,40743,13313,5596,743,8730,8749
TGCTTCGCAGAGAGCC,sample,30925,30592,3439,27153,7325,19828,5088,395,8219,870,13307,5256,2851,389,2053,4316
TCAATATAAGAGAGCC,sample,72725,72088,7426,64662,12739,51923,16939,863,20802,1906,37741,11413,4077,729,6442,8151
TCGCCTGAAGAGAGCC,sample,37412,37173,1331,35842,13444,22398,14694,679,5339,809,20033,877,548,285,9025,8390
AGGTCGGAAGAGAGCC,sample,86021,85197,11145,74052,14927,59125,13305,583,24019,2938,37324,18280,6492,750,4962,9140
TATCAGTTAGCATTGA,sample,65113,64725,3603,61122,13548,47574,22594,662,16956,2198,39550,5164,2879,851,10149,9600
ATTCTCTTAGCATTGA,sample,85205,84650,4220,80430,30495,49935,29417,1031,13649,1466,43066,4372,2330,751,17091,18111
TCCAACTTAGCATTGA,sample,75013,74306,3262,71044,22077,48967,23816,1085,16550,2460,40366,5056,2243,771,8435,14597
AAGTTCGTAGCATTGA,sample,107384,106503,6556,99947,41746,58201,32628,1548,15453,2032,48081,6540,3146,894,18532,22779
GGTTGCGTAGCATTGA,sample,98307,96973,12129,84844,16455,68389,14484,976,26723,2549,41207,23657,6475,809,6371,10805
CCTCTAGAAGCATTGA,sample,82188,81353,5134,76219,27437,48782,23343,1294,15791,1888,39134,6466,2775,727,13892,16463
TTCGTAATAGCATTGA,sample,80778,80030,7559,72471,24133,48338,22425,689,15175,1758,37600,8291,3432,627,14446,14622
TAGTACGGAGCATTGA,sample,56603,56063,4523,51540,13838,37702,16054,1212,12280,1617,28334,6539,3593,1091,5413,8920
CAACCGCGAGCATTGA,sample,14724,14468,1925,12543,2563,9980,3120,220,3841,405,6961,2394,2196,766,198,1601
AATGGTAAAGCATTGA,sample,97174,96307,7638,88669,30630,58039,28956,1508,17584,2080,46540,7911,2887,660,17266,18578
TTAGAAGTAGCATTGA,sample,65032,64125,4979,59146,11145,48001,18416,1227,19597,2279,38013,6482,3191,869,2713,7632
GGACGTAGAGCATTGA,sample,73969,73060,10774,62286,12181,50105,11500,673,21254,2186,32754,14492,5595,915,3455,7605
TGGACGAGAGCATTGA,sample,75689,74906,6493,68413,17510,50903,20326,1295,19194,1729,39520,8359,4565,921,9762,11483
GGCCAGAGAGCATTGA,sample,59212,58504,6759,51745,11306,40439,12938,931,15311,1526,28249,9733,4365,860,4752,7222
ACGACTTCAGCATTGA,sample,76636,75224,10365,64859,15662,49197,9175,585,22353,1887,31528,15197,5553,681,2825,9568
AATCCGTCAGCATTGA,sample,39761,39238,4405,34833,8288,26545,8667,415,10519,1124,19186,5820,3396,710,2081,5208
AGTCCGCAAGCATTGA,sample,30947,30588,4117,26471,4562,21909,6102,484,9158,1036,15260,5129,3445,870,413,2780
CGTATGAAAGCATTGA,sample,111696,110866,7404,103462,44705,58757,31692,2281,16095,1681,47787,7008,2949,950,15958,23949
AATATATCAGCATTGA,Neg_Ctrl,958,660,386,274,71,203,34,6,82,6,116,75,62,21,16,19
AAGAGCGCAGCATTGA,sample,85790,85038,6493,78545,23343,55202,30879,1538,13890,2278,44769,6617,2022,546,17648,14667
TCAATATAAGCATTGA,sample,63056,62508,2293,60215,23470,36745,23730,1179,9832,857,33562,1147,816,373,13288,13805
TCGCCTGAAGCATTGA,sample,45536,45101,4632,40469,6851,33618,11559,731,13917,1538,25476,5873,3205,890,1459,4538
AGGTCGGAAGCATTGA,sample,77777,76761,8124,68637,11963,56674,15648,969,24684,2864,40332,12509,5164,798,3158,7696
ATGACCGAAGCATTGA,sample,82861,82166,4595,77571,25329,52242,26791,965,15157,2257,41948,7072,2427,603,14790,16085
GACCGGAAAGCATTGA,sample,100495,99802,7674,92128,22371,69757,20619,1029,27776,3241,48395,17092,5372,882,10138,14188
TATCAGTTAATTACCA,sample,49896,49231,10920,38311,4490,33821,4918,133,15088,1507,20006,12175,5926,528,2003,2435
ATTCTCTTAATTACCA,sample,6167,6056,1080,4976,1062,3914,1009,82,1542,177,2551,1104,905,137,580,622
AGTACCATAATTACCA,sample,44448,44030,5567,38463,12985,25478,10339,540,7956,935,18295,5708,3183,866,4201,6856
ATGCCTGGAATTACCA,sample,89770,88982,10783,78199,13185,65014,14622,461,26754,2484,41376,20693,7128,929,7877,8718
TTCCGTCTAATTACCA,sample,39104,38622,4278,34344,7971,26373,10075,259,8989,1005,19064,6045,2409,368,6667,5293
TCGCATCTAATTACCA,sample,60722,59927,12195,47732,7362,40370,6554,224,17899,1769,24453,13924,6070,577,2642,4041
CAAGGCCTAATTACCA,sample,29363,28971,4013,24958,6099,18859,5748,244,7534,655,13282,4678,2599,392,3197,3832
CATAACCTAATTACCA,sample,51134,50495,6311,44184,10307,33877,10349,381,12867,1342,23216,8938,3860,543,6392,6595
GACGGAGAAATTACCA,sample,41919,41420,4668,36752,7518,29234,10106,559,11192,1360,21298,6017,3429,756,3709,4846
GTTAGCCGAATTACCA,sample,40089,39643,4035,35608,10704,24904,10362,463,8240,613,18602,5226,1861,482,5610,6355
ACCTCGAGAATTACCA,sample,19798,19500,3633,15867,3111,12756,2119,231,5464,622,7583,4320,2399,303,705,1855
CATGATTCAATTACCA,sample,31159,30802,3839,26963,5982,20981,7491,425,8028,817,15519,4220,2609,564,2515,3671
AATCCGTCAATTACCA,sample,67871,67017,10325,56692,10975,45717,9457,531,19188,1961,28645,14580,5338,586,3053,6980
AATATATCAATTACCA,sample,9185,9045,1934,7111,1105,6006,1021,88,2708,327,3729,1862,1444,219,282,622
GTCTTAGCAATTACCA,sample,41088,40703,3944,36759,6275,30484,10026,625,12387,1514,22413,5932,3182,634,2391,4243
CCAATTCCAATTACCA,sample,60522,59894,5346,54548,12484,42064,17353,863,15102,1751,32455,6995,3342,640,8260,8467
TTGGTTAAAATTACCA,sample,50572,50221,3324,46897,14890,32007,15561,1155,9507,1128,25068,4656,2602,670,7908,9166
AGGTCGGAAATTACCA,sample,62157,61608,6750,54858,12165,42693,17085,1164,14572,1562,31657,8310,4279,722,7213,7800
TTATTCGAAATTACCA,sample,58597,58029,7581,50448,11645,38803,12392,353,15284,1435,27676,9339,3526,577,5991,7112
GACCGGAAAATTACCA,sample,76086,75328,10016,65312,9534,55778,15284,911,23232,2739,38516,13612,5458,868,3739,5845
ATTCTCTTTAGATGAC,Pos_Ctrl,8470,8393,646,7747,532,7215,6022,542,408,58,6430,185,1955,1644,556,311
TCCAACTTTAGATGAC,sample,16340,16173,1637,14536,4529,10007,4788,126,3087,368,7875,1638,1361,354,2804,2710
TTCGTAATTAGATGAC,sample,57938,57458,5794,51664,14896,36768,13452,576,13715,1780,27167,7245,3484,746,5880,9147
ACGTTATGTAGATGAC,Pos_Ctrl,36914,36269,3663,32606,1938,30668,25284,2367,2113,262,27397,642,4777,4692,2171,1107
TAGTACGGTAGATGAC,sample,42104,41630,4439,37191,8900,28291,8017,501,12090,1206,20107,6477,3545,779,1712,5564
TGAGCGCGTAGATGAC,sample,49424,48833,6611,42222,9155,33067,8875,259,13366,1492,22241,9075,4264,529,4856,5565
TTCCGTCTTAGATGAC,Pos_Ctrl,24631,24320,2417,21903,1359,20544,16956,1507,1444,161,18400,476,3764,3488,1568,829
GACGGAGATAGATGAC,sample,14133,14000,1937,12063,3255,8808,3249,197,3242,361,6491,1759,1698,433,1329,1945
GTTAGCCGTAGATGAC,sample,25828,25521,2885,22636,7161,15475,6303,378,5163,463,11466,3168,2188,499,3500,3963
TGGACGAGTAGATGAC,sample,38873,38550,2193,36357,11722,24635,12188,852,7870,872,20058,2853,2047,817,3668,7114
GACGATAATAGATGAC,sample,81403,80402,11566,68836,13484,55352,12616,497,22880,2483,35496,16876,6460,1018,3423,8236
AGTCCGCATAGATGAC,sample,70420,69777,4141,65636,19419,46217,24629,753,13707,1364,38336,5764,2387,618,13878,12977
GTCCTGCCTAGATGAC,sample,34210,33872,1875,31997,6020,25977,10747,604,10491,1353,21238,2782,2003,785,1793,4270
CTAGGACCTAGATGAC,sample,56470,55990,4814,51176,16282,34894,14469,981,11871,887,26340,6686,3264,628,6813,9864
GTTAGGACTAGATGAC,sample,46936,46321,6419,39902,8322,31580,7418,364,13629,1367,21047,8802,3724,482,1522,5220
TGCTTCGCTAGATGAC,sample,55209,54620,5446,49174,9654,39520,16477,1139,13262,1404,29739,7238,3873,786,5424,6374
GAAGGCGCTAGATGAC,sample,37340,36831,7020,29811,4511,25300,5198,282,11016,1070,16214,7734,4148,543,1681,2679
CTTCATGATAGATGAC,sample,81247,80487,8322,72165,13362,58803,17161,953,22222,2384,39383,16083,4931,765,5830,8985
TTATTCGATAGATGAC,sample,50358,49919,6671,43248,6879,36369,7783,345,16102,1482,23885,10657,4745,578,2953,4266
GGAGAGTTGTTCAGAA,sample,103046,102458,6853,95605,26184,69421,27670,858,23553,2584,51223,14756,5279,872,18218,16591
AAGTTCGTGTTCAGAA,sample,104274,103241,11851,91390,16219,75171,16311,1047,33136,3886,49447,20791,7271,1223,4562,10854
GGTTGCGTGTTCAGAA,sample,90810,90074,5409,84665,30498,54167,29586,1463,14316,1940,43902,6862,2207,699,17663,18303
ACGTAAGTGTTCAGAA,sample,75383,74691,4870,69821,19513,50308,20538,1154,18736,1888,39274,7992,3688,701,9299,12853
AGTACCATGTTCAGAA,sample,106990,105997,9590,96407,18796,77611,23572,1651,31474,3203,55046,17711,6027,917,10840,13675
ACGTTATGGTTCAGAA,sample,68035,67421,4545,62876,10886,51990,20343,976,20840,1809,41183,8022,3370,797,5639,7554
ATGCCTGGGTTCAGAA,sample,54883,54341,4425,49916,9236,40680,11926,776,17220,1617,29146,9141,3877,716,2663,6451
TAGTACGGGTTCAGAA,sample,59373,58901,3869,55032,15013,40019,18655,712,12030,1559,30685,7063,2319,457,10637,10116
TTCCGTCTGTTCAGAA,sample,82206,81486,8892,72594,14706,57888,14037,1254,25822,3358,39859,13417,5469,978,1078,9609
TCGCATCTGTTCAGAA,sample,12026,11806,913,10893,4625,6268,3797,132,1609,276,5406,454,504,230,2592,2512
GCCTTGCTGTTCAGAA,sample,60348,59630,7461,52169,9922,42247,8213,294,17503,1733,25716,14504,5462,568,3805,6294
CATAACCTGTTCAGAA,sample,24133,23901,1421,22480,7775,14705,6775,450,5063,636,11838,1781,1796,807,1494,4655
ACTATACTGTTCAGAA,sample,54011,53538,4075,49463,12496,36967,14739,502,13699,1484,28438,6543,3185,704,6313,8154
GGAGGACGGTTCAGAA,sample,17294,17081,2392,14689,3662,11027,3632,128,4125,498,7757,2644,2009,387,1716,2221
CCGCAACGGTTCAGAA,sample,10972,10765,1877,8888,1984,6904,1535,51,2876,351,4411,2091,1667,233,703,1262
GGACGTAGGTTCAGAA,sample,29268,28894,1895,26999,11569,15430,9450,311,4130,331,13580,1208,757,366,6092,6230
TGGACGAGGTTCAGAA,sample,25943,25590,3805,21785,5068,16717,3154,239,7280,857,10434,5187,2947,438,775,3050
GGCCAGAGGTTCAGAA,sample,16424,16211,1567,14644,5095,9549,3275,178,3867,431,7142,1798,1627,448,1456,2952
CGAGGCAGGTTCAGAA,sample,39795,39309,3391,35918,11084,24834,9966,443,8327,727,18293,5371,2909,892,1940,6536
CCATGAAGGTTCAGAA,sample,123152,121298,22216,99082,11422,87660,14993,382,37650,3932,52643,30703,10130,1057,6248,6697
ACGACTTCGTTCAGAA,sample,41272,40714,4802,35912,9209,26703,6810,347,11276,1157,18086,7113,3643,485,3062,5634
AATCCGTCGTTCAGAA,sample,38955,38616,2429,36187,10112,26075,13039,846,8264,731,21303,3195,2366,832,4927,6576
AGTCCGCAGTTCAGAA,sample,44370,43974,3085,40889,14260,26629,13612,770,8098,824,21710,3325,1909,601,6578,8545
GTCCTGCCGTTCAGAA,sample,62201,61443,6431,55012,14455,40557,12356,459,15472,1731,27828,10539,4144,761,5507,9060
ACGTATTAGTTCAGAA,sample,21924,21508,3985,17523,2647,14876,3427,160,6186,686,9613,4417,2551,457,1340,1585
CGTATGAAGTTCAGAA,sample,56516,55750,6240,49510,10912,38598,11885,517,15819,1892,27704,8485,4435,627,4770,7163
TTGGCCTCGTTCAGAA,sample,28417,28159,2018,26141,6716,19425,8861,425,6640,699,15501,2800,1915,575,2949,4322
ACCAATGCGTTCAGAA,sample,55364,54770,6552,48218,8963,39255,13978,693,14402,1317,28380,8865,3722,719,4371,6080
TGCTTCGCGTTCAGAA,sample,18828,18590,2360,16230,3667,12563,4075,229,4763,423,8838,3073,1965,330,2234,2261
GAAGGCGCGTTCAGAA,sample,45003,44439,6060,38379,5961,32418,7810,699,13228,1271,21038,9410,4496,740,1611,3909
TCAATATAGTTCAGAA,sample,29188,28944,2121,26823,6922,19901,8538,624,6711,1178,15249,2850,1352,348,4663,4895
CTTCATGAGTTCAGAA,sample,71077,70102,12264,57838,8428,49410,9826,286,21046,2127,30872,16125,5855,676,4177,4684
AGGTCGGAGTTCAGAA,Pos_Ctrl,37834,37041,2960,34081,1622,32459,26762,2452,2238,308,29000,699,4854,4994,1757,912
GGAGAGTTTTCTGGTT,sample,31471,31128,2697,28431,12556,15875,8234,281,4344,547,12578,2469,1808,463,5138,6424
ATTCTCTTTTCTGGTT,sample,98998,97516,17131,80385,12764,67621,14146,603,28272,3089,42418,21511,7092,905,5253,7465
TCCAACTTTTCTGGTT,Neg_Ctrl,1355,734,536,198,23,175,59,9,68,0,127,39,33,13,19,17
GGTTGCGTTTCTGGTT,sample,57395,56484,8747,47737,8147,39590,9221,473,16535,1785,25756,11576,4833,774,3324,5103
TTCGTAATTTCTGGTT,sample,44979,44445,3275,41170,15411,25759,17954,478,4758,1174,22712,1395,750,360,12785,9564
TTCTAATGTTCTGGTT,Neg_Ctrl,1688,1104,907,197,38,159,35,0,58,35,93,31,47,13,17,6
CAACCGCGTTCTGGTT,sample,30979,30666,2396,28270,9475,18795,11007,269,5150,372,16157,1997,1214,412,6883,5732
GGACCTCTTTCTGGTT,Neg_Ctrl,732,444,265,179,35,144,59,1,55,5,114,24,53,13,31,16
CAAGGCCTTTCTGGTT,sample,45257,44776,4399,40377,6689,33688,13736,691,12638,1612,26374,5011,3129,772,4828,4608
CATAACCTTTCTGGTT,sample,75820,75204,5504,69700,19999,49701,24287,1211,14404,1675,38691,8124,3100,749,14616,13170
GACGGAGATTCTGGTT,sample,10405,9780,704,9076,3925,5151,2940,284,1370,92,4310,465,939,546,848,1905
CCAGAGCGTTCTGGTT,sample,5447,5393,514,4879,1563,3316,912,113,1314,136,2226,841,744,157,507,903
GGAGGACGTTCTGGTT,sample,11861,11665,1328,10337,4356,5981,3259,114,1559,177,4818,872,880,339,1885,2247
CCGCAACGTTCTGGTT,sample,8288,8071,1862,6209,999,5210,705,20,2257,248,2962,1980,1324,129,200,554
GGACGTAGTTCTGGTT,sample,19052,18721,3893,14828,2368,12460,1616,89,5686,573,7302,4496,2619,246,507,1390
CTTGATAGTTCTGGTT,sample,14708,14442,1807,12635,4340,8295,3456,197,2531,350,5987,1761,1114,254,1982,2500
TGGACGAGTTCTGGTT,sample,17926,17599,1067,16532,7968,8564,5367,358,2196,207,7563,436,626,328,3417,3885
ACGACTTCTTCTGGTT,sample,55983,55205,8463,46742,9503,37239,10935,678,14600,1519,25535,9507,4547,735,5293,5913
CATGATTCTTCTGGTT,sample,44593,44055,4839,39216,10651,28565,11016,395,10596,1037,21612,5521,3394,577,5937,6998
CGTACGTCTTCTGGTT,sample,24799,24507,2204,22303,7000,15303,5473,373,6044,529,11517,2884,2225,568,1346,4186
TTGGTACCTTCTGGTT,sample,15950,15641,3865,11776,1600,10176,1317,76,4496,472,5813,3815,2414,246,469,911
GCCTGAACTTCTGGTT,sample,91294,90133,18582,71551,8908,62643,9178,382,27058,2812,36236,23213,8674,833,3670,5168
TTGGCCTCTTCTGGTT,sample,22684,22362,3597,18765,4787,13978,1469,53,6204,688,7673,5564,2776,217,347,2778
CCAATTCCTTCTGGTT,sample,33133,32838,2133,30705,9905,20800,10373,816,6006,632,16379,2973,2232,607,4035,5905
ACGTTATGGTTCGGTT,sample,53296,52772,3771,49001,17982,31019,18037,436,8072,1125,26109,3349,1636,514,10886,10673
TGAGCGCGGTTCGGTT,sample,47299,46686,6594,40092,7036,33056,9054,403,13552,1340,22606,8707,4454,797,3663,4508
TTAGAAGTGTTCGGTT,sample,73154,72339,6329,66010,14513,51497,25561,1473,15561,1720,41122,7182,4217,1584,4860,9470
GGACCTCTGTTCGGTT,sample,28404,27880,3828,24052,7312,16740,3866,210,6747,724,10613,5193,2660,312,1740,4156
GCCTTGCTGTTCGGTT,sample,19051,18722,2538,16184,4452,11732,3328,195,4868,549,8196,2792,2113,404,1602,2665
CCAGAGCGGTTCGGTT,sample,52693,52232,2911,49321,16217,33104,19035,461,10205,614,29240,2789,1392,432,13413,10758
CTTGATAGGTTCGGTT,sample,37566,37180,2407,34773,14108,20665,10053,755,6903,792,16956,2162,1954,798,1929,7569
ACCTCGAGGTTCGGTT,sample,44693,44060,3185,40875,10630,30245,12366,775,11640,1066,24006,4398,2833,883,3038,6923
GACGATAAGTTCGGTT,sample,25968,25716,2874,22842,4214,18628,5380,338,7625,991,13005,4294,2708,679,722,2663
GGCCAGAGGTTCGGTT,sample,75414,74912,3903,71009,18774,52235,27811,1783,16379,2094,44190,4168,2576,1256,8279,12886
ACGACTTCGTTCGGTT,sample,63892,63489,2528,60961,21695,39266,21574,895,11999,1234,33573,3564,2149,601,12115,12985
GTCCTGCCGTTCGGTT,sample,59514,58877,5701,53176,5956,47220,13702,878,21244,2128,34946,9268,4361,978,1195,4169
GTCTTAGCGTTCGGTT,sample,70031,69309,8606,60703,12097,48606,13428,561,19870,2283,33298,12464,5218,704,5853,7655
TTGGTTAAGTTCGGTT,sample,87592,86977,5926,81051,21802,59249,27219,889,19716,1636,46935,9789,3401,663,13536,14835
GTACCGTAGTTCGGTT,sample,40279,39801,4402,35399,6517,28882,7681,593,11959,1338,19640,7311,3686,641,954,4086
TTATTCGAGTTCGGTT,Neg_Ctrl,658,509,264,245,37,208,149,9,31,2,180,17,96,64,32,21
TATCAGTTTGGCGGTT,sample,59835,58863,6248,52615,15820,36795,13296,599,13544,1479,26840,7877,3446,654,6437,9919
ATTCTCTTTGGCGGTT,sample,84104,82810,6561,76249,23658,52591,25631,1137,16800,1821,42431,7202,2787,696,15429,15167
GGTTGCGTTGGCGGTT,sample,10422,10116,660,9456,3362,6094,3803,171,1594,126,5397,400,1161,727,953,1976
TCCTCCGTTGGCGGTT,sample,79879,78749,7416,71333,17568,53765,21357,1648,19552,2468,40909,8740,3079,762,10039,11726
AGTACCATTGGCGGTT,sample,70481,69387,7054,62333,17988,44345,22256,766,14386,1496,36642,5441,2295,667,12793,11454
TTCGTAATTGGCGGTT,sample,90396,89292,6157,83135,34181,48954,31346,1606,11717,721,43063,3564,1161,519,21035,19508
ATGCCTGGTGGCGGTT,sample,87190,86069,8142,77927,22043,55884,21930,1111,19549,1851,41479,11443,4365,748,12762,14306
AATGGTAATGGCGGTT,sample,55698,54596,7912,46684,9590,37094,10761,385,13922,1387,24683,10639,4448,528,5724,6309
GGACCTCTTGGCGGTT,sample,87484,86453,7925,78528,17747,60781,19834,895,23951,2395,43785,13706,5419,887,9087,11566
ACTATACTTGGCGGTT,sample,160727,159192,17492,141700,21374,120326,31164,996,49000,5626,80164,33540,9090,1373,16436,14439
GACGGAGATGGCGGTT,sample,121905,121272,9170,112102,36971,75131,27979,1867,25200,2177,53179,17908,5321,1142,14467,21960
CCAGAGCGTGGCGGTT,sample,104026,103105,8690,94415,27538,66877,26560,1003,21495,2782,48055,15037,5644,964,14280,17434
CCGCAACGTGGCGGTT,sample,17527,17272,2263,15009,3619,11390,2666,143,5081,627,7747,2873,2167,412,956,2162
GGACGTAGTGGCGGTT,sample,104215,103351,7311,96040,29929,66111,26815,1329,22361,2320,49176,13286,4226,954,13425,18266
CTTGATAGTGGCGGTT,sample,19235,18959,3070,15889,2592,13297,2549,223,5998,622,8547,3905,2554,478,500,1479
GACGATAATGGCGGTT,sample,113866,113128,6432,106696,51446,55250,34517,1789,12286,997,46803,5661,2656,1124,15618,24901
CATTGCAGTGGCGGTT,sample,64711,64260,6755,57505,11535,45970,13045,610,18297,2034,31342,11984,5367,788,7156,7447
ACGACTTCTGGCGGTT,sample,128435,127298,8240,119058,38776,80282,43860,1062,21960,2546,65820,10854,3184,628,28973,24550
CGTACGTCTGGCGGTT,sample,88105,87256,4204,83052,29765,53287,32345,1590,13332,1549,45677,4471,1906,671,17100,18506
AGTCCGCATGGCGGTT,sample,337505,334653,29258,305395,49738,255657,59753,2838,103033,13272,162786,76761,12981,2886,26197,33439
TTGGTACCTGGCGGTT,sample,221507,219474,29847,189627,41739,147888,35436,1791,58834,5939,94270,45888,12232,1829,16254,25717
AACTCGTATGGCGGTT,sample,150161,148892,13191,135701,32703,102998,41910,1389,35385,3923,77295,20391,6212,974,23811,21444
CGTATGAATGGCGGTT,sample,198049,196187,17685,178502,38589,139913,35253,1210,53663,5523,88916,44264,8894,1333,16849,25785
ACCAATGCTGGCGGTT,sample,103721,103283,6352,96931,42186,54745,23239,1160,18674,1759,41913,9913,3920,1023,9981,22505
GAAGGCGCTGGCGGTT,sample,102013,100854,12583,88271,14867,73404,10871,801,33169,3525,44040,25038,7785,968,1959,9234
ACGTAAGTTCCTTATT,sample,9828,9581,2180,7401,703,6698,1220,60,3064,339,4284,2015,1589,246,237,395
AGTACCATTCCTTATT,sample,15226,14900,2811,12089,1938,10151,2066,119,4407,492,6473,3067,1734,300,531,1077
TAGTACGGTCCTTATT,sample,25064,24713,2108,22605,5417,17188,6835,338,5506,801,12341,3708,1933,374,3919,3784
GCCTTGCTTCCTTATT,sample,25060,24798,1717,23081,8399,14682,9730,317,3482,235,13212,918,716,310,6615,4958
CCAGAGCGTCCTTATT,sample,16354,16098,2645,13453,2679,10774,2013,69,4792,586,6805,3314,2389,363,278,1584
GGAGGACGTCCTTATT,sample,24522,24206,4853,19353,1862,17491,3328,171,7864,827,11192,5301,3393,584,623,1000
GGACGTAGTCCTTATT,sample,17480,17321,1119,16202,7546,8656,6116,269,1558,121,7674,592,775,444,3530,3849
CTTGATAGTCCTTATT,sample,25423,25198,2900,22298,5176,17122,5886,182,6407,571,12293,4076,2459,480,2510,3241
TGGACGAGTCCTTATT,sample,10856,10786,762,10024,3800,6224,2579,137,2263,344,4842,901,1089,391,772,2105
ACGACTTCTCCTTATT,sample,28049,27815,1474,26341,9120,17221,11654,466,4284,162,15938,655,525,279,7736,5729
CATGATTCTCCTTATT,sample,16430,16280,2129,14151,2054,12097,2136,105,5373,644,7509,3839,2430,349,414,1163
AATCCGTCTCCTTATT,sample,13428,13330,1191,12139,1960,10179,3414,297,4000,486,7414,1982,1618,467,556,1244
CGTACGTCTCCTTATT,sample,20194,20035,982,19053,6919,12134,5923,611,3533,458,9456,1609,1060,337,2698,3987
CGGATTACTCCTTATT,sample,29100,28752,3304,25448,4781,20667,6453,328,7723,720,14176,5443,2877,501,2696,3075
ACGTATTATCCTTATT,sample,37695,37303,3842,33461,7635,25826,8468,382,9750,760,18218,6466,2790,466,4543,5012
TTGGCCTCTCCTTATT,Pos_Ctrl,25010,24648,2403,22245,1200,21045,17641,1513,1320,183,18961,388,3879,3551,1318,694
TGCTTCGCTCCTTATT,sample,17918,17683,2261,15422,2459,12963,3536,246,5590,481,9126,3110,2216,485,544,1556
GAAGGCGCTCCTTATT,sample,24033,23725,4157,19568,3043,16525,3032,78,7208,823,10240,5384,3040,303,1234,1665
AAGAGCGCTCCTTATT,sample,30868,30580,3341,27239,5221,22018,6855,426,8871,735,15726,5131,3286,538,2814,3529
CCAATTCCTCCTTATT,sample,24111,23794,2084,21710,5488,16222,5938,227,5769,566,11707,3722,1578,294,2829,3690
GTACCGTATCCTTATT,sample,28496,28150,5061,23089,3426,19663,2177,135,8856,930,11033,7565,3500,297,521,1820
GGCATATATCCTTATT,sample,33743,33292,6327,26965,2545,24420,2088,124,11701,1167,13789,9340,4416,345,230,1333
TCAATATATCCTTATT,sample,48524,48066,7328,40738,5547,35191,7466,242,14360,1643,21826,11480,4692,517,3132,3434
AGGTCGGATCCTTATT,sample,14067,13899,1935,11964,2304,9660,2744,227,3963,528,6707,2198,1970,505,241,1439
GGAGAGTTAATAAGGT,sample,66287,65659,5162,60497,13624,46873,22551,1560,14472,1978,37023,6312,3398,1167,7036,9210
TATCAGTTAATAAGGT,sample,76088,75078,10199,64879,12975,51904,16421,724,20375,2105,36796,12279,4992,796,8542,8584
TCCAACTTAATAAGGT,sample,71022,70112,3489,66623,26333,40290,26387,1182,9498,774,35885,2449,883,456,17756,15108
ACGTAAGTAATAAGGT,sample,38976,38393,6617,31776,4438,27338,6670,408,11801,1304,18471,7155,3999,812,1279,2793
CCTCTAGAAATAAGGT,sample,53063,52019,9654,42365,5910,36455,8253,431,14730,1501,22983,11540,4834,654,3787,3809
TTCGTAATAATAAGGT,sample,32011,31530,4156,27374,5458,21916,5480,359,9275,962,14755,5840,3341,575,1411,3278
TGAGCGCGAATAAGGT,sample,58424,57577,8342,49235,9454,39781,7535,335,17337,1697,24872,12877,4950,534,2580,5414
CATAACCTAATAAGGT,sample,113933,110860,12507,98353,23808,74545,22947,840,29996,3265,52943,17497,5259,863,10064,14715
ACTATACTAATAAGGT,sample,27734,26998,2713,24285,8329,15956,7544,552,5283,551,12827,2026,2093,951,1667,4793
GACGGAGAAATAAGGT,sample,70747,69989,6498,63491,12286,51205,23367,831,16715,2022,40082,8270,3487,704,14085,8863
CCAGAGCGAATAAGGT,sample,37700,37463,3167,34296,10822,23474,8592,410,8120,881,16712,5471,3230,485,5136,6469
GGAGGACGAATAAGGT,sample,78683,78014,5902,72112,22452,49660,25055,1291,13037,1562,38092,8715,3691,1079,9850,14465
CCGCAACGAATAAGGT,Pos_Ctrl,26991,26413,2381,24032,1471,22561,18900,1556,1477,168,20377,460,4109,3846,1747,830
CTTGATAGAATAAGGT,sample,82685,82049,5450,76599,22582,54017,23807,803,17729,2001,41536,9677,3442,742,12322,14854
TGGACGAGAATAAGGT,sample,64262,63601,6352,57249,15568,41681,13707,704,15788,1760,29495,9722,4056,778,4426,9607
GGCCAGAGAATAAGGT,sample,66129,65466,6372,59094,12755,46339,15809,872,18458,1843,34267,9357,4129,835,6164,8595
CATTGCAGAATAAGGT,sample,25855,25439,3726,21713,3283,18430,4160,240,8211,850,12371,4969,2903,514,1328,2021
AATCCGTCAATAAGGT,Pos_Ctrl,75008,74100,4909,69191,3136,66055,54905,5214,4071,533,58976,1332,6204,7273,3760,1955
CGTACGTCAATAAGGT,sample,85536,84496,11336,73160,16197,56963,14543,1186,23139,2776,37682,15319,6030,1089,2854,9763
AGTCCGCAAATAAGGT,sample,241112,237981,39584,198397,21428,176969,27244,896,76749,8538,103993,63542,14303,1977,10172,12600
TTGGTTAAAATAAGGT,sample,61861,60969,8944,52025,5852,46173,8069,459,20468,2185,28537,14992,5733,674,932,3716
GGCATATAAATAAGGT,sample,43271,42994,2835,40159,15219,24940,9821,845,8678,1109,18499,4487,2478,460,3910,8349
GGAGAGTTCAGGACCA,sample,22417,22159,3911,18248,5192,13056,2783,141,5452,592,8235,4088,2691,407,1202,2869
ATTCTCTTCAGGACCA,sample,158683,157380,17304,140076,36344,103732,42309,1736,33820,3224,76129,22643,6384,1458,21221,23069
TCCTCCGTCAGGACCA,sample,34582,33871,3462,30409,8966,21443,8567,677,7819,816,16386,3564,2316,707,3363,5581
TTCTAATGCAGGACCA,sample,115789,114792,10479,104313,29583,74730,32105,1214,24083,2692,56188,14636,3992,752,17657,18346
ATGCCTGGCAGGACCA,sample,77660,76480,13262,63218,10088,53130,12514,433,21721,2385,34235,16077,6369,693,6971,6460
TTCCGTCTCAGGACCA,sample,39757,39186,5322,33864,5950,27914,9085,556,11943,1221,21028,5109,3407,860,3086,4069
TCGCATCTCAGGACCA,sample,149780,148646,10196,138450,43610,94840,50515,2288,26948,3235,77463,11854,3368,913,25939,28186
GCCTTGCTCAGGACCA,sample,36993,36470,4983,31487,6683,24804,7238,380,10706,1108,17944,5372,3268,720,2254,3854
CATAACCTCAGGACCA,sample,88764,87552,14570,72982,10558,62424,8785,536,27434,2783,36219,22886,7154,846,2740,6248
CCAGAGCGCAGGACCA,sample,52847,52178,5399,46779,12114,34665,15789,570,10548,1240,26337,6518,2469,540,9198,8354
GGAGGACGCAGGACCA,sample,66161,65117,8619,56498,8390,48108,8832,551,22107,2130,30939,14488,5970,758,2374,5330
GGACGTAGCAGGACCA,sample,41532,41036,2600,38436,12452,25984,12911,883,7921,1124,20832,3145,2093,832,4083,7478
CTTGATAGCAGGACCA,sample,67968,67361,4255,63106,24762,38344,25774,732,9303,776,35077,1759,921,511,15682,14624
CGAGGCAGCAGGACCA,sample,24861,24611,2071,22540,9407,13133,6487,315,4055,392,10542,1884,1499,471,3641,4848
AACTCGTACAGGACCA,sample,102176,101404,6218,95186,34610,60576,37574,1031,15122,1213,52696,5636,1664,517,24475,20916
CGTATGAACAGGACCA,sample,92604,91707,7771,83936,28054,55882,25486,1241,17724,1926,43210,9505,4325,807,13988,16345
AATATATCCAGGACCA,Neg_Ctrl,1880,1563,640,923,50,873,408,66,298,15,706,86,63,30,22,97
TGCTTCGCCAGGACCA,sample,67293,66689,7162,59527,13189,46338,13640,1001,19337,2175,32977,10185,4479,761,6102,8428
GTCTTAGCCAGGACCA,sample,45487,44984,4321,40663,5737,34926,11975,490,14671,1661,26646,6129,3203,780,1474,3859
GTACCGTACAGGACCA,sample,171562,169782,19649,150133,43377,106756,26703,1253,41757,4339,68460,32704,9445,1377,11160,26667
TCGCCTGACAGGACCA,sample,59536,58762,8841,49921,9168,40753,6125,328,18010,1884,24135,14406,5216,579,1564,5509
TTATTCGACAGGACCA,sample,75297,74352,11660,62692,9655,53037,10434,440,22035,2159,32469,17969,6481,696,3970,5791
ATGACCGACAGGACCA,sample,57621,56932,5934,50998,9097,41901,13267,636,17582,1773,30849,8643,4075,813,2270,5803
GACCGGAACAGGACCA,sample,66372,65889,4795,61094,8720,52374,19556,1069,20788,2735,40344,8226,3879,1111,2122,6253
ATTCTCTTCCTCGTTG,sample,26566,26098,4256,21842,3703,18139,5778,218,7023,776,12801,4344,2862,577,2286,2397
TCCAACTTCCTCGTTG,sample,34221,33705,5109,28596,4434,24162,6440,261,9269,1038,15709,7154,3228,384,4033,2851
CCTCTAGACCTCGTTG,sample,109271,108195,9156,99039,20908,78131,33877,2048,25183,3126,59060,13897,5460,1272,13478,13969
TAGTACGGCCTCGTTG,sample,50450,49707,6385,43322,8365,34957,11163,596,13488,1459,24651,8251,3804,782,2190,5481
TCGCATCTCCTCGTTG,sample,17099,16654,3016,13638,1795,11843,2496,120,5351,633,7847,3243,2215,397,720,973
GACGGAGACCTCGTTG,sample,71826,70994,9560,61434,10270,51164,12226,594,21623,1865,33849,14856,5550,879,2914,6436
CCGCAACGCCTCGTTG,sample,26791,26369,3984,22385,2899,19486,5104,331,8540,910,13644,4601,3033,700,886,1821
GGACGTAGCCTCGTTG,Neg_Ctrl,901,457,302,155,37,118,27,1,51,6,78,33,40,16,8,9
CTTGATAGCCTCGTTG,sample,16261,16067,829,15238,6902,8336,4328,223,2526,262,6854,997,1026,539,1294,3518
ACCTCGAGCCTCGTTG,sample,80454,79702,9567,70135,14044,56091,14139,600,22306,2327,36445,16719,5628,879,5534,8896
TGGACGAGCCTCGTTG,sample,34282,33991,1988,32003,14483,17520,10537,683,4338,529,14875,1433,1139,518,6082,7573
GACGATAACCTCGTTG,sample,52609,52043,5021,47022,14282,32740,12871,688,11810,1154,24681,6217,3357,653,6333,8571
GGCCAGAGCCTCGTTG,sample,12738,12565,2455,10110,1176,8934,1401,110,4142,468,5543,2813,1907,284,296,630
CGTACGTCCCTCGTTG,Neg_Ctrl,1180,630,388,242,53,189,63,0,93,8,156,25,56,16,21,9
AGTCCGCACCTCGTTG,sample,41113,40574,4602,35972,5782,30190,9995,571,12132,1117,22127,6375,3545,732,1487,4093
TTGGTACCCCTCGTTG,sample,27422,27098,3549,23549,5080,18469,5267,325,6891,819,12158,5167,2854,600,1670,3073
CGGATTACCCTCGTTG,sample,62458,61594,9888,51706,8365,43341,7104,388,19426,1886,26530,14537,5589,604,1928,5135
GCCTGAACCCTCGTTG,sample,62915,62116,8521,53595,11234,42361,10168,631,17516,2253,27684,11793,4931,930,2074,6981
AACTCGTACCTCGTTG,sample,83056,82098,14636,67462,8683,58779,11695,645,24717,2389,36412,19333,6955,1057,3641,5043
TGCTTCGCCCTCGTTG,sample,52422,51980,3287,48693,16876,31817,15362,617,10187,882,25549,4769,2731,515,8229,10365
GAAGGCGCCCTCGTTG,sample,81903,81032,9973,71059,16194,54865,18226,761,19339,1993,37565,14546,3355,635,8714,10095
TTGGTTAACCTCGTTG,sample,58547,57896,7540,50356,8185,42171,8779,389,19535,1795,28314,11673,4644,608,1602,5047
GTACCGTACCTCGTTG,Pos_Ctrl,34955,34290,3302,30988,1618,29370,24194,2214,2041,271,26235,650,4588,4614,1292,1022
TCAATATACCTCGTTG,sample,48557,48233,4407,43826,13544,30282,7990,454,12804,1476,20794,7558,3261,705,1699,8109
TCGCCTGACCTCGTTG,sample,81967,80980,11898,69082,7991,61091,8631,520,27094,2860,35725,21986,6753,724,1748,4600
TATCAGTTTTGCGGAC,sample,53838,53541,3541,50000,19550,30450,17697,681,7158,1155,24855,3759,2274,543,10812,11086
AAGTTCGTTTGCGGAC,sample,56238,55516,7616,47900,10129,37771,12604,407,13937,1543,26541,9280,4340,608,7496,6568
TCCTCCGTTTGCGGAC,sample,20908,20678,1946,18732,3326,15406,6325,418,5882,692,12207,2089,2053,776,1460,2334
TTCTAATGTTGCGGAC,sample,83221,82397,6760,75637,23538,52099,23542,1229,17632,1624,41174,8072,4009,846,10458,14764
ATGCCTGGTTGCGGAC,sample,37477,37054,5546,31508,7668,23840,5688,210,9745,976,15433,7221,3844,482,2881,4596
TAGTACGGTTGCGGAC,sample,20396,20145,2499,17646,3085,14561,4847,266,6187,596,11034,2665,2218,478,2069,1949
TTAGAAGTTTGCGGAC,sample,49293,48827,5836,42991,10891,32100,9062,304,12471,1595,21533,8668,3788,549,4507,6599
TTCCGTCTTTGCGGAC,sample,23981,23793,2171,21622,6604,15018,7220,418,4484,488,11704,2408,2158,787,2920,4137
GGACCTCTTTGCGGAC,sample,40988,40519,4578,35941,9826,26115,8898,445,9878,1345,18776,5549,2688,436,4697,6165
TGGACGAGTTGCGGAC,sample,119275,118212,12791,105421,17551,87870,22226,813,35126,3923,57352,25782,7528,1112,10168,11651
GACGATAATTGCGGAC,sample,103524,102376,14860,87516,12976,74540,19322,1222,30529,3471,49851,19996,7122,1078,6853,8467
AATCCGTCTTGCGGAC,sample,55882,55252,6187,49065,9139,39926,10074,605,16815,1583,26889,10849,4578,564,1497,5841
AACTCGTATTGCGGAC,sample,115394,114256,15460,98796,16286,82510,12379,613,37518,3724,49897,28276,8850,1154,2936,9620
ACCAATGCTTGCGGAC,sample,68361,67498,9639,57859,8729,49130,10226,764,21091,2251,31317,14798,5387,713,2084,5605
AAGAGCGCTTGCGGAC,sample,57151,56628,5104,51524,8052,43472,14875,974,18288,2373,33163,6962,3471,803,4196,5599
CCAATTCCTTGCGGAC,sample,97772,96807,10100,86707,13912,72795,24764,1621,26535,3495,51299,16380,5870,1014,8135,8953
GACCGGAATTGCGGAC,sample,76180,75640,5256,70384,25518,44866,20753,962,14041,1356,34794,7754,2688,565,10292,14213
AAGTTCGTTCCATTGG,sample,5244,5088,1129,3959,830,3129,862,42,1259,139,2121,827,721,123,497,452
CAACCGCGTCCATTGG,sample,21923,21602,2986,18616,4496,14120,3442,203,5622,582,9064,4271,2219,368,1585,2768
TTCCGTCTTCCATTGG,sample,46858,46335,5346,40989,8626,32363,11214,427,12406,1530,23620,6786,3033,563,5608,5634
GCCTTGCTTCCATTGG,sample,31459,31102,4116,26986,4723,22263,8532,394,7708,755,16240,4874,2898,719,2778,3056
CATAACCTTCCATTGG,sample,9443,9301,577,8724,2588,6136,3294,261,1775,206,5069,600,1203,680,460,1621
ACTATACTTCCATTGG,sample,36281,35920,3198,32722,9821,22901,10600,358,7629,741,18229,3573,2081,430,6839,6206
GGACGTAGTCCATTGG,sample,13271,13079,927,12152,4582,7570,4757,106,1822,192,6579,693,642,271,3103,2741
TGGACGAGTCCATTGG,sample,15003,14719,2858,11861,1622,10239,1274,54,4780,529,6054,3602,2314,210,381,969
AGTCCGCATCCATTGG,sample,39453,38965,5531,33434,6560,26874,6414,288,11138,1266,17552,7768,3905,537,2513,4052
GTCCTGCCTCCATTGG,sample,20345,20156,1111,19045,6910,12135,7763,279,2840,476,10603,777,637,294,4841,4159
CTAGGACCTCCATTGG,sample,26036,25725,2585,23140,5443,17697,6294,303,6301,997,12595,3802,2350,539,2504,3477
CGGATTACTCCATTGG,sample,27238,26922,2869,24053,6596,17457,5684,241,6457,818,12141,4257,2562,398,2915,4083
GCCTGAACTCCATTGG,sample,66363,65737,8055,57682,8455,49227,11043,612,20461,2500,31504,14611,5841,749,4544,5858
TTGGCCTCTCCATTGG,sample,18013,17905,901,17004,8287,8717,4568,279,2477,224,7045,1169,1177,491,1944,3906
GAAGGCGCTCCATTGG,sample,20473,20282,2291,17991,2016,15975,4880,283,6290,851,11170,3671,2341,512,253,1297
AAGAGCGCTCCATTGG,sample,25823,25677,1649,24028,9394,14634,6726,576,4216,526,10942,2590,1715,443,3334,5353
CCAATTCCTCCATTGG,sample,34430,34112,4220,29892,4740,25152,6092,351,10001,1170,16093,7538,4019,433,3104,2867
GGCATATATCCATTGG,Neg_Ctrl,227,124,56,68,12,56,23,1,19,0,42,13,22,5,13,2
TTATTCGATCCATTGG,sample,18472,18380,901,17479,5546,11933,5757,216,3872,350,9629,1738,1060,309,2931,3632
ACGTAAGTCATAGGCG,sample,29070,28411,3089,25322,3997,21325,7315,315,9068,1041,16383,3586,2695,777,797,2650
CCTCTAGACATAGGCG,sample,77139,75488,8399,67089,18646,48443,18841,707,16259,1838,35100,10798,3396,658,11682,11640
TTCTAATGCATAGGCG,sample,127353,125348,24246,101102,6653,94449,13034,921,43445,4583,56479,32466,8770,1198,758,2918
ATGCCTGGCATAGGCG,sample,107055,105889,12208,93681,19214,74467,25577,1848,28653,3190,54230,15199,5259,981,9752,13411
TAGTACGGCATAGGCG,sample,178249,176029,30202,145827,18014,127813,25463,1001,53642,5431,79105,42276,10301,1377,11525,11247
CAACCGCGCATAGGCG,sample,69695,68775,8884,59891,11933,47958,15894,393,17880,2093,33774,11698,4427,625,9341,7639
AATGGTAACATAGGCG,sample,31490,31017,5173,25844,3708,22136,6542,412,8877,1049,15419,5256,3028,557,2573,2273
TTAGAAGTCATAGGCG,sample,7518,7370,1554,5816,1542,4274,1040,63,1741,200,2781,1230,1104,227,381,862
GGACCTCTCATAGGCG,sample,14229,14013,3187,10826,694,10132,1800,107,4587,489,6387,3149,2478,535,89,278
GCCTTGCTCATAGGCG,sample,56487,55871,5176,50695,17325,33370,13511,514,11795,1413,25306,6137,3239,800,6713,9917
CATAACCTCATAGGCG,sample,43045,42323,6995,35328,7399,27929,5559,391,11781,1244,17340,8954,3655,509,2573,4901
CCGCAACGCATAGGCG,sample,23098,22652,4086,18566,2501,16065,2932,163,7096,779,10028,5095,3148,483,988,1584
ACCTCGAGCATAGGCG,sample,13735,13591,809,12782,5633,7149,3971,269,1866,299,5837,744,975,436,2072,2873
GACGATAACATAGGCG,sample,19415,19024,3390,15634,1851,13783,2756,153,6497,665,9253,3712,2700,498,521,1083
GGCCAGAGCATAGGCG,sample,33430,32838,7283,25555,3250,22305,3189,103,10510,1141,13699,7362,4018,442,864,1853
CCATGAAGCATAGGCG,sample,51992,51434,4613,46821,6580,40241,13204,814,17736,2056,30940,6431,3463,884,3110,4370
AATCCGTCCATAGGCG,sample,92201,91370,9274,82096,20197,61899,22604,684,22450,2496,45054,13665,4315,746,10704,13394
TTGGTACCCATAGGCG,sample,75948,75130,9602,65528,11430,54098,16953,398,21622,2618,38575,12507,5167,706,7407,7584
CGGATTACCATAGGCG,sample,34065,33593,4473,29120,9188,19932,5429,251,7785,900,13214,5567,2953,450,1906,5066
GCCTGAACCATAGGCG,sample,62508,61952,5533,56419,15542,40877,16502,943,13971,1344,30473,8117,3550,777,6881,9875
AACTCGTACATAGGCG,sample,53722,53231,4312,48919,15432,33487,11906,724,13239,1484,25145,6134,3519,819,4506,9450
CGTATGAACATAGGCG,sample,52738,52121,7206,44915,4527,40388,9723,507,18485,1927,28208,9746,4597,899,876,2665
TTGGCCTCCATAGGCG,sample,31744,31320,4043,27277,4324,22953,5651,504,9949,1205,15600,5644,3127,640,435,2823
AATATATCCATAGGCG,sample,136152,134813,17002,117811,17069,100742,18909,1158,44959,4660,63868,31056,9177,1461,4743,11202
AAGAGCGCCATAGGCG,sample,157486,155904,20229,135675,16804,118871,25638,440,49691,5074,75329,38028,10351,1353,11164,10591
GTCTTAGCCATAGGCG,sample,41567,41058,5242,35816,3957,31859,8527,433,13491,1668,22018,7740,3957,828,1109,2481
CCAATTCCCATAGGCG,sample,36484,35899,5940,29959,3714,26245,5537,177,11477,1121,17014,7933,4047,681,1432,2196
GTACCGTACATAGGCG,sample,69429,68692,8940,59752,10576,49176,15666,703,18334,1978,34000,12495,4841,869,6371,6604
CTTCATGACATAGGCG,sample,112306,111196,14792,96404,17310,79094,18281,1059,33093,3816,51374,22845,7042,1064,6539,11270
AGGTCGGACATAGGCG,sample,33037,32805,2161,30644,12249,18395,10338,634,4461,527,14799,2435,2132,939,2955,6842
ATGACCGACATAGGCG,sample,37375,36905,4272,32633,5177,27456,5850,660,12220,1273,18070,7453,3464,516,858,3385
GACCGGAACATAGGCG,sample,48213,47812,5332,42480,8987,33493,9843,525,14022,1589,23865,7514,3505,500,4697,5774
ATTCTCTTTTGGAGAG,Pos_Ctrl,58757,57553,6554,50999,3182,47817,39495,3361,3453,406,42948,1102,5595,5792,3639,2433
GGTTGCGTTTGGAGAG,sample,55679,54573,8753,45820,6194,39626,6415,340,18430,2219,24845,12222,4528,647,1047,3538
ATGCCTGGTTGGAGAG,sample,5012,4883,815,4068,689,3379,889,66,1380,153,2269,891,876,198,313,446
TGAGCGCGTTGGAGAG,sample,28188,27783,4845,22938,3950,18988,3809,209,8262,904,12071,5804,3384,642,726,2286
TTCCGTCTTTGGAGAG,Pos_Ctrl,36238,35617,3825,31792,2124,29668,24515,2130,2114,232,26629,677,4644,4170,2365,1569
TCGCATCTTTGGAGAG,sample,61907,61113,7054,54059,11651,42408,13664,506,15816,1895,29480,10527,4109,664,7296,7985
CAAGGCCTTTGGAGAG,sample,29976,29517,3567,25950,6717,19233,5647,447,7555,854,13202,4730,3075,839,1465,3886
CATAACCTTTGGAGAG,sample,8733,8600,653,7947,2866,5081,2376,237,1617,192,3993,659,1133,610,352,1618
ACTATACTTTGGAGAG,sample,47769,47268,3643,43625,14257,29368,13870,779,8784,1046,22654,4889,1816,522,8471,8783
GGAGGACGTTGGAGAG,sample,86133,85036,13257,71779,12451,59328,13889,461,24416,2402,38305,18160,7018,817,7200,8157
CTTGATAGTTGGAGAG,sample,73550,72702,4671,68031,23531,44500,25705,1059,11831,1974,37536,3931,1756,604,15105,14333
AGTCCGCATTGGAGAG,sample,10882,10718,1865,8853,1581,7272,1650,60,3009,370,4659,2183,1646,315,686,980
GTCCTGCCTTGGAGAG,sample,92516,91255,14970,76285,11073,65212,9387,725,28836,3183,38223,23081,7683,779,3168,6547
TTGGTACCTTGGAGAG,sample,42075,41745,2445,39300,15288,24012,13014,823,6248,988,19262,2939,2133,864,6308,8665
CGGATTACTTGGAGAG,sample,62148,61640,4901,56739,11799,44940,18646,1188,16237,1850,34883,7019,3258,859,5989,8282
ACGTATTATTGGAGAG,sample,105561,104192,16071,88121,17654,70467,15871,671,28611,2783,44482,22531,7054,883,6987,10675
CGTATGAATTGGAGAG,sample,82197,81259,10380,70879,14126,56753,17888,737,21051,2421,38939,14656,5014,571,9742,8774
GGCATATATTGGAGAG,sample,61932,61301,8103,53198,13676,39522,11665,782,14917,1446,26582,10712,4885,1007,3151,8481
TCGCCTGATTGGAGAG,sample,108194,107291,13438,93853,17465,76388,21685,857,30626,3096,52311,20124,5960,830,7683,10770
TTATTCGATTGGAGAG,sample,38786,38536,2762,35774,11651,24123,12820,719,6694,1081,19514,2809,1696,456,6584,7012
ATGACCGATTGGAGAG,sample,51170,50693,5835,44858,11117,33741,7849,278,14364,1932,22213,9318,4138,512,2120,7024
ATTCTCTTTTCAAGCC,sample,63780,63199,6408,56791,21605,35186,15437,963,10329,1137,25766,7320,3081,1045,6274,12357
AAGTTCGTTTCAAGCC,sample,26367,25855,3859,21996,3414,18582,5512,343,7731,957,13243,4039,2826,634,1826,2179
ACGTAAGTTTCAAGCC,sample,57746,56965,5064,51901,13879,38022,17381,626,12058,1044,29439,6913,2264,543,10601,9425
CCTCTAGATTCAAGCC,sample,45287,44539,5622,38917,9411,29506,8657,480,11601,1089,20258,7679,3229,573,4492,5957
ATGCCTGGTTCAAGCC,sample,35568,34892,5422,29470,4396,25074,6257,331,10633,1118,16890,6735,3798,651,1932,2655
TGAGCGCGTTCAAGCC,sample,24757,24416,2662,21754,5006,16748,5194,267,6889,753,12083,3645,2242,438,1822,3242
CAACCGCGTTCAAGCC,sample,21744,21454,1798,19656,5360,14296,7330,367,4426,564,11756,1609,1552,600,3293,3479
GCCTTGCTTTCAAGCC,sample,19131,18837,1219,17618,7451,10167,4610,333,3152,421,7762,1651,1325,579,1416,3960
CATAACCTTTCAAGCC,sample,20754,20370,2541,17829,4510,13319,3264,173,5705,532,8969,3645,2044,306,1171,2686
TGGACGAGTTCAAGCC,sample,50722,50175,6499,43676,10808,32868,10620,731,12023,1312,22643,8182,4106,796,4265,6852
GACGATAATTCAAGCC,sample,198817,196519,30632,165887,18636,147251,21715,1024,62831,6538,84546,55143,12358,1698,7390,10926
CGAGGCAGTTCAAGCC,sample,23406,23087,3219,19868,4085,15783,4163,230,6563,772,10726,4055,2472,430,1928,2500
CGTACGTCTTCAAGCC,sample,22094,21895,2818,19077,2459,16618,3009,211,7453,923,10462,5022,2937,544,373,1392
TTGGTACCTTCAAGCC,sample,72123,71369,8147,63222,12599,50623,12876,550,19902,2386,32778,14909,5677,822,6183,8545
CGGATTACTTCAAGCC,sample,50893,50120,5406,44714,11651,33063,13725,863,11287,1156,25012,6032,2638,561,7096,7852
ACGTATTATTCAAGCC,sample,17966,17766,2078,15688,3076,12612,3965,227,5010,559,8975,2851,1967,447,1626,2030
TTGGCCTCTTCAAGCC,Pos_Ctrl,30784,30343,3115,27228,1641,25587,21138,1930,1756,195,22894,568,4390,4071,1916,1054
AATATATCTTCAAGCC,sample,65484,64737,8623,56114,10112,46002,12198,435,18514,2045,30712,12810,5248,680,5450,6937
TGCTTCGCTTCAAGCC,sample,28026,27680,3837,23843,4591,19252,4900,273,7800,785,12700,5494,3085,473,2340,2974
GGCATATATTCAAGCC,sample,25183,24879,5013,19866,2664,17202,3088,125,7617,811,10705,5561,3443,434,889,1536
GGAGAGTTAACTTAAC,sample,85397,84865,7514,77351,22189,55162,23018,945,18955,2332,41973,9912,3663,850,12370,14391
ATTCTCTTAACTTAAC,sample,70967,70209,8364,61845,14068,47777,12050,524,19581,1846,31631,13776,5267,598,6531,8561
TCCAACTTAACTTAAC,Neg_Ctrl,893,423,248,175,42,133,58,2,45,2,103,26,42,16,27,7
TAGTACGGAACTTAAC,sample,35041,34529,5047,29482,6272,23210,4226,190,9724,1037,13950,8033,3534,364,1374,3841
CAACCGCGAACTTAAC,sample,10043,9959,995,8964,3866,5098,1214,71,2202,222,3416,1389,1283,291,234,1926
GGACCTCTAACTTAAC,Neg_Ctrl,579,385,207,178,29,149,57,5,39,2,96,46,42,20,22,13
GGACGTAGAACTTAAC,sample,30093,29888,1526,28362,14746,13616,9114,491,2548,383,11662,1080,1117,598,5237,6791
CTTGATAGAACTTAAC,sample,31781,31458,3168,28290,4929,23361,7763,414,9812,890,17575,4482,2966,711,1581,3363
ACCTCGAGAACTTAAC,sample,38678,38305,5154,33151,6194,26957,7280,486,11355,1138,18635,6698,3502,539,3044,3822
GACGATAAAACTTAAC,sample,23326,23088,2175,20913,6264,14649,5555,347,5323,459,10878,2965,2262,717,1381,3712
CATTGCAGAACTTAAC,sample,27178,26740,5221,21519,2166,19353,3586,218,8534,869,12120,6146,3637,664,312,1112
ACGACTTCAACTTAAC,sample,38340,37926,4310,33616,7996,25620,7991,549,9351,1069,17342,6660,2953,453,3916,4819
CATGATTCAACTTAAC,sample,43350,42859,3480,39379,10676,28703,14975,483,8225,968,23200,4052,1626,453,8812,7095
AATCCGTCAACTTAAC,sample,30507,30161,3409,26752,4142,22610,6802,361,9261,1236,16063,4950,2722,590,1091,2704
AGTCCGCAAACTTAAC,sample,40182,39680,3782,35898,7219,28679,12920,623,8705,1115,21625,5316,2982,859,1816,4737
GCCTGAACAACTTAAC,sample,28189,27830,2972,24858,3009,21849,7615,450,8775,1126,16390,3883,2523,645,1694,2071
ACGTATTAAACTTAAC,sample,26184,25847,3088,22759,3082,19677,6437,351,8166,946,14603,3777,2577,661,1638,1975
AACTCGTAAACTTAAC,sample,32620,32262,3148,29114,5443,23671,8051,553,9186,1086,17237,4795,2614,559,1821,3519
AATATATCAACTTAAC,sample,53608,53093,5018,48075,11042,37033,13012,955,13281,1588,26293,8197,4167,714,6750,6965
ACCAATGCAACTTAAC,sample,60488,59700,8904,50796,10390,40406,7613,556,17170,1862,24783,13205,5171,577,2998,6513
GAAGGCGCAACTTAAC,sample,14314,14129,1886,12243,1475,10768,3627,186,4242,411,7869,2302,1956,543,792,933
CCAATTCCAACTTAAC,sample,69837,68923,9786,59137,8786,50351,11447,575,20487,2258,31934,15584,5992,663,4548,5629
GTACCGTAAACTTAAC,sample,55409,54676,8483,46193,3568,42625,8252,718,18881,2098,27133,12676,5721,851,822,2101
GGCATATAAACTTAAC,sample,21228,21008,1672,19336,3648,15688,6314,429,5826,855,12140,2264,1837,533,1676,2550
GGAGAGTTATACTTGA,sample,45359,44855,3565,41290,14347,26943,14345,910,7932,760,22277,2996,1831,545,8366,8751
ATTCTCTTATACTTGA,sample,65744,64804,11593,53211,7705,45506,8060,525,20278,2274,28338,14369,5566,834,1721,4282
TCCAACTTATACTTGA,sample,18487,18168,3071,15097,2657,12440,2951,158,5513,639,8464,3179,2426,477,862,1634
GGTTGCGTATACTTGA,sample,49042,48470,3294,45176,13138,32038,16542,982,9563,1093,26105,3858,1737,425,10983,9034
ACGTAAGTATACTTGA,sample,34790,34405,2322,32083,4864,27219,12059,530,10263,1143,22322,3224,2371,836,3519,3631
ATGCCTGGATACTTGA,sample,51155,50602,5795,44807,14230,30577,11468,501,9564,1243,21032,7801,3231,528,6657,8161
TTAGAAGTATACTTGA,sample,25057,24729,4176,20553,2996,17557,5550,257,6333,682,11883,4735,3115,743,1458,1955
GGACCTCTATACTTGA,sample,41966,41375,4704,36671,8452,28219,10604,677,9825,1024,20429,6089,3159,741,4421,5285
CATAACCTATACTTGA,sample,76431,75509,11141,64368,12666,51702,12442,644,20606,2436,33048,15574,5892,760,6027,7739
GGAGGACGATACTTGA,sample,52449,51755,7471,44284,8490,35794,11372,393,12911,1387,24283,9731,4280,499,6809,5476
CCGCAACGATACTTGA,sample,37120,36490,6293,30197,5964,24233,4254,203,10546,1220,14800,8010,3893,465,1373,3651
GACGATAAATACTTGA,sample,94371,93308,14306,79002,10941,68061,14907,850,28277,3412,43184,20615,7605,995,6270,6540
CCATGAAGATACTTGA,sample,43417,42931,3725,39206,5775,33431,11636,627,13647,1727,25283,5794,3055,841,1956,4252
CTAGGACCATACTTGA,sample,77252,76454,7391,69063,13940,55123,16639,776,22045,2351,38684,13312,4505,801,6031,9613
GTTAGGACATACTTGA,sample,32355,31963,4028,27935,4595,23340,5785,453,9728,1209,15513,6165,3060,605,1201,3031
ACGTATTAATACTTGA,sample,115049,113990,15079,98911,15249,83662,20416,1296,34128,3995,54544,23827,7434,1026,8766,9437
GAAGGCGCATACTTGA,sample,69727,69120,6092,63028,14041,48987,16518,1211,18327,2231,34845,10700,4725,741,6911,9077
CCAATTCCATACTTGA,sample,31540,31070,5373,25697,3954,21743,3211,160,9598,1027,12809,7747,3664,407,621,2298
TTATTCGAATACTTGA,sample,59205,58732,6585,52147,7622,44525,11567,791,19666,2381,31233,10120,4731,784,2557,5507
GACCGGAAATACTTGA,sample,769,758,57,701,197,504,207,27,141,19,348,110,150,67,91,122
AAGTTCGTATCCGCGA,sample,115016,113534,13850,99684,23046,76638,21402,634,30927,3166,52329,20509,5905,932,10078,15672
ACGTTATGATCCGCGA,sample,59040,58309,4455,53854,11773,42081,20688,1050,13462,1663,34150,5218,2757,930,7152,7957
TTCTAATGATCCGCGA,sample,31988,31393,5973,25420,3267,22153,4741,281,10000,1087,14741,6044,3381,627,741,1902
ACTATACTATCCGCGA,sample,128639,127433,10399,117034,32459,84575,37502,1716,27458,2609,64960,15290,3544,763,22049,21854
CCGCAACGATCCGCGA,sample,49263,48659,2828,45831,15902,29929,18633,575,7602,613,26235,2506,1142,452,11501,9888
CTTGATAGATCCGCGA,sample,166846,164858,27734,137124,18220,118904,24290,871,48937,4655,73227,40151,9105,1150,12239,10653
CATTGCAGATCCGCGA,sample,102507,100555,31316,69239,4288,64951,4918,178,31046,3011,35964,25798,9145,645,507,1526
CGAGGCAGATCCGCGA,sample,101916,100978,7461,93517,25752,67765,34310,1132,20822,2503,55132,8998,2921,709,19681,17361
CCATGAAGATCCGCGA,sample,102186,101255,8543,92712,20208,72504,30411,1180,23389,2292,53800,15232,4203,765,16455,14631
ACGACTTCATCCGCGA,sample,111743,110665,12227,98438,20544,77894,25736,1247,28531,2637,54267,19743,5687,963,11999,13927
AATCCGTCATCCGCGA,sample,128174,126953,14277,112676,22194,90482,27204,1276,35839,3994,63043,22169,6333,1134,12201,15390
AGTCCGCAATCCGCGA,sample,44093,43561,6596,36965,6747,30218,8423,469,12379,1156,20802,7791,4303,866,2054,4239
CTAGGACCATCCGCGA,sample,28331,27948,5782,22166,3902,18264,3949,327,7497,812,11446,5679,3493,742,959,2240
CGGATTACATCCGCGA,sample,70544,69727,9266,60461,8312,52149,15242,951,21189,2783,36431,11984,4514,953,3124,5319
GCCTGAACATCCGCGA,sample,14314,14144,997,13147,5609,7538,4124,302,2139,231,6263,742,1234,617,1256,2964
AACTCGTAATCCGCGA,sample,189388,187830,25366,162464,30798,131666,31362,1195,52795,5628,84157,40686,10065,1214,15223,19170
AAGAGCGCATCCGCGA,sample,64345,63790,6311,57479,8194,49285,15914,1089,20629,2338,36543,9315,4298,893,1921,5899
CCAATTCCATCCGCGA,sample,59597,59039,4861,54178,10407,43771,15179,1029,18237,2075,33416,7251,3155,818,2011,7051
TTGGTTAAATCCGCGA,sample,138016,137120,9802,127318,41422,85896,40778,2001,25274,3153,66052,14690,4404,860,19417,25450
GGCATATAATCCGCGA,sample,112116,111085,12541,98544,16699,81845,26751,1441,31412,3457,58163,18784,6493,1188,4687,10885
TTATTCGAATCCGCGA,sample,46360,45917,6680,39237,7955,31282,8634,516,12187,1387,20821,8558,4199,569,3761,4707
ATGACCGAATCCGCGA,sample,108852,107971,8303,99668,27535,72133,29679,1913,24827,2667,54506,13047,3741,819,13434,18004
ATTCTCTTAGGACTCA,sample,15511,15324,1822,13502,4193,9309,4171,167,2930,277,7101,1764,1191,290,2260,2455
TCCAACTTAGGACTCA,sample,12190,11987,1553,10434,2218,8216,3333,48,2698,272,6031,1865,1349,227,2158,1435
TCCTCCGTAGGACTCA,sample,30505,30129,2747,27382,11694,15688,6629,376,5714,731,12343,2238,1822,643,2693,6215
ACGTAAGTAGGACTCA,sample,22776,22346,3356,18990,2111,16879,5032,218,7347,726,12379,3556,2615,641,1294,1357
ACGTTATGAGGACTCA,sample,34684,34031,6305,27726,3852,23874,4169,271,11133,1036,15302,7265,3810,563,955,2373
TTCCGTCTAGGACTCA,sample,46465,45801,6520,39281,7142,32139,5672,263,14725,1469,20397,10010,4335,531,2108,4942
CAAGGCCTAGGACTCA,sample,33917,33606,2994,30612,10428,20184,10309,509,5681,738,15990,2947,1792,456,5728,6327
CATAACCTAGGACTCA,sample,43895,43329,5741,37588,9109,28479,10239,511,10477,993,20716,6259,3341,622,5266,5954
GACGGAGAAGGACTCA,sample,55549,54847,6452,48395,9809,38586,13700,747,14324,1336,28024,8479,3575,577,8111,6567
CCAGAGCGAGGACTCA,sample,31483,31043,5172,25871,4969,20902,4646,308,8916,959,13562,6073,3509,500,1622,3051
GGAGGACGAGGACTCA,sample,32562,32056,4553,27503,7168,20335,4779,321,8803,920,13582,5512,3265,496,1728,4333
CCGCAACGAGGACTCA,sample,36106,35764,1966,33798,11397,22401,14029,929,5190,518,19219,1735,1182,640,6638,7354
CTTGATAGAGGACTCA,sample,73822,72931,9819,63112,10464,52648,12111,420,20571,2188,32682,17358,5671,675,6574,6228
ACCTCGAGAGGACTCA,sample,4046,3977,523,3454,483,2971,730,47,1340,138,2070,716,844,193,114,331
TGGACGAGAGGACTCA,sample,58316,57723,6169,51554,14602,36952,14109,468,13473,1142,27582,7760,2772,508,8365,8971
CGAGGCAGAGGACTCA,sample,12022,11893,2008,9885,2162,7723,1339,63,3332,351,4671,2638,1980,285,335,1261
CCATGAAGAGGACTCA,sample,76634,75888,5989,69899,16939,52960,26660,1062,15986,1737,42646,7515,3188,878,10531,11937
ACGACTTCAGGACTCA,sample,37724,37349,3916,33433,6085,27348,9792,648,10558,1418,20350,4932,2949,810,3033,3995
CATGATTCAGGACTCA,sample,41942,41456,3737,37719,4742,32977,11112,802,13821,1534,24933,5708,3440,998,899,3264
AATCCGTCAGGACTCA,sample,93140,92073,11126,80947,13137,67810,17051,917,28961,3262,46012,17619,6419,1116,4546,8828
CGGATTACAGGACTCA,sample,19815,19554,1639,17915,5044,12871,6014,441,3925,407,9939,2084,2231,1009,516,2988
ACGTATTAAGGACTCA,sample,152473,150960,19180,131780,23477,108303,27615,921,42532,4214,70147,33021,8569,1179,14388,15043
CGTATGAAAGGACTCA,sample,44953,44403,4400,40003,14171,25832,9356,497,9768,1250,19124,4961,2919,603,3699,7827
TTGGCCTCAGGACTCA,sample,96747,95657,17024,78633,10601,68032,12201,461,29841,3175,42042,22354,7213,874,4084,6184
GAAGGCGCAGGACTCA,sample,65062,64458,7783,56675,11027,45648,10197,668,18827,1932,29024,14024,5475,673,4099,7125
TTGGTTAAAGGACTCA,sample,61484,61051,3128,57923,25278,32645,19696,1048,7980,1231,27676,2690,1347,522,9665,13501
GTACCGTAAGGACTCA,sample,85143,84322,9942,74380,11045,63335,12792,1031,27591,2911,40383,19010,6268,786,3832,7049
CTTCATGAAGGACTCA,sample,48018,47511,6408,41103,6461,34642,5620,223,15710,1634,21330,11455,4668,568,1026,3949
AGGTCGGAAGGACTCA,Pos_Ctrl,46759,46012,3584,42428,2044,40384,33421,3272,2508,338,35929,845,5205,5705,2185,1045
TATCAGTTTATTGAAC,sample,5015,4962,679,4283,540,3743,1090,73,1698,179,2788,703,930,259,127,386
ATTCTCTTTATTGAAC,sample,10096,10013,704,9309,1803,7506,3417,191,2676,324,6093,898,1202,475,1241,1225
TCCAACTTTATTGAAC,sample,27933,27580,4667,22913,3249,19664,2806,120,8823,826,11629,7089,3500,306,938,1938
AAGTTCGTTATTGAAC,sample,35477,35151,2218,32933,9506,23427,12960,385,6419,770,19379,2893,1502,438,8091,6236
TTAGAAGTTATTGAAC,sample,40384,39772,6078,33694,6551,27143,5412,230,11433,1150,16845,8918,3982,431,2140,4036
ACTATACTTATTGAAC,sample,57136,56448,9420,47028,7864,39164,6894,226,16962,1889,23856,13193,5214,516,2720,4801
GACGGAGATATTGAAC,sample,11910,11772,1824,9948,1344,8604,2330,154,3711,323,6041,2086,1791,503,395,873
CCGCAACGTATTGAAC,sample,36093,35492,5879,29613,5133,24480,5457,210,10128,1123,15585,7562,3934,451,2619,3069
TTGGTACCTATTGAAC,sample,67726,66876,11030,55846,8423,47423,8669,474,21660,2187,30329,14433,6009,753,1583,5055
CGTATGAATATTGAAC,sample,42457,41992,4825,37167,6240,30927,10040,718,12380,1467,22420,6322,3312,761,1629,4104
ACCAATGCTATTGAAC,sample,61681,60969,9096,51873,10117,41756,8904,449,17280,2004,26184,13119,5287,516,4352,6267
GTCTTAGCTATTGAAC,sample,85357,84607,7412,77195,18919,58276,21485,814,20307,1828,41792,13842,3480,641,11271,12680
ATGACCGATATTGAAC,sample,58951,58465,4625,53840,13162,40678,17249,1168,14420,1426,31669,6415,2849,605,7027,8753
TATCAGTTGTTCAACT,sample,14894,14676,3135,11541,1765,9776,2339,119,3874,436,6213,3008,1965,238,1246,1120
AGTACCATGTTCAACT,sample,20879,20464,3420,17044,2742,14302,3855,180,5894,670,9749,3703,2634,519,1164,1807
ACGTTATGGTTCAACT,sample,11454,11180,1460,9720,2304,7416,2599,101,2984,335,5583,1397,1247,295,1372,1446
ATGCCTGGGTTCAACT,sample,7792,7684,1093,6591,1429,5162,1364,37,2033,244,3397,1484,1078,201,617,873
TAGTACGGGTTCAACT,sample,21717,21444,2296,19148,5799,13349,5584,152,4361,510,9945,2742,1550,361,3139,3534
TGAGCGCGGTTCAACT,sample,10174,10038,1293,8745,2146,6599,2507,126,2465,280,4972,1221,1195,294,1363,1430
TTCCGTCTGTTCAACT,sample,9088,8962,993,7969,1928,6041,2237,138,2379,203,4616,1084,1175,324,827,1258
CAAGGCCTGTTCAACT,sample,18685,18334,4438,13896,1562,12334,765,42,6143,707,6908,4677,2867,119,84,826
GACGGAGAGTTCAACT,sample,15002,14832,1701,13131,2125,11006,4040,177,4341,518,8381,1930,1742,482,1494,1375
CCAGAGCGGTTCAACT,sample,22149,21858,3751,18107,3457,14650,4342,230,5672,640,10014,3766,2864,657,1493,2124
GTTAGCCGGTTCAACT,sample,31189,30638,5607,25031,2100,22931,4435,288,10373,1146,14808,6689,3784,655,551,1020
GGAGGACGGTTCAACT,sample,10432,10276,1599,8677,1718,6959,1752,101,2960,270,4712,1876,1422,216,638,1058
CTTGATAGGTTCAACT,sample,12084,11933,1284,10649,1435,9214,2860,122,4029,567,6889,1636,1552,474,447,948
ACCTCGAGGTTCAACT,sample,3818,3714,441,3273,1255,2018,998,33,529,82,1527,376,486,193,456,701
GGCCAGAGGTTCAACT,sample,9648,9459,1400,8059,1189,6870,1664,147,2679,392,4343,1988,1316,260,734,817
CGTACGTCGTTCAACT,sample,22496,22178,2016,20162,5884,14278,6596,297,4405,387,11001,2593,1206,336,3738,3836
GCCTGAACGTTCAACT,sample,23106,22803,2812,19991,3512,16479,4989,383,6415,769,11404,3923,2216,441,2138,2280
AAGAGCGCGTTCAACT,sample,33752,33350,5236,28114,3906,24208,3570,201,10871,1009,14441,8557,4235,369,1096,2256
TTGGTTAAGTTCAACT,sample,15735,15616,1854,13762,2494,11268,3544,293,4380,517,7924,2534,1739,394,1268,1527
CTTCATGAGTTCAACT,sample,13397,13199,1354,11845,1235,10610,2712,220,4753,455,7465,2470,1808,434,277,805
AGGTCGGAGTTCAACT,sample,14327,14134,1794,12340,2257,10083,3203,253,3770,411,6973,2446,1671,307,1700,1466
TTATTCGAGTTCAACT,Neg_Ctrl,237,162,50,112,28,84,34,2,34,2,68,12,32,13,5,11
ATGACCGAGTTCAACT,sample,24659,24439,1806,22633,3281,19352,7512,530,7448,1045,14960,2817,1980,575,2413,2281
GACCGGAAGTTCAACT,sample,21188,21007,1376,19631,5944,13687,6061,246,4493,520,10554,2367,1683,415,2983,3691
TCCTCCGTCTGAGGTT,sample,98147,96687,11620,85067,16755,68312,24309,1263,24650,2431,48959,15659,5604,909,12773,11585
ACGTAAGTCTGAGGTT,sample,126421,119126,16769,102357,22782,79575,30394,2244,27218,3218,57612,16501,5562,1424,11531,14188
TGAGCGCGCTGAGGTT,sample,106323,105065,12646,92419,16145,76274,21384,1050,28855,2908,50239,22077,7298,923,10935,11479
GGACCTCTCTGAGGTT,sample,84182,83285,5536,77749,18115,59634,31361,1929,18209,1605,49570,6530,3870,1672,6458,12702
GCCTTGCTCTGAGGTT,sample,77180,76390,5868,70522,7788,62734,23056,1695,25873,2925,48929,9185,3859,1213,1976,5658
CATAACCTCTGAGGTT,sample,107799,106543,7140,99403,16487,82916,27928,2257,34411,3266,62339,15054,4956,1126,3326,11044
GGAGGACGCTGAGGTT,sample,47590,46528,4216,42312,8338,33974,10721,665,15294,1793,26015,5501,2990,726,3507,5547
CCGCAACGCTGAGGTT,sample,45963,45302,4842,40460,11082,29378,10423,673,11345,1401,21768,5536,3386,793,3991,6821
GGACGTAGCTGAGGTT,sample,18483,18213,1331,16882,3462,13420,6175,297,5066,433,11241,1449,1633,620,2530,2457
GACGATAACTGAGGTT,sample,110305,109430,10827,98603,23297,75306,32085,1099,24033,2798,56118,15291,4718,849,17789,15964
CGAGGCAGCTGAGGTT,sample,87096,86061,6680,79381,17204,62177,18641,990,24198,2665,42839,15683,5370,916,7513,11645
AATCCGTCCTGAGGTT,sample,87089,86137,7181,78956,22696,56260,26068,1032,17761,2084,43829,9315,3845,847,14387,14453
CTAGGACCCTGAGGTT,sample,86467,85134,10627,74507,15316,59191,21887,1498,19627,1920,41514,14259,5204,734,11857,9523
TGCTTCGCCTGAGGTT,sample,127414,126289,14600,111689,17784,93905,23027,1313,36375,4123,59402,29067,7985,1027,12427,11033
GAAGGCGCCTGAGGTT,sample,90939,90013,9486,80527,17577,62950,18842,1248,26492,3120,45334,13248,5339,857,8403,11242
AAGAGCGCCTGAGGTT,sample,125378,124401,7623,116778,35261,81517,42233,1387,23776,2335,66009,11786,4212,845,20334,22498
CCAATTCCCTGAGGTT,sample,102795,101456,13489,87967,8694,79273,15351,1389,34191,3683,49542,24659,7404,1126,2788,5057
GTACCGTACTGAGGTT,sample,131853,130809,9660,121149,37574,83575,43349,1232,22811,3833,66160,12350,3271,883,21646,23952
TCAATATACTGAGGTT,sample,114824,113982,5258,108724,34221,74503,49125,1521,18622,2645,67747,2590,1005,500,31225,23535
TCGCCTGACTGAGGTT,sample,97963,97175,7590,89585,28307,61278,30842,1419,18467,1564,49309,8986,3153,707,16710,17513
GGAGAGTTAGACCGTT,sample,163562,161492,19146,142346,19774,122572,27552,947,48337,4739,75889,40997,9440,1309,13842,13164
AAGTTCGTAGACCGTT,sample,41981,41154,5292,35862,6279,29583,9638,497,11854,1368,21492,6226,3721,955,3580,4242
AGTACCATAGACCGTT,sample,76347,75014,6206,68808,10059,58749,24193,1057,22448,2890,46641,8161,3141,951,3366,7390
ACGTTATGAGACCGTT,sample,39165,38455,5058,33397,1832,31565,8496,459,14287,1482,22783,6841,3922,1046,274,905
ATGCCTGGAGACCGTT,sample,69659,68696,4484,64212,18972,45240,29999,1699,10458,918,40457,2166,1103,461,18508,12721
TGAGCGCGAGACCGTT,sample,38506,38122,3265,34857,4623,30234,11646,629,11181,1437,22827,5341,3022,869,3173,3262
AATGGTAAAGACCGTT,sample,67021,66271,8117,58154,15397,42757,17022,684,14959,1592,31981,8500,3323,584,8776,10180
CAAGGCCTAGACCGTT,sample,133043,131623,15320,116303,20216,96087,34016,1003,34115,3596,68131,23357,6723,1063,19578,13461
ACGACTTCAGACCGTT,sample,116289,115014,11206,103808,20698,83110,29056,899,33942,3912,62998,15301,4817,957,13595,14228
CATGATTCAGACCGTT,sample,88062,86921,7954,78967,17694,61273,24514,925,21620,2399,46134,11815,4237,867,9937,11886
CGTACGTCAGACCGTT,sample,84166,83335,6900,76435,24296,52139,24030,1826,16386,2156,40416,7741,3901,966,10733,15292
AGTCCGCAAGACCGTT,sample,65081,64395,7155,57240,11583,45657,17844,1273,16000,1820,33844,8720,4238,1075,6967,7492
GTCCTGCCAGACCGTT,sample,93271,92470,6044,86426,22947,63479,25193,993,21180,2259,46373,13854,3438,726,14774,15825
GTTAGGACAGACCGTT,sample,60776,60146,6030,54116,7571,46545,18072,995,18137,1866,36209,7475,3772,888,6453,5804
CGTATGAAAGACCGTT,sample,44039,43485,4393,39092,5025,34067,9541,662,15139,2377,24680,6348,3743,806,1902,3294
TTGGCCTCAGACCGTT,sample,90585,89944,5653,84291,18471,65820,32237,1401,21015,2017,53252,9150,3494,929,14900,12788
GAAGGCGCAGACCGTT,sample,56273,55567,4203,51364,11067,40297,14722,669,15944,2073,30666,6889,3430,667,2846,7668
TCAATATAAGACCGTT,sample,154590,153578,9834,143744,36304,107440,50909,4486,33584,4327,84493,14134,3897,1091,21747,24657
CTTCATGAAGACCGTT,sample,107052,106320,4790,101530,27491,74039,48538,1632,17100,1971,65638,4798,1978,608,31316,19124
TTATTCGAAGACCGTT,sample,108688,108005,6505,101500,34508,66992,43474,1204,16953,1544,60427,3817,1304,490,23466,21571
ATTCTCTTCTTGAGTT,sample,97086,95732,10619,85113,18357,66756,15445,863,27317,2847,42762,20284,6220,889,7007,11795
GGTTGCGTCTTGAGTT,sample,150760,148946,11333,137613,41331,96282,44552,1268,29944,3585,74496,16933,4450,919,25693,26381
TCCTCCGTCTTGAGTT,sample,55588,54684,4177,50507,13537,36970,14710,834,14891,1300,29601,5235,2878,769,5764,8336
TTCGTAATCTTGAGTT,sample,223590,220992,25400,195592,32253,163339,52221,1873,60955,6343,113176,41947,9217,1267,31940,22263
TTCTAATGCTTGAGTT,sample,67361,66431,6865,59566,8316,51250,15234,929,22411,2372,37645,10304,4746,1124,2623,5883
TGAGCGCGCTTGAGTT,sample,31442,31132,2608,28524,9743,18781,9884,608,4812,548,14696,2929,2372,850,4457,5754
TTAGAAGTCTTGAGTT,sample,103403,101796,10416,91380,21332,70048,25852,839,25649,2893,51501,14815,5499,868,16216,13449
TTCCGTCTCTTGAGTT,sample,37500,36891,3478,33413,15919,17494,7343,276,6193,731,13536,2951,1862,470,3853,7475
TCGCATCTCTTGAGTT,sample,163274,161493,19296,142197,28312,113885,31219,1111,47277,5171,78496,29107,8289,1278,14501,17583
CCAGAGCGCTTGAGTT,sample,91744,90530,9995,80535,14796,65739,21112,1046,25450,2524,46562,15607,5783,981,10368,9893
GTTAGCCGCTTGAGTT,sample,11557,11326,1232,10094,2897,7197,2598,157,2471,369,5069,1602,1168,348,1275,1822
CTTGATAGCTTGAGTT,sample,80691,79523,11012,68511,12717,55794,11726,982,24472,2772,36198,15842,6298,1067,2619,7989
ACCTCGAGCTTGAGTT,sample,81673,80680,6651,74029,15271,58758,33173,1770,15117,1544,48290,7154,4143,1575,6680,10400
GACGATAACTTGAGTT,sample,156629,154813,16460,138353,27638,110715,26783,1978,43757,5122,70540,33075,7339,1392,9237,17603
GGCCAGAGCTTGAGTT,sample,42925,42331,5135,37196,4729,32467,10076,576,13653,1661,23729,6501,3721,862,3206,3207
CATTGCAGCTTGAGTT,sample,54136,53391,4407,48984,12766,36218,15007,1141,12904,1736,27911,5430,3481,1262,2337,8326
CCATGAAGCTTGAGTT,sample,180025,177613,23755,153858,27197,126661,26685,783,50761,6042,77446,42390,7546,1236,11982,16909
AATCCGTCCTTGAGTT,sample,167300,165499,17191,148308,30367,117941,33800,2559,45198,4664,78998,31720,5212,1203,14316,20380
TTGGTACCCTTGAGTT,sample,196103,193706,25006,168700,21616,147084,24587,1236,62881,6736,87468,51644,10357,1433,9584,13767
GTTAGGACCTTGAGTT,sample,135164,133631,9368,124263,33017,91246,44603,3652,26947,3164,71550,12880,4821,1172,20832,22546
ACGTATTACTTGAGTT,sample,105689,104309,10324,93985,25303,68682,38468,2112,19863,2507,58331,5732,2662,820,19293,16538
AACTCGTACTTGAGTT,sample,78888,77835,6636,71199,9396,61803,22575,1368,25766,2873,48341,9221,4056,1189,6763,6507
ACCAATGCCTTGAGTT,sample,144837,143543,12505,131038,25815,105223,39318,2083,37457,3377,76775,22988,6504,1206,19783,16604
TTGGTTAACTTGAGTT,sample,89035,87894,7821,80073,11573,68500,22385,1511,28204,3656,50589,12744,4852,1057,2795,7747
GTACCGTACTTGAGTT,sample,113045,112072,10718,101354,29766,71588,35051,1519,21861,2579,56912,10578,3961,816,18439,20037
AGGTCGGACTTGAGTT,sample,82944,81543,11904,69639,6212,63427,16746,890,26007,2961,42753,16823,6022,1135,1383,3456
TTATTCGACTTGAGTT,sample,88127,87122,8976,78146,3927,74219,21057,1577,33393,3487,54450,14705,5685,1440,278,1744
GACCGGAACTTGAGTT,sample,223211,220899,20087,200812,35460,165352,51146,2500,65631,7302,116777,38773,8571,1719,28194,25629
TATCAGTTTCGGAGTT,sample,29025,28489,3396,25093,4083,21010,4966,210,8952,928,13918,5954,3318,569,1215,2754
ATTCTCTTTCGGAGTT,sample,16783,16444,1314,15130,2728,12402,5372,317,4378,629,9750,1706,2034,845,262,1882
ACGTAAGTTCGGAGTT,sample,22543,22243,1636,20607,2631,17976,8286,504,6525,690,14811,1971,1926,714,2361,1900
CAACCGCGTCGGAGTT,sample,26175,25703,2567,23136,4620,18516,7147,211,6819,736,13966,3603,2408,565,2931,2919
GCCTTGCTTCGGAGTT,sample,35518,35057,4022,31035,6920,24115,6474,277,10116,1074,16590,6174,3120,537,2561,4299
GTTAGCCGTCGGAGTT,sample,12530,12249,1483,10766,2274,8492,3289,164,2620,304,5909,2115,1279,289,1863,1492
CCGCAACGTCGGAGTT,sample,18209,17952,1843,16109,4030,12079,5132,288,4180,406,9312,2073,1787,550,2121,2653
TGGACGAGTCGGAGTT,sample,78667,77783,9899,67884,9379,58505,14838,504,23180,2088,38018,17895,6267,891,6668,6306
CATGATTCTCGGAGTT,sample,24139,23799,2123,21676,3123,18553,6749,482,7391,881,14140,3050,1996,518,1132,2239
TTGGTACCTCGGAGTT,sample,25560,25190,2402,22788,3616,19172,7439,463,6907,620,14346,3743,2553,652,1441,2580
CTAGGACCTCGGAGTT,sample,16754,16494,2267,14227,2801,11426,2547,161,4913,473,7460,3332,2468,419,948,1855
GTTAGGACTCGGAGTT,sample,18879,18528,2656,15872,2588,13284,1863,132,5935,620,7798,4734,2575,276,492,1574
GCCTGAACTCGGAGTT,sample,9068,8922,1036,7886,969,6917,2139,166,2763,354,4902,1495,1384,411,367,613
TTGGCCTCTCGGAGTT,Pos_Ctrl,26611,26197,1848,24349,1060,23289,19547,1664,1420,181,20967,477,4112,3975,1891,565
AATATATCTCGGAGTT,sample,24042,23766,1603,22163,7337,14826,7539,229,4514,434,12053,2110,1058,330,4053,4615
GTACCGTATCGGAGTT,sample,43290,42779,4888,37891,6091,31800,8589,341,12881,1415,21470,8574,3910,553,4305,3761
ATGACCGATCGGAGTT,sample,33549,33149,3410,29739,4533,25206,5795,431,11365,1175,17160,6440,3358,569,1107,2712
GACCGGAATCGGAGTT,sample,72476,71766,8700,63066,9710,53356,15355,674,20187,1971,35542,15169,5729,634,8570,6445
GGAGAGTTTGAACCTT,sample,63957,63123,6641,56482,12645,43837,14206,758,16645,1880,30851,10348,4013,780,5326,8350
ATTCTCTTTGAACCTT,Pos_Ctrl,77203,75692,6038,69654,3647,66007,54793,4865,4451,668,59244,1230,6190,7053,5262,2277
TCCAACTTTGAACCTT,sample,62767,61745,7476,54269,8849,45420,14870,809,16992,1916,31862,10833,4541,843,5955,6018
CCTCTAGATGAACCTT,sample,30499,29944,2285,27659,8044,19615,7933,687,6550,944,14483,3501,2331,736,2285,4935
TTCGTAATTGAACCTT,sample,75351,74071,7654,66417,11995,54422,20871,1089,19431,2372,40302,10659,3776,684,11374,8375
ATGCCTGGTGAACCTT,sample,29967,29331,5535,23796,2929,20867,3998,279,9527,1118,13525,5945,3586,619,610,1613
TAGTACGGTGAACCTT,Pos_Ctrl,50547,49570,4307,45263,2542,42721,35337,3133,3047,318,38384,886,5334,5408,3238,1473
CATAACCTTGAACCTT,sample,52864,52161,5793,46368,8275,38093,8430,459,17775,1897,26205,9532,3836,616,2774,5500
GACGGAGATGAACCTT,sample,71723,70964,7330,63634,12268,51366,15036,575,20621,1977,35657,13157,4923,762,7311,8182
CCAGAGCGTGAACCTT,sample,53515,52739,6180,46559,7340,39219,10922,674,16075,1614,26997,9934,4247,683,4242,4553
GGAGGACGTGAACCTT,sample,24610,24253,2260,21993,8397,13596,5234,354,4558,608,9792,2842,1934,511,2564,4747
CCGCAACGTGAACCTT,Pos_Ctrl,37917,37208,3020,34188,1971,32217,27083,2249,1977,313,29060,595,4862,4736,2874,1172
ACCTCGAGTGAACCTT,sample,43788,43313,6791,36522,5121,31401,5137,366,14499,1394,19636,10005,5086,760,656,3281
GACGATAATGAACCTT,sample,53999,53476,2963,50513,15239,35274,18858,1739,9695,1018,28553,3964,2670,1185,3020,9368
AATCCGTCTGAACCTT,Pos_Ctrl,54483,53562,4511,49051,2548,46503,38553,3405,3070,368,41623,1107,5612,6016,3530,1409
CGTACGTCTGAACCTT,sample,105952,104674,12385,92289,10667,81622,24436,1478,34832,3747,59268,17129,6615,1250,5401,7019
CTAGGACCTGAACCTT,sample,83543,82465,10648,71817,9334,62483,9016,390,27847,2764,36863,22466,6994,820,1892,6067
CGGATTACTGAACCTT,sample,99752,98609,10784,87825,23472,64353,21433,1530,22318,2474,43751,16598,5386,1115,10013,15509
ACGTATTATGAACCTT,sample,80384,79328,10066,69262,11917,57345,17763,732,20568,2070,38331,16212,5632,719,11042,7873
CGTATGAATGAACCTT,sample,30990,30593,2590,28003,2431,25572,8768,536,10695,1212,19463,4361,2780,878,716,1749
AATATATCTGAACCTT,sample,115140,113881,18218,95663,12130,83533,9734,279,37550,3729,47284,32241,8522,899,2370,7417
GTACCGTATGAACCTT,Pos_Ctrl,79421,78519,4925,73594,3328,70266,58618,5672,4233,460,62851,1283,6212,7520,4555,1644
GGAGAGTTACCGAATT,sample,149946,148281,22198,126083,28531,97552,22769,1124,39332,4331,62101,29996,8659,1196,10451,16466
ATTCTCTTACCGAATT,sample,119808,118572,14411,104161,18464,85697,31833,1976,29808,3235,61641,18845,6561,1726,10605,12417
GGTTGCGTACCGAATT,sample,31819,31073,6198,24875,2740,22135,4788,287,9713,1048,14501,6299,3725,723,892,1567
TAGTACGGACCGAATT,sample,64277,63549,4346,59203,9236,49967,23277,977,17227,2392,40504,6094,3080,1120,7392,6720
AATGGTAAACCGAATT,sample,62218,61616,4860,56756,9461,47295,16337,1332,20255,2383,36592,6988,3445,984,4602,6607
TTCCGTCTACCGAATT,sample,66481,65591,4246,61345,10899,50446,19884,1309,21166,2277,41050,5810,3071,951,4390,7450
TCGCATCTACCGAATT,sample,119102,118079,8391,109688,33051,76637,34319,1632,25370,2799,59689,12517,3507,762,20460,21289
CAAGGCCTACCGAATT,sample,141615,140390,15812,124578,24473,100105,29559,939,37354,3655,66913,28598,7423,1055,15208,16547
CCAGAGCGACCGAATT,sample,109505,107965,14222,93743,16717,77026,14044,756,32559,3425,46603,26242,7739,968,5315,10775
CCGCAACGACCGAATT,sample,113536,112298,9366,102932,23166,79766,31393,1664,26819,2702,58212,17188,5286,926,16859,16192
GGACGTAGACCGAATT,sample,55715,55156,3204,51952,17902,34050,17721,928,11887,854,29608,2660,2282,924,7622,10688
CTTGATAGACCGAATT,sample,45727,45063,4696,40367,5826,34541,11319,625,14370,1750,25689,6477,3288,828,2054,3747
ACCTCGAGACCGAATT,sample,84790,83751,8613,75138,18493,56645,22686,694,20366,2174,43052,10725,3902,701,12263,11532
TGGACGAGACCGAATT,sample,83969,83098,7983,75115,19971,55144,24940,1128,16403,1761,41343,10912,4726,1052,9089,13206
GTCCTGCCACCGAATT,sample,185721,183083,26116,156967,20760,136207,25207,1423,58518,5843,83725,45216,10593,1409,11459,13334
AATATATCACCGAATT,Neg_Ctrl,1124,717,376,341,117,224,43,1,130,15,173,35,61,18,16,30
ACCAATGCACCGAATT,sample,78811,77966,6546,71420,23004,48416,30995,1594,11143,2340,42138,2344,961,421,16278,14965
GTCTTAGCACCGAATT,sample,56957,56116,4400,51716,16425,35291,18898,1746,9646,1123,28544,3878,2117,796,2785,10230
TCAATATAACCGAATT,sample,133934,132473,12902,119571,30620,88951,49177,1917,23115,2803,72292,11939,3529,741,25996,20716
CTTCATGAACCGAATT,sample,174952,173316,18997,154319,24352,129967,36494,2216,50162,5281,86656,35814,7726,1302,17296,16765
TCCAACTTGGTCTGGT,Neg_Ctrl,1362,873,559,314,70,244,88,5,93,6,181,52,66,22,19,30
ACGTAAGTGGTCTGGT,sample,119161,117699,13061,104638,20260,84378,16249,751,36839,4050,53088,26489,7104,1010,5588,13103
TTCGTAATGGTCTGGT,sample,203385,201478,26399,175079,29215,145864,34482,2166,59376,6054,93858,43786,11037,1586,14555,18976
ACGTTATGGGTCTGGT,sample,116414,115231,11843,103388,25194,78194,33763,1059,25709,2604,59472,15059,5743,909,20202,16780
TGAGCGCGGGTCTGGT,Neg_Ctrl,859,501,340,161,28,133,38,2,52,9,90,32,38,17,18,11
CAACCGCGGGTCTGGT,sample,45753,45226,3095,42131,11358,30773,17959,984,7723,1138,25682,2969,2129,936,6010,7388
AATGGTAAGGTCTGGT,sample,94419,93394,10899,82495,17873,64622,16923,791,25887,2624,42810,18397,6343,809,8803,11173
TTAGAAGTGGTCTGGT,sample,99650,98477,4640,93837,21184,72653,44976,3927,16446,1883,61422,5421,3443,1780,8200,15119
GGAGGACGGGTCTGGT,sample,75326,74437,7649,66788,13773,53015,17284,1230,19323,2022,36607,13156,5300,1061,7160,9431
GGACGTAGGGTCTGGT,Neg_Ctrl,949,602,387,215,48,167,45,1,56,10,101,55,39,10,23,22
CGAGGCAGGGTCTGGT,sample,50887,50335,5244,45091,12495,32596,12387,594,11289,1181,23676,7145,4047,981,5396,8227
CCATGAAGGGTCTGGT,sample,86583,85522,7739,77783,17330,60453,24128,1134,20795,2207,44923,12189,4964,907,10400,11782
CGTACGTCGGTCTGGT,Neg_Ctrl,992,641,350,291,43,248,80,4,64,6,144,94,60,19,24,27
TTGGTACCGGTCTGGT,sample,42963,42300,5106,37194,3274,33920,7705,646,16082,1833,23787,7654,4201,850,790,1957
CTAGGACCGGTCTGGT,sample,36208,35756,2788,32968,5341,27627,9764,635,11802,1131,21566,4295,2500,651,1838,3845
CGGATTACGGTCTGGT,sample,41776,41087,4762,36325,7364,28961,5347,355,13234,1406,18581,8619,4329,687,1014,4761
AACTCGTAGGTCTGGT,sample,63950,63298,6223,57075,7579,49496,17952,894,19103,2163,37055,9384,4247,954,6865,5627
ACCAATGCGGTCTGGT,sample,56323,55746,4531,51215,12024,39191,18287,1082,12420,1513,30707,5889,2847,528,9169,8002
TGCTTCGCGGTCTGGT,sample,57579,56683,3961,52722,12771,39951,18454,1349,13063,1393,31517,5692,3060,733,7767,8473
GAAGGCGCGGTCTGGT,sample,73173,72501,4689,67812,17346,50466,22991,1076,16287,1956,39278,8156,2534,518,11784,12333
GTACCGTAGGTCTGGT,sample,181490,179513,23469,156044,17947,138097,20849,1901,60932,5920,81781,48495,11542,1592,5648,11102
GGCATATAGGTCTGGT,Neg_Ctrl,1427,1043,803,240,61,179,49,4,61,7,110,58,63,19,15,13
TCAATATAGGTCTGGT,sample,108404,107387,10987,96400,19327,77073,30243,1267,25902,3122,56145,16539,4611,921,15384,12516
TCGCCTGAGGTCTGGT,sample,50318,49851,4208,45643,8741,36902,19579,861,9921,1369,29500,5172,2753,731,8838,6694
CTTCATGAGGTCTGGT,sample,40085,39371,5326,34045,5534,28511,7162,403,13006,1224,20168,6716,3058,490,783,3592
ATGACCGAGGTCTGGT,sample,52971,52130,6990,45140,7169,37971,7438,522,16320,1920,23758,11771,4642,549,1918,4381
TATCAGTTCGACGTTA,sample,114355,112928,12539,100389,21518,78871,25548,1018,28239,3023,53787,21043,5423,955,13987,15308
AAGTTCGTCGACGTTA,sample,227885,224376,33282,191094,25401,165693,32099,1131,69349,7502,101448,55612,11700,1804,12580,16138
ACGTTATGCGACGTTA,sample,162624,160806,16101,144705,26921,117784,52144,3755,37294,4043,89438,20548,6373,1708,11647,17738
TGAGCGCGCGACGTTA,sample,107501,105996,15777,90219,10959,79260,12683,766,34965,3644,47648,27202,8678,1111,3067,6840
CAACCGCGCGACGTTA,sample,71395,70498,6135,64363,9851,54512,27059,1706,16096,1796,43155,7855,4079,1295,3039,7092
AATGGTAACGACGTTA,sample,131666,129938,10734,119204,45538,73666,49051,3352,16004,2120,65055,3139,1114,537,29038,26703
TTCCGTCTCGACGTTA,sample,305340,301734,40333,261401,37675,223726,48535,1332,93217,10031,141752,70611,14104,2429,20707,24296
CAAGGCCTCGACGTTA,sample,59899,58842,6608,52234,10300,41934,9544,425,18971,2135,28515,10859,4106,819,1992,6835
CATAACCTCGACGTTA,sample,73466,72616,5933,66683,16397,50286,23057,1312,16626,2092,39683,7199,3498,949,10491,10942
GGAGGACGCGACGTTA,sample,138010,136509,12022,124487,32174,92313,42035,2138,31755,2781,73790,13604,4270,1020,24735,22145
ACCTCGAGCGACGTTA,sample,78998,78058,6903,71155,14553,56602,18422,1068,22888,2390,41310,11834,5126,948,4885,9826
GACGATAACGACGTTA,sample,80321,79616,4494,75122,24043,51079,28941,1599,13985,1461,42926,5093,2870,1003,14992,14996
ACGACTTCCGACGTTA,sample,107536,106825,6516,100309,38321,61988,38383,2669,12200,1860,50583,6876,3266,1306,16348,21745
CTAGGACCCGACGTTA,sample,112824,111602,9151,102451,18026,84425,35879,1487,30709,2638,66588,13712,4547,852,6863,11507
CGTATGAACGACGTTA,sample,45965,45552,4360,41192,5542,35650,11868,792,14492,1883,26360,6615,3348,864,2621,3942
GAAGGCGCCGACGTTA,sample,169501,168241,14374,153867,32887,120980,44800,1531,42883,4159,87683,27607,6122,1198,22227,22683
CCAATTCCCGACGTTA,sample,116202,114191,14331,99860,19732,80128,33761,1869,27976,3899,61737,12623,4798,910,13496,11963
GTACCGTACGACGTTA,sample,127500,126525,7103,119422,29735,89687,55150,4368,21090,2123,76240,6956,3291,1187,14206,20636
TCAATATACGACGTTA,sample,57695,57179,5388,51791,13213,38578,12372,584,14357,1603,26729,9662,4530,640,5913,8105
CTTCATGACGACGTTA,sample,80246,79664,4410,75254,19690,55564,24964,1503,20600,1656,45564,6841,3412,795,8806,12479
TTATTCGACGACGTTA,sample,199671,198392,20090,178302,27661,150641,35349,1786,60725,7083,96074,45698,13238,2545,15547,17399
TATCAGTTTACTAAGT,sample,28530,28093,3283,24810,3368,21442,6339,362,9210,899,15549,4632,2960,640,1896,2253
AAGTTCGTTACTAAGT,sample,36123,35480,5704,29776,4814,24962,3751,156,10931,1223,14682,8901,3712,397,1249,2733
GGTTGCGTTACTAAGT,sample,21087,20589,2748,17841,3002,14839,3328,188,6433,670,9761,4220,2517,540,542,1881
CCTCTAGATACTAAGT,sample,30027,29600,2612,26988,5585,21403,10763,439,6606,921,17369,2674,1559,512,5717,4100
TTCGTAATTACTAAGT,sample,73412,72669,8121,64548,14429,50119,15718,535,18718,1936,34436,13212,3698,600,8702,9542
TTCTAATGTACTAAGT,sample,36983,36624,2337,34287,9507,24780,17352,688,4066,331,21418,2343,1090,557,10774,6437
TTAGAAGTTACTAAGT,sample,27311,26855,4181,22674,2478,20196,3881,151,8336,896,12217,6932,3286,299,2012,1460
TCGCATCTTACTAAGT,sample,12187,12005,1792,10213,1088,9125,2362,102,3913,425,6275,2323,1707,356,669,709
CATAACCTTACTAAGT,sample,23817,23527,1733,21794,7798,13996,6202,610,4736,495,10938,1953,1845,741,1942,4503
ACTATACTTACTAAGT,sample,32936,32625,3824,28801,4779,24022,8623,537,9345,940,17968,4577,3064,874,2481,3389
GTTAGCCGTACTAAGT,sample,21460,21143,3914,17229,1516,15713,3326,192,6670,739,9996,4786,2930,381,1657,955
CTTGATAGTACTAAGT,sample,28100,27713,2206,25507,7368,18139,10225,523,4735,790,14960,1866,1040,331,6055,4902
CATTGCAGTACTAAGT,sample,22750,22389,2421,19968,2343,17625,5848,194,7318,847,13166,3418,2323,566,2032,1563
CATGATTCTACTAAGT,sample,39595,39139,2925,36214,3720,32494,12532,845,12412,1549,24944,5156,2617,693,1748,2453
CTAGGACCTACTAAGT,sample,20784,20507,2144,18363,3857,14506,6531,173,4636,414,11167,2752,1980,499,2778,2524
CGGATTACTACTAAGT,sample,54452,53755,7833,45922,4736,41186,6604,258,17856,1928,24460,14540,5882,558,2399,2850
GTTAGGACTACTAAGT,sample,23564,23264,3522,19742,2206,17536,3787,258,7522,801,11309,5168,2968,524,666,1218
AACTCGTATACTAAGT,sample,21246,21020,1254,19766,4693,15073,9539,784,3591,328,13130,831,1123,648,3620,3227
GTCTTAGCTACTAAGT,sample,94668,93783,10584,83199,8465,74734,18305,673,29039,2956,47344,23761,7002,989,7542,6337
CCAATTCCTACTAAGT,sample,47762,47336,5620,41716,5126,36590,11561,577,14346,1547,25907,8559,3826,598,4217,3512
TTGGTTAATACTAAGT,sample,57376,56820,4739,52081,4116,47965,19948,1399,17548,2160,37496,6910,3510,911,4191,2690
GGCATATATACTAAGT,sample,60109,59411,9035,50376,6042,44334,7468,549,19217,1737,26685,15363,5971,582,2962,3356
CTTCATGATACTAAGT,sample,14796,14611,1998,12613,3280,9333,2320,165,3891,430,6211,2527,1882,399,446,1920
GGAGAGTTTTGCCGCT,sample,96220,95422,5914,89508,19594,69914,33601,1373,20377,1738,53978,12825,3938,851,16297,14052
ACGTAAGTTTGCCGCT,sample,37150,36575,3895,32680,9796,22884,10567,467,7494,952,18061,3404,2437,590,5631,6254
AGTACCATTTGCCGCT,sample,80240,79389,6440,72949,22754,50195,24115,641,16784,1762,40899,6893,3793,847,13291,14019
ATGCCTGGTTGCCGCT,sample,89642,88263,10780,77483,15222,62261,21140,1157,21934,2408,43074,15622,5165,700,11676,9768
AATGGTAATTGCCGCT,sample,218574,215671,24953,190718,31442,159276,32530,2773,67845,7019,100375,49109,9314,1675,7552,19941
ACCTCGAGTTGCCGCT,sample,9446,9189,1409,7780,1749,6031,1771,92,2271,277,4042,1620,1372,304,800,1050
CGAGGCAGTTGCCGCT,sample,57524,56700,4196,52504,8546,43958,18787,1259,16194,1944,34981,5774,2995,1007,2141,5885
AGTCCGCATTGCCGCT,sample,86249,85191,8187,77004,23621,53383,19238,919,20078,2141,39316,11007,4644,754,9512,14797
CTAGGACCTTGCCGCT,sample,28840,28357,2811,25546,6490,19056,6459,279,7334,1083,13793,3901,2303,500,1808,4137
TTGGCCTCTTGCCGCT,sample,150802,149880,9297,140583,39504,101079,45878,2058,29872,4131,75750,19140,5327,1016,26354,25188
TTGGTTAATTGCCGCT,sample,155142,154276,10844,143432,34625,108807,43334,2364,38632,3579,81966,20898,6204,1259,18533,23458
GGCATATATTGCCGCT,sample,108181,107491,7519,99972,22651,77321,29333,1440,26695,2649,56028,17204,6657,1241,13531,15216
AGGTCGGATTGCCGCT,sample,94420,93506,7704,85802,18647,67155,24925,1342,25269,2536,50194,13083,4779,923,8408,11288
AAGTTCGTTTCGACCT,sample,92699,91195,13545,77650,12742,64908,19122,867,24605,2472,43727,17842,5794,1055,9713,8178
TCCTCCGTTTCGACCT,sample,39632,39070,5285,33785,10467,23318,6289,501,9158,1064,15447,6306,3830,975,1448,5843
AATGGTAATTCGACCT,sample,6728,6562,1276,5286,749,4537,945,39,1901,224,2846,1428,1037,138,484,423
TCGCATCTTTCGACCT,sample,40742,40227,3909,36318,4391,31927,11524,398,12734,1409,24258,5862,3134,694,3349,2966
CAAGGCCTTTCGACCT,sample,291811,288388,43507,244881,19775,225106,20102,1142,101680,11282,121782,90900,13200,2213,2138,10467
CATAACCTTTCGACCT,sample,187019,185022,19018,166004,30378,135626,45171,2686,49705,4868,94876,33196,7461,1319,24776,21822
CCGCAACGTTCGACCT,sample,17935,17494,2836,14658,3501,11157,2829,91,4631,498,7460,3108,2146,336,1437,2110
GGACGTAGTTCGACCT,sample,16112,15839,1662,14177,2475,11702,4866,248,4509,443,9375,1636,1605,568,2147,1836
CTTGATAGTTCGACCT,sample,2617,2572,547,2025,503,1522,340,30,595,86,935,471,460,124,104,293
ACCTCGAGTTCGACCT,sample,30665,30044,4375,25669,5498,20171,4339,191,8669,857,13008,6115,3303,395,1824,3322
CATTGCAGTTCGACCT,sample,68989,67892,6398,61494,11509,49985,17733,949,19575,2316,37308,9412,4226,825,3427,7927
AATCCGTCTTCGACCT,sample,136017,134734,15958,118776,18301,100475,30357,1669,37667,3929,68024,26853,8085,1616,11272,12006
CGTACGTCTTCGACCT,sample,112330,111297,12959,98338,25622,72716,22178,1030,26751,3408,48929,19349,6841,1236,8693,15379
AGTCCGCATTCGACCT,sample,60251,59592,5046,54546,16995,37551,18811,812,10423,1050,29234,6455,2739,614,11581,10510
GTCCTGCCTTCGACCT,sample,25164,24703,2797,21906,3614,18292,6284,362,7021,840,13305,3785,2421,591,2422,2372
TTGGTTAATTCGACCT,sample,162720,161685,11466,150219,34823,115396,55142,1813,34277,4200,89419,19964,4513,1028,27741,23713
CTTCATGATTCGACCT,sample,58871,58516,2450,56066,20538,35528,21961,1057,8489,1223,30450,2798,1325,404,15434,11823
TATCAGTTTCCAGACT,sample,49320,48887,4907,43980,9320,34660,13854,681,12861,1288,26715,5976,3446,757,7087,6242
ATTCTCTTTCCAGACT,sample,23142,22734,2762,19972,3923,16049,4114,191,7025,881,11139,3838,2311,456,1348,2530
TCCAACTTTCCAGACT,sample,35013,34307,4549,29758,5837,23921,8788,337,8585,1031,17373,5180,2921,568,4590,3841
CCTCTAGATCCAGACT,sample,22888,22479,3597,18882,3437,15445,2633,113,6714,747,9347,5238,2756,358,792,1973
TAGTACGGTCCAGACT,sample,13012,12762,2137,10625,1552,9073,1936,136,3917,454,5853,2630,1748,271,537,902
TGAGCGCGTCCAGACT,sample,8985,8816,1067,7749,1615,6134,2715,112,1773,188,4488,1346,907,219,1538,1053
TTCCGTCTTCCAGACT,sample,26552,26046,2439,23607,4981,18626,8003,624,6606,667,14609,2726,2386,856,2577,3347
GGACCTCTTCCAGACT,sample,4342,4213,982,3231,238,2993,315,16,1419,144,1734,1099,836,87,39,133
TCGCATCTTCCAGACT,sample,24596,24278,2392,21886,2589,19297,6249,371,8623,1005,14872,3049,2423,687,1333,1746
CAAGGCCTTCCAGACT,sample,28284,27893,1719,26174,8668,17506,11806,506,3919,484,15725,791,735,343,7524,5698
CATAACCTTCCAGACT,sample,12105,11892,1586,10306,1367,8939,2958,173,3674,329,6632,1805,1661,533,669,944
ACTATACTTCCAGACT,sample,33152,32683,5397,27286,4234,23052,5026,190,9056,1016,14082,7764,3234,428,2683,2438
CCAGAGCGTCCAGACT,sample,33083,32553,4712,27841,3859,23982,6390,262,9808,1006,16198,6516,3178,399,3738,2748
GTTAGCCGTCCAGACT,sample,10793,10539,1360,9179,956,8223,2419,123,3641,384,6060,1656,1658,465,444,662
TGGACGAGTCCAGACT,sample,18376,17908,3211,14697,2131,12566,2504,96,5383,653,7887,3930,2413,352,824,1172
GACGATAATCCAGACT,sample,32794,32432,3387,29045,7178,21867,10028,426,6803,762,16831,3848,1975,483,5845,4780
CGAGGCAGTCCAGACT,sample,56472,55682,8583,47099,8467,38632,9980,399,14751,1661,24731,11841,4920,673,4801,6015
CCATGAAGTCCAGACT,sample,13381,13191,1296,11895,4774,7121,3858,196,1798,281,5656,988,904,351,2271,2663
TTGGTACCTCCAGACT,sample,57848,57241,7445,49796,3793,46003,13109,588,19393,1665,32502,11248,4947,779,3262,2359
CGGATTACTCCAGACT,sample,30370,30000,3190,26810,6420,20390,9309,543,6543,704,15852,3291,2247,603,4645,4220
GTTAGGACTCCAGACT,Pos_Ctrl,45238,44425,3719,40706,1859,38847,32377,2817,2625,274,35002,754,5158,5363,2614,1041
TTGGCCTCTCCAGACT,Pos_Ctrl,24055,23713,1826,21887,998,20889,17353,1476,1408,187,18761,465,3929,3591,1543,522
TGCTTCGCTCCAGACT,sample,14918,14732,1457,13275,3284,9991,4264,204,3524,399,7788,1600,1302,339,1704,2095
GGCATATATCCAGACT,sample,11069,10847,1213,9634,2416,7218,2063,142,3166,273,5229,1574,1263,254,785,1529
CTTCATGATCCAGACT,sample,17690,17448,2200,15248,2931,12317,4531,182,4646,404,9177,2554,1750,350,2336,1953
AGGTCGGATCCAGACT,sample,68160,67202,10846,56356,4174,52182,9088,390,23621,2662,32709,16421,6236,900,565,2473
TTATTCGATCCAGACT,sample,33697,33312,4061,29251,4786,24465,9657,459,9238,887,18895,4224,2850,597,4083,3246
GACCGGAATCCAGACT,sample,40952,40373,5787,34586,3142,31444,8818,367,12666,1233,21484,8360,4297,755,2990,1993
GGAGAGTTACCATTAT,sample,56769,56181,3309,52872,22256,30616,18688,1176,7389,882,26077,2481,1780,939,9260,12215
ACGTAAGTACCATTAT,sample,36988,36111,5892,30219,4237,25982,6424,284,11199,1156,17623,6919,3538,646,2564,2769
ATGCCTGGACCATTAT,sample,63254,62748,3502,59246,17901,41345,31359,2766,4696,445,36055,2079,2826,2268,8842,11932
TAGTACGGACCATTAT,sample,131857,130448,9878,120570,37314,83256,48012,1379,20185,2404,68197,11276,2387,691,31627,24210
TGAGCGCGACCATTAT,sample,60512,59905,5540,54365,6825,47540,18540,981,19247,2210,37787,6562,3924,1205,5744,4568
TTCCGTCTACCATTAT,sample,152065,150194,10333,139861,30443,109418,53045,2939,37825,3407,90870,12202,3917,1302,13753,21117
GGACCTCTACCATTAT,sample,57021,56117,8519,47598,7758,39840,12509,986,14752,1461,27261,10132,4874,1132,1569,4796
GCCTTGCTACCATTAT,sample,63368,62368,6314,56054,9665,46389,14956,1422,18783,1674,33739,9554,4137,863,2159,6461
GTTAGCCGACCATTAT,sample,24419,23917,3044,20873,5397,15476,5502,339,5555,607,11057,3473,2101,411,3002,3335
CTTGATAGACCATTAT,sample,53632,52668,8008,44660,7932,36728,11241,495,14451,1951,25692,8590,4283,780,4934,4995
ACCTCGAGACCATTAT,sample,130766,129036,14944,114092,18760,95332,38152,1612,32707,3316,70859,19545,6620,1322,13459,11640
GGCCAGAGACCATTAT,sample,43191,42602,2903,39699,6431,33268,14805,1147,12263,1503,27068,3550,2761,1203,3259,4607
CCATGAAGACCATTAT,sample,99118,98009,10158,87851,23600,64251,23179,1462,23727,2700,46906,13183,5890,1433,5735,14732
CGTACGTCACCATTAT,sample,146306,144900,18477,126423,33403,93020,31562,750,33239,3778,64801,23691,6721,922,15421,21003
AGTCCGCAACCATTAT,sample,119145,117453,14740,102713,13588,89125,23624,1668,37110,4018,60734,22705,6524,1116,4451,8805
GTCCTGCCACCATTAT,sample,83445,82238,11529,70709,13077,57632,11130,787,24330,2570,35460,18815,6321,841,2791,7728
TTGGTACCACCATTAT,sample,122067,120817,13055,107762,23842,83920,32242,1538,29731,3645,61973,16764,6317,1059,14973,16330
CTAGGACCACCATTAT,sample,96938,95924,8411,87513,11425,76088,28181,1604,30332,3740,58513,12231,5086,1302,6010,8072
CGGATTACACCATTAT,sample,97279,96233,7136,89097,23914,65183,28896,2148,22319,2924,51215,8896,4166,978,11314,15207
ACGTATTAACCATTAT,sample,214234,212405,25611,186794,42004,144790,56975,2154,50598,6303,107573,28760,6482,1298,31794,29146
AACTCGTAACCATTAT,sample,96866,95780,10971,84809,12209,72600,12304,980,35839,4002,48143,19475,6254,900,1667,7397
TTGGCCTCACCATTAT,sample,108458,107566,9718,97848,22786,75062,31344,1035,26351,2496,57695,13836,4984,688,17496,14959
TGCTTCGCACCATTAT,sample,121367,119797,10531,109266,29088,80178,45014,2995,21041,1979,66055,9149,3468,946,17445,19611
GAAGGCGCACCATTAT,sample,187265,185839,13563,172276,40714,131562,51583,3446,43336,6070,94919,27127,6557,1299,22628,28759
AAGAGCGCACCATTAT,sample,144523,143058,19268,123790,15261,108529,20538,1335,48770,5211,69308,32675,9159,1383,5703,8921
TTATTCGAACCATTAT,sample,62350,61743,4539,57204,6467,50737,17548,1031,23339,2765,40887,6054,3575,1022,782,4378
ATTCTCTTCAATGGAT,sample,165685,163867,18290,145577,25516,120061,43135,2262,46399,5688,89534,22577,7215,1405,16616,16472
GGTTGCGTCAATGGAT,sample,33683,32919,4732,28187,6227,21960,5311,213,9347,1004,14658,6085,3150,428,2414,3566
TCCTCCGTCAATGGAT,sample,143925,142207,16856,125351,25519,99832,28344,1430,37448,3832,65792,28778,7101,1062,15977,16562
TTCGTAATCAATGGAT,sample,145037,142876,22677,120199,17615,102584,26219,1001,39762,4070,65981,31532,8327,1049,14789,11253
ACGTTATGCAATGGAT,sample,43157,42561,4879,37682,6179,31503,11628,920,12607,1440,24235,4908,3259,941,3878,4539
CAACCGCGCAATGGAT,sample,64677,63625,5457,58168,16259,41909,22795,737,11869,1535,34664,4973,2116,600,13995,10967
AATGGTAACAATGGAT,sample,18781,18399,5087,13312,1324,11988,1497,81,5569,537,7066,4304,2989,343,327,769
TTAGAAGTCAATGGAT,sample,53396,52480,5432,47048,5330,41718,15635,1020,17147,1941,32782,5975,3618,1210,3559,3813
TTCCGTCTCAATGGAT,sample,87372,84654,12673,71981,14025,57956,14951,731,25158,2284,40109,14832,4827,720,5794,9174
GGACCTCTCAATGGAT,sample,101400,99053,8366,90687,23347,67340,35126,1667,17251,1430,52377,11866,2520,686,20207,15346
TCGCATCTCAATGGAT,sample,104206,102654,13919,88735,14379,74356,18416,954,30110,3263,48526,21613,7033,946,7872,9220
GCCTTGCTCAATGGAT,sample,58223,57285,6157,51128,8836,42292,10660,887,19092,2079,29752,9574,3849,732,1806,6005
ACTATACTCAATGGAT,sample,30622,30206,1363,28843,10858,17985,11908,1196,3312,462,15220,1107,1859,1344,1750,6265
CCGCAACGCAATGGAT,sample,38016,37269,6407,30862,4813,26049,5198,315,11324,1370,16522,7842,4014,565,2130,3039
ACCTCGAGCAATGGAT,sample,49464,48206,12933,35273,3065,32208,3810,199,14660,1636,18470,11903,5799,620,905,1523
CCATGAAGCAATGGAT,sample,110191,108884,13388,95496,18631,76865,27936,1162,26904,2641,54840,18222,6210,821,18376,12398
AATCCGTCCAATGGAT,sample,118853,117783,7965,109818,35852,73966,44341,3151,16254,1519,60595,8701,1959,617,27836,22848
TTGGTACCCAATGGAT,sample,34682,34277,4541,29736,3874,25862,7848,546,10596,1306,18444,5566,3907,1146,365,2555
CTAGGACCCAATGGAT,sample,52922,52232,4306,47926,6280,41646,15728,815,17403,1842,33131,5858,3162,918,4394,4855
GTTAGGACCAATGGAT,sample,77517,76685,5993,70692,9229,61463,23994,1612,24836,2888,48830,8133,3464,1044,5700,6785
GCCTGAACCAATGGAT,Neg_Ctrl,1466,984,523,461,98,363,87,6,180,15,267,75,102,26,48,33
AACTCGTACAATGGAT,sample,122006,120865,9771,111094,30555,80539,39963,1381,24011,2356,63974,12828,4265,928,19523,20376
AATATATCCAATGGAT,Neg_Ctrl,1352,977,604,373,93,280,87,5,108,13,195,67,111,39,32,29
AAGAGCGCCAATGGAT,sample,176216,174653,13313,161340,21612,139728,50625,2994,57777,7957,108402,20375,4993,1281,14720,15942
GTCTTAGCCAATGGAT,sample,124418,123446,10079,113367,21752,91615,40411,2095,29046,4264,69457,15799,4936,926,19312,15226
CCAATTCCCAATGGAT,sample,204173,202084,21341,180743,27099,153644,38562,1779,60085,6730,98647,46488,9049,1717,17005,18713
TTGGTTAACAATGGAT,sample,151475,150441,10276,140165,31676,108489,54181,2145,32852,3165,87033,16146,4060,863,33270,21871
GTACCGTACAATGGAT,sample,119532,118509,11153,107356,26470,80886,31552,1485,29371,2770,60923,15708,4677,785,15168,17261
TCGCCTGACAATGGAT,sample,138350,137175,11472,125703,23293,102410,32627,1035,39327,3701,71954,25720,7698,1156,16913,16590
CTTCATGACAATGGAT,sample,80794,79913,8622,71291,17686,53605,13781,1176,23117,2384,36898,13147,4762,728,4668,10356
AGGTCGGACAATGGAT,Pos_Ctrl,70779,69972,4519,65453,3011,62442,51687,5151,3964,490,55651,1150,6094,7230,3854,1486
TTATTCGACAATGGAT,sample,41764,41255,5163,36092,5294,30798,4967,387,13917,1367,18884,10160,4289,641,440,2728
GGAGAGTTAGATTCAT,sample,86984,86073,10036,76037,13955,62082,20684,849,23929,2802,44613,13818,5300,813,10641,9827
TATCAGTTAGATTCAT,sample,32682,32087,6889,25198,4007,21191,4437,208,9093,939,13530,6514,3770,508,1872,2288
TCCAACTTAGATTCAT,sample,53986,53020,5019,48001,12376,35625,16540,573,11378,1359,27918,5775,2869,655,8554,7969
TTCGTAATAGATTCAT,sample,131405,129864,17086,112778,15981,96797,28651,1155,38680,4303,67331,24008,6942,1107,13862,10599
TTCTAATGAGATTCAT,sample,56823,56135,4967,51168,18187,32981,19468,917,8272,787,27740,3537,1917,716,10672,11009
ATGCCTGGAGATTCAT,sample,10865,10663,2497,8166,1135,7031,1228,85,2834,372,4062,2512,1869,310,231,650
TAGTACGGAGATTCAT,sample,62419,61710,3955,57755,18562,39193,27697,1036,7004,783,34701,2673,1285,675,14271,12110
AATGGTAAAGATTCAT,sample,156660,154970,19677,135293,29649,105644,28371,1203,39750,5290,68121,31030,8711,1195,13265,19343
TTCCGTCTAGATTCAT,sample,53703,52849,6902,45947,10279,35668,8095,431,15500,1297,23595,10345,4125,549,3209,6687
TCGCATCTAGATTCAT,sample,58347,57339,6221,51118,11757,39361,14598,950,13610,1361,28208,8842,3936,898,5909,7376
CAAGGCCTAGATTCAT,sample,80260,79278,4725,74553,23565,50988,35550,1441,9672,1412,45222,2913,972,439,26420,15449
CATAACCTAGATTCAT,sample,51239,50618,3301,47317,9647,37670,17269,1023,13905,2043,31174,3430,2531,955,4877,6652
GTTAGCCGAGATTCAT,sample,31848,31401,3190,28211,7253,20958,7418,519,8322,980,15740,3719,2547,552,3628,4784
ACCTCGAGAGATTCAT,sample,41267,40838,4183,36655,4447,32208,11625,492,12932,1262,24557,5897,3309,885,3940,2905
CCATGAAGAGATTCAT,sample,95356,94302,10673,83629,18438,65191,25978,1366,21666,1962,47644,14219,4309,762,13654,12158
AGTCCGCAAGATTCAT,sample,77528,76683,7812,68871,18181,50690,24877,1263,16206,2041,41083,6303,3156,643,15563,11684
GTCCTGCCAGATTCAT,sample,89785,88720,9147,79573,13739,65834,20782,718,24323,2229,45105,17782,4992,736,10464,9756
TTGGTACCAGATTCAT,sample,134933,133487,12672,120815,22717,98098,26754,1727,39587,4043,66341,25987,6577,1186,12904,15666
CGGATTACAGATTCAT,sample,31668,31195,5113,26082,1283,24799,5166,366,11666,1218,16832,6383,3865,859,35,411
GCCTGAACAGATTCAT,sample,61521,60760,6680,54080,11941,42139,12192,536,16187,1899,28379,11325,4487,744,2353,7698
AACTCGTAAGATTCAT,sample,90988,90026,10434,79592,15276,64316,19151,1297,24003,2394,43154,17471,5877,708,9822,9673
CGTATGAAAGATTCAT,sample,112276,111328,8578,102750,14289,88461,36665,2089,29191,3228,65856,17288,6118,965,18789,10234
ACCAATGCAGATTCAT,sample,67231,66509,9862,56647,7321,49326,8291,541,22015,2576,30306,15903,6042,731,1921,4029
TGCTTCGCAGATTCAT,sample,78212,77639,4233,73406,15659,57747,30383,1036,15981,2551,46364,7796,2367,555,20196,11843
AAGAGCGCAGATTCAT,sample,71721,70970,7426,63544,10454,53090,14397,1256,21300,2823,35697,13314,4977,777,3923,6843
GTACCGTAAGATTCAT,sample,996,620,193,427,70,357,114,14,123,19,237,87,111,31,64,23
GGCATATAAGATTCAT,sample,54514,54092,4228,49864,10500,39364,14973,1889,13709,1525,28682,7268,3435,826,2362,6951
TCGCCTGAAGATTCAT,sample,75291,74928,4475,70453,15216,55237,27884,1209,15355,2039,43239,8750,3423,700,15714,11356
GGAGAGTTCAATCTTG,sample,69566,69200,4707,64493,23035,41458,20241,905,12465,1519,32706,6328,2244,688,10097,13482
TATCAGTTCAATCTTG,sample,66236,65668,6909,58759,12019,46740,14084,761,20218,2334,34302,9343,4299,862,6357,7871
TCCAACTTCAATCTTG,sample,87165,86156,9488,76668,18753,57915,21026,697,21010,2002,42036,13180,4697,876,11877,12399
AAGTTCGTCAATCTTG,sample,126670,125474,7515,117959,42568,75391,48759,1912,16201,1602,64960,6917,1451,657,26868,25987
AGTACCATCAATCTTG,sample,43535,42807,5098,37709,6796,30913,10851,691,12817,1191,23668,5363,3034,765,4231,4646
TTCGTAATCAATCTTG,sample,264217,261411,29392,232019,29503,202516,40504,1874,87762,8760,128266,63616,12308,2113,17649,20251
TTCTAATGCAATCTTG,sample,129037,127855,14492,113363,26249,87114,34506,1286,27669,2472,62175,21181,4789,953,19574,17292
ATGCCTGGCAATCTTG,sample,122915,121683,14204,107479,17054,90425,32015,1346,33840,2856,65855,20368,6671,1194,16089,11890
CAACCGCGCAATCTTG,sample,59803,59030,4751,54279,16698,37581,20223,1020,11121,1121,31344,4096,2285,728,9935,10507
TTAGAAGTCAATCTTG,sample,38440,37825,4696,33129,8057,25072,10379,585,8643,759,19022,4706,2742,518,5933,5057
CCAGAGCGCAATCTTG,sample,95905,93663,7493,86170,34892,51278,32687,1086,10945,1071,43632,5489,2485,782,19312,18726
GTTAGCCGCAATCTTG,sample,89357,87950,9975,77975,15805,62170,21970,1227,21441,2357,43411,15175,4427,776,13514,10724
GGACGTAGCAATCTTG,sample,65452,64788,5124,59664,9293,50371,18274,1276,21229,2342,39503,7250,3555,1003,2036,6205
CCATGAAGCAATCTTG,sample,110448,109360,5603,103757,37030,66727,45449,3281,12768,2456,58217,2773,1158,513,27895,23634
AATCCGTCCAATCTTG,sample,96766,95475,8358,87117,19968,67149,26225,1559,23215,2375,49440,13775,4432,826,11956,13785
GTCCTGCCCAATCTTG,sample,147070,145618,12282,133336,26573,106763,37018,2547,38942,3760,75960,24496,6040,1125,19394,18886
CTAGGACCCAATCTTG,sample,130932,129477,13327,116150,19701,96449,37393,1292,34488,4036,71881,19240,5588,982,21199,14997
TTGGCCTCCAATCTTG,sample,81607,80734,9377,71357,7884,63473,15172,755,26447,2578,41619,18521,6607,759,5749,4227
AAGAGCGCCAATCTTG,sample,102916,101873,9268,92605,9144,83461,31295,1657,33588,2724,64883,14197,4984,1047,6049,6626
GTACCGTACAATCTTG,sample,92408,91716,7599,84117,22890,61227,34710,1779,15277,1659,49987,7802,1821,509,20197,15043
CTTCATGACAATCTTG,sample,93612,91927,12079,79848,9366,70482,12476,582,31622,3233,44098,22569,6519,887,2614,5377
TTATTCGACAATCTTG,Neg_Ctrl,1164,886,296,590,73,517,218,8,140,72,358,79,154,81,40,58
TATCAGTTCGTTCCGA,sample,84874,83540,10422,73118,14698,58420,20063,880,22346,2278,42409,12853,4926,800,8602,9744
AAGTTCGTCGTTCCGA,sample,113398,111854,10623,101231,27269,73962,35357,1877,23289,2596,58646,10843,4839,1301,13037,17144
TCCTCCGTCGTTCCGA,sample,124770,123112,15796,107316,22091,85225,27379,1466,32305,3392,59684,20683,6974,1408,9299,13499
TTCGTAATCGTTCCGA,sample,96706,95004,8772,86232,16051,70181,23225,1194,27252,3627,50477,14883,4566,1068,5294,10885
TTCTAATGCGTTCCGA,sample,130931,129138,16056,113082,22897,90185,25095,939,35863,4401,60958,23887,6203,953,11362,14501
ATGCCTGGCGTTCCGA,sample,52432,51692,3759,47933,18335,29598,19337,762,7073,530,26410,1896,1667,910,9096,10755
AATGGTAACGTTCCGA,sample,310371,306716,44204,262512,37605,224907,42741,1736,95654,11400,138395,73376,12193,2031,19360,24672
TTAGAAGTCGTTCCGA,sample,103004,101797,9368,92429,10473,81956,27563,1278,36135,4372,63698,12608,4879,1220,3883,7425
GCCTTGCTCGTTCCGA,sample,113264,111655,11909,99746,17514,82232,27189,1550,35754,4082,62943,13657,4803,1044,6583,12548
CAAGGCCTCGTTCCGA,sample,126573,125068,11546,113522,24717,88805,37207,2500,30518,3093,67725,15487,5335,984,17719,16331
GACGGAGACGTTCCGA,sample,141875,140344,10780,129564,40218,89346,48009,3326,23298,3437,71307,11276,2880,768,28714,26160
CTTGATAGCGTTCCGA,sample,163664,162299,14336,147963,27054,120909,58578,3213,37504,4268,96082,17346,6041,1145,23046,18885
ACCTCGAGCGTTCCGA,sample,105278,104031,6888,97143,17428,79715,41973,2335,24362,3049,66335,7996,3668,1166,14454,12682
GTCCTGCCCGTTCCGA,sample,72993,71945,10349,61596,9114,52482,12535,575,22738,2643,35273,13991,5250,795,5029,5725
CTAGGACCCGTTCCGA,sample,193643,191796,24654,167142,23170,143972,28018,3013,60030,6849,88048,46062,8784,1573,7211,14310
AACTCGTACGTTCCGA,sample,129929,128565,13846,114719,22605,92114,30647,2056,32849,3657,63496,22905,6658,1251,8635,14940
TTGGCCTCCGTTCCGA,sample,150297,149021,13704,135317,31090,104227,46048,3354,31319,2568,77367,20938,5465,1015,23096,21314
AATATATCCGTTCCGA,sample,141000,139907,11726,128181,37555,90626,40067,2217,28338,2802,68405,17202,5574,784,22120,24015
CCAATTCCCGTTCCGA,sample,169422,167627,23971,143656,14290,129366,15667,1182,58876,6072,74543,47569,10813,1689,2339,8576
GTACCGTACGTTCCGA,sample,180998,179907,16485,163422,31161,132261,39399,2948,50615,5884,90014,33415,9108,1678,12827,21492
GGCATATACGTTCCGA,sample,189328,187449,24822,162627,23808,138819,33026,1246,56050,5233,89076,43264,10274,1480,14002,14326
TCAATATACGTTCCGA,sample,142836,141619,12747,128872,26956,101916,34452,2232,39103,4217,73555,21912,7262,1311,9065,17335
CTTCATGACGTTCCGA,sample,2498,2453,305,2148,410,1738,313,11,743,125,1056,546,513,94,79,233
ATTCTCTTCAATTCGG,Pos_Ctrl,70008,68725,5975,62750,3452,59298,49308,4135,4018,512,53326,1325,6087,6598,4813,1968
TCCAACTTCAATTCGG,sample,44327,43828,2414,41414,16846,24568,16911,908,5367,491,22278,891,1426,960,8104,9402
AAGTTCGTCAATTCGG,sample,55292,54303,7326,46977,7807,39170,10323,522,16458,1943,26781,9924,3908,778,2763,4798
GGTTGCGTCAATTCGG,sample,69546,68277,9601,58676,10820,47856,9828,472,20159,2067,29987,15330,5257,560,3834,6833
TCCTCCGTCAATTCGG,sample,97021,95751,8745,87006,15937,71069,28605,1227,26892,3282,55497,11063,4577,1009,13203,11164
ACGTAAGTCAATTCGG,sample,23025,22472,2667,19805,3350,16455,5417,323,6554,731,11971,3430,2266,649,1628,2107
ACGTTATGCAATTCGG,Pos_Ctrl,66106,64527,5751,58776,3071,55705,46529,3961,3725,429,50254,1061,6067,6578,4377,1921
ATGCCTGGCAATTCGG,sample,223987,221107,34268,186839,21076,165763,30853,960,69385,6912,100238,57653,13476,1944,13210,12067
TAGTACGGCAATTCGG,sample,70840,69993,6367,63626,15027,48599,21051,1331,16374,1647,37425,8196,3761,997,5903,9617
TGAGCGCGCAATTCGG,sample,43798,43270,5568,37702,4595,33107,10803,500,13284,1628,24087,6892,4042,898,3638,3141
GCCTTGCTCAATTCGG,Pos_Ctrl,40868,40034,2777,37257,1721,35536,29365,2815,2310,366,31675,680,5040,5068,2357,909
ACTATACTCAATTCGG,sample,67267,66423,6561,59862,14652,45210,16481,1019,18296,1919,34777,7495,4090,1083,3665,9073
GTTAGCCGCAATTCGG,sample,225703,223377,31910,191467,23449,168018,34652,1725,67782,8596,102434,55263,12522,2097,15890,15676
CCGCAACGCAATTCGG,Pos_Ctrl,64593,62808,4805,58003,2806,55197,46043,4064,3463,470,49506,1157,5892,6685,3834,1390
CCATGAAGCAATTCGG,Pos_Ctrl,99536,98081,6131,91950,4189,87761,73255,6967,5231,697,78486,1611,6632,8382,5840,1816
ACGACTTCCAATTCGG,sample,150831,149344,13884,135460,29506,105954,41681,3389,33229,3207,74910,24448,6969,1038,21810,20809
AATCCGTCCAATTCGG,sample,131677,130428,10874,119554,26404,93150,46747,2581,28081,3621,74828,12120,4708,1100,18399,18844
AGTCCGCACAATTCGG,sample,106083,104973,7630,97343,31242,66101,45502,3071,10737,1022,56239,5769,2315,936,16734,19552
GTCCTGCCCAATTCGG,sample,83642,82768,6815,75953,15612,60341,27145,1152,19440,2173,46585,10431,3660,839,13793,11621
CGGATTACCAATTCGG,Pos_Ctrl,92470,91023,4792,86231,3555,82676,69135,6502,4890,646,74025,1503,6189,7971,4624,1397
GTTAGGACCAATTCGG,sample,101016,100184,8462,91722,24193,67529,25539,1750,24308,2472,49847,13460,4559,829,12563,15268
TTGGCCTCCAATTCGG,Pos_Ctrl,47975,47571,2392,45179,2053,43126,36200,3479,2377,315,38577,755,5223,5855,2748,871
AATATATCCAATTCGG,sample,287606,285076,44216,240860,22804,218056,26493,1165,97663,10538,124156,82197,16250,2685,6483,11120
TTGGTTAACAATTCGG,sample,100695,99913,12145,87768,7399,80369,11674,588,38948,4174,50622,24985,7627,986,475,3833
GGCATATACAATTCGG,sample,71018,70531,5714,64817,18038,46779,18220,1088,16520,1912,34740,9039,3812,708,7403,11348
TCAATATACAATTCGG,sample,115055,114175,6642,107533,25559,81974,35864,2512,26986,2946,62850,13666,4622,840,14336,16640
TCGCCTGACAATTCGG,sample,90105,89450,6472,82978,22869,60109,26061,1849,19611,1872,45672,10716,3360,736,14342,14648
GACCGGAACAATTCGG,sample,64874,64361,3598,60763,9327,51436,20672,1205,20382,2703,41054,6474,3091,906,2439,6578
ATTCTCTTAACTCCGG,sample,33262,32664,2207,30457,9296,21161,10647,961,6329,858,16976,2366,2191,911,2957,5762
TCCAACTTAACTCCGG,sample,45625,44958,6284,38674,7935,30739,6306,268,12643,1483,18949,10039,3881,453,2724,4847
AAGTTCGTAACTCCGG,sample,82588,81600,9959,71641,12735,58906,17467,590,22847,2091,40314,15911,5817,784,10603,8317
ACGTAAGTAACTCCGG,sample,123982,122836,14040,108796,22124,86672,32238,1735,28639,3187,60877,20873,5358,1029,17081,14300
CCTCTAGAAACTCCGG,sample,49218,48424,6544,41880,7536,34344,14570,848,10941,1182,25511,6803,4384,1518,3161,4918
TAGTACGGAACTCCGG,sample,84835,83991,6131,77860,19157,58703,31768,2590,16703,1662,48471,5980,2654,622,18098,13360
TTAGAAGTAACTCCGG,sample,53094,52320,3992,48328,13335,34993,20969,774,7694,1234,28663,4322,1951,572,10857,9108
TTCCGTCTAACTCCGG,sample,35339,34586,4624,29962,6360,23602,7048,516,9995,972,17043,5071,3356,797,1874,3936
GTTAGCCGAACTCCGG,sample,8951,8686,1221,7465,1215,6250,1915,108,2604,318,4519,1305,1346,324,723,841
GACGATAAAACTCCGG,sample,9235,9108,1033,8075,1732,6343,2514,134,2161,246,4675,1288,1021,309,1222,1127
CATTGCAGAACTCCGG,sample,53027,52351,5062,47289,5968,41321,15351,964,15986,1979,31337,7041,3838,943,4282,4408
ACGACTTCAACTCCGG,sample,136839,135347,19616,115731,16770,98961,22290,1010,39555,4001,61845,32105,8392,1023,10577,11024
AATCCGTCAACTCCGG,sample,45834,45280,4160,41120,5826,35294,13950,674,13816,1314,27766,5540,3206,780,5721,4319
AGTCCGCAAACTCCGG,sample,38549,38103,3017,35086,5052,30034,12101,669,11703,1535,23804,4026,2609,911,2044,3775
GTCCTGCCAACTCCGG,sample,61612,60736,7646,53090,8894,44196,9664,585,18076,2182,27740,13689,5123,825,2660,5670
TTGGTACCAACTCCGG,sample,38137,37512,4463,33049,6399,26650,7731,511,11018,1292,18749,6098,3282,578,2874,4125
ACGTATTAAACTCCGG,sample,136950,135533,19032,116501,16765,99736,21160,813,41484,4043,62644,32236,8626,1194,10166,9833
TTGGCCTCAACTCCGG,sample,27717,27364,2651,24713,2674,22039,7824,492,8833,973,16657,3917,2581,741,602,1862
ACCAATGCAACTCCGG,sample,55209,54605,4517,50088,11201,38887,19070,800,10545,1826,29615,6646,1990,484,11594,7897
AAGAGCGCAACTCCGG,sample,61582,60867,9458,51409,7793,43616,6520,362,19957,2136,26477,14641,6038,686,1564,4592
GTCTTAGCAACTCCGG,sample,32724,32140,4378,27762,5304,22458,4065,288,9900,1218,13965,6987,3713,535,844,3168
GTACCGTAAACTCCGG,sample,73560,72998,6417,66581,11332,55249,18653,861,19594,1771,38247,14370,4519,756,10408,7812
GGCATATAAACTCCGG,sample,66879,66255,7257,58998,12871,46127,17627,958,15278,1668,32905,10596,4989,1094,7314,8169
TCGCCTGAAACTCCGG,sample,56601,56158,4048,52110,14560,37550,21914,1204,8798,799,30712,4835,2793,896,9970,9323
AGGTCGGAAACTCCGG,sample,80303,79453,7145,72308,14520,57788,23080,1421,18613,1918,41693,12756,5404,1168,9082,9887
ATGACCGAAACTCCGG,sample,46333,45746,5270,40476,2664,37812,8732,660,16732,1890,25464,9798,4684,901,342,1232
TATCAGTTCCTGAAGG,sample,63250,62357,7754,54603,10066,44537,12821,774,17080,1864,29901,11998,4753,568,7022,6515
ATTCTCTTCCTGAAGG,sample,45518,44734,7514,37220,3971,33249,6678,427,14814,1630,21492,9700,4442,743,1823,2526
TCCAACTTCCTGAAGG,Neg_Ctrl,1296,806,534,272,67,205,52,2,110,8,162,33,58,18,24,26
GGTTGCGTCCTGAAGG,sample,87770,86666,6942,79724,21956,57768,33474,550,14253,1462,47727,8029,2197,550,23936,14459
TCCTCCGTCCTGAAGG,sample,63338,62358,8215,54143,11083,43060,13440,413,15591,1680,29031,11936,4645,557,8671,7246
AGTACCATCCTGAAGG,sample,89685,88347,9918,78429,18991,59438,25937,1335,19182,2486,45119,10498,4129,799,14369,12327
TTCGTAATCCTGAAGG,sample,108682,107058,11294,95764,12125,83639,23268,1360,35057,3624,58325,20330,6248,1201,4128,8071
TTCTAATGCCTGAAGG,Neg_Ctrl,1777,1008,621,387,74,313,83,1,81,12,164,136,75,27,20,25
CAACCGCGCCTGAAGG,sample,52350,51577,7080,44497,5627,38870,11447,303,14792,1461,26239,10867,4652,652,5222,3657
CAAGGCCTCCTGAAGG,Neg_Ctrl,1784,1107,846,261,55,206,63,2,86,4,149,51,55,12,28,9
GGACGTAGCCTGAAGG,Neg_Ctrl,886,574,386,188,24,164,29,2,90,17,119,26,45,13,8,17
CATTGCAGCCTGAAGG,sample,54390,53484,6580,46904,10990,35914,14040,504,11818,1575,25858,7977,3501,534,7794,7380
CCATGAAGCCTGAAGG,sample,94752,93340,11187,82153,20874,61279,25475,1143,20152,2036,45627,12473,3713,741,14202,14596
ACGACTTCCCTGAAGG,Neg_Ctrl,1265,853,522,331,53,278,78,3,141,6,219,50,78,21,39,26
CGTACGTCCCTGAAGG,sample,110845,109480,14666,94814,20987,73827,28569,893,22665,2692,51234,19008,4443,712,18812,13148
CTAGGACCCCTGAAGG,sample,68356,66169,7933,58236,15279,42957,16184,314,15339,1343,31523,9777,3674,632,8365,9248
GTTAGGACCCTGAAGG,Neg_Ctrl,851,577,340,237,53,184,58,2,59,1,117,64,62,20,16,24
ACGTATTACCTGAAGG,sample,119006,117503,16609,100894,15349,85545,17097,722,35996,4181,53093,27549,7612,1026,6892,10316
AATATATCCCTGAAGG,Neg_Ctrl,918,620,421,199,35,164,56,2,50,5,106,51,49,20,28,24
ACCAATGCCCTGAAGG,sample,78537,77375,12143,65232,6974,58258,10920,431,25624,3129,36544,18154,6028,766,3081,3600
TGCTTCGCCCTGAAGG,sample,60726,60172,4517,55655,6616,49039,23252,1155,16425,2033,39677,6174,3172,949,6189,4673
AAGAGCGCCCTGAAGG,sample,61958,61220,6827,54393,5930,48463,17708,1119,17858,2222,35566,9556,4125,1119,2124,3455
GTACCGTACCTGAAGG,sample,41186,40774,2881,37893,11302,26591,13520,1468,7508,897,21028,3198,2346,848,3607,6871
TCAATATACCTGAAGG,sample,249818,247750,36610,211140,21536,189604,29830,1932,83278,8153,113108,66411,14068,2332,10571,12608
ATGACCGACCTGAAGG,sample,56399,55850,3879,51971,9105,42866,19362,1023,15824,1915,35186,4742,2455,797,5368,6652
ACGTAAGTAATATTCG,sample,40346,39738,5669,34069,5417,28652,9629,491,10614,1070,20243,6848,3356,562,5172,3495
CCTCTAGAAATATTCG,sample,92096,89299,12422,76877,11239,65638,15329,754,25988,2862,41317,20705,7147,856,8345,7272
TTCGTAATAATATTCG,sample,70870,69180,7660,61520,10639,50881,15666,1655,19838,2058,35504,11664,4588,899,2260,6695
TTCTAATGAATATTCG,sample,110196,108825,16529,92296,13484,78812,15076,739,33341,3442,48417,26214,7935,1020,6155,8164
ATGCCTGGAATATTCG,sample,34631,34128,3605,30523,7428,23095,8101,431,9213,1056,17314,4294,2866,654,2979,4736
TAGTACGGAATATTCG,sample,39294,38873,3124,35749,7524,28225,13190,341,8924,677,22114,5093,2296,499,6889,5345
TGAGCGCGAATATTCG,sample,28570,28228,2920,25308,4192,21116,7686,487,7439,645,15125,4859,2415,424,4511,2922
CAACCGCGAATATTCG,sample,49602,48966,4015,44951,5901,39050,18905,1043,11289,1220,30194,6593,3788,1153,1783,3682
GGACCTCTAATATTCG,sample,63748,62743,5646,57097,11398,45699,13707,1046,16945,2639,30652,11362,4061,739,4045,7723
GCCTTGCTAATATTCG,sample,43677,42795,8105,34690,5514,29176,3120,166,13213,1390,16333,11287,5130,429,835,3153
GACGGAGAAATATTCG,sample,80098,79348,6044,73304,21500,51804,27368,734,15106,1367,42474,7229,2212,633,17346,13795
ACCTCGAGAATATTCG,sample,21547,21212,2463,18749,5142,13607,2615,135,5978,770,8593,4109,2275,384,672,3076
CATTGCAGAATATTCG,sample,60298,59386,5463,53923,13690,40233,19102,543,11845,1333,30947,7410,2442,541,11472,9382
CCATGAAGAATATTCG,sample,65825,65082,5831,59251,16391,42860,21212,754,12724,1736,33936,6434,2511,562,14045,11297
CGTACGTCAATATTCG,sample,109170,107983,11635,96348,10336,86012,22069,1391,33440,3334,55509,25778,7315,1164,9292,6373
CGGATTACAATATTCG,sample,86125,85099,9596,75503,13528,61975,17360,715,25203,3446,42563,15251,5570,802,8560,8626
GCCTGAACAATATTCG,sample,62378,61728,4992,56736,17450,39286,15761,782,13142,1263,28903,8338,4025,715,7751,10497
CGTATGAAAATATTCG,sample,157225,155401,20584,134817,20289,114528,24793,894,46843,5288,71636,36710,9735,1395,11517,12586
ACCAATGCAATATTCG,sample,64719,64145,5334,58811,16458,42353,19454,1153,12970,1425,32424,7351,2309,523,10967,10444
GAAGGCGCAATATTCG,sample,74475,73950,5378,68572,17760,50812,27498,1627,13293,1398,40791,6996,3262,809,13202,12199
AAGAGCGCAATATTCG,sample,70534,69725,7078,62647,14202,48445,19348,840,16129,1769,35477,10359,3924,638,10410,9548
GTCTTAGCAATATTCG,sample,102456,101609,9834,91775,13362,78413,25824,1001,31781,3424,57605,16383,5504,978,11357,9519
GTACCGTAAATATTCG,Pos_Ctrl,57010,56294,3245,53049,2149,50900,42451,3864,3186,391,45637,1008,5633,6336,3509,1089
GGCATATAAATATTCG,sample,58360,57660,7130,50530,6144,44386,6646,308,20849,2086,27495,14497,5834,643,765,3737
GACCGGAAAATATTCG,sample,61354,60934,3788,57146,17108,40038,20930,925,12744,1347,33674,4092,2781,822,9077,10934
ACGTAAGTAGTCTCCG,sample,58351,57355,6622,50733,11466,39267,11879,415,15315,1527,27194,10131,4236,509,6720,7225
AGTACCATAGTCTCCG,sample,47624,46795,4806,41989,3744,38245,11367,853,18460,1797,29827,5768,3584,966,863,2428
TTAGAAGTAGTCTCCG,sample,47671,46679,7713,38966,5649,33317,7437,339,13536,1351,20973,10654,4868,533,3883,3588
CAAGGCCTAGTCTCCG,sample,30449,30001,3983,26018,4568,21450,4871,266,9132,931,14003,6250,3232,471,1354,2927
ACTATACTAGTCTCCG,sample,79225,78510,6364,72146,18011,54135,27365,1169,15050,1702,42415,8849,3100,646,16737,12743
GACGGAGAAGTCTCCG,sample,84507,83807,8595,75212,12548,62664,24372,631,21880,2698,46252,13083,5317,847,13147,8459
CCGCAACGAGTCTCCG,sample,17606,17424,1449,15975,3352,12623,4715,226,4969,597,9684,2116,1922,629,1468,2312
GGACGTAGAGTCTCCG,sample,20305,20039,3254,16785,3259,13526,2833,103,5900,629,8733,4061,2739,349,1208,1962
CGAGGCAGAGTCTCCG,sample,59935,59361,6857,52504,9485,43019,10149,408,17872,1636,28021,12954,5225,616,5321,5988
ACGACTTCAGTCTCCG,sample,83829,83138,8937,74201,8984,65217,11606,553,29404,3028,41010,20626,7169,1054,2632,5413
CATGATTCAGTCTCCG,sample,57172,56796,4819,51977,11689,40288,21546,972,12121,1346,33667,4303,2863,646,11373,8146
CTAGGACCAGTCTCCG,sample,45776,45182,4781,40401,4235,36166,10465,944,15674,1828,26139,7255,3666,793,1412,2741
AACTCGTAAGTCTCCG,sample,58530,58060,3944,54116,19718,34398,20057,1022,8512,1060,28569,3747,1402,532,11569,11925
GAAGGCGCAGTCTCCG,sample,78872,78273,7728,70545,16948,53597,25110,1418,15504,1709,40614,9856,4724,1083,8463,11019
AAGAGCGCAGTCTCCG,sample,49962,49445,3856,45589,3319,42270,13048,1079,18648,2464,31696,7031,3961,1010,397,2016
GTCTTAGCAGTCTCCG,sample,75455,74401,6894,67507,13956,53551,25212,683,17295,1379,42507,8982,3268,617,14081,9612
TTGGTTAAAGTCTCCG,sample,75023,73912,6695,67217,7646,59571,21310,824,23507,3172,44817,10758,4565,1058,5218,5087
GTACCGTAAGTCTCCG,sample,43479,42924,2982,39942,11165,28777,13466,934,9346,1111,22812,3920,2314,650,5733,7401
CTTCATGAAGTCTCCG,sample,189997,187964,25284,162680,16795,145885,18476,823,65276,7268,83752,54042,13145,1912,4498,9467
AGGTCGGAAGTCTCCG,sample,68170,67426,5914,61512,9510,52002,17634,517,20862,1861,38496,11128,4363,814,7976,7046
TATCAGTTTGCCTACG,sample,20605,20334,2093,18241,3148,15093,5477,276,6312,646,11789,2382,2125,607,1500,2122
AGTACCATTGCCTACG,sample,18847,18482,2715,15767,2735,13032,3659,203,5003,660,8662,3507,2033,386,1416,1662
TTCGTAATTGCCTACG,sample,29236,28851,2381,26470,8975,17495,9574,495,4251,467,13825,2708,1633,653,4378,5762
ATGCCTGGTGCCTACG,sample,33376,32999,3404,29595,3007,26588,8167,484,11814,1042,19981,5081,3047,685,1070,1890
CAACCGCGTGCCTACG,sample,12426,12216,1159,11057,3347,7710,3956,162,2147,307,6103,1138,982,277,2444,2201
TTCCGTCTTGCCTACG,sample,46758,46236,6836,39400,3696,35704,6462,401,14707,1636,21169,12498,5571,984,906,1913
GGACCTCTTGCCTACG,sample,20351,19964,2547,17417,4776,12641,4127,371,4574,619,8701,2950,2191,484,1747,2954
TCGCATCTTGCCTACG,sample,27054,26751,2456,24295,4351,19944,6604,375,8062,700,14666,4203,2381,453,3048,3129
CCAGAGCGTGCCTACG,sample,4117,4035,762,3273,530,2743,670,47,1118,106,1788,802,878,236,42,317
TGGACGAGTGCCTACG,sample,5011,4953,253,4700,1647,3053,1017,105,1376,109,2393,446,721,285,141,922
GGCCAGAGTGCCTACG,sample,23251,22997,1713,21284,5760,15524,8959,250,4166,234,13125,1915,1022,274,6235,3881
CATTGCAGTGCCTACG,sample,60,54,15,39,4,35,12,1,11,2,23,9,11,4,9,7
CCATGAAGTGCCTACG,sample,32354,31943,3762,28181,4346,23835,7515,615,9438,1189,16953,5078,3067,606,2337,3112
AATCCGTCTGCCTACG,sample,16359,16188,2790,13398,1693,11705,2335,188,5157,510,7492,3515,2583,416,565,993
AAGAGCGCTGCCTACG,sample,15997,15787,2299,13488,1389,12099,3055,171,5349,518,8404,3006,2143,431,782,796
GTCTTAGCTGCCTACG,sample,65965,65187,10345,54842,4619,50223,6137,213,22253,2269,28390,19351,6774,673,1186,2536
CCAATTCCTGCCTACG,sample,31126,30759,2980,27779,6518,21261,9125,336,6384,477,15509,4939,2182,491,4792,4082
GGCATATATGCCTACG,Neg_Ctrl,476,275,169,106,22,84,28,1,22,0,50,33,26,12,9,6
TCAATATATGCCTACG,sample,51594,51128,4516,46612,7793,38819,14271,510,14116,1576,28387,8346,2673,528,6588,5760
TCGCCTGATGCCTACG,sample,58113,57641,7081,50560,5271,45289,9966,342,18410,2425,28376,14146,6121,654,5203,3645
GGAGAGTTCTTAGTTC,sample,130374,129206,13845,115361,21880,93481,31955,1597,34366,3596,66321,21967,6241,1121,19224,13928
TATCAGTTCTTAGTTC,sample,41484,41082,2261,38821,19873,18948,12948,668,3632,577,16580,1123,1144,747,6403,9329
TCCTCCGTCTTAGTTC,sample,62005,60363,7086,53277,13038,40239,16573,780,14413,1348,30986,7125,3217,715,7618,9073
ACGTAAGTCTTAGTTC,sample,44938,43840,6483,37357,8780,28577,5899,238,12066,1399,17965,8975,4141,472,2136,5195
CCTCTAGACTTAGTTC,sample,24631,24008,2173,21835,3859,17976,7308,498,6898,815,14206,2457,2169,779,2354,2683
ACGTTATGCTTAGTTC,sample,90746,89407,7224,82183,20394,61789,30838,609,17638,1947,48476,10757,2864,586,20040,14112
AATGGTAACTTAGTTC,sample,108428,107320,10271,97049,25570,71479,39332,1783,18116,1992,57448,10256,3407,894,22412,17104
TTAGAAGTCTTAGTTC,sample,107774,105984,14605,91379,14469,76910,13513,1001,33561,3449,47074,25386,6114,872,4886,9244
TCGCATCTCTTAGTTC,sample,46750,46182,2288,43894,10887,33007,22978,2240,5228,696,28206,1865,2132,1567,4516,7363
GCCTTGCTCTTAGTTC,sample,52601,51946,4455,47491,6593,40898,14667,929,16971,1899,31638,6432,3241,888,4130,4662
CAAGGCCTCTTAGTTC,sample,79763,78618,9246,69372,11199,58173,19396,1070,23221,2263,42617,12223,4259,864,8017,8056
ACTATACTCTTAGTTC,sample,109180,107715,11562,96153,22416,73737,27835,700,26489,2478,54324,16235,4138,762,16743,15374
GACGGAGACTTAGTTC,sample,39478,38791,5609,33182,7196,25986,9075,506,9319,963,18394,6123,3431,811,3441,4290
CCGCAACGCTTAGTTC,sample,25637,25278,1540,23738,8667,15071,8105,547,4425,341,12530,1653,1920,939,2331,4990
GGACGTAGCTTAGTTC,sample,8062,7932,1085,6847,2357,4490,1378,112,1755,188,3133,1057,1166,301,488,1264
ACCTCGAGCTTAGTTC,sample,82004,81079,11678,69401,13416,55985,15652,831,21391,2435,37043,15676,4845,738,8494,8498
ACGACTTCCTTAGTTC,sample,119199,118467,7198,111269,41224,70045,41014,2231,17312,1713,58326,7775,2802,880,23530,24732
TTGGTACCCTTAGTTC,sample,172007,170798,9991,160807,42550,118257,54606,3107,37452,3641,92058,19451,4993,1020,31466,28547
CTAGGACCCTTAGTTC,sample,89942,89444,5934,83510,19844,63666,34747,2292,15584,1407,50331,9636,4593,1585,13852,13720
ACGTATTACTTAGTTC,sample,107200,106200,11449,94751,12226,82525,28343,1254,32457,3744,60800,16727,5899,1251,10271,8879
TTGGCCTCCTTAGTTC,sample,151300,150242,14034,136208,24420,111788,39767,2582,39257,4071,79024,26111,7377,1061,24788,16857
AATATATCCTTAGTTC,sample,110889,110068,6724,103344,24868,78476,37039,1930,23893,2310,60932,13304,4465,1042,18354,16566
ACCAATGCCTTAGTTC,sample,149435,148096,14585,133511,22284,111227,38748,1947,41491,4065,80239,24976,7779,1368,17852,15816
GAAGGCGCCTTAGTTC,sample,101856,100705,12453,88252,10009,78243,11859,508,35063,3590,46922,27223,8521,1005,3646,6439
CCAATTCCCTTAGTTC,sample,81488,80604,9365,71239,12557,58682,11612,698,25847,2392,37459,18133,6298,748,4201,8010
TCGCCTGACTTAGTTC,sample,51747,51109,4344,46765,8559,38206,10997,997,16580,1842,27577,7790,3466,702,2143,5723
ATGACCGACTTAGTTC,sample,57534,57003,6778,50225,6105,44120,9665,439,19904,1995,29569,12117,4890,717,986,3975
TATCAGTTCGAGCTTC,sample,313028,310634,30418,280216,39603,240613,54532,1792,99039,11038,153571,74212,13171,2729,26700,24831
AAGTTCGTCGAGCTTC,sample,12387,11333,1467,9866,3775,6091,4017,86,1323,172,5340,493,528,243,2740,2172
GGTTGCGTCGAGCTTC,sample,70878,69582,8045,61537,12664,48873,15462,588,18025,1729,33487,13069,4406,697,8220,9026
TCCTCCGTCGAGCTTC,sample,32207,31520,3971,27549,6451,21098,5618,287,9690,739,15308,4764,2694,507,1734,4002
AGTACCATCGAGCTTC,sample,70573,69446,6599,62847,18006,44841,22442,656,14103,2340,36545,5300,1703,468,14304,12308
TTCTAATGCGAGCTTC,sample,118417,116535,17263,99272,12276,86996,16445,657,37302,4433,53747,28159,9317,1201,5216,7342
TAGTACGGCGAGCTTC,sample,38364,37507,4449,33058,8022,25036,8328,329,9516,965,17844,5898,3198,488,4450,5079
TCGCATCTCGAGCTTC,sample,43660,43311,2132,41179,11748,29431,19613,1123,6377,1127,25990,1191,625,326,11579,7787
GACGATAACGAGCTTC,sample,96692,95737,10401,85336,15850,69486,14817,854,30171,3398,44988,20246,6483,996,4273,10325
CGAGGCAGCGAGCTTC,sample,36747,36410,1938,34472,8616,25856,14237,693,7976,890,22213,2060,1673,624,7892,6192
CCATGAAGCGAGCTTC,sample,125105,123887,10955,112932,20411,92521,36778,2163,33669,3750,70447,16161,6534,1194,16451,14294
CGTACGTCCGAGCTTC,sample,99523,98875,8376,90499,21057,69442,24359,1353,24705,2424,49064,16601,5235,888,13814,13062
CTAGGACCCGAGCTTC,sample,86289,85610,5144,80466,21452,59014,32015,2106,15787,1556,47802,7550,2452,649,18040,14452
GTTAGGACCGAGCTTC,sample,108251,107332,10739,96593,17298,79295,24725,975,29438,3040,54163,21117,6497,929,13635,11910
GCCTGAACCGAGCTTC,sample,114754,113735,10965,102770,19411,83359,25759,934,31521,3574,57280,21571,7097,1030,11677,13320
TTGGCCTCCGAGCTTC,sample,24193,23970,1725,22245,2900,19345,7105,639,8297,949,15402,2355,2048,628,2212,2083
ACCAATGCCGAGCTTC,sample,112061,111066,10523,100543,21043,79500,27414,1226,27987,2931,55401,19942,6734,1058,12723,12926
CCAATTCCCGAGCTTC,sample,41982,41526,2801,38725,8491,30234,14202,952,9601,945,23803,4534,3092,834,4389,5714
TTGGTTAACGAGCTTC,sample,86883,86212,6041,80171,24129,56042,27304,2225,15813,1299,43117,9401,4495,945,8443,15277
GTACCGTACGAGCTTC,sample,71096,70506,6172,64334,14190,50144,18045,598,20602,1694,38647,9205,3726,575,9398,9747
TCAATATACGAGCTTC,sample,100770,100174,6041,94133,25282,68851,38797,2073,16755,1841,55552,9385,2586,686,20317,17976
ATGACCGACGAGCTTC,sample,92770,92126,5973,86153,13471,72682,25815,718,26256,3090,52071,16803,5381,869,11134,9877
TATCAGTTGTAGAATG,sample,30504,29996,2873,27123,2114,25009,7573,353,12140,1388,19713,3555,2673,746,597,1515
ATTCTCTTGTAGAATG,Pos_Ctrl,55458,54612,4122,50490,2461,48029,39728,3419,3394,449,43122,1039,5678,5889,3978,1354
TCCAACTTGTAGAATG,sample,59618,58850,3801,55049,10629,44420,21910,983,14997,1786,36907,4744,2400,697,10612,7729
AGTACCATGTAGAATG,sample,52943,52236,4548,47688,6337,41351,18898,870,14887,1932,33785,4764,3042,1105,4509,5156
ATGCCTGGGTAGAATG,sample,35531,34883,3175,31708,6036,25672,8761,706,10146,1087,18907,4972,2655,687,2104,4220
AATGGTAAGTAGAATG,sample,119963,118253,15188,103065,12430,90635,23160,1044,38825,4998,61985,22608,7772,1149,7974,8148
GGACCTCTGTAGAATG,Pos_Ctrl,58762,57495,4589,52906,2678,50228,41274,3745,3686,453,44960,1070,5719,6071,3731,1567
TCGCATCTGTAGAATG,sample,88170,87353,5113,82240,20748,61492,38810,1378,14100,2332,52910,4872,1778,685,20468,14911
GTTAGCCGGTAGAATG,sample,70245,69099,10699,58400,4016,54384,7412,346,25024,2332,32436,19270,6931,861,444,2197
GGACGTAGGTAGAATG,sample,60303,59787,5573,54214,12886,41328,16443,910,13888,1423,30331,8664,4302,943,6931,8600
CTTGATAGGTAGAATG,sample,77534,76864,5274,71590,20408,51182,29307,974,12971,1673,42278,6257,2024,581,14310,13517
ACCTCGAGGTAGAATG,sample,78579,77695,7838,69857,14480,55377,19560,868,19786,2475,39346,12688,5222,728,10819,9220
CATTGCAGGTAGAATG,sample,72875,72136,6498,65638,15867,49771,29115,755,12887,1618,42002,5396,2127,542,18350,10835
CGAGGCAGGTAGAATG,Pos_Ctrl,66479,65388,4182,61206,2736,58470,48917,4338,3644,429,52561,1142,5975,6821,4174,1292
AATCCGTCGTAGAATG,sample,59136,58475,4105,54370,14583,39787,15932,1012,16053,2129,31985,4661,2967,816,4497,9449
CGTACGTCGTAGAATG,sample,53516,52881,4895,47986,11311,36675,13703,428,13337,1372,27040,7835,3651,513,8226,7232
GTTAGGACGTAGAATG,sample,85120,84330,6890,77440,17708,59732,28345,669,17238,2354,45583,11126,3409,666,16068,12209
ACGTATTAGTAGAATG,sample,85720,84916,7880,77036,20046,56990,19414,965,20478,2546,39892,13587,5237,740,9717,12965
ACCAATGCGTAGAATG,Pos_Ctrl,61222,60441,3392,57049,2473,54576,45777,4277,3103,401,48880,1018,5730,6870,3188,1157
TGCTTCGCGTAGAATG,sample,69794,69177,6038,63139,11666,51473,19199,1155,17084,1959,36283,12076,4308,802,7764,7731
GTCTTAGCGTAGAATG,sample,44905,44514,2523,41991,4225,37766,13636,1171,16912,2101,30548,3946,2563,679,1031,2930
CCAATTCCGTAGAATG,sample,69225,68581,4615,63966,14391,49575,25464,1242,15062,1140,40526,6667,2575,536,14805,10376
TTGGTTAAGTAGAATG,sample,76360,75781,4014,71767,22106,49661,32590,1307,10002,1483,42592,4279,1785,477,18140,14441
GTACCGTAGTAGAATG,sample,110671,109742,10900,98842,11065,87777,22100,1199,37285,4417,59385,22776,7578,1095,8183,7224
TCAATATAGTAGAATG,sample,70368,69659,7890,61769,9570,52199,9897,723,22101,2606,31998,16872,6064,854,1832,5945
TCGCCTGAGTAGAATG,sample,75688,74930,7305,67625,10328,57297,13973,888,24345,2529,38318,15562,6027,860,4205,6812
CTTCATGAGTAGAATG,sample,90000,89312,6729,82583,21724,60859,24511,1399,21177,2154,45688,11618,4166,750,12248,14429
TTATTCGAGTAGAATG,sample,58268,57819,7197,50622,7205,43417,6976,908,19299,2159,26275,14075,5584,683,1377,4458
ATGACCGAGTAGAATG,sample,36605,36364,1995,34369,10960,23409,7740,495,8954,1135,16694,5085,2668,550,2280,6821
ATTCTCTTCAATAGTC,sample,28916,28716,1807,26909,5908,21001,10010,442,7225,1105,17235,2219,2021,743,4203,4109
GGTTGCGTCAATAGTC,sample,42408,41741,2822,38919,11569,27350,14534,722,7937,1001,22471,3156,2067,756,7162,7305
ACGTAAGTCAATAGTC,sample,58426,57920,3768,54152,15967,38185,18680,1076,11173,1060,29853,6196,2726,663,8842,10172
CCTCTAGACAATAGTC,sample,61958,61364,4334,57030,13591,43439,19800,930,16140,1393,35940,5176,2803,813,7740,9487
ACGTTATGCAATAGTC,sample,44067,43622,3535,40087,14479,25608,14629,1141,6025,747,20654,3066,1945,787,6933,8862
TGAGCGCGCAATAGTC,sample,35985,35696,2350,33346,11806,21540,13717,598,5074,437,18791,1714,1543,738,6166,7338
CAACCGCGCAATAGTC,sample,41348,40963,4535,36428,9252,27176,12483,678,8550,902,21033,4563,2205,458,7813,6228
TCGCATCTCAATAGTC,sample,18862,18750,907,17843,5821,12022,8167,350,2660,388,10827,457,459,265,5155,3933
CATAACCTCAATAGTC,sample,63280,62464,8469,53995,10409,43586,9221,354,18329,2109,27550,13573,4780,652,3210,6298
GACGGAGACAATAGTC,sample,96564,95885,6240,89645,22845,66800,30024,1050,21430,2851,51454,11445,4531,834,16180,15297
GGACGTAGCAATAGTC,sample,60450,59909,6085,53824,8941,44883,17040,1007,15578,1680,32618,9578,4141,968,4831,5978
CTTGATAGCAATAGTC,sample,53731,53310,5812,47498,10632,36866,13901,607,13117,1523,27018,7718,3510,694,6721,6753
ACCTCGAGCAATAGTC,sample,48427,48064,2117,45947,17130,28817,21030,642,5477,329,26507,1339,846,483,11207,10598
GACGATAACAATAGTC,sample,97987,97143,10535,86608,17581,69027,21157,1085,25767,2595,46924,18423,6792,985,10730,11700
ACGACTTCCAATAGTC,sample,47845,47446,4360,43086,10907,32179,13642,771,10425,991,24067,6350,2817,583,7542,6995
CGGATTACCAATAGTC,sample,23475,23165,3028,20137,1705,18432,3719,200,8871,860,12590,4782,2839,498,746,1026
GTTAGGACCAATAGTC,sample,61538,60949,4060,56889,17614,39275,23526,758,9671,1039,33197,4281,1518,426,15689,11444
GCCTGAACCAATAGTC,sample,48710,48216,5197,43019,7422,35597,13364,702,12617,1841,25981,7073,3788,780,5430,4673
ACGTATTACAATAGTC,sample,80662,79823,7759,72064,16825,55239,24184,935,17150,2288,41334,10682,3978,809,15152,11710
TGCTTCGCCAATAGTC,sample,64459,63834,7620,56214,9655,46559,9580,355,19247,2055,28827,15322,5767,639,4179,6285
AAGAGCGCCAATAGTC,sample,81254,80605,8573,72032,15829,56203,22900,916,19192,2064,42092,11131,3891,631,13589,10583
TTGGTTAACAATAGTC,sample,32058,31776,3284,28492,4587,23905,7535,284,9537,1138,17072,5411,2947,543,2110,3157
GTACCGTACAATAGTC,sample,22905,22693,2305,20388,2234,18154,5869,419,7480,1027,13349,3359,2249,681,659,1484
TCGCCTGACAATAGTC,sample,25463,25179,2839,22340,2446,19894,4504,228,8661,869,13165,5632,3268,645,313,1368
CTTCATGACAATAGTC,sample,97152,96208,9884,86324,14450,71874,18561,899,27667,2766,46228,21981,6906,1033,8335,10400
TTATTCGACAATAGTC,sample,36859,36546,2724,33822,5322,28500,12483,815,10388,1031,22871,3783,2742,905,4301,3585
TATCAGTTCGTTACTC,sample,83325,82510,5245,77265,35188,42077,25172,1397,10257,1076,35429,4175,2542,1054,12738,18156
ATTCTCTTCGTTACTC,sample,91907,90967,6317,84650,32363,52287,25508,1188,16314,1933,41822,7344,3618,1107,12586,18279
TCCAACTTCGTTACTC,Neg_Ctrl,3856,2741,2109,632,95,537,135,1,189,91,324,121,93,33,63,27
AAGTTCGTCGTTACTC,sample,142083,139804,25253,114551,15521,99030,13904,850,43545,4849,57449,35882,8802,1271,2763,9546
GGTTGCGTCGTTACTC,sample,106502,104869,9572,95297,28760,66537,29153,1293,23682,2856,52835,9553,4255,1015,11648,18437
TTCGTAATCGTTACTC,sample,33540,33005,5872,27133,3596,23537,4736,267,10278,1009,15014,7247,4007,705,1262,2200
ACGTTATGCGTTACTC,sample,67741,67041,4640,62401,17311,45090,26716,1265,12289,753,39005,4067,2092,547,15877,11867
ATGCCTGGCGTTACTC,sample,79522,78697,3799,74898,26200,48698,37372,2468,5887,1067,43259,1904,1854,1476,13215,16274
TGAGCGCGCGTTACTC,sample,37610,37041,5447,31594,6391,25203,5711,696,10861,1279,16572,6656,3738,806,469,3770
CAACCGCGCGTTACTC,sample,138346,136459,19654,116805,16220,100585,16741,507,43352,4413,60093,35572,8757,1154,4990,10259
TCGCATCTCGTTACTC,Neg_Ctrl,2509,1550,967,583,63,520,90,4,209,8,299,209,85,33,35,70
CAAGGCCTCGTTACTC,sample,154459,152513,16295,136218,27282,108936,43853,1288,38094,3560,81947,22141,5369,913,25087,18562
CATAACCTCGTTACTC,sample,220115,217936,22772,195164,34081,161083,47746,2105,63083,5664,110829,42485,9060,1481,25605,22197
GACGGAGACGTTACTC,sample,144298,142401,18686,123715,18194,105521,26074,1139,45079,4715,71153,28514,7365,1245,3518,11892
CTTGATAGCGTTACTC,sample,75899,74809,8009,66800,19045,47755,21871,1080,15261,1696,37132,7847,2843,674,13511,11986
TGGACGAGCGTTACTC,sample,94717,94193,3863,90330,29882,60448,45104,3873,8374,1050,53478,2047,1257,1008,17548,18974
GACGATAACGTTACTC,sample,67639,66493,12377,54116,5021,49095,4586,200,22905,2376,27491,19028,7169,704,640,2430
CATTGCAGCGTTACTC,sample,144341,143275,7675,135600,48409,87191,63023,2782,14084,3357,77107,3945,983,487,43963,29052
CGAGGCAGCGTTACTC,sample,137870,136813,9472,127341,49193,78148,47349,2184,19410,2081,66759,7124,2469,643,28824,28672
CCATGAAGCGTTACTC,Neg_Ctrl,1591,1068,645,423,91,332,123,6,120,10,243,73,117,44,54,59
GTCCTGCCCGTTACTC,sample,77444,76602,8287,68315,7515,60800,17288,711,27109,2816,44397,12876,5420,1134,1991,4845
CGGATTACCGTTACTC,sample,125166,123799,9883,113916,30206,83710,42689,2819,24694,3434,67383,10074,4137,1194,15494,20542
ACGTATTACGTTACTC,sample,175123,173641,11254,162387,39389,122998,61709,3250,38352,4072,100061,15615,5064,1296,27057,25706
AACTCGTACGTTACTC,sample,25833,25544,3127,22417,4439,17978,5127,359,7145,701,12272,4646,2990,662,1853,2809
ACCAATGCCGTTACTC,sample,95008,94054,10871,83183,16774,66409,15285,596,28879,2854,44164,18795,6796,962,6084,10406
TGCTTCGCCGTTACTC,Neg_Ctrl,1033,524,251,273,55,218,84,0,81,2,165,51,68,22,39,15
TCAATATACGTTACTC,sample,131000,130137,10262,119875,27264,92611,44278,2235,27098,3734,71376,15266,5313,1040,21761,18077
TCGCCTGACGTTACTC,sample,59666,59236,5037,54199,15235,38964,14592,448,13975,1613,28567,8336,3500,496,7568,9027
CTTCATGACGTTACTC,sample,2372,2333,231,2102,647,1455,492,26,564,55,1056,318,425,110,246,374
TATCAGTTTGGACTGC,sample,114611,113872,7744,106128,38510,67618,30163,1307,21068,2963,51231,12117,5114,832,18297,22983
ATTCTCTTTGGACTGC,sample,93323,92439,5726,86713,16396,70317,33448,2028,23712,2470,57160,8659,4481,1724,1992,11517
GGTTGCGTTGGACTGC,sample,38999,38591,3050,35541,6673,28868,12085,653,10845,1345,22930,3940,2734,1010,3205,4771
TCCTCCGTTGGACTGC,sample,57938,57114,6329,50785,8718,42067,12703,548,16518,1808,29221,10490,5026,908,5888,5754
CCTCTAGATGGACTGC,sample,155403,153122,24031,129091,20784,108307,18092,766,46213,4668,64305,38568,10937,1392,6754,12401
TGAGCGCGTGGACTGC,sample,27361,27059,3031,24028,5148,18880,7390,352,6424,582,13814,4132,2072,347,4991,3606
GACGGAGATGGACTGC,sample,67336,66678,5589,61089,16083,45006,22810,1397,13756,1811,36566,5232,2542,649,12574,10918
GTTAGCCGTGGACTGC,sample,15948,15521,2326,13195,2830,10365,2996,161,3981,436,6977,2791,1920,323,1579,1813
GGAGGACGTGGACTGC,sample,32718,32060,3046,29014,6296,22718,11098,818,6681,588,17779,3533,2789,1082,3100,4339
CCGCAACGTGGACTGC,sample,25616,25252,1558,23694,8353,15341,8265,361,4543,777,12808,1395,915,369,5651,5077
CTTGATAGTGGACTGC,sample,13781,13608,1138,12470,2821,9649,3556,225,3970,440,7526,1458,1542,509,938,1864
CATTGCAGTGGACTGC,sample,49959,49324,5343,43981,9089,34892,13116,693,11647,1416,24763,8020,3498,580,8006,5806
CGTACGTCTGGACTGC,sample,69155,68283,10552,57731,7666,50065,8195,359,22114,2254,30309,17143,7128,819,3176,4841
TTGGTACCTGGACTGC,sample,10277,10095,1619,8476,550,7926,1895,121,3574,356,5469,1980,1805,418,70,272
CTAGGACCTGGACTGC,sample,29526,29040,5155,23885,3029,20856,2776,185,9182,923,11958,7790,3876,308,784,1578
CGTATGAATGGACTGC,sample,60155,59709,2914,56795,17797,38998,28817,2481,4863,538,33680,2299,2349,1770,6253,11356
AATATATCTGGACTGC,sample,77404,76598,8205,68393,11250,57143,16258,831,23620,2291,39878,14143,6053,984,6003,7354
ACCAATGCTGGACTGC,sample,53666,53128,4877,48251,11963,36288,16970,1004,11549,1084,28519,5681,2463,558,8856,7500
TGCTTCGCTGGACTGC,sample,59510,58922,5333,53589,8201,45388,16807,1146,17815,1758,34622,7862,4087,895,4942,5555
AAGAGCGCTGGACTGC,sample,58592,57979,6326,51653,9614,42039,13749,672,16574,1621,30323,9423,4059,703,4846,6066
GTCTTAGCTGGACTGC,sample,41582,41109,4861,36248,8993,27255,9439,471,10121,768,19560,6456,3227,453,5428,5480
GGCATATATGGACTGC,sample,125666,124451,14674,109777,16889,92888,24835,784,37553,3736,62388,25980,8017,1103,12435,11378
TCGCCTGATGGACTGC,sample,76594,75941,8095,67846,12758,55088,14576,843,22222,2659,36798,14788,6154,979,6653,8770
TTATTCGATGGACTGC,sample,50987,50356,6162,44194,4238,39956,9000,592,18185,2054,27185,10125,4730,810,1285,2413
ATGACCGATGGACTGC,sample,82692,81987,7230,74757,17558,57199,24914,1560,16626,1856,41540,12243,4192,690,13264,11811
GGAGAGTTCCTTGAGC,sample,24071,23707,4183,19524,2971,16553,3020,208,7345,803,10365,5177,2799,449,939,1729
TATCAGTTCCTTGAGC,sample,139359,138085,13410,124675,32265,92410,37179,1688,29766,3579,66945,20198,4928,1094,20108,20829
TTCGTAATCCTTGAGC,Pos_Ctrl,113749,111838,9499,102339,5909,96430,79804,7016,6950,793,86754,1867,7055,8548,7508,3403
ATGCCTGGCCTTGAGC,sample,32819,32324,3348,28976,3573,25403,7892,559,11137,1385,19029,4430,3038,938,957,2537
TAGTACGGCCTTGAGC,sample,41965,41222,5293,35929,5913,30016,7346,307,13362,1399,20708,7602,3359,552,2407,3842
GGACCTCTCCTTGAGC,sample,116692,114268,13825,100443,17871,82572,18490,870,34473,3542,52963,25197,6601,1010,6025,11708
GTTAGCCGCCTTGAGC,Pos_Ctrl,60348,59326,5246,54080,3000,51080,42267,3802,3481,409,45748,1121,5866,6368,4442,1869
CTTGATAGCCTTGAGC,sample,92956,91505,15390,76115,9984,66131,10158,704,30747,3155,40905,21367,7311,893,2187,6546
ACCTCGAGCCTTGAGC,sample,22298,21972,2613,19359,4955,14404,5174,377,5192,595,10366,3066,2668,969,917,3109
TGGACGAGCCTTGAGC,sample,126241,125142,11951,113191,27203,85988,41124,823,26450,2702,67574,14889,5076,900,25069,18177
GGCCAGAGCCTTGAGC,sample,68426,67614,4606,63008,6043,56965,19539,1165,25533,3269,45072,7459,3308,964,1427,4278
CATTGCAGCCTTGAGC,sample,155586,154245,10984,143261,38308,104953,49025,1674,32586,3020,81611,18648,4271,970,29935,25671
CGAGGCAGCCTTGAGC,sample,57801,56920,7425,49495,12159,37336,8754,439,15604,1879,24358,10660,4244,610,2708,7366
CCATGAAGCCTTGAGC,sample,203607,202090,25309,176781,30579,146202,51406,1817,50535,5471,101941,36973,9239,1325,28559,20322
CATGATTCCCTTGAGC,sample,156518,154894,19555,135339,24965,110374,23046,1303,46791,4645,69837,34589,8958,1339,7308,15871
TTGGTACCCCTTGAGC,Pos_Ctrl,130769,129663,6683,122980,5256,117724,98183,9735,6742,866,104925,2198,7040,9722,6808,2448
GCCTGAACCCTTGAGC,sample,168662,167246,11959,155287,42456,112831,52878,2058,35618,4186,88496,18091,3492,911,29536,29132
CGTATGAACCTTGAGC,sample,145523,144150,12465,131685,31246,100439,51196,3552,30720,2468,81916,12503,5191,1321,20834,20640
AATATATCCCTTGAGC,sample,299464,296932,43558,253374,32633,220741,44031,2319,91968,9667,135999,72756,14768,2633,16382,19888
TGCTTCGCCCTTGAGC,sample,117689,116854,10015,106839,23024,83815,33394,598,29329,3121,62723,17373,5497,933,20686,15195
CCAATTCCCCTTGAGC,sample,155122,153819,16000,137819,32845,104974,43491,2047,35575,3699,79066,20162,4567,937,24970,20438
GTACCGTACCTTGAGC,sample,248394,246267,31686,214581,35760,178821,45356,1936,70635,7268,115991,53626,10782,1999,20964,22388
GGCATATACCTTGAGC,sample,53437,53002,6252,46750,5583,41167,13278,806,16908,1724,30186,8451,4229,1148,2844,3577
AGGTCGGACCTTGAGC,Pos_Ctrl,77059,76142,4737,71405,3509,67896,57136,5305,3811,480,60947,1164,6239,7558,4619,1663
GACCGGAACCTTGAGC,sample,77671,77093,6363,70730,18107,52623,17585,797,20121,2270,37706,11850,4810,747,6873,11729
TATCAGTTCGATATCC,sample,189977,188638,14297,174341,39534,134807,51475,1474,45002,4622,96477,32234,5871,1269,31128,26395
AAGTTCGTCGATATCC,sample,132457,131158,9370,121788,33837,87951,39976,1073,26355,2698,66331,17849,3686,774,26231,22031
GGTTGCGTCGATATCC,sample,81185,80239,8403,71836,8629,63207,20306,1037,27121,3184,47427,11559,4944,1079,2655,5808
CCTCTAGACGATATCC,sample,74144,73160,5905,67255,18721,48534,24237,730,14389,1536,38626,7642,3226,634,14788,12216
TTCGTAATCGATATCC,sample,113139,112189,7707,104482,23265,81217,34273,2277,31294,3142,65567,10231,4569,1274,10522,15618
CAACCGCGCGATATCC,sample,65059,64295,5631,58664,24993,33671,15318,613,10149,1184,25467,6407,3358,712,8914,13155
AATGGTAACGATATCC,sample,178507,176458,15516,160942,35400,125542,33895,1759,49904,5198,83799,34786,7261,1174,17397,23978
GGACCTCTCGATATCC,sample,86626,85599,5628,79971,9269,70702,29527,1368,29500,3520,59027,6787,3353,1142,4588,6596
ACTATACTCGATATCC,sample,47653,47285,4518,42767,8226,34541,16138,945,10768,1055,26906,5635,3957,1516,7143,5702
GTTAGCCGCGATATCC,sample,52227,51584,4949,46635,12491,34144,15188,559,10218,996,25406,7183,3561,523,9907,7917
CGAGGCAGCGATATCC,sample,99633,99076,4938,94138,37580,56558,36472,2779,12106,1426,48578,3775,2566,1341,14551,20943
ACGACTTCCGATATCC,sample,37658,37334,2687,34647,19314,15333,5201,98,5792,582,10993,3660,2326,334,2968,7741
CGTACGTCCGATATCC,sample,134616,133468,11799,121669,30892,90777,36134,1357,30962,3160,67096,19164,5906,994,21980,20288
GTCCTGCCCGATATCC,sample,28758,28493,1235,27258,11413,15845,8363,465,5474,366,13837,1177,1166,420,4608,6124
GTTAGGACCGATATCC,sample,36385,35961,4322,31639,6847,24792,6280,371,10867,949,17147,6325,3312,579,2175,4192
GCCTGAACCGATATCC,sample,110642,109730,7632,102098,25528,76570,38419,2285,23772,2388,62191,9706,3768,894,19934,16883
CGTATGAACGATATCC,sample,76032,75361,5373,69988,23189,46799,27808,1079,12577,1194,40385,4141,2385,658,16881,14006
AATATATCCGATATCC,sample,100917,100261,6056,94205,30834,63371,35229,1561,17031,2012,52260,7538,2467,645,21079,19841
TGCTTCGCCGATATCC,sample,77485,76908,7301,69607,16187,53420,21781,1124,17590,1724,39371,11201,3708,799,10756,10886
GAAGGCGCCGATATCC,sample,101153,100245,10743,89502,16640,72862,24314,982,26419,3208,50733,17939,6567,1064,10533,10885
GTCTTAGCCGATATCC,sample,133912,132913,9797,123116,25219,97897,39518,2758,35348,4092,74866,16181,5545,1334,14436,17415
CCAATTCCCGATATCC,sample,150885,149630,14145,135485,25078,110407,37554,1909,37579,4100,75133,29265,7564,1241,20936,16914
TCGCCTGACGATATCC,sample,77536,76748,6410,70338,7207,63131,18861,1128,29564,3116,48425,10462,4506,908,2498,4646
TTATTCGACGATATCC,sample,110929,110199,12135,98064,23040,75024,23908,1197,28278,3129,52186,18512,5243,983,9445,14802
ATGACCGACGATATCC,sample,96606,95901,6417,89484,28022,61462,33404,1415,17619,2465,51023,6559,2424,706,15298,17596
GGAGAGTTATCTGACC,sample,1503,1473,107,1366,504,862,479,22,223,13,702,125,213,113,228,262
TTCGTAATATCTGACC,sample,55530,55089,4861,50228,15119,35109,19366,484,9072,938,28438,5249,2399,509,13374,9605
ACGTTATGATCTGACC,Neg_Ctrl,978,556,271,285,34,251,44,3,111,16,155,77,50,22,21,15
CAACCGCGATCTGACC,sample,29365,28916,3600,25316,5158,20158,5996,407,8057,974,14053,4724,2953,616,1627,3154
ACTATACTATCTGACC,sample,78232,77504,7229,70275,17461,52814,20861,1018,17200,2013,38061,11722,4724,949,10839,11729
GGAGGACGATCTGACC,Neg_Ctrl,573,410,231,179,19,160,38,1,91,0,129,30,42,6,14,23
CTTGATAGATCTGACC,sample,39608,39292,2591,36701,9382,27319,13559,786,8187,1079,21746,3708,2232,720,5201,6133
GGCCAGAGATCTGACC,sample,61198,60718,5650,55068,10298,44770,17113,934,16340,1490,33453,8893,4036,755,8856,6993
CATTGCAGATCTGACC,sample,26710,26392,2388,24004,7174,16830,6893,415,6105,683,12998,2734,2033,472,2952,4399
CGAGGCAGATCTGACC,sample,38575,38258,3459,34799,9364,25435,9297,556,9900,987,19197,4695,3144,712,4114,5933
CCATGAAGATCTGACC,sample,15771,15563,1754,13809,2993,10816,2765,150,4390,503,7155,3008,1867,337,981,1873
ACGACTTCATCTGACC,sample,61386,60931,4136,56795,15979,40816,20385,931,11330,1191,31715,6979,2861,727,11036,10763
GTCCTGCCATCTGACC,sample,61866,61326,4039,57287,19002,38285,24156,1106,8505,1335,32661,3183,1268,452,15776,12209
CTAGGACCATCTGACC,Neg_Ctrl,671,422,190,232,46,186,62,7,51,2,113,64,50,25,39,23
CGGATTACATCTGACC,sample,18537,18342,1224,17118,5053,12065,5142,360,4526,458,9668,1579,1745,618,2030,3215
AACTCGTAATCTGACC,sample,42083,41755,3457,38298,10073,28225,13989,521,8903,1206,22892,3606,1836,464,7411,6867
CGTATGAAATCTGACC,sample,79050,78296,11274,67022,8572,58450,11470,494,25189,2809,36659,18488,6995,863,4705,5289
TTGGCCTCATCTGACC,sample,41252,41012,2726,38286,13977,24309,13433,527,6576,976,20009,2797,1769,385,8340,8116
ACCAATGCATCTGACC,sample,35485,35189,3051,32138,8687,23451,12449,447,6978,572,19427,3005,1857,406,7878,6033
TGCTTCGCATCTGACC,sample,6988,6863,1526,5337,560,4777,547,18,2230,259,2777,1723,1276,107,124,265
GTCTTAGCATCTGACC,sample,41494,41165,2536,38629,9778,28851,15780,888,7474,968,23254,3741,2103,500,8647,6505
CCAATTCCATCTGACC,sample,43922,43505,3609,39896,7041,32855,16361,1246,9098,897,25459,5253,3099,868,5789,4721
GGCATATAATCTGACC,sample,117996,117095,15809,101286,20180,81106,25616,1639,28935,3300,54551,21616,6855,1070,14059,12360
TCAATATAATCTGACC,sample,39506,39214,1852,37362,12484,24878,17697,920,4985,376,22682,900,686,383,11277,7811
TCGCCTGAATCTGACC,sample,49986,49548,4482,45066,6072,38994,13402,570,15767,1849,29169,7406,3614,714,4397,3879
TTATTCGAATCTGACC,Neg_Ctrl,461,254,157,97,25,72,14,8,28,6,42,16,29,7,4,9
GACCGGAAATCTGACC,sample,37294,36941,2233,34708,9138,25570,12597,334,7474,813,20071,4352,1504,382,6285,5886
GGAGAGTTCTTCTTAC,sample,65649,65119,7003,58116,12829,45287,13461,570,17572,1877,31033,11807,5198,783,7386,8228
TCCAACTTCTTCTTAC,sample,23769,23419,3501,19918,3743,16175,4289,131,6420,781,10709,4554,2823,396,2102,2337
AGTACCATCTTCTTAC,sample,124427,122543,18711,103832,14550,89282,21422,719,37631,3467,59053,26043,7860,979,10921,8758
ATGCCTGGCTTCTTAC,sample,70122,69222,8365,60857,12905,47952,15440,838,18504,1696,33944,11474,4758,773,7554,9269
TTAGAAGTCTTCTTAC,sample,89850,88515,9312,79203,26003,53200,22583,912,16113,1634,38696,11958,4630,819,11485,14864
GGACCTCTCTTCTTAC,sample,82855,81758,7930,73828,22304,51524,26135,1157,13768,1235,39903,9229,2087,537,16540,14364
CAAGGCCTCTTCTTAC,sample,81595,80313,11071,69242,12991,56251,13781,533,23737,2223,37518,15977,5652,729,7218,7993
ACTATACTCTTCTTAC,sample,79015,78118,7948,70170,17180,52990,21942,862,17174,1908,39116,11104,4299,682,12819,11175
GACGGAGACTTCTTAC,sample,51086,50567,3964,46603,6729,39874,16231,768,15063,2041,31294,5771,3128,1008,4773,4892
CTTGATAGCTTCTTAC,sample,44441,43802,6479,37323,7108,30215,7043,425,12511,1455,19554,8781,3959,492,3337,4275
CGAGGCAGCTTCTTAC,sample,71504,70487,6124,64363,15036,49327,16626,881,19323,2169,35949,10328,3636,696,6642,10013
CATGATTCCTTCTTAC,sample,83336,82463,8701,73762,13305,60457,19333,895,24695,2450,44028,13084,4869,890,8595,8451
AATCCGTCCTTCTTAC,sample,87399,86513,7922,78591,21015,57576,25421,1457,20675,1782,46096,8241,2983,675,14503,14768
TTGGTACCCTTCTTAC,sample,84887,84168,10896,73272,18622,54650,14410,630,21684,2266,36094,15660,5745,767,6677,11022
GCCTGAACCTTCTTAC,sample,108967,108076,13981,94095,24851,69244,29355,722,22800,3118,52155,13249,3347,722,15378,14693
AACTCGTACTTCTTAC,sample,52625,51971,5706,46265,5461,40804,9545,628,18399,2172,27944,10060,4278,690,1567,3672
TTGGCCTCCTTCTTAC,sample,60687,60158,5599,54559,10427,44132,14797,629,17152,1850,31949,9704,4313,633,5275,7030
AATATATCCTTCTTAC,sample,56981,56491,4596,51895,7745,44150,15300,1086,17246,1868,32546,8650,3471,729,1566,5055
ACCAATGCCTTCTTAC,sample,42307,41767,4644,37123,6866,30257,10076,475,10771,1428,20847,7507,3506,485,4949,4517
TGCTTCGCCTTCTTAC,sample,39584,39243,2797,36446,4769,31677,11921,667,13217,1461,25138,4411,2511,758,753,3414
GAAGGCGCCTTCTTAC,sample,56551,56093,3810,52283,16133,36150,21997,530,8516,1278,30513,3829,1845,434,13107,10602
AAGAGCGCCTTCTTAC,sample,72276,71747,4512,67235,19677,47558,24360,1952,13500,1533,37860,6213,2942,721,12909,13292
GTCTTAGCCTTCTTAC,sample,67150,66578,6423,60155,12190,47965,13204,827,19554,2230,32758,12150,4930,723,4209,7957
GTACCGTACTTCTTAC,sample,83776,83064,12072,70992,15319,55673,18791,603,20366,2384,39157,13529,3792,645,8737,9943
TCGCCTGACTTCTTAC,sample,49453,49034,6686,42348,5380,36968,5728,394,16447,2060,22175,12339,4853,622,1187,3035
TTATTCGACTTCTTAC,sample,87132,86433,10521,75912,11354,64558,14691,606,26711,2885,41402,19665,6810,968,5708,6875
ATGACCGACTTCTTAC,sample,36356,36063,3338,32725,4772,27953,7150,794,11512,1280,18662,7217,4238,944,584,2985
ATTCTCTTACTTCTAC,sample,73060,72223,6576,65647,15776,49871,19887,500,16503,1611,36390,11370,2983,653,11019,10677
TCCTCCGTACTTCTAC,sample,75726,74958,6268,68690,14864,53826,19181,1202,22182,2160,41363,9101,3120,768,7091,9855
CCTCTAGAACTTCTAC,sample,53312,52624,5214,47410,9267,38143,15284,674,14723,1694,30007,5768,3061,768,5160,6530
TTCGTAATACTTCTAC,sample,53151,52462,3159,49303,21215,28088,19053,1203,5869,375,24922,1588,1307,706,10567,12049
TAGTACGGACTTCTAC,sample,19849,19486,2540,16946,4592,12354,3635,316,4847,447,8482,3109,2172,462,1251,2746
GGACCTCTACTTCTAC,sample,13637,13466,1356,12110,2924,9186,3467,206,3258,455,6725,1800,1546,423,1340,1850
GACGGAGAACTTCTAC,sample,63344,62965,4476,58489,18877,39612,24116,1488,9218,1023,33334,3767,2129,830,12490,11622
GTTAGCCGACTTCTAC,sample,40776,40311,3019,37292,11362,25930,13003,779,7833,1083,20836,3232,2619,802,5765,6855
CTTGATAGACTTCTAC,sample,75789,75119,7069,68050,18111,49939,19540,777,17150,2211,36690,10261,4036,596,11002,11391
ACCTCGAGACTTCTAC,sample,24997,24816,1916,22900,3292,19608,7611,545,7553,910,15164,2989,2477,833,1904,2262
GACGATAAACTTCTAC,sample,27359,27093,2122,24971,7244,17727,8738,211,5328,615,14066,2835,1711,329,5486,4552
ACGACTTCACTTCTAC,sample,32175,31796,2604,29192,4299,24893,8788,601,10526,1162,19314,3816,2351,650,2022,3031
AATCCGTCACTTCTAC,sample,48626,48180,5889,42291,7469,34822,8793,204,14122,1474,22915,10229,4440,488,4639,4920
CGTACGTCACTTCTAC,sample,36797,36348,4211,32137,8729,23408,5780,330,9249,917,15029,7132,3296,399,2436,5330
TTGGTACCACTTCTAC,sample,46528,46053,7429,38624,4881,33743,5250,260,14770,1610,20020,11853,5029,486,2041,2783
CGGATTACACTTCTAC,sample,48343,47839,7149,40690,5207,35483,6592,246,16384,1728,22976,10533,4760,586,2182,3150
ACGTATTAACTTCTAC,sample,126075,124955,13696,111259,22842,88417,35161,640,29133,3615,64294,19868,4727,915,20467,15543
TTGGCCTCACTTCTAC,sample,21318,21172,1374,19798,6889,12909,6445,508,3661,393,10106,1902,1674,678,2141,3992
TGCTTCGCACTTCTAC,sample,64481,63970,6715,57255,6304,50951,12852,570,20837,2187,33689,14505,6424,879,5729,3913
AAGAGCGCACTTCTAC,sample,55471,54902,5401,49501,7841,41660,14022,780,15418,1526,29440,9914,4184,617,6670,4828
ATTCTCTTAGAAGTAA,sample,55938,55524,3516,52008,15812,36196,16372,1049,12808,1503,29180,4464,2745,914,4770,9573
TCCTCCGTAGAAGTAA,sample,54562,54071,3929,50142,13918,36224,15408,635,11780,1044,27188,7357,3580,586,9937,8469
AGTACCATAGAAGTAA,sample,31892,31470,1806,29664,11007,18657,8756,637,6709,737,15465,1818,1867,883,1690,6432
TTCTAATGAGAAGTAA,sample,84631,83453,11308,72145,7214,64931,10476,684,28436,3041,38912,22294,7162,1171,866,4149
TGAGCGCGAGAAGTAA,sample,46357,45788,4761,41027,5601,35426,8875,639,16788,1882,25663,7242,4041,834,661,3648
AATGGTAAAGAAGTAA,sample,24091,23780,2521,21259,1350,19909,6204,436,8948,947,15152,3374,2798,913,186,774
GGACCTCTAGAAGTAA,sample,66475,65875,4604,61271,7754,53517,20939,1142,21021,3070,41960,7345,3778,1396,1552,5062
GCCTTGCTAGAAGTAA,sample,117939,116969,8927,108042,20157,87885,37025,2000,31138,3781,68163,13941,5072,1119,13155,14167
CAAGGCCTAGAAGTAA,sample,76693,75435,11343,64092,10844,53248,7611,472,23521,2772,31132,18872,5809,636,2003,7321
GACGGAGAAGAAGTAA,sample,74200,73318,9095,64223,11231,52992,8637,585,23672,2633,32309,17465,5872,709,2543,7212
CCAGAGCGAGAAGTAA,sample,87602,86785,7715,79070,16992,62078,21720,1312,25093,2635,46813,11318,4959,946,8310,11217
GACGATAAAGAAGTAA,sample,45604,45282,3512,41770,10638,31132,11132,748,12501,1733,23633,5018,2513,560,4098,6749
CCATGAAGAGAAGTAA,sample,52002,51672,3752,47920,14384,33536,17470,1035,8904,1009,26374,5118,3713,1412,6653,8873
ACGACTTCAGAAGTAA,sample,125185,124491,8189,116302,35989,80313,35505,1515,29152,3407,64657,10734,4517,977,18972,22511
GTTAGGACAGAAGTAA,sample,102912,102071,5975,96096,21906,74190,32354,979,24547,2155,56901,14155,4193,869,19178,15023
AACTCGTAAGAAGTAA,sample,120066,118984,10190,108794,18803,89991,26945,1997,34962,3494,61907,22593,6763,1007,10292,12733
GTCTTAGCAGAAGTAA,sample,86934,86196,8513,77683,18894,58789,16432,1125,22755,2705,39187,15772,5741,774,5551,11710
TTGGTTAAAGAAGTAA,sample,156273,155256,14428,140828,29345,111483,45894,2083,37047,3855,82941,22604,5462,1121,22190,18807
GTACCGTAAGAAGTAA,sample,61014,60702,3066,57636,19642,37994,22428,1590,9288,1091,31716,3597,2715,1315,6801,11572
TCGCCTGAAGAAGTAA,sample,101392,100602,10452,90150,13490,76660,14691,1088,32624,3705,47315,24552,7806,1278,1270,8386
CTTCATGAAGAAGTAA,sample,21209,21011,2099,18912,2902,16010,3781,132,7264,712,11045,4121,2612,442,906,1908
Short,Non_sample,0,NA,NA,NA,NA,NA,NA,NA,NA,NA,NA,NA,NA,NA,NA,NA
Unselected,Non_sample,0,NA,NA,NA,NA,NA,NA,NA,NA,NA,NA,NA,NA,NA,NA,NA
Undetermined,Non_sample,158019757,NA,NA,NA,NA,NA,NA,NA,NA,NA,NA,NA,NA,NA,NA,NA
