Barcode,Sample,Barcoded_Reads,Trimmed_Reads,Unmapped_Reads,Mapped_Reads,Multimapped_Reads,Uniquely_Mapped_Reads,Exon_Reads,Ambiguous_Exon_Reads,Intron_Reads,Ambiguous_Intron_Reads,Gene_Reads,Intergenic_Reads,No_of_Genes,No_of_Transcripts,Mitochondrial_Reads,Ribosomal_Reads
CTGGTCTTCGTTGGTT,sample,102167,100460,13057,87403,13200,74203,34952,2254,23736,1988,58688,11273,5851,1992,8841,8785
GTCGTTCTCGTTGGTT,sample,105738,104056,14007,90049,17303,72746,38411,2156,18381,1966,56792,11832,6535,1836,12245,11290
CATAATGGCGTTGGTT,sample,81368,80351,7904,72447,17787,54660,35023,2283,9678,1187,44701,6489,3918,1532,11500,11839
TATACGGACGTTGGTT,sample,15728,15494,1713,13781,3030,10751,5401,302,3066,353,8467,1629,2321,877,1968,1924
CTAGCGACCGTTGGTT,sample,116485,114979,9529,105450,25518,79932,58515,4848,9571,1087,68086,5911,4211,2294,13674,17273
CGTCGCCACGTTGGTT,sample,19175,18690,1412,17278,3515,13763,8781,718,2711,245,11492,1308,1970,1107,1673,2305
TCATCGAACGTTGGTT,sample,1998,1890,265,1625,308,1317,735,53,331,36,1066,162,580,298,158,191
GACTCAAGCGTTGGTT,sample,681,643,160,483,95,388,229,20,81,15,310,43,229,135,46,60
ATACGTTCCGTTGGTT,sample,1157,1096,247,849,184,665,380,24,137,29,517,95,334,161,118,115
CCGCAGTCCGTTGGTT,sample,1454,1376,343,1033,182,851,410,28,217,23,627,173,429,182,86,108
CCGTACGCCGTTGGTT,sample,815,775,72,703,240,463,280,22,85,8,365,68,238,129,71,136
CCATTCTTCGTTGGTT,sample,75566,74873,5240,69633,16953,52680,35589,2816,8536,946,44125,4793,3943,1892,9326,11305
CATTCGGTCGTTGGTT,sample,26509,26104,4349,21755,5323,16432,5977,371,5298,579,11275,4207,3865,1086,1724,3104
GAGATTCTCGTTGGTT,sample,82004,81236,8783,72453,16099,56354,30907,1783,12824,1396,43731,9444,5848,2134,9515,11090
AAGGTCTGCGTTGGTT,sample,33407,33043,4678,28365,4054,24311,8526,679,8536,935,17062,5635,5060,1547,1546,2611
CTAACCGGCGTTGGTT,sample,4046,3946,423,3523,920,2603,1523,162,554,54,2077,310,869,484,409,566
GCCTATTCCGTTGGTT,sample,228,213,37,176,29,147,67,1,47,2,114,30,83,42,13,21
AGCAGAGCCGTTGGTT,sample,176,164,37,127,13,114,68,1,30,1,98,14,70,33,12,12
GCGTTACCCGTTGGTT,sample,380,339,100,239,32,207,97,9,53,6,150,42,112,58,21,19
AAGTAGAGCGTTGGTT,sample,64129,63149,12746,50403,6781,43622,11742,717,16166,1683,27908,13314,7918,1356,3460,3982
TAACGCCACGTTGGTT,sample,331,315,66,249,49,200,116,5,46,2,162,31,114,55,24,28
CGCGAGACCGTTGGTT,sample,281,244,44,200,27,173,122,10,27,3,149,11,102,65,31,20
CGTAGAACCGTTGGTT,sample,439,408,131,277,31,246,144,4,47,11,191,40,145,69,31,17
AGATACTACGTTGGTT,sample,465,420,125,295,63,232,150,7,37,6,187,32,125,57,49,34
AGAGTTCTCTATCGTT,sample,41028,40232,5367,34865,3856,31009,15188,945,9252,1193,24440,4431,4011,1929,1733,2725
AGCTGAATCTATCGTT,sample,12380,11955,2100,9855,2047,7808,4377,322,1764,173,6141,1172,1592,727,1354,1352
CATAATGGCTATCGTT,sample,32753,31976,3669,28307,6843,21464,14472,1079,3305,394,17777,2214,2450,1390,4277,4795
TATACGGACTATCGTT,sample,51970,50973,5625,45348,5265,40083,21557,1469,10976,1286,32533,4795,3635,1864,3302,3872
GAGCCTCCCTATCGTT,sample,39180,38208,4923,33285,4784,28501,15797,899,7489,804,23286,3512,3119,1419,3520,3371
CATACTCCCTATCGTT,sample,52777,51299,8612,42687,7215,35472,16351,1190,10311,1186,26662,6434,5038,1639,3345,4625
TCATCGAACTATCGTT,sample,61951,60872,7706,53166,11007,42159,24445,1518,8748,873,33193,6575,3497,1142,8559,7255
TCATACCACTATCGTT,sample,87920,86511,10755,75756,11728,64028,37283,2427,13693,1448,50976,9177,5269,1765,8510,7945
ATACGTTCCTATCGTT,sample,55899,55281,4692,50589,11455,39134,26819,2252,6166,1107,32985,2790,3413,2186,6386,7447
GGCAGGTTCTATCGTT,sample,107712,105245,17756,87489,14685,72804,38994,2590,16867,1705,55861,12648,5945,1933,8999,9995
GATGCGTTCTATCGTT,sample,84127,82394,12158,70236,10185,60051,28567,2195,15730,1655,44297,11904,6326,1429,8070,7218
CCATTCTTCTATCGTT,sample,63875,62248,9811,52437,5296,47141,18437,1054,17972,2122,36409,7556,4859,1784,3104,3606
GCTCTTCTCTATCGTT,sample,2225,2162,395,1767,348,1419,666,56,397,36,1063,264,567,241,204,242
CTAAGCATCTATCGTT,sample,85484,84553,5623,78930,16877,62053,51551,3467,5255,514,56806,1266,1476,1260,10960,12187
CTAACCGGCTATCGTT,sample,36688,36191,3333,32858,5370,27488,18372,1476,5081,494,23453,2065,2735,1633,4630,4211
GCGTTACCCTATCGTT,sample,10496,10401,814,9587,2026,7561,4762,392,1557,223,6319,627,1400,862,1221,1400
TTATGACGCTATCGTT,sample,2145,2100,221,1879,402,1477,869,77,326,46,1195,159,558,340,247,258
GACTAACCCTATCGTT,sample,264,259,50,209,28,181,107,10,36,1,143,27,96,55,23,18
CGCGAGACCTATCGTT,sample,238,228,42,186,28,158,100,6,30,3,130,19,91,50,23,14
CGTAGAACCTATCGTT,sample,331,306,90,216,32,184,105,3,46,3,151,27,111,48,27,15
CTGGTCTTGTCTTCTT,Pos_Ctrl,27640,26192,4335,21857,1253,20604,17161,1341,1448,182,18609,472,4661,4259,910,760
AGAGTTCTGTCTTCTT,sample,37402,36734,3843,32891,7090,25801,16804,1202,4548,567,21352,2680,3149,1661,4204,4899
TATACGGAGTCTTCTT,Pos_Ctrl,65313,62898,8885,54013,2993,51020,42667,3774,3194,431,45861,954,6625,7446,3366,1561
CGTCGCCAGTCTTCTT,sample,45353,44381,5029,39352,5641,33711,19303,1084,8236,1110,27539,3978,2894,1442,3570,4247
ATTCAAGGGTCTTCTT,sample,20562,19753,4084,15669,3446,12223,4286,284,4343,454,8629,2856,3003,938,1123,1972
ATACGTTCGTCTTCTT,sample,16470,16042,2998,13044,2494,10550,5405,372,2611,265,8016,1897,2174,914,1319,1586
CCGTACGCGTCTTCTT,sample,49549,48745,4309,44436,7484,36952,24005,1444,7740,829,31745,2934,2684,1757,4184,5298
TGGATCAAGTCTTCTT,sample,54722,53392,7809,45583,8672,36911,21735,1521,7479,813,29214,5363,4316,1518,6567,6016
GATGCGTTGTCTTCTT,sample,36345,35822,3024,32798,8697,24101,18656,1477,2799,212,21455,957,1281,1038,6341,5895
ATGGCGTTGTCTTCTT,sample,56464,54913,8721,46192,6198,39994,17657,1050,11952,1337,29609,7998,5700,1768,3681,4071
CGGTTGGTGTCTTCTT,sample,35040,34379,4015,30364,5984,24380,14580,918,5284,446,19864,3152,2784,1187,4823,4234
ACGCTTAAGTCTTCTT,sample,26917,26325,3658,22667,3141,19526,9942,666,5480,591,15422,2847,2975,1270,1984,2280
GCTCTTCTGTCTTCTT,sample,140669,135658,36356,99302,7888,91414,20158,1353,39123,4587,59281,26193,11721,2515,2315,3793
CCTAGCGGGTCTTCTT,sample,35276,34566,4719,29847,5489,24358,13970,1029,5240,546,19210,3573,3624,1484,3302,3756
CGCGGTCGGTCTTCTT,sample,17279,17068,1475,15593,3167,12426,7920,454,2543,259,10463,1250,1904,1031,2141,2262
TTATGACGGTCTTCTT,sample,17334,17048,1567,15481,3844,11637,8867,659,1294,173,10161,644,1463,1044,2583,2660
ATGAATAGGTCTTCTT,sample,5484,5415,324,5091,1217,3874,2701,224,653,94,3354,202,997,741,655,803
TCAATCAGGTCTTCTT,sample,20221,19837,2525,17312,3166,14146,7638,479,3298,426,10936,2305,2425,905,2627,2124
TAACGCCAGTCTTCTT,sample,14247,14076,1232,12844,2563,10281,7131,594,1613,223,8744,720,1779,1255,2010,1768
GACTAACCGTCTTCTT,sample,1690,1641,202,1439,260,1179,597,46,289,32,886,215,507,254,110,166
CGCGAGACGTCTTCTT,sample,401,383,42,341,38,303,186,13,65,7,251,32,165,87,44,21
AGATACTAGTCTTCTT,sample,329,317,70,247,28,219,139,13,36,9,175,22,105,64,43,17
CCTAACTAGTCTTCTT,Pos_Ctrl,1754,1670,203,1467,474,993,738,120,75,8,813,52,443,376,87,223
TCTAGGTTTAGGCTCT,sample,78095,76586,8638,67948,10732,57216,34222,2689,13348,1004,47570,5953,4786,1955,6272,7775
GTCGTTCTTAGGCTCT,sample,78407,76202,10676,65526,15790,49736,27270,1840,11967,1157,39237,7502,4572,1473,10182,10220
AGAGTTCTTAGGCTCT,sample,130176,127578,12319,115259,14031,101228,54922,4119,29077,3755,83999,9355,5063,2395,7277,10699
GAGCCTCCTAGGCTCT,sample,145314,143811,8552,135259,46375,88884,74832,5012,5941,697,80773,2402,1515,1386,25328,29340
CATACTCCTAGGCTCT,sample,223367,220083,20722,199361,46020,153341,94307,5686,32856,2838,127163,17654,6570,2000,26241,33029
TCGAACGATAGGCTCT,sample,57889,56489,9829,46660,9853,36807,9743,709,14464,1548,24207,10343,6319,1297,1938,5900
GGTAGAGATAGGCTCT,sample,494735,486148,55360,430788,72870,357918,131493,8266,119400,11760,250893,86999,15768,4336,42498,50430
CGTCGCCATAGGCTCT,sample,200326,196406,19726,176680,41456,135224,83443,5602,28166,3065,111609,14948,7634,3095,16838,29262
GCAACTAGTAGGCTCT,sample,76041,75060,7866,67194,15936,51258,30048,2323,11111,1253,41159,6523,5252,2407,6949,10584
TACGCGAGTAGGCTCT,sample,169218,165079,21002,144077,25277,118800,61737,3644,30733,3619,92470,19067,7882,2093,16865,17974
GACTCAAGTAGGCTCT,sample,72904,71441,6724,64717,14031,50686,35855,2178,7428,751,43283,4474,4199,2410,6277,9660
ATACGTTCTAGGCTCT,sample,169404,166913,15280,151633,38921,112712,81374,5950,15496,1359,96870,8533,5509,2899,16597,26701
CCGCAGTCTAGGCTCT,sample,86496,83125,17036,66089,7248,58841,18566,1090,22127,2152,40693,14906,7840,1828,4964,4265
CCGTACGCTAGGCTCT,sample,29141,28426,3474,24952,5360,19592,12622,910,3704,539,16326,1817,2601,1402,3676,3593
ATGGCGTTTAGGCTCT,sample,194013,190112,21098,169014,29343,139671,78953,5112,31640,3260,110593,20706,8309,2441,19035,21062
CCATTCTTTAGGCTCT,sample,198136,194401,20723,173678,27781,145897,88789,7006,30437,3614,119226,16051,7959,2924,18576,20892
AGCGTCTTTAGGCTCT,sample,224329,220718,21251,199467,20581,178886,104096,5099,47331,5540,151427,16820,6498,2387,12782,15831
TAGCGAGTTAGGCTCT,sample,141863,139826,10792,129034,33205,95829,79310,6492,6718,797,86028,2512,2404,2244,16756,22883
GCTGCTTCTAGGCTCT,sample,326189,321094,30545,290549,43047,247502,158560,13459,46200,4137,204760,25146,6383,2583,26054,31185
ATACCGCCTAGGCTCT,sample,104069,101542,13619,87923,15981,71942,40104,2353,18187,1672,58291,9626,5862,1804,12238,11949
GCGTTACCTAGGCTCT,sample,23604,22623,5025,17598,2910,14688,3620,302,5802,611,9422,4353,3672,802,725,1650
GGCGTACCTAGGCTCT,sample,74120,72180,9506,62674,10528,52146,29176,1860,12692,1131,41868,7287,4402,1584,7224,7509
ATGAATAGTAGGCTCT,sample,51932,50420,7610,42810,7083,35727,20374,1401,8305,1053,28679,4594,4577,2394,4892,4962
GCGCAATATAGGCTCT,sample,80897,80257,4392,75865,12201,63664,41969,3897,12052,1342,54021,4404,3258,1821,8022,8995
TTAACTGATAGGCTCT,sample,124533,122875,9036,113839,21314,92525,63589,4581,14467,1581,78056,8307,2668,1361,16412,15951
AACCGGTTTTGACTAT,sample,5230,5105,358,4747,1361,3386,2608,252,350,40,2958,136,688,580,743,875
TCTAGGTTTTGACTAT,sample,45129,43773,9269,34504,4193,30311,9721,447,10481,1121,20202,8541,5216,973,2726,2318
GTCGTTCTTTGACTAT,Neg_Ctrl,2159,1173,659,514,88,426,261,15,87,19,348,44,232,121,55,23
AGAGTTCTTTGACTAT,sample,33884,33229,3703,29526,7538,21988,16508,1244,2640,305,19148,1291,2248,1599,3658,5233
TATACGGATTGACTAT,sample,27610,27117,2372,24745,7542,17203,13753,1009,1524,257,15277,660,1685,1449,4246,4925
GGAGAAGCTTGACTAT,Neg_Ctrl,1382,981,627,354,51,303,142,8,76,5,218,72,152,67,42,32
GAGCCTCCTTGACTAT,sample,25285,24772,3475,21297,6812,14485,10187,705,1971,278,12158,1344,2119,1193,2729,4131
CATACTCCTTGACTAT,sample,32786,32104,2905,29199,6889,22310,17835,1245,1872,356,19707,1002,1719,1444,4793,4966
TCGAACGATTGACTAT,sample,34159,33122,5033,28089,5025,23064,12938,838,5093,457,18031,3738,3075,1100,3608,3623
GGTAGAGATTGACTAT,sample,39217,38373,4083,34290,8620,25670,19731,1176,3110,343,22841,1310,1971,1266,5267,6207
TGATTCCGTTGACTAT,Pos_Ctrl,45334,42390,8603,33787,2106,31681,26134,2148,2333,264,28467,802,5651,5554,1484,1286
TACGCGAGTTGACTAT,sample,46910,45772,5878,39894,7861,32033,19821,1375,6420,676,26241,3741,3453,1279,6131,5378
ATACGTTCTTGACTAT,sample,75028,72653,14549,58104,6085,52019,17962,1071,18365,2094,36327,12527,6552,1651,4114,3677
TGGATCAATTGACTAT,sample,34433,33767,2744,31023,5034,25989,18411,1108,4832,456,23243,1182,2145,1636,3843,3815
ATGGCGTTTTGACTAT,Pos_Ctrl,38120,36186,6564,29622,1842,27780,23096,1884,1936,241,25032,623,5229,5078,1407,1172
ACGCTTAATTGACTAT,sample,42755,41226,8689,32537,3319,29218,9421,668,10079,1058,19500,7992,4876,987,2972,2170
TAGCGAGTTTGACTAT,sample,75522,73516,12619,60897,6915,53982,25326,1335,14859,1476,40185,10986,6237,1578,4871,4669
CCTAGCGGTTGACTAT,Pos_Ctrl,16609,15964,2913,13051,890,12161,10149,883,757,93,10906,279,3597,2992,726,572
CTAACCGGTTGACTAT,sample,76943,75759,6667,69092,6136,62956,48138,4080,7290,643,55428,2805,4161,3755,1941,5149
TAACGAAGTTGACTAT,sample,112672,110628,11327,99301,11132,88169,59699,4623,12702,1410,72401,9735,5464,2083,9969,7670
AGCAGAGCTTGACTAT,sample,11915,11519,2709,8810,1272,7538,3040,181,2275,233,5315,1809,2003,516,1172,765
TGCGCTCCTTGACTAT,sample,47624,47088,3089,43999,8785,35214,30243,2103,1986,278,32229,604,924,973,10090,6690
GCGTTACCTTGACTAT,sample,84833,82984,15131,67853,5900,61953,18975,1160,24995,2595,43970,14228,8169,1748,3181,3636
CGTCGAGGTTGACTAT,Pos_Ctrl,18188,17726,2296,15430,950,14480,12129,1193,805,113,12934,240,3861,3676,760,566
TAACGCCATTGACTAT,sample,45626,44807,6568,38239,5673,32566,18476,1407,7019,874,25495,4790,3981,1471,3293,3813
ATTCTACCTTGACTAT,sample,37487,36922,2873,34049,6567,27482,22989,1667,2065,276,25054,485,1017,1002,6673,5100
CGCGAGACTTGACTAT,sample,58061,56381,11448,44933,4365,40568,12568,807,15029,1816,27597,10348,6390,1453,1721,2640
CCTAACTATTGACTAT,sample,55681,54363,8789,45574,5704,39870,17216,1137,11250,1161,28466,9106,5222,1107,3987,3600
GCGCAATATTGACTAT,Neg_Ctrl,1163,797,469,328,47,281,155,14,57,26,212,29,144,74,37,24
TTAACTGATTGACTAT,sample,25190,24844,2703,22141,3306,18835,12203,795,3253,479,15456,2105,1997,1008,3014,2329
CTGGTCTTTGCAGTTG,sample,57620,56545,6457,50088,7851,42237,25594,1646,8952,934,34546,5111,3402,1633,5339,5630
AGAGTTCTTGCAGTTG,sample,66276,64468,9338,55130,9548,45582,23698,1862,10651,1047,34349,8324,5009,1607,5833,6541
GGAGAAGCTGCAGTTG,sample,68988,67172,8578,58594,8424,50170,25814,1448,14419,1611,40233,6878,4538,1655,5469,5779
CATACTCCTGCAGTTG,sample,54916,53441,7283,46158,7085,39073,20715,1133,10108,1018,30823,6099,4495,1686,4140,5184
TCATACCATGCAGTTG,sample,68671,67033,8457,58576,12994,45582,28717,1826,8765,1193,37482,5081,4469,1702,7221,9184
ATTCAAGGTGCAGTTG,sample,63999,62005,9511,52494,6908,45586,20047,1161,13193,1398,33240,9787,5844,1348,4716,4709
GCAACTAGTGCAGTTG,sample,22693,22295,1976,20319,3997,16322,11363,896,2481,361,13844,1221,2368,1694,1770,3032
TACGCGAGTGCAGTTG,sample,67432,66059,7402,58657,6718,51939,30833,1633,12934,1587,43767,4952,3702,1794,4304,5121
CCGCAGTCTGCAGTTG,sample,45856,44608,5525,39083,5309,33774,20477,1115,7333,879,27810,3970,3804,1788,4139,3921
TGGATCAATGCAGTTG,sample,76888,73962,15389,58573,6742,51831,12480,665,21892,2472,34372,14322,7961,1498,2534,4016
ATGGCGTTTGCAGTTG,sample,67734,66444,8140,58304,7737,50567,28149,1644,10701,1195,38850,8878,5368,1903,4655,5319
TGCGCGTTTGCAGTTG,sample,49307,48036,7038,40998,6471,34527,19507,1120,7596,829,27103,5475,3374,1183,5132,4340
GAGATTCTTGCAGTTG,sample,48200,47356,4549,42807,5881,36926,23719,1612,7496,893,31215,3206,3161,1577,4340,4504
CTAAGCATTGCAGTTG,sample,90661,89104,9858,79246,8218,71028,37384,2783,18440,2123,55824,10298,5538,1717,4959,5888
CCTAGCGGTGCAGTTG,sample,27801,27169,3078,24091,3777,20314,12426,859,4165,406,16591,2458,3137,1647,2395,2803
GCTGCTTCTGCAGTTG,sample,23958,23455,2511,20944,2684,18260,9944,627,4978,608,14922,2103,2986,1546,1857,1997
GGCGTACCTGCAGTTG,sample,33101,32591,3937,28654,3130,25524,11905,647,7763,956,19668,4253,3883,1318,2333,2238
GTCGCGAATGCAGTTG,sample,11551,11432,729,10703,2553,8150,6091,526,985,90,7076,458,1350,1070,1197,1776
CCTAACTATGCAGTTG,sample,49235,47871,10017,37854,2615,35239,6092,423,14977,1590,21069,12157,7528,1137,797,1159
AACCGGTTTCATGCTG,sample,271,261,30,231,24,207,133,7,44,8,177,15,106,67,46,17
GGAGAAGCTCATGCTG,sample,12121,11838,1463,10375,2740,7635,4348,272,1711,185,6059,1119,1540,757,1116,1738
GAGCCTCCTCATGCTG,sample,25051,24665,1889,22776,6104,16672,14076,812,1427,77,15503,280,955,1020,3915,4396
CTAGCGACTCATGCTG,sample,23187,22136,6084,16052,1895,14157,3015,155,5746,576,8761,4665,3888,593,816,1002
TCGAACGATCATGCTG,sample,7028,6732,1685,5047,656,4391,1415,90,1539,166,2954,1181,1470,395,425,382
CGTCGCCATCATGCTG,sample,41021,39674,6819,32855,3641,29214,13066,845,9221,1148,22287,4934,4101,1357,2320,2582
GCAACTAGTCATGCTG,Neg_Ctrl,766,341,238,103,15,88,50,3,19,0,69,16,42,27,9,4
ATACGTTCTCATGCTG,sample,18326,17615,3738,13877,1949,11928,5057,332,3433,361,8490,2745,2587,707,1724,1308
CCGTACGCTCATGCTG,sample,17501,17069,2063,15006,3072,11934,7471,504,2217,200,9688,1542,1872,895,1740,2177
TGCGCGTTTCATGCTG,Neg_Ctrl,831,563,357,206,26,180,102,7,41,4,143,26,110,60,16,19
CCATTCTTTCATGCTG,sample,26648,25976,4024,21952,2626,19326,10044,784,4819,553,14863,3126,3157,1092,2635,1814
CGGTTGGTTCATGCTG,sample,21490,20919,3166,17753,2515,15238,7323,518,4013,397,11336,2987,2949,1041,2285,1654
CTAACCGGTCATGCTG,Neg_Ctrl,545,333,199,134,11,123,73,3,20,11,93,16,59,42,16,6
CAGCTTCGTCATGCTG,Neg_Ctrl,539,374,229,145,11,134,76,11,17,3,93,27,65,33,24,16
AAGTAGAGTCATGCTG,sample,11707,11466,1157,10309,2179,8130,6695,484,632,114,7327,205,683,629,2285,1658
CGCGAGACTCATGCTG,sample,21140,20543,3891,16652,2245,14407,7454,468,3433,359,10887,2693,2258,696,2077,1537
TCTAGGTTTTAGGCGG,sample,105894,104807,6248,98559,30509,68050,59147,3491,3758,262,62905,1392,1737,1849,15347,19754
CTGGTCTTTTAGGCGG,Pos_Ctrl,67699,64817,9607,55210,3117,52093,43668,3633,3270,444,46938,1078,6687,7474,3166,1896
GTCGTTCTTTAGGCGG,sample,137064,135192,10861,124331,39080,85251,63224,4616,9439,1448,72663,6524,3915,2179,16706,25259
TATACGGATTAGGCGG,Pos_Ctrl,71460,67217,10911,56306,2919,53387,44678,3572,3573,463,48251,1101,6762,7714,2955,1500
GCAACTAGTTAGGCGG,sample,30168,29494,2942,26552,6340,20212,15301,987,2781,133,18082,1010,1498,1075,4163,5032
GACTCAAGTTAGGCGG,sample,43438,42355,5675,36680,6712,29968,20484,1337,4697,602,25181,2848,2967,1343,5663,5064
GCTCTTCTTTAGGCGG,sample,92893,91104,10291,80813,11436,69377,44014,2959,12366,1241,56380,8797,5541,1989,7271,7860
AAGGTCTGTTAGGCGG,sample,101911,100056,10362,89694,13744,75950,40871,3278,19429,2689,60300,9683,4721,1415,10113,10640
CCTAGCGGTTAGGCGG,sample,64082,63369,4205,59164,14391,44773,37057,1666,4145,541,41202,1364,1549,1119,9369,10109
AGCAGAGCTTAGGCGG,sample,56681,55861,4361,51500,10640,40860,34134,2361,3300,398,37434,667,1127,1042,8725,8061
ATACCGCCTTAGGCGG,sample,69093,67635,7656,59979,10560,49419,30716,2486,9596,959,40312,5662,4171,1558,5835,7739
GGCGTACCTTAGGCGG,sample,34623,33559,5301,28258,3896,24362,12634,825,6011,567,18645,4325,3588,974,3654,2806
CGCGGTCGTTAGGCGG,sample,28020,27422,3031,24391,5462,18929,12932,896,2841,301,15773,1959,2588,1558,2863,3838
TTATGACGTTAGGCGG,sample,79544,77609,12141,65468,8033,57435,27226,1515,15767,1482,42993,11445,6524,1380,7407,5812
TCTCCTAGTTAGGCGG,sample,81020,78659,11361,67298,6639,60659,31308,1958,15332,1740,46640,10321,6043,2193,3884,4173
AAGTAGAGTTAGGCGG,sample,75788,73809,11374,62435,7641,54794,24601,1792,15259,1594,39860,11548,5941,1392,7115,4975
TCAATCAGTTAGGCGG,sample,41931,41380,3179,38201,8451,29750,23576,1851,3259,161,26835,903,1048,888,6815,6393
CGTAGAACTTAGGCGG,sample,90025,88081,9054,79027,10119,68908,47904,3686,11539,1099,59443,4680,4076,2159,6428,7462
ATATGCAATTAGGCGG,sample,25929,25583,3154,22429,2950,19479,9263,597,5675,658,14938,3286,3059,1026,2269,2025
TCTAGGTTTCAGATAC,sample,6743,6641,549,6092,1727,4365,3443,315,450,44,3893,113,646,547,1071,1146
CTGGTCTTTCAGATAC,sample,389350,383617,48755,334862,42132,292730,95195,4753,99821,10665,195016,82296,14353,3734,25793,29712
TCGAACGATCAGATAC,sample,64263,63532,4353,59179,15019,44160,38283,2456,2504,436,40787,481,1369,1489,8962,10889
TCATACCATCAGATAC,sample,103592,101724,12382,89342,13488,75854,48988,2885,14090,1219,63078,8672,5250,1594,10873,9625
CCGTACGCTCAGATAC,sample,40379,39606,4847,34759,4389,30370,17014,1138,8091,1130,25105,2997,3179,1716,2709,3194
GATGCGTTTCAGATAC,sample,26712,26133,4315,21818,2676,19142,8206,586,6389,804,14595,3157,3003,1001,2305,1676
TGCGCGTTTCAGATAC,sample,77058,75632,11702,63930,7431,56499,29102,1726,16227,2028,45329,7416,4800,2049,4413,5011
AGCGTCTTTCAGATAC,sample,6291,6103,1373,4730,758,3972,1935,114,999,114,2934,810,1135,470,577,468
TAGCGAGTTCAGATAC,sample,20665,20283,2326,17957,3805,14152,10510,499,1850,269,12360,1024,1744,1081,2786,2606
CCTAGCGGTCAGATAC,sample,12063,11586,3323,8263,1044,7219,1857,72,2719,265,4576,2306,2492,481,456,578
TAACGAAGTCAGATAC,sample,29240,28598,4243,24355,3096,21259,10347,690,6668,708,17015,2846,2914,1168,2438,2183
GCCTATTCTCAGATAC,sample,21243,20844,2482,18362,4607,13755,10435,545,1615,323,12050,837,1112,800,3799,3191
AGCAGAGCTCAGATAC,sample,34489,33635,5789,27846,4279,23567,12042,821,5937,514,17979,4253,3359,903,4879,2769
ATACCGCCTCAGATAC,sample,27127,26320,5224,21096,3589,17507,8802,564,4439,536,13241,3166,2835,950,2581,2226
GCGTTACCTCAGATAC,sample,21189,20588,3728,16860,1895,14965,7101,372,4441,469,11542,2582,2828,1136,1424,1231
GGCGTACCTCAGATAC,sample,11321,11104,1016,10088,2405,7683,6151,447,724,95,6875,266,866,718,2138,1710
GTCGCGAATCAGATAC,sample,13859,13542,2057,11485,1763,9722,5672,409,2185,267,7857,1189,1999,1043,1403,1163
CGTCGAGGTCAGATAC,sample,12437,12181,1441,10740,2293,8447,5819,299,1342,141,7161,846,1330,677,2124,1567
CAGCTTCGTCAGATAC,sample,18671,18119,3511,14608,2491,12117,6305,429,2719,344,9024,2320,2507,925,1838,1643
CGCGGTCGTCAGATAC,sample,7449,7255,1273,5982,934,5048,2767,190,1153,127,3920,811,1426,592,825,630
TTATGACGTCAGATAC,sample,14318,14080,1509,12571,2612,9959,7289,504,1314,173,8603,679,1411,1013,1788,1844
TCTCCTAGTCAGATAC,sample,12378,12054,1460,10594,2332,8262,5565,256,1304,112,6869,1025,1011,624,2068,1663
TCAATCAGTCAGATAC,sample,9559,9336,1388,7948,1296,6652,4096,212,1492,222,5588,630,1166,592,1390,924
TAACGCCATCAGATAC,sample,17674,17192,3731,13461,1092,12369,4250,193,4694,476,8944,2756,2997,834,864,622
ATTCTACCTCAGATAC,sample,17069,16617,2994,13623,2027,11596,6086,342,2906,344,8992,1918,2419,926,1670,1276
GACTAACCTCAGATAC,sample,7362,7032,2028,5004,660,4344,1175,89,1610,198,2785,1272,1502,364,293,331
CGTAGAACTCAGATAC,sample,16704,16280,2500,13780,2552,11228,6545,467,2398,266,8943,1552,2342,1089,1724,1748
TCTAGGTTTCGCTAGG,sample,95352,94239,6416,87823,18609,69214,57170,3867,5847,488,63017,1842,1381,1147,19804,14091
CTGGTCTTTCGCTAGG,sample,160823,157604,20798,136806,18975,117831,62005,3921,29349,3271,91354,19285,7834,2051,15106,13633
GTCGTTCTTCGCTAGG,Neg_Ctrl,2405,1255,807,448,71,377,206,11,82,6,288,72,197,83,44,34
TATACGGATCGCTAGG,sample,112934,110540,16924,93616,12320,81296,41960,2618,21383,2413,63343,12922,6877,1777,11065,8186
GGAGAAGCTCGCTAGG,Neg_Ctrl,1418,991,700,291,40,251,139,7,67,10,206,28,153,61,28,13
GAGCCTCCTCGCTAGG,sample,42311,41233,6282,34951,5666,29285,17175,1271,5822,616,22997,4401,3806,1603,3294,3856
TCGAACGATCGCTAGG,sample,167317,161324,35236,126088,8230,117858,32886,1643,48177,6133,81063,29019,11447,2027,6569,4207
CGTCGCCATCGCTAGG,sample,74840,72542,10771,61771,10197,51574,26386,1914,12937,1597,39323,8740,5733,1952,4395,6993
TGATTCCGTCGCTAGG,sample,93216,90217,16916,73301,7500,65801,30173,1960,18102,2380,48275,13186,7409,1965,6100,5395
GACTCAAGTCGCTAGG,sample,32884,32040,4298,27742,5188,22554,14353,830,4211,439,18564,2721,3024,1447,3732,3730
GATGCGTTTCGCTAGG,sample,52601,51332,8003,43329,4966,38363,19457,1226,10501,1246,29958,5933,4915,1886,3580,2950
ATGGCGTTTCGCTAGG,sample,19046,18559,3056,15503,1928,13575,6425,388,4069,499,10494,2194,3001,1275,1318,1290
TGCGCGTTTCGCTAGG,sample,78718,76021,20470,55551,5414,50137,12255,797,19057,1930,31312,16098,8626,1245,3224,2832
CGGTTGGTTCGCTAGG,sample,17122,16661,2662,13999,2330,11669,6681,524,2674,228,9355,1562,2409,1117,2035,1581
GAGATTCTTCGCTAGG,sample,21886,21291,3664,17627,3788,13839,8209,604,2568,352,10777,2106,2331,1202,2396,2395
CTAAGCATTCGCTAGG,sample,21150,20545,3215,17330,2474,14856,9938,497,2370,274,12308,1777,2415,1254,2130,1778
CTAACCGGTCGCTAGG,sample,43408,42478,6467,36011,4512,31499,17950,1136,6580,663,24530,5170,3613,1281,5142,3020
GGCGACGATCGCTAGG,sample,22458,21952,3223,18729,2516,16213,8885,514,3956,462,12841,2396,2583,1139,1950,1549
GTCGCGAATCGCTAGG,sample,15894,15433,2593,12840,2311,10529,5719,471,2228,225,7947,1886,1954,817,1934,1487
CGTCGAGGTCGCTAGG,sample,14899,14477,2162,12315,1887,10428,5952,469,2383,287,8335,1337,1756,771,2192,1338
TTATGACGTCGCTAGG,sample,16897,16495,2530,13965,2028,11937,7353,421,2671,273,10024,1219,1941,892,2088,1445
TCAATCAGTCGCTAGG,sample,25939,24806,7034,17772,1351,16421,3963,207,6611,816,10574,4824,4241,827,586,663
TAACGCCATCGCTAGG,sample,18916,18181,4716,13465,1289,12176,3625,199,4339,452,7964,3561,3179,692,1130,707
ATTCTACCTCGCTAGG,Pos_Ctrl,8995,8562,1684,6878,355,6523,5415,445,461,53,5876,149,2542,1844,441,229
GACTAACCTCGCTAGG,sample,14298,13829,2520,11309,1584,9725,4898,384,2539,254,7437,1650,2208,921,1231,1093
CTGGTCTTCCGTTGCG,sample,207919,204797,19249,185548,34204,151344,103425,6577,26266,2960,129691,12116,6013,2340,26338,24669
CATAATGGCCGTTGCG,sample,382771,373093,68554,304539,33631,270908,111822,8587,85770,9383,197592,55346,13166,3130,24206,21293
TACGCGAGCCGTTGCG,sample,292805,284295,51890,232405,31146,201259,84416,6137,57950,6733,142366,46023,12183,2486,24514,20347
CCGCAGTCCCGTTGCG,sample,220762,217054,23565,193489,34465,159024,101410,8827,28425,3932,129835,16430,6785,2111,20815,25698
GATGCGTTCCGTTGCG,sample,294636,289922,34794,255128,26022,229106,114517,7188,66540,5871,181057,34990,9114,2449,20911,17343
TGCGCGTTCCGTTGCG,sample,110664,108401,14596,93805,15427,78378,41092,2829,19825,2555,60917,12077,6168,2433,8526,10871
CCATTCTTCCGTTGCG,sample,80389,77944,16012,61932,10519,51413,16869,690,17876,1801,34745,14177,6927,1269,5834,6287
AGCGTCTTCCGTTGCG,sample,115917,113326,22219,91107,12745,78362,30664,1849,25655,2638,56319,17556,8404,1985,8745,8016
CTAACCGGCCGTTGCG,sample,124592,122852,11624,111228,20920,90308,62977,5032,13185,1435,76162,7679,5071,2533,11420,14792
GCCTATTCCCGTTGCG,sample,102264,100524,10536,89988,16894,73094,48136,3284,13629,1575,61765,6470,4981,2602,10293,12031
GCGTTACCCCGTTGCG,sample,73141,71732,8242,63490,12387,51103,35440,2399,7628,1205,43068,4431,3235,1463,10743,9162
CGTCGAGGCCGTTGCG,sample,99238,97847,12905,84942,13980,70962,39034,2328,16449,1794,55483,11357,6099,1588,13892,8848
TTATGACGCCGTTGCG,sample,22508,22099,3220,18879,3675,15204,9000,643,3085,434,12085,2042,2217,966,3014,2580
TCTCCTAGCCGTTGCG,sample,99038,97475,11426,86049,12926,73123,44439,2381,15609,1824,60048,8870,5338,2080,9808,9418
AAGTAGAGCCGTTGCG,sample,50718,50239,3991,46248,8821,37427,25750,1954,6169,925,31919,2629,2986,1743,5624,6355
TTAACTGACCGTTGCG,sample,148697,146549,16780,129769,20815,108954,69071,5636,19801,3236,88872,11210,5830,1764,12088,16146
CTGGTCTTAGGCCAAG,sample,132729,131539,7589,123950,27771,96179,80126,6586,6947,1025,87073,1495,1238,1166,20884,19533
CATAATGGAGGCCAAG,sample,113425,110661,14593,96068,19967,76101,42606,3099,16135,1534,58741,12727,6743,2117,10913,13089
CTAGCGACAGGCCAAG,sample,186893,184714,14408,170306,29825,140481,110344,8452,14967,1789,125311,4929,4040,2652,19912,22266
TCGAACGAAGGCCAAG,sample,220398,216262,27943,188319,26029,162290,71411,5107,52271,6188,123682,27313,9108,2274,17830,18030
CGTCGCCAAGGCCAAG,sample,245432,239371,34150,205221,29711,175510,85216,5715,47696,4886,132912,31997,10102,2309,21153,20815
ATACGTTCAGGCCAAG,sample,179653,172434,47748,124686,13200,111486,23571,1333,45295,4833,68866,36454,13131,2392,4352,7057
GGCAGGTTAGGCCAAG,sample,234350,229822,28729,201093,22199,178894,86580,4913,59577,7494,146157,20330,7897,2466,13506,15152
CCATTCTTAGGCCAAG,sample,137584,135103,16250,118853,22052,96801,55696,2860,22771,2440,78467,13034,5551,1538,18404,15555
AGCGTCTTAGGCCAAG,sample,232441,229914,14039,215875,34649,181226,157738,10138,9176,945,166914,3229,3314,3159,18509,27075
CGGTTGGTAGGCCAAG,sample,59111,57578,9954,47624,7481,40143,18541,1032,11370,1335,29911,7865,5268,1227,6062,5166
CTAAGCATAGGCCAAG,sample,36942,36079,5356,30723,3945,26778,12576,799,8134,1009,20710,4260,3626,1460,3134,2576
GGCGACGAAGGCCAAG,sample,13767,13147,3470,9677,984,8693,3291,267,2902,307,6193,1926,2530,895,714,565
TAACGAAGAGGCCAAG,sample,119614,116653,20903,95750,15569,80181,40051,2393,20062,2188,60113,15487,6461,1581,15233,9292
AGCAGAGCAGGCCAAG,sample,48521,47252,7656,39596,6352,33244,16886,1109,8308,1018,25194,5923,4600,1446,4978,4132
TGCGCTCCAGGCCAAG,sample,49311,48036,7888,40148,5863,34285,16001,976,10114,1156,26115,6038,4676,1524,4058,3812
ATACCGCCAGGCCAAG,sample,34302,33261,6047,27214,4366,22848,10889,660,6333,665,17222,4301,3554,1033,3884,2913
GTCGCGAAAGGCCAAG,sample,17821,17236,3418,13818,2340,11478,5896,307,2918,301,8814,2056,2336,873,2057,1399
CAGCTTCGAGGCCAAG,sample,29042,27579,6371,21208,2770,18438,7623,504,5529,588,13152,4194,4128,1329,1704,1666
GACTAACCAGGCCAAG,Neg_Ctrl,2271,1542,1165,377,54,323,182,10,81,8,263,42,175,89,56,12
CGCGAGACAGGCCAAG,sample,91192,89687,8542,81145,11902,69243,44162,3351,14409,1583,58571,5738,3306,1246,9354,8385
GCGCAATAAGGCCAAG,sample,121804,119921,12407,107514,15206,92308,61634,4872,14475,1253,76109,10074,4956,1622,15853,11815
GTCGTTCTAGAACCGC,sample,260303,255554,28518,227036,39455,187581,101227,8246,43073,4430,144300,30605,8396,2456,27939,28962
AGAGTTCTAGAACCGC,sample,459507,447967,59581,388386,36033,352353,203051,12118,72199,6628,275250,58357,12866,4329,29419,23501
GGAGAAGCAGAACCGC,sample,68836,67710,7241,60469,9936,50533,33171,3146,9249,1128,42420,3839,3501,1529,9284,7509
GAGCCTCCAGAACCGC,sample,229282,226032,21570,204462,29080,175382,100824,6980,44367,5162,145191,18049,6104,2292,18174,20659
CTAGCGACAGAACCGC,sample,229157,226750,14832,211918,51632,160286,127115,9201,18434,1235,145549,4301,1975,1569,33573,36400
TCGAACGAAGAACCGC,sample,204615,202751,10873,191878,48822,143056,123449,7981,8348,1243,131797,2035,1422,1311,43901,34977
CGTCGCCAAGAACCGC,sample,164284,160936,16775,144161,27084,117077,75895,6631,20016,2999,95911,11536,3043,1493,19385,19200
TGATTCCGAGAACCGC,sample,157363,153852,18591,135261,16690,118571,76066,5277,21890,3074,97956,12264,6985,3417,10340,12829
GCAACTAGAGAACCGC,sample,63743,62811,6204,56607,11223,45384,25850,1891,10486,1030,36336,6127,4410,1576,6320,7846
CCGCAGTCAGAACCGC,sample,96802,93518,17579,75939,10675,65264,29360,2196,18343,1933,47703,13432,7066,1713,7270,6630
GGCAGGTTAGAACCGC,sample,289223,285089,26001,259088,45248,213840,155357,12897,27838,2950,183195,14798,6240,2535,29409,32717
ATGGCGTTAGAACCGC,sample,358980,350065,63298,286767,33330,253437,86995,4955,86628,9127,173623,65732,14354,3238,22674,22353
CATTCGGTAGAACCGC,sample,112085,110466,8677,101789,22967,78822,63060,3150,8550,1012,71610,3050,2843,1720,18371,16576
TAGCGAGTAGAACCGC,sample,78191,76036,15080,60956,8948,52008,23426,1543,14400,1515,37826,11124,5681,1418,7889,5928
GCTCTTCTAGAACCGC,sample,159108,156205,17286,138919,20372,118547,79682,4918,20059,2227,99741,11661,6296,2479,15635,15885
AAGGTCTGAGAACCGC,sample,157403,152557,26554,126003,17273,108730,43525,3102,33665,3800,77190,24638,9790,2103,12104,11144
AGCAGAGCAGAACCGC,sample,62664,61121,7854,53267,7745,45522,27784,2230,9423,1227,37207,4858,3863,1799,6018,5476
ATACCGCCAGAACCGC,sample,144861,140088,26326,113762,15075,98687,42338,2829,28898,2968,71236,21654,7960,1737,15158,10253
GCGTTACCAGAACCGC,sample,82482,79891,12461,67430,8084,59346,35867,2863,11456,1258,47323,7902,5426,2272,5402,5080
CAGCTTCGAGAACCGC,sample,68260,66999,8655,58344,6609,51735,26643,1907,14772,1899,41415,6514,4467,1880,6209,4769
CGCGGTCGAGAACCGC,sample,16077,15451,3191,12260,2006,10254,5011,314,2697,254,7708,1978,2265,799,1549,1241
TTATGACGAGAACCGC,sample,138203,134602,23951,110651,14777,95874,40667,3166,28919,3073,69586,20049,8475,1819,12109,9098
ATGAATAGAGAACCGC,sample,127378,124244,18578,105666,14762,90904,50842,3462,19518,2300,70360,14782,7514,2547,10734,9817
CGTAGAACAGAACCGC,sample,263200,256755,43781,212974,30910,182064,86024,7133,48043,4867,134067,35997,10172,2674,15376,18115
GCGCAATAAGAACCGC,sample,128074,125406,17330,108076,12673,95403,45884,3389,24981,2808,70865,18341,7577,1546,12446,8443
ATATGCAAAGAACCGC,sample,206251,202592,29312,173280,22138,151142,65685,4338,43285,5207,108970,32627,8586,2188,15433,14554
GACGTATGCATCAAGC,sample,190617,187132,19614,167518,40233,127285,86231,6660,18967,2444,105198,12983,6099,1910,27386,28435
TATACGGACATCAAGC,sample,197006,194022,19654,174368,30630,143738,92044,6230,27570,4079,119614,13815,6734,2378,21535,21876
TCATCGAACATCAAGC,sample,58935,55595,22871,32724,1981,30743,3286,152,14220,1562,17506,11523,7282,795,322,737
GACTCAAGCATCAAGC,sample,121566,119413,13494,105919,20260,85659,53421,3919,16008,1671,69429,10640,5747,1762,14260,14193
ATACGTTCCATCAAGC,sample,216396,213327,20019,193308,18424,174884,104473,7613,41489,5957,145962,15352,5484,2197,15722,13343
GGCAGGTTCATCAAGC,sample,119588,117162,15226,101936,16582,85354,50407,4187,18137,1571,68544,11052,5408,1753,11779,11556
CCATTCTTCATCAAGC,sample,124661,123400,7580,115820,25745,90075,75901,5158,6650,1130,82551,1236,1347,1274,21466,18924
CGGTTGGTCATCAAGC,sample,92816,91629,6189,85440,16730,68710,57566,3262,6282,576,63848,1024,1179,1088,17659,13206
TAGCGAGTCATCAAGC,sample,146292,143857,16655,127202,22328,104874,65672,4769,18193,1843,83865,14397,4714,1419,20773,15972
AAGGTCTGCATCAAGC,sample,99499,97663,11378,86285,11720,74565,46913,2669,16388,1563,63301,7032,4516,2143,9089,8217
GGCGACGACATCAAGC,sample,213969,210384,22966,187418,19859,167559,98768,6385,38325,4016,137093,20065,7188,2281,9599,14158
GCCTATTCCATCAAGC,sample,61974,60731,7564,53167,9777,43390,25526,1936,8542,1054,34068,6332,3351,1190,8944,6851
AGCAGAGCCATCAAGC,sample,31537,30406,8465,21941,1969,19972,6220,447,7144,800,13364,5361,4512,1179,921,962
CGTCGAGGCATCAAGC,Pos_Ctrl,48685,46237,7989,38248,2062,36186,30337,2568,2314,293,32651,674,5689,6075,1548,1092
CGCGGTCGCATCAAGC,sample,74966,73853,5864,67989,9999,57990,43017,3250,7441,880,50458,3402,2399,1476,9069,7892
ATTCTACCCATCAAGC,sample,66032,63805,13633,50172,6005,44167,18036,1073,12924,1239,30960,10895,5736,1110,3419,3484
CGCGAGACCATCAAGC,sample,101876,100529,7951,92578,12049,80529,63084,4975,7050,1309,70134,4111,3386,2164,10016,9252
ATATGCAACATCAAGC,sample,37667,36610,7984,28626,3180,25446,9481,596,7706,866,17187,6797,4274,929,1958,1669
AGCTGAATAGAGAGCC,sample,127614,124964,14518,110446,17807,92639,58885,4286,18295,2057,77180,9116,5132,2321,8598,13191
GGAGAAGCAGAGAGCC,sample,55717,53998,9131,44867,6179,38688,17506,1298,11007,1205,28513,7672,5192,1156,5701,4042
CTAGCGACAGAGAGCC,sample,270057,259972,62286,197686,14135,183551,55494,4618,73867,9408,129361,40164,13795,2697,7897,7378
TCATCGAAAGAGAGCC,sample,137798,135111,16353,118758,17920,100838,61898,4095,18938,2952,80836,12955,5828,1903,12102,12856
GCAACTAGAGAGAGCC,sample,28682,28342,2438,25904,6440,19464,14931,1224,2083,240,17014,986,2519,2160,2491,4681
CCGCAGTCAGAGAGCC,sample,150478,146095,25667,120428,13244,107184,42231,2811,33927,4104,76158,24111,9922,2102,9450,8906
CCGTACGCAGAGAGCC,sample,137169,135468,10307,125161,23821,101340,82300,5551,9050,954,91350,3485,2371,1615,18401,17400
AGCGTCTTAGAGAGCC,sample,90931,89768,6714,83054,16598,66456,51353,3165,7465,1337,58818,3136,1598,1083,17414,12453
ACGCTTAAAGAGAGCC,sample,47657,46441,8258,38183,4492,33691,17543,1092,8519,819,26062,5718,4482,1592,1834,3015
CTAAGCATAGAGAGCC,sample,143581,139402,27901,111501,8185,103316,30214,1992,39549,4495,69763,27066,9265,1982,4530,4194
CTAACCGGAGAGAGCC,sample,18105,17879,1830,16049,2399,13650,7871,520,3351,357,11222,1551,2197,1059,2103,1723
TAACGAAGAGAGAGCC,sample,50561,49870,4643,45227,4986,40241,23283,1465,9815,1654,33098,4024,3111,1576,4859,3742
GCCTATTCAGAGAGCC,sample,48292,47644,4012,43632,8573,35059,23991,1735,5935,586,29926,2812,2213,1078,7420,6559
AGCAGAGCAGAGAGCC,sample,71630,70901,4178,66723,13784,52939,43750,3819,4086,244,47836,1040,981,933,14123,10508
TGCGCTCCAGAGAGCC,sample,56046,55394,4209,51185,11324,39861,29509,2530,4539,466,34048,2817,3404,2254,4544,8259
GGCGTACCAGAGAGCC,sample,50573,49496,5850,43646,6552,37094,24983,1850,6031,707,31014,3523,3280,1125,6779,4829
CGCGGTCGAGAGAGCC,sample,24341,23562,4499,19063,1980,17083,8094,607,4527,514,12621,3341,3132,1217,1340,1219
TCTCCTAGAGAGAGCC,sample,47779,45518,10058,35460,3375,32085,11272,858,10710,1242,21982,8003,5280,1189,2237,1896
AGATACTAAGAGAGCC,sample,208634,199243,50162,149081,11368,137713,31758,2320,53897,5701,85655,44037,14194,2301,6285,5480
CATAATGGAGCATTGA,sample,208556,205434,18456,186978,38578,148400,107166,6832,20981,2016,128147,11405,5915,2508,26762,28181
TATACGGAAGCATTGA,sample,307800,301647,36643,265004,38186,226818,110056,9584,59031,7864,169087,40283,10667,2565,27784,26651
GGAGAAGCAGCATTGA,sample,43341,41873,7877,33996,4791,29205,13855,852,7744,902,21599,5852,3984,1049,4270,2943
CGTCGCCAAGCATTGA,sample,257863,253358,25392,227966,46105,181861,103808,6666,41226,4117,145034,26044,9705,2961,22304,29716
ATTCAAGGAGCATTGA,sample,146637,144457,13180,131277,34012,97265,65236,5588,16733,2249,81969,7459,5077,2457,15304,22584
GCAACTAGAGCATTGA,sample,79836,78840,7669,71171,16130,55041,31924,2456,12669,1595,44593,6397,5345,2146,7405,10898
GACTCAAGAGCATTGA,sample,212655,209873,15205,194668,36967,157701,114084,8366,20310,2781,134394,12160,4003,1696,35199,27818
ATACGTTCAGCATTGA,sample,97155,94290,18961,75329,9097,66232,22105,1718,23486,2656,45591,16267,7916,1663,5595,5530
CCGTACGCAGCATTGA,sample,203188,200968,11558,189410,40387,149023,129405,7929,8430,1567,137835,1692,1572,1654,30235,29983
TCTCAGGAAGCATTGA,sample,197947,194990,16742,178248,27270,150978,84546,6732,36058,3645,120604,19997,6508,2011,27661,20940
CCATTCTTAGCATTGA,sample,276725,270640,36571,234069,31624,202445,88003,6433,59241,5912,147244,42856,11011,2428,18862,21621
CCTAGCGGAGCATTGA,sample,130202,128501,11786,116715,20694,96021,60809,4122,18749,1702,79558,10639,5045,1540,13685,14575
TAACGAAGAGCATTGA,sample,250729,248067,20032,228035,37601,190434,131293,11354,26787,3358,158080,17642,5053,1978,35091,28146
ATACCGCCAGCATTGA,sample,143021,141107,13806,127301,12509,114792,56071,4728,36171,3425,92242,14397,6300,2079,9958,9217
CAGCTTCGAGCATTGA,Neg_Ctrl,2697,1778,1122,656,114,542,325,15,126,10,451,66,289,157,81,66
TTATGACGAGCATTGA,sample,109397,108246,9313,98933,14057,84876,54536,4063,15688,1645,70224,8944,5375,1572,16384,9506
CGCGAGACAGCATTGA,sample,136865,135496,11808,123688,17474,106214,60022,4419,23994,2452,84016,15327,7008,1835,10910,11800
GCGCAATAAGCATTGA,sample,98002,97155,7552,89603,12937,76666,49353,4344,12907,1391,62260,8671,5378,2012,10064,8709
TCTAGGTTAATTACCA,sample,156662,152522,27703,124819,20458,104361,51404,3139,25059,2474,76463,22285,7804,1962,12262,12356
AGCTGAATAATTACCA,sample,53711,52648,5258,47390,10944,36446,31031,1975,2534,448,33565,458,1009,1037,11766,8200
TCATACCAAATTACCA,sample,141438,139815,9351,130464,21756,108708,89966,5953,8255,1089,98221,3445,3857,3013,9415,15969
ATTCAAGGAATTACCA,sample,134695,133038,11479,121559,23244,98315,64057,3846,17181,1866,81238,11365,5678,1739,21113,17382
CCGTACGCAATTACCA,sample,146324,144509,13208,131301,17467,113834,74011,6611,19725,2424,93736,11063,6251,2914,11621,12669
CCATTCTTAATTACCA,sample,96598,95476,8131,87345,15062,72283,53088,4712,7974,1063,61062,5446,3832,2071,8873,10502
ACGCTTAAAATTACCA,sample,93282,92158,8920,83238,11664,71574,46380,3062,12782,1634,59162,7716,4463,1748,9456,8495
CATTCGGTAATTACCA,sample,53973,52951,7891,45060,5881,39179,19373,1261,10025,1254,29398,7266,4341,1203,5426,3839
TAGCGAGTAATTACCA,sample,25856,25127,5106,20021,3200,16821,7422,449,4947,521,12369,3482,3145,817,2777,1978
GAGATTCTAATTACCA,sample,20408,19819,4069,15750,1915,13835,7305,420,3247,320,10552,2543,2671,1046,1860,1281
CTAAGCATAATTACCA,sample,20756,20333,2113,18220,4278,13942,11045,713,1442,140,12487,602,1805,1436,3046,3086
CCTAGCGGAATTACCA,sample,10203,9906,2307,7599,1160,6439,2750,142,1781,193,4531,1573,1697,538,1020,661
TGCGCTCCAATTACCA,sample,281999,277872,37848,240024,31204,208820,113006,7261,47440,5529,160446,35584,7598,2191,28237,18376
GGCGTACCAATTACCA,sample,196202,192331,25235,167096,18224,148872,77850,7588,33611,3387,111461,26436,6158,1613,21561,11507
CGTCGAGGAATTACCA,sample,184296,181775,17061,164714,18343,146371,98466,8140,23809,2097,122275,13859,6571,1940,19801,13392
TAACGCCAAATTACCA,sample,32498,31727,5479,26248,4226,22022,12997,988,4358,567,17355,3112,2985,1175,3574,2710
CGCGAGACAATTACCA,sample,21371,20732,3592,17140,3085,14055,7986,453,2885,327,10871,2404,2534,1043,1937,2015
CGTAGAACAATTACCA,sample,21924,21084,4833,16251,2064,14187,6148,311,4210,412,10358,3106,2989,803,2447,1170
CCTAACTAAATTACCA,sample,140742,138568,13982,124586,21416,103170,75114,5813,13514,1290,88628,7439,4183,1581,14324,14402
CTGGTCTTTAGATGAC,Pos_Ctrl,212495,202955,30517,172438,8287,164151,138319,11807,9616,1291,147935,3118,8414,12104,11007,3775
AGAGTTCTTAGATGAC,sample,572789,567793,34235,533558,44494,489064,310089,18079,112232,11680,422321,36984,7063,2576,49482,29735
CATACTCCTAGATGAC,Pos_Ctrl,119134,112101,18923,93178,4474,88704,74811,6198,5267,852,80078,1576,7307,9481,4660,2084
CTAGCGACTAGATGAC,sample,254520,249194,36696,212498,23820,188678,88062,5048,54523,6341,142585,34704,9841,2202,23606,15641
ATTCAAGGTAGATGAC,sample,267666,264721,21086,243635,47171,196464,128659,8547,38573,3115,167232,17570,7350,1865,34539,32613
TGATTCCGTAGATGAC,Pos_Ctrl,135466,129263,21402,107861,5367,102494,85850,7447,6465,785,92315,1947,7591,10013,5266,2685
GCAACTAGTAGATGAC,sample,38369,37957,3485,34472,5164,29308,16703,1562,6351,742,23054,3950,4701,2353,2308,3499
GACTCAAGTAGATGAC,sample,149523,144349,32358,111991,12689,99302,29737,1869,35107,3523,64844,29066,10758,2061,9681,7258
ATACGTTCTAGATGAC,sample,107715,106341,9347,96994,22130,74864,53875,3799,11621,1251,65496,4318,4732,2985,11326,15646
CCGCAGTCTAGATGAC,sample,145002,141008,25790,115218,17338,97880,38976,2842,28610,2703,67586,24749,8964,1779,12666,11128
TCTCAGGATAGATGAC,sample,148519,146779,11903,134876,18276,116600,79120,4543,22152,3048,101272,7737,4074,2594,16666,13175
TGGATCAATAGATGAC,sample,124272,122082,12687,109395,16981,92414,63968,4310,15335,1492,79303,7309,5319,3173,8133,12965
GATGCGTTTAGATGAC,sample,66762,65191,10782,54409,5877,48532,23616,1773,14223,1516,37839,7404,5368,2129,5825,3406
ATGGCGTTTAGATGAC,sample,80061,76919,27764,49155,4543,44612,6701,376,19578,2183,26279,15774,8428,1262,1307,2034
TGCGCGTTTAGATGAC,sample,94732,93037,11328,81709,17592,64117,37782,2676,14059,1609,51841,7991,5154,2108,10707,11759
ACGCTTAATAGATGAC,sample,119193,115691,26506,89185,9878,79307,29949,1857,25393,2544,55342,19564,9046,1831,9143,5876
TAGCGAGTTAGATGAC,sample,57900,56256,11762,44494,5912,38582,15713,1071,12590,1273,28303,7935,5328,1589,4617,3564
GCTCTTCTTAGATGAC,sample,78266,77180,6394,70786,14094,56692,44856,3017,5449,661,50305,2709,3374,2616,8851,10652
GAGATTCTTAGATGAC,sample,110205,108165,11526,96639,14746,81893,56851,4126,11445,1065,68296,8406,5750,3418,8860,10998
GCTGCTTCTAGATGAC,sample,50515,49252,6687,42565,8575,33990,21278,1705,6527,716,27805,3764,3790,1736,5630,5451
GCCTATTCTAGATGAC,sample,201779,198062,21238,176824,30455,146369,83225,4586,31697,2953,114922,23908,6264,1744,34121,21647
ATACCGCCTAGATGAC,sample,16050,15304,4054,11250,924,10326,3474,180,3824,407,7298,2441,2894,875,787,484
TCTCCTAGTAGATGAC,sample,11148,10771,1836,8935,1713,7222,4396,331,1428,127,5824,940,1691,850,1299,1177
TAACGCCATAGATGAC,sample,27620,26671,5384,21287,2826,18461,8448,427,5088,498,13536,4000,3209,903,3113,1750
ATTCTACCTAGATGAC,sample,44351,43398,5186,38212,3750,34462,19113,1048,9502,1030,28615,3769,3619,1934,3602,2446
AGCTGAATGTTCAGAA,sample,235581,233111,13440,219671,52454,167217,137596,13702,10199,1589,147795,4131,2264,1971,22199,38961
GACGTATGGTTCAGAA,sample,246403,242180,22061,220119,29643,190476,123844,9004,36552,3894,160396,17182,8352,3098,20391,21809
GGAGAAGCGTTCAGAA,sample,257571,250479,41548,208931,18048,190883,73074,5245,59904,6532,132978,46128,12925,2801,15206,10097
TCTCAGGAGTTCAGAA,sample,94102,92956,6929,86027,20331,65696,49555,3175,7825,822,57380,4319,2245,1299,16503,14118
GGCAGGTTGTTCAGAA,sample,191079,187190,25022,162168,21827,140341,67111,4938,39143,4110,106254,25039,8871,2363,19667,15100
ATGGCGTTGTTCAGAA,sample,148473,146747,12632,134115,26630,107485,73803,5357,14949,1691,88752,11685,3609,1546,27726,19057
TGCGCGTTGTTCAGAA,sample,144465,143096,7191,135905,26181,109724,90871,6643,8530,1046,99401,2634,2695,2696,23416,19190
CCATTCTTGTTCAGAA,sample,153762,151496,16592,134904,24069,110835,60894,4237,24925,2857,85819,17922,6756,1798,23198,16846
AGCGTCTTGTTCAGAA,sample,53717,52780,5747,47033,8171,38862,23311,1518,8201,997,31512,4835,4416,2127,6867,5794
CGGTTGGTGTTCAGAA,sample,69339,68724,4547,64177,7580,56597,37114,1726,12852,1260,49966,3645,3133,1675,8827,5903
TAGCGAGTGTTCAGAA,sample,138896,137668,7932,129736,24643,105093,81826,6060,11040,1119,92866,5048,3921,2511,15049,18223
CCTAGCGGGTTCAGAA,sample,16522,16391,705,15686,3221,12465,10374,970,740,109,11114,272,1554,1685,1762,2340
AGCAGAGCGTTCAGAA,sample,124917,121663,18945,102718,10815,91903,33745,1660,30316,3186,64061,22996,8823,1794,10303,6828
GGCGTACCGTTCAGAA,sample,38022,37157,4603,32554,5477,27077,15971,920,5623,590,21594,3973,2839,1111,5948,3771
TCTCCTAGGTTCAGAA,sample,49245,48164,5471,42693,4663,38030,23573,1473,8078,1425,31651,3481,3532,1766,3992,3392
TAACGCCAGTTCAGAA,sample,42983,42092,5350,36742,5650,31092,20296,1349,5495,543,25791,3409,2608,1280,5280,4073
CCTAACTAGTTCAGAA,Pos_Ctrl,111415,104964,14911,90053,3752,86301,72062,6455,5466,687,77528,1631,6906,9196,3649,1795
ATATGCAAGTTCAGAA,sample,82855,81187,14108,67079,7430,59649,19243,1561,20596,2308,39839,15941,8845,2202,3536,4247
TCTAGGTTTTCTGGTT,sample,117218,114272,18472,95800,9968,85832,39994,2010,25911,2903,65905,15014,7011,2148,8119,6222
GTCGTTCTTTCTGGTT,Neg_Ctrl,1985,1482,686,796,123,673,381,22,151,11,532,108,345,185,93,73
AGAGTTCTTTCTGGTT,sample,277552,272897,36907,235990,25228,210762,95332,7206,60714,6302,156046,41208,11327,2506,27863,16207
CATACTCCTTCTGGTT,sample,151574,149094,12588,136506,21704,114802,76433,6045,19810,2751,96243,9763,4993,1808,17760,16014
CTAGCGACTTCTGGTT,Neg_Ctrl,1990,1601,609,992,130,862,456,32,214,20,670,140,453,217,108,84
TCGAACGATTCTGGTT,sample,233549,231315,14794,216521,30304,186217,135292,10237,29480,2738,164772,8470,4065,2350,23632,23761
GGTAGAGATTCTGGTT,sample,123357,119168,21189,97979,10803,87176,33607,2190,26674,2936,60281,21769,8868,1778,7533,6756
CGTCGCCATTCTGGTT,sample,48590,47416,5368,42048,8061,33987,23836,1745,5280,497,29116,2629,2927,1563,7291,5852
TCATCGAATTCTGGTT,sample,231769,229548,11456,218092,37728,180364,156055,10563,8608,2377,164663,2761,1774,1720,36216,28731
TCATACCATTCTGGTT,sample,258238,254324,25668,228656,22023,206633,116373,5570,55883,6729,172256,22078,7696,2244,16290,16200
ATTCAAGGTTCTGGTT,sample,479470,467596,90028,377568,29923,347645,104468,6089,124913,12820,229381,99355,19428,4743,23055,14670
TGATTCCGTTCTGGTT,sample,192666,188418,31422,156996,18292,138704,54777,3473,41432,4255,96209,34767,10256,1875,16855,11165
GCAACTAGTTCTGGTT,Neg_Ctrl,2200,1067,558,509,72,437,236,14,109,22,345,56,219,124,50,24
GACTCAAGTTCTGGTT,sample,232685,228973,24809,204164,25015,179149,88904,6905,44592,5812,133496,32936,9114,2247,24018,16750
ATACGTTCTTCTGGTT,sample,222268,218419,31703,186716,31433,155283,77815,4287,39670,4275,117485,29236,9498,2422,15314,19969
CCGCAGTCTTCTGGTT,sample,184642,182776,12458,170318,22190,148128,93455,6912,31178,3629,124633,12954,4308,1782,16968,16545
GATGCGTTTTCTGGTT,sample,253833,250691,24501,226190,25873,200317,117197,7747,48111,5078,165308,22184,8959,2200,27677,19811
TGCGCGTTTTCTGGTT,sample,24372,23671,4055,19616,3379,16237,8726,383,4307,441,13033,2380,2692,1045,3170,2297
CGGTTGGTTTCTGGTT,sample,58951,57663,6116,51547,9161,42386,26845,1916,8083,748,34928,4794,2898,1161,9602,6451
TAACGAAGTTCTGGTT,sample,181684,176769,39587,137182,13438,123744,34678,2198,45585,4352,80263,36931,12925,2324,9550,7684
ATACCGCCTTCTGGTT,sample,114450,113180,8012,105168,14521,90647,62223,4302,16166,1350,78389,6606,3587,1652,16013,11067
ATGAATAGTTCTGGTT,sample,64106,62343,12318,50025,4217,45808,17766,1007,16642,2362,34408,8031,6024,1670,3075,2482
AGATACTATTCTGGTT,sample,2357,2313,256,2057,365,1692,1066,73,353,34,1419,166,663,388,249,249
CTGGTCTTGTTCGGTT,sample,96377,94893,7034,87859,14596,73263,56090,3482,7433,1472,63523,4786,2350,1107,18328,11465
GACGTATGGTTCGGTT,sample,119816,115941,18430,97511,12153,85358,46551,2894,18456,2063,65007,15394,6521,1877,9939,8023
GAGCCTCCGTTCGGTT,sample,111584,110182,7922,102260,22578,79682,63423,5183,7150,719,70573,3207,3307,2624,12910,16271
TCGAACGAGTTCGGTT,sample,223613,219565,25026,194539,17380,177159,93134,6084,48527,5746,141661,23668,7963,2358,14231,12312
TACGCGAGGTTCGGTT,sample,187973,185767,10523,175244,33224,142020,123183,9240,7132,695,130315,1770,1450,1387,28450,26160
ATACGTTCGTTCGGTT,sample,318667,310797,52126,258671,23937,234734,92009,5616,75073,7293,167082,54743,11957,2836,14329,14130
TCTCAGGAGTTCGGTT,sample,14741,14423,1828,12595,4435,8160,5152,313,1676,213,6828,806,1858,927,1695,2532
ACGCTTAAGTTCGGTT,sample,172193,169984,15079,154905,28495,126410,93478,7378,16115,1285,109593,8154,3146,1571,25079,20427
CTAAGCATGTTCGGTT,sample,40940,40698,2059,38639,8965,29674,20717,1851,4811,654,25528,1641,2668,1996,3787,6160
CTAACCGGGTTCGGTT,sample,136963,135269,13567,121702,17039,104663,58348,4244,25056,3290,83404,13725,6593,2032,15318,12350
CGTCGAGGGTTCGGTT,sample,77506,76732,5552,71180,14097,57083,39601,3041,9328,1108,48929,4005,3346,1771,10937,9921
CAGCTTCGGTTCGGTT,sample,73109,72222,5037,67185,14230,52955,39030,3079,6565,1127,45595,3154,3236,1912,9771,9891
ATGAATAGGTTCGGTT,sample,83699,81719,12192,69527,7649,61878,31060,1929,17503,2550,48563,8836,5946,2138,6040,5092
TAACGCCAGTTCGGTT,sample,83895,82717,7115,75602,11063,64539,50374,2885,6999,792,57373,3489,3884,2452,8526,8112
CGTAGAACGTTCGGTT,sample,192357,189568,19715,169853,18999,150854,86135,6555,31535,5250,117670,21379,7294,1727,19202,11977
GCGCAATAGTTCGGTT,Neg_Ctrl,1342,717,428,289,45,244,142,14,59,9,201,20,132,71,34,14
AACCGGTTTGGCGGTT,sample,309984,303904,41809,262095,31741,230354,117422,6663,59586,5766,177008,40917,9324,2251,27765,22021
AGAGTTCTTGGCGGTT,sample,393445,387588,34294,353294,37693,315601,193993,11085,74312,7931,268305,28280,7841,2516,38513,27899
CATAATGGTGGCGGTT,sample,604813,587869,103123,484746,41146,443600,130579,7229,155066,17995,285645,132731,20705,5379,33176,24264
TCATACCATGGCGGTT,sample,385566,381431,20864,360567,72736,287831,238216,18999,18892,2991,257108,8733,3587,2582,44969,53507
GCAACTAGTGGCGGTT,sample,40312,39600,5980,33620,3026,30594,11539,835,11208,1308,22747,5704,5244,2079,1532,1789
TGCGCGTTTGGCGGTT,sample,493156,488259,31823,456436,62096,394340,291949,17375,50166,6093,342115,28757,6798,2732,39147,46295
GCTCTTCTTGGCGGTT,sample,111867,110455,6971,103484,21628,81856,68106,5016,7310,774,75416,650,1550,1448,22896,16428
GAGATTCTTGGCGGTT,sample,310499,305616,20508,285108,54328,230780,190773,12886,21134,1656,211907,4331,1974,1561,56474,41471
CCTAGCGGTGGCGGTT,sample,247719,245205,14640,230565,27827,202738,154994,8849,25342,3404,180336,10149,4280,1680,19185,21105
CTAACCGGTGGCGGTT,sample,240932,237676,18145,219531,31077,188454,133480,13288,26947,2498,160427,12241,5846,1795,26356,23782
TAACGAAGTGGCGGTT,sample,495652,490820,31502,459318,57450,401868,298050,23612,43443,4441,341493,32322,8008,3267,47305,40669
TGCGCTCCTGGCGGTT,sample,183316,178797,25270,153527,21741,131786,66224,4590,32589,3692,98813,24691,8834,1907,21281,14008
GTCGCGAATGGCGGTT,sample,94766,91509,16246,75263,9803,65460,28538,2080,19380,2185,47918,13277,7266,1959,7135,6172
CGTCGAGGTGGCGGTT,sample,99647,95943,20044,75899,8021,67878,21959,1289,23799,2566,45758,18265,8917,1702,6655,5267
CAGCTTCGTGGCGGTT,sample,176125,173274,19514,153760,19725,134035,69053,4467,33552,3621,102605,23342,8989,2159,19609,12840
CCTAACTATGGCGGTT,sample,233373,229203,25741,203462,38108,165354,80428,6216,41755,4923,122183,32032,11703,2428,15905,24025
GCGCAATATGGCGGTT,sample,21694,21448,1025,20423,4287,16136,13260,1435,933,206,14193,302,894,905,2560,2938
AACCGGTTTCCTTATT,sample,36924,36610,1797,34813,6507,28306,24076,1719,1734,124,25810,653,799,756,7620,4862
AGCTGAATTCCTTATT,sample,294906,290967,25117,265850,43073,222777,159797,11820,28260,2199,188057,20701,6725,2395,34340,31456
CTAGCGACTCCTTATT,sample,135595,132866,18081,114785,11823,102962,49749,3043,30767,3434,80516,15969,7241,2291,8007,8298
TCGAACGATCCTTATT,sample,101703,100645,5903,94742,17452,77290,65107,5473,5120,275,70227,1315,1270,1125,20383,13332
TCTCAGGATCCTTATT,sample,116411,114842,9152,105690,13657,92033,66791,4193,12980,1586,79771,6483,4923,2725,7401,9396
ACGCTTAATCCTTATT,sample,96930,95668,9760,85908,7632,78276,41803,2695,21256,2298,63059,10224,4804,1492,7053,5283
GCTCTTCTTCCTTATT,sample,27991,27486,3142,24344,3302,21042,13271,1024,3957,412,17228,2378,2365,1012,4101,2283
AAGGTCTGTCCTTATT,sample,69228,68193,8638,59555,6795,52760,32630,2047,10388,1184,43018,6511,4771,1778,6894,4558
CCTAGCGGTCCTTATT,sample,32669,32043,4634,27409,3678,23731,12707,869,5535,575,18242,4045,3323,963,4076,2396
GCGTTACCTCCTTATT,sample,79775,78369,10036,68333,6627,61706,31429,2448,15433,1608,46862,10788,5653,1502,5247,4356
GTCGCGAATCCTTATT,sample,63909,62943,6856,56087,7486,48601,29273,2123,9780,1220,39053,6205,4317,1268,7078,5117
CGTCGAGGTCCTTATT,Pos_Ctrl,32195,30890,4842,26048,1298,24750,20741,1854,1464,200,22205,491,4849,4901,1040,653
GACTAACCTCCTTATT,sample,135747,133389,20689,112700,10300,102400,43878,2784,30340,2981,74218,22417,8385,1615,10880,6502
CGTAGAACTCCTTATT,sample,49399,48441,6697,41744,4291,37453,18005,1375,9987,1078,27992,7008,4564,1082,4934,2782
AGATACTATCCTTATT,sample,50336,48788,11589,37199,2500,34699,8025,600,13240,1432,21265,11402,5738,1071,1731,964
GCGCAATATCCTTATT,sample,89406,88439,5217,83222,8797,74425,59434,5167,5857,598,65291,3369,3322,2230,6638,6035
CTGGTCTTAATAAGGT,sample,423659,419374,22610,396764,71892,324872,249969,18514,37859,4259,287828,14271,4926,1860,73310,52304
GACGTATGAATAAGGT,sample,189483,183960,33769,150191,14048,136143,53051,3634,46735,4690,99786,28033,9971,2590,7400,8345
TATACGGAAATAAGGT,sample,945882,935537,78989,856548,81392,775156,445176,34196,153817,16606,598993,125361,17102,5988,39472,52090
GGAGAAGCAATAAGGT,sample,302612,298668,27637,271031,45670,225361,144851,8697,40298,4696,185149,26819,9626,2568,35423,30987
CGTCGCCAAATAAGGT,sample,90610,87489,19127,68362,7548,60814,23660,1341,18158,1972,41818,15683,6946,1443,6715,4409
ATTCAAGGAATAAGGT,sample,79015,78389,4036,74353,14307,60046,38058,4733,10677,1189,48735,5389,4249,1385,10947,9475
GGCAGGTTAATAAGGT,sample,380580,373775,44804,328971,45497,283474,173466,13942,52574,4990,226040,38502,8797,2729,33740,31692
GATGCGTTAATAAGGT,sample,343089,338981,24264,314717,38411,276306,223376,19634,18842,2762,242218,11692,6288,3589,18856,29868
ATGGCGTTAATAAGGT,Pos_Ctrl,122959,116940,18657,98283,4803,93480,78176,6520,6098,792,84274,1894,7358,9363,4677,2523
AGCGTCTTAATAAGGT,sample,214280,211185,20136,191049,22437,168612,113773,6669,30766,2774,144539,14630,7007,2139,29889,16338
CATTCGGTAATAAGGT,sample,247166,243809,21495,222314,26871,195443,126262,7594,37542,4168,163804,19877,6516,1785,31650,18957
GCTCTTCTAATAAGGT,sample,471252,462783,53462,409321,34527,374794,217424,13900,80833,7904,298257,54733,11650,3343,24402,22487
GAGATTCTAATAAGGT,sample,388540,381681,48503,333178,36969,296209,129045,10222,90859,10625,219904,55458,13328,3766,22264,24614
CCTAGCGGAATAAGGT,Pos_Ctrl,45992,44554,6523,38031,1947,36084,30392,2682,2100,251,32492,659,5735,6149,2147,869
GGCGACGAAATAAGGT,sample,103962,101727,12883,88844,12465,76379,48150,4045,13936,1669,62086,8579,6088,2380,10569,8890
GGCGTACCAATAAGGT,sample,315355,310512,34346,276166,30889,245277,129721,9128,56091,5995,185812,44342,10813,2427,35125,20946
CGCGGTCGAATAAGGT,sample,195605,193011,16254,176757,14319,162438,107455,7365,29011,4349,136466,14258,5386,2052,15151,10688
TTATGACGAATAAGGT,sample,203646,201429,15129,186300,14715,171585,114699,6186,34835,4421,149534,11444,4444,1784,19058,12251
TCTCCTAGAATAAGGT,sample,349286,342666,52285,290381,23220,267161,92339,6251,84511,9216,176850,74844,16081,3929,17967,12209
GCGCAATAAATAAGGT,sample,176850,174433,14199,160234,21439,138795,95159,8728,20816,2498,115975,11594,5273,1724,23945,15309
GAGCCTCCCAGGACCA,sample,245123,241854,18663,223191,42091,181100,134352,12067,22260,2420,156612,10001,3907,2089,29734,30406
TCGAACGACAGGACCA,sample,113729,112011,9403,102608,22806,79802,61557,4060,9609,1001,71166,3575,3305,2227,14508,15361
ATTCAAGGCAGGACCA,sample,82185,81031,5831,75200,15131,60069,50723,4101,3174,572,53897,1499,2329,2305,13866,11443
TGATTCCGCAGGACCA,sample,352499,346330,30002,316328,34954,281374,168123,11638,71474,7930,239597,22209,5979,2261,33706,25126
ATACGTTCCAGGACCA,sample,1217558,1186160,173248,1012912,57322,955590,416965,29997,339888,48506,756853,120234,18166,5508,40483,32967
ACGCTTAACAGGACCA,sample,322329,314670,41791,272879,27796,245083,122199,6662,63998,7033,186197,45191,11437,2798,23398,18675
GCTCTTCTCAGGACCA,sample,327526,323152,27921,295231,36366,258865,184332,15534,37560,3705,221892,17734,6956,2473,39637,27776
CTAAGCATCAGGACCA,sample,207668,205119,13070,192049,36302,155747,129022,9887,13128,1311,142150,2399,1510,1333,33625,26165
AAGGTCTGCAGGACCA,sample,214141,210340,19920,190420,22086,168334,115536,9024,26315,2718,141851,14741,6845,3142,16940,15099
TAACGAAGCAGGACCA,sample,205522,202068,24207,177861,21337,156524,90775,6157,34707,3227,125482,21658,7170,1723,28198,14713
CAGCTTCGCAGGACCA,Neg_Ctrl,2339,1594,908,686,110,576,317,33,146,14,463,66,308,170,62,51
ATGAATAGCAGGACCA,sample,167424,165697,10219,155478,27267,128211,102452,8519,12868,974,115320,3398,2814,1823,25653,20539
AAGTAGAGCAGGACCA,sample,284768,281195,32101,249094,29302,219792,110961,9168,54351,5034,165312,40278,11512,2540,23796,18616
TCAATCAGCAGGACCA,sample,216156,212981,23708,189273,20981,168292,93769,5197,39142,3856,132911,26328,7712,1958,22873,15836
TAACGCCACAGGACCA,sample,104730,103904,6077,97827,20036,77791,65353,5034,5019,855,70372,1530,1881,1833,15937,14134
CGCGAGACCAGGACCA,sample,228130,225104,16945,208159,25567,182592,142506,11364,18247,2200,160753,8275,4633,2271,18329,18806
AGATACTACAGGACCA,sample,260265,255662,34106,221556,23355,198201,91404,5959,54771,7006,146175,39061,10534,2280,17027,14171
CCTAACTACAGGACCA,sample,248802,245062,24400,220662,25741,194921,125224,8554,35371,3879,160595,21893,7975,2067,21774,17757
TCTAGGTTCCTCGTTG,sample,75297,73976,7304,66672,13239,53433,40108,2912,6721,659,46829,3033,3601,2686,6677,9922
GTCGTTCTCCTCGTTG,sample,123869,121969,11443,110526,15245,95281,61431,3331,19075,2195,80506,9249,3969,1767,15527,11386
AGAGTTCTCCTCGTTG,sample,385664,380567,40987,339580,39914,299666,156552,11529,75918,8699,232470,46968,10958,2725,27494,27479
GACGTATGCCTCGTTG,sample,137594,134834,13869,120965,17192,103773,77187,5458,11925,1256,89112,7947,5303,2799,12340,12722
CATAATGGCCTCGTTG,sample,104926,102961,11608,91353,17783,73570,48653,3042,13180,1392,61833,7303,4820,2247,9556,13095
TATACGGACCTCGTTG,sample,278958,274508,23761,250747,41038,209709,151914,12130,25364,4168,177278,16133,5365,2226,31129,30701
GAGCCTCCCCTCGTTG,sample,327301,320666,45954,274712,25963,248749,113452,6693,76075,7928,189527,44601,11532,2919,19423,19278
CATACTCCCCTCGTTG,sample,505986,501695,23957,477738,58110,419628,339685,30247,31777,2085,371462,15834,6474,3000,35504,42256
CTAGCGACCCTCGTTG,sample,788162,769898,128407,641491,33914,607577,187817,13825,270129,27182,457946,108624,19175,4989,19014,18531
GGTAGAGACCTCGTTG,sample,140840,138205,11596,126609,22955,103654,79245,4830,12400,1265,91645,5914,3982,1957,22463,17641
TACGCGAGCCTCGTTG,sample,222551,217848,37419,180429,23261,157168,70894,5124,44609,4946,115503,31595,10476,2810,18117,15025
CCGCAGTCCCTCGTTG,sample,141793,138330,27091,111239,12108,99131,40502,2172,30540,3558,71042,22359,9435,2176,9232,7256
CCATTCTTCCTCGTTG,sample,277591,273820,24617,249203,31822,217381,131393,9549,46393,5737,177786,24309,6034,2319,25446,24129
GCTCTTCTCCTCGTTG,sample,89333,87312,13679,73633,7538,66095,29309,2103,20971,2287,50280,11425,5753,2091,5645,5360
CTAAGCATCCTCGTTG,sample,62248,61003,7183,53820,10722,43098,28485,1535,7651,849,36136,4578,3850,1468,9492,7602
AAGGTCTGCCTCGTTG,sample,87695,85340,16862,68478,7807,60671,25260,1559,18959,1891,44219,13002,6912,1745,7980,5138
CCTAGCGGCCTCGTTG,sample,35450,34571,6091,28480,4466,24014,11828,696,6392,728,18220,4370,3876,1203,3758,3013
CTAACCGGCCTCGTTG,Neg_Ctrl,2015,1345,719,626,83,543,301,29,96,18,397,99,263,140,76,36
CGTCGAGGCCTCGTTG,sample,163986,162151,9727,152424,22242,130182,105017,6211,12464,3154,117481,3336,1378,1112,26029,17040
TTATGACGCCTCGTTG,sample,255897,253541,17960,235581,26367,209214,139956,10198,37135,5332,177091,16593,5575,1853,29439,20230
ATTCTACCCCTCGTTG,Pos_Ctrl,44491,43831,5152,38679,2209,36470,30712,3070,1861,255,32573,572,5555,6228,2265,1250
AGATACTACCTCGTTG,sample,294239,290155,30509,259646,30112,229534,146647,8961,39562,3836,186209,30528,7906,2163,25302,22356
AACCGGTTTTGCGGAC,sample,289282,287126,13229,273897,35975,237922,152103,11986,54801,6216,206904,12816,3622,2067,22427,26456
GTCGTTCTTTGCGGAC,sample,281817,277221,41453,235768,37089,198679,93249,6813,52520,6110,145769,39987,12086,3370,18317,23722
TCGAACGATTGCGGAC,sample,194950,193003,12957,180046,27414,152632,108910,7876,24105,2557,133015,9184,4758,1791,30532,20055
ATTCAAGGTTGCGGAC,sample,273405,270968,15189,255779,43443,212336,176419,11476,18759,2560,195178,3122,1873,1543,51444,33740
GCAACTAGTTGCGGAC,sample,18952,18743,2065,16678,4181,12497,6895,487,2945,300,9840,1870,2426,1040,2009,2671
GGCAGGTTTTGCGGAC,sample,141362,139990,8801,131189,35123,96066,76874,5681,9014,1076,85888,3421,2920,2134,20730,24275
TGCGCGTTTTGCGGAC,sample,250595,247158,21666,225492,30868,194624,135237,9534,32562,4768,167799,12523,5231,2427,25324,23627
GGCGACGATTGCGGAC,sample,197764,194748,18301,176447,25732,150715,106328,7873,21846,2995,128174,11673,4291,1942,35458,19005
GCGTTACCTTGCGGAC,sample,155978,153011,20109,132902,16474,116428,65897,4259,27019,2690,92916,16563,7710,2063,17753,10932
CGTCGAGGTTGCGGAC,sample,49200,48492,4752,43740,5030,38710,24866,1622,7922,991,32788,3309,3396,2084,5046,3495
CGCGGTCGTTGCGGAC,sample,33337,32690,4195,28495,4003,24492,14967,945,5082,590,20049,2908,2873,1141,4707,2664
GCGCAATATTGCGGAC,sample,285078,281309,23791,257518,28218,229300,140168,14305,40677,4586,180845,29564,9419,2846,22436,19238
CTGGTCTTTCCATTGG,sample,153150,151684,9524,142160,29310,112850,94144,6218,8866,1966,103010,1656,1488,1394,27430,21430
GTCGTTCTTCCATTGG,sample,75051,73569,13955,59614,8207,51407,18355,1179,16743,1801,35098,13329,7649,1927,5594,4791
GAGCCTCCTCCATTGG,sample,86578,85006,11723,73283,11319,61964,32557,2242,15743,1488,48300,9934,5730,1572,10143,7813
CTAGCGACTCCATTGG,sample,85753,84012,13233,70779,7767,63012,31277,1737,15839,1825,47116,12334,6082,1293,12010,5047
GGTAGAGATCCATTGG,sample,217677,213880,28772,185108,16233,168875,78970,5511,51535,5278,130505,27581,9414,2047,17541,10622
CGTCGCCATCCATTGG,sample,124655,122353,16231,106122,18390,87732,42890,2970,23810,2215,66700,15847,7444,2037,9342,11835
TCATCGAATCCATTGG,sample,131582,129792,12174,117618,15726,101892,67003,5224,18179,2036,85182,9450,4883,2224,11145,11391
TCATACCATCCATTGG,sample,240958,236578,29098,207480,15414,192066,107202,7276,45496,5854,152698,26238,8542,2630,14518,9526
TCTCAGGATCCATTGG,sample,82501,81159,9550,71609,7874,63735,32966,2164,18120,2110,51086,8375,4854,1728,7990,5748
TGGATCAATCCATTGG,sample,113292,111178,12885,98293,14167,84126,49436,3127,18379,1592,67815,11592,4988,1712,14863,10170
CGGTTGGTTCCATTGG,sample,75539,74269,8706,65563,6497,59066,36550,1958,13504,1234,50054,5820,4162,1973,6216,4630
CATTCGGTTCCATTGG,sample,80763,78715,12795,65920,8206,57714,31299,2172,13613,1540,44912,9090,5374,1787,9269,5500
GCTCTTCTTCCATTGG,sample,64993,63391,10410,52981,4196,48785,24641,1473,13817,1461,38458,7393,5547,2210,2806,2746
GAGATTCTTCCATTGG,sample,71063,69071,13639,55432,4585,50847,19372,1223,17501,2151,36873,10600,6075,1641,4299,2618
CTAAGCATTCCATTGG,sample,37768,36899,4847,32052,4673,27379,17146,934,5235,594,22381,3470,2764,1002,7219,3490
ATACCGCCTCCATTGG,sample,7253,6963,1762,5201,734,4467,2074,165,1132,131,3206,965,1473,656,435,421
GGCGTACCTCCATTGG,sample,30363,29735,3660,26075,3387,22688,14806,777,4003,539,18809,2563,2816,1364,3355,2289
CGTCGAGGTCCATTGG,sample,50453,49214,9382,39832,4382,35450,15075,1084,10400,1065,25475,7826,5135,1201,4171,2761
CGCGGTCGTCCATTGG,sample,43376,42306,8156,34150,3489,30661,12529,981,9021,985,21550,7145,4792,1096,3332,2106
AAGTAGAGTCCATTGG,sample,25175,24274,5771,18503,2274,16229,5759,391,5276,534,11035,4269,3702,958,1622,1131
GACTAACCTCCATTGG,Neg_Ctrl,1086,695,383,312,38,274,165,6,60,4,225,39,162,85,34,19
TTAACTGATCCATTGG,sample,46550,45682,5562,40120,4913,35207,21800,1540,6879,715,28679,4273,2459,929,5716,3284
TCTAGGTTCATAGGCG,sample,248966,245441,24412,221029,40049,180980,122503,8470,27954,3470,150457,18583,7699,2975,29379,27617
CTGGTCTTCATAGGCG,sample,336163,331984,25854,306130,48205,257925,174548,13984,42160,4034,216708,23199,7154,2646,39838,36186
GTCGTTCTCATAGGCG,sample,235434,230004,37267,192737,24114,168623,76687,4325,51689,5575,128376,30347,9710,2479,14205,15226
GACGTATGCATAGGCG,sample,149187,145327,23185,122142,16505,105637,59253,3891,22896,2589,82149,17008,7231,1860,16511,10711
TATACGGACATAGGCG,sample,308145,303074,32040,271034,33688,237346,162513,10474,37452,4547,199965,22360,8157,3123,20970,23592
GAGCCTCCCATAGGCG,sample,157172,154802,14844,139958,23074,116884,82038,5168,18584,1989,100622,9105,5382,2059,21799,16562
TCATACCACATAGGCG,sample,182007,178622,23666,154956,21110,133846,72670,5540,30142,3268,102812,22226,7637,1841,21617,13679
GCAACTAGCATAGGCG,sample,102491,101166,7868,93298,14780,78518,47712,3233,17018,1690,64730,8865,3917,1491,13545,10647
GACTCAAGCATAGGCG,sample,224595,220816,24899,195917,25984,169933,102773,9188,34229,3871,137002,19872,7885,2284,26339,18420
TCTCAGGACATAGGCG,sample,270255,266475,23336,243139,34423,208716,145574,8067,34048,3907,179622,17120,5388,2140,29560,25859
TGGATCAACATAGGCG,sample,52235,51889,2138,49751,10748,39003,31567,3772,2591,201,34158,872,1869,1648,5060,7301
TGCGCGTTCATAGGCG,sample,62585,61375,6822,54553,9034,45519,31097,2478,7120,799,38217,4025,4659,2857,6393,6290
ACGCTTAACATAGGCG,sample,111691,108461,20051,88410,8655,79755,31247,1781,28243,3735,59490,14749,6979,2032,6238,5239
CATTCGGTCATAGGCG,sample,209637,203897,33464,170433,19134,151299,70974,6745,40908,3941,111882,28731,10465,2766,12429,12588
GCTCTTCTCATAGGCG,sample,169069,166737,13949,152788,15029,137759,85319,6653,31283,3691,116602,10813,4801,2376,14533,11227
GGCGACGACATAGGCG,sample,73095,71306,11039,60267,7745,52522,26893,1844,14239,1443,41132,8103,4962,1784,7539,5351
GCTGCTTCCATAGGCG,sample,73652,71525,14040,57485,6924,50561,20910,1174,15385,1745,36295,11347,7098,1803,6436,4221
AGCAGAGCCATAGGCG,sample,88624,87499,6256,81243,16633,64610,53320,3432,5973,614,59293,1271,1238,1178,18387,12185
ATACCGCCCATAGGCG,sample,47413,46367,6814,39553,4995,34558,18244,1298,9346,1137,27590,4533,3760,1431,4738,3189
GGCGTACCCATAGGCG,sample,159282,153963,31584,122379,11640,110739,51636,3324,29504,3378,81140,22897,10224,3285,4716,6921
CAGCTTCGCATAGGCG,sample,52207,50812,8278,42534,6346,36188,19573,1652,8007,966,27580,5990,4367,1292,6020,4277
CGCGGTCGCATAGGCG,sample,44930,43339,10035,33304,4350,28954,11081,834,9488,1264,20569,6287,5266,1505,2588,2394
TTATGACGCATAGGCG,sample,115550,112894,18123,94771,13579,81192,41417,2261,21319,2338,62736,13857,7112,1967,12240,9150
ATGAATAGCATAGGCG,sample,220351,214519,38588,175931,18973,156958,78429,4589,41111,4507,119540,28322,9778,2877,14129,11818
TCAATCAGCATAGGCG,sample,82416,79553,17001,62552,5943,56609,21726,1232,17753,1882,39479,14016,6754,1570,4735,3085
ATTCTACCCATAGGCG,sample,124513,121587,16976,104611,13403,91208,56756,3900,16716,1977,73472,11859,6169,2064,13769,9230
TCTAGGTTTTGGAGAG,sample,152892,150690,23552,127138,9255,117883,28596,1437,45102,4966,73698,37782,11155,2050,5944,4538
CTGGTCTTTTGGAGAG,Pos_Ctrl,49193,45789,8670,37119,1798,35321,29453,2485,2335,308,31788,740,5580,5704,1659,985
CGTCGCCATTGGAGAG,sample,235439,230369,30247,200122,19092,181030,78352,4769,59545,7411,137897,30953,8662,2568,13234,12454
TCATCGAATTGGAGAG,sample,58241,57082,6409,50673,9070,41603,30074,2144,5583,629,35657,3173,3118,1601,7923,6402
TCATACCATTGGAGAG,sample,195110,192273,14369,177904,27008,150896,105214,6220,26834,2875,132048,9753,4205,2491,17506,19420
TGATTCCGTTGGAGAG,Pos_Ctrl,85835,81684,14486,67198,3718,63480,53356,4540,3906,548,57262,1130,6854,8099,3733,2304
GCAACTAGTTGGAGAG,sample,87334,86112,5907,80205,13946,66259,48514,4008,8797,685,57311,4255,3725,1890,8109,10316
TGGATCAATTGGAGAG,sample,254391,249880,33566,216314,33497,182817,102946,5774,40780,5053,143726,28264,7000,1975,27288,23053
ATGGCGTTTTGGAGAG,sample,177992,174767,20255,154512,19556,134956,84548,5682,27584,2987,112132,14155,6848,2655,12543,12604
TGCGCGTTTTGGAGAG,sample,252099,248628,19279,229349,19967,209382,143857,9669,39107,4350,182964,12399,5617,3320,12281,15724
GAGATTCTTTGGAGAG,sample,197378,193763,23453,170310,24869,145441,80704,6784,32926,3329,113630,21698,7302,1949,26178,16434
AAGGTCTGTTGGAGAG,sample,245576,241149,30127,211022,26194,184828,96830,5514,44998,4505,141828,32981,10168,2385,29256,17872
CTAACCGGTTGGAGAG,sample,59174,58150,5346,52804,5984,46820,27728,1701,11654,1595,39382,4142,3336,1638,7367,4447
TAACGAAGTTGGAGAG,sample,188622,185371,24026,161345,19885,141460,67559,3899,39675,4076,107234,26251,9497,1960,25291,13198
GCTGCTTCTTGGAGAG,sample,74656,73705,7970,65735,7043,58692,36511,2626,11446,1095,47957,7014,5408,2667,5856,4313
ATACCGCCTTGGAGAG,sample,105289,103161,13827,89334,14506,74828,44414,2795,15867,1859,60281,9893,5972,1851,14283,10041
CGTCGAGGTTGGAGAG,sample,78671,76883,9777,67106,9828,57278,32724,2677,12977,1819,45701,7081,4688,1583,8640,6976
CAGCTTCGTTGGAGAG,sample,82556,80116,11936,68180,9035,59145,32532,1899,13534,1358,46066,9822,5623,1663,9199,6015
CGCGGTCGTTGGAGAG,sample,42031,39885,14042,25843,1670,24173,3129,177,10648,1023,13777,9196,6050,680,622,613
AAGTAGAGTTGGAGAG,sample,109196,105964,19034,86930,9728,77202,32576,2395,24280,2641,56856,15310,7270,1540,8674,6214
TAACGCCATTGGAGAG,sample,70473,69006,9354,59652,8429,51223,28912,2110,11839,1226,40751,7136,4779,1686,8008,5660
GACTAACCTTGGAGAG,sample,182099,177948,23598,154350,15679,138671,73287,6193,32966,3818,106253,22407,8867,2189,16989,10525
CGCGAGACTTGGAGAG,sample,214256,211147,20841,190306,15663,174643,103677,6805,37339,5711,141016,21111,5312,1862,16678,10216
AGATACTATTGGAGAG,sample,123389,120658,13171,107487,9071,98416,60714,4709,20249,2091,80963,10653,5657,2051,7825,5993
AGAGTTCTTTCAAGCC,sample,160942,158913,9856,149057,29974,119083,100111,7342,8789,899,108900,1942,1689,1617,27400,21744
CATAATGGTTCAAGCC,sample,290021,285821,27718,258103,32948,225155,133058,11130,47916,5023,180974,28028,7745,2416,26938,24361
CTAGCGACTTCAAGCC,sample,194906,192008,15773,176235,28318,147917,113279,10005,15502,1472,128781,7659,4839,2267,22726,20501
TCGAACGATTCAAGCC,sample,120434,118632,10835,107797,13920,93877,60302,3999,19185,2789,79487,7602,4376,2015,12119,9932
TGATTCCGTTCAAGCC,sample,201565,197378,28210,169168,16061,153107,68745,3851,50680,5442,119425,24389,7142,2100,14423,10273
GACTCAAGTTCAAGCC,sample,160759,156324,31233,125091,12956,112135,43681,2354,35663,3626,79344,26811,9704,2043,12301,7658
CCGCAGTCTTCAAGCC,sample,164778,162205,16616,145589,15073,130516,72606,4897,36121,4011,108727,12881,6397,2318,13064,11133
CCGTACGCTTCAAGCC,sample,102546,100576,9186,91390,14561,76829,54777,3425,11882,1352,66659,5393,2709,1350,18391,11209
GGCAGGTTTTCAAGCC,sample,442355,432838,64446,368392,29224,339168,153594,11904,91866,9159,245460,72645,13895,3969,18879,16042
ATGGCGTTTTCAAGCC,sample,222120,217921,32348,185573,22025,163548,78587,5543,42967,5003,121554,31448,8852,2215,20587,14261
TGCGCGTTTTCAAGCC,sample,278433,272819,41419,231400,23396,208004,93486,6749,57106,5872,150592,44791,10168,2382,22649,15101
GCTCTTCTTTCAAGCC,sample,81474,79084,14686,64398,6991,57407,25737,1621,16902,1971,42639,11176,6372,1966,4677,3903
CTAAGCATTTCAAGCC,sample,118925,116173,16353,99820,11340,88480,48217,2750,23472,2241,71689,11800,5744,2063,10974,7343
AAGGTCTGTTCAAGCC,sample,112051,108994,19285,89709,12659,77050,37978,2696,19226,2670,57204,14480,7021,1808,10212,7689
GGCGACGATTCAAGCC,sample,271418,267317,29787,237530,19333,218197,121245,11164,53394,5285,174639,27109,8732,2510,12284,12044
GGCGTACCTTCAAGCC,sample,85457,83855,9032,74823,10485,64338,46099,3416,8631,988,54730,5204,4920,2562,7426,7482
GTCGCGAATTCAAGCC,sample,54533,53868,3605,50263,10596,39667,33174,2185,3117,412,36291,779,1915,1675,10614,7707
CGTCGAGGTTCAAGCC,Pos_Ctrl,37907,35959,6734,29225,1569,27656,23047,1987,1789,277,24836,556,5156,4967,1726,835
CGCGGTCGTTCAAGCC,sample,74084,72465,11439,61026,7521,53505,27993,1730,13296,1326,41289,9160,5429,1544,6600,5147
TCTCCTAGTTCAAGCC,sample,86132,84580,8055,76525,10111,66414,41474,3012,12822,1236,54296,7870,4296,1746,10465,7185
AAGTAGAGTTCAAGCC,sample,162785,161032,13882,147150,13910,133240,83837,7560,25459,2620,109296,13764,6841,2747,12350,9526
TCAATCAGTTCAAGCC,sample,160983,158827,13497,145330,13298,132032,83062,6203,28007,3578,111069,11182,4377,1705,11766,9387
TAACGCCATTCAAGCC,sample,286839,282445,34149,248296,19880,228416,122578,8662,56870,7199,179448,33107,8388,2255,17292,12654
CGCGAGACTTCAAGCC,sample,203571,199764,27917,171847,14047,157800,88214,6131,34903,3518,123117,25034,8771,2182,12080,9610
GTCGTTCTAACTTAAC,Neg_Ctrl,2407,1305,715,590,96,494,293,25,99,8,392,69,268,145,67,31
CATAATGGAACTTAAC,sample,287340,283118,32787,250331,18397,231934,107207,8298,74968,9551,182175,31910,9723,3053,13321,12686
CATACTCCAACTTAAC,sample,155757,154108,9638,144470,36454,108016,88119,6497,10691,978,98810,1731,1502,1311,26487,25351
TCATACCAAACTTAAC,sample,208176,205204,22730,182474,24088,158386,89441,6040,36375,4489,125816,22041,8710,2104,22414,17327
GCAACTAGAACTTAAC,Neg_Ctrl,1840,795,503,292,38,254,162,8,44,5,206,35,146,82,40,9
GACTCAAGAACTTAAC,sample,112814,111477,9649,101828,19217,82611,60731,4650,11933,874,72664,4423,3587,1536,17325,12969
ATACGTTCAACTTAAC,sample,252811,250650,13256,237394,37413,199981,173148,14439,8243,1366,181391,2785,2793,3056,23545,27737
CCGTACGCAACTTAAC,sample,155380,152425,21893,130532,15109,115423,54611,4059,31375,3098,85986,22280,9519,2753,11688,9418
AGCGTCTTAACTTAAC,sample,173521,171283,17298,153985,13333,140652,76790,6401,34102,4925,110892,18434,7204,2166,11139,9859
CGGTTGGTAACTTAAC,sample,135396,132398,21724,110674,12498,98176,41963,2762,28629,2609,70592,22213,8169,1551,12847,7647
GCTCTTCTAACTTAAC,sample,145119,143431,10394,133037,19608,113429,87137,7392,12481,1471,99618,4948,3094,1464,21408,14734
GAGATTCTAACTTAAC,sample,143132,140460,17588,122872,15386,107486,58851,4388,24175,2266,83026,17806,7545,1708,14188,11210
GGCGACGAAACTTAAC,sample,230891,227322,27672,199650,20069,179581,101362,6717,42531,4593,143893,24378,7033,1690,15725,13432
ATACCGCCAACTTAAC,sample,60576,59789,4852,54937,9604,45333,32928,2919,6035,926,38963,2525,3078,2030,7299,6736
TTATGACGAACTTAAC,sample,81475,80438,6053,74385,10543,63842,50702,3146,6367,470,57069,3157,2725,1378,12216,7067
TCTCCTAGAACTTAAC,sample,81175,80032,7096,72936,9042,63894,42348,2800,11090,1172,53438,6484,2803,1222,11742,6063
TAACGCCAAACTTAAC,sample,98084,95298,16335,78963,6910,72053,31530,2493,20006,2505,51536,15519,7369,1894,6408,3898
CCTAACTAAACTTAAC,sample,104555,103062,7784,95278,14462,80816,63692,5417,7805,1331,71497,2571,2243,1394,13019,10691
CATAATGGATACTTGA,sample,183571,181326,14407,166919,34120,132799,98071,7365,17506,1868,115577,7989,4307,1776,27039,24302
GGAGAAGCATACTTGA,sample,173830,169289,28922,140367,17387,122980,58238,3562,32308,3407,90546,25465,9349,2179,16036,11474
TCATCGAAATACTTGA,sample,419369,410383,62445,347938,37297,310641,134299,8348,88239,8878,222538,70877,14977,3365,29936,25441
GCAACTAGATACTTGA,sample,112789,111450,10074,101376,19019,82357,48890,3199,16253,1532,65143,12483,6602,1811,14399,13341
TACGCGAGATACTTGA,sample,272243,267889,27194,240695,17721,222974,125006,6397,61258,7216,186264,23097,6732,2763,11611,12040
GACTCAAGATACTTGA,sample,188213,185818,12024,173794,17872,155922,109922,8850,25854,3064,135776,8232,4403,3112,12833,13237
ATACGTTCATACTTGA,sample,165477,163280,12638,150642,25026,125616,97653,6860,12819,1207,110472,7077,4384,2463,20015,19156
TGGATCAAATACTTGA,sample,325092,320408,32601,287807,37106,250701,169588,11334,39074,4558,208662,26147,8287,2775,28343,26875
CATTCGGTATACTTGA,sample,196176,193337,17765,175572,26123,149449,97970,8014,25505,2034,123475,15926,7405,2524,19958,17321
GAGATTCTATACTTGA,sample,307834,303180,35335,267845,31468,236377,128242,8233,48023,4255,176265,47624,6618,1934,42839,21439
GGCGACGAATACTTGA,sample,164343,161402,20318,141084,15911,125173,74630,3873,28009,2692,102639,15969,7264,2347,17549,10189
TGCGCTCCATACTTGA,sample,158457,156902,8997,147905,27919,119986,98161,8041,8821,1850,106982,3113,2678,2028,20745,20577
GCGTTACCATACTTGA,sample,179328,177446,10613,166833,17924,148909,118201,9404,15602,1327,133803,4375,3467,2505,14960,14801
CAGCTTCGATACTTGA,Neg_Ctrl,2542,1399,776,623,77,546,329,25,93,26,422,73,274,160,81,29
TTATGACGATACTTGA,sample,195165,192346,18064,174282,18170,156112,92234,5785,36092,3359,128326,18642,5877,1736,14969,13097
TCTCCTAGATACTTGA,sample,176303,173583,21678,151905,16261,135644,70548,4633,33739,5434,104287,21290,6998,1987,16179,10431
ATGAATAGATACTTGA,sample,241434,238440,22196,216244,24654,191590,116777,8289,37620,3881,154397,25023,8528,2669,22415,17741
CGCGAGACATACTTGA,sample,255101,250717,36137,214580,22284,192296,80290,6527,59949,7616,140239,37914,9711,2368,18977,15249
CGTAGAACATACTTGA,sample,139588,138058,11296,126762,15628,111134,72280,3966,20999,2860,93279,11029,4977,1678,15652,10691
AGATACTAATACTTGA,sample,2120,2076,242,1834,285,1549,1062,78,235,21,1297,153,615,450,188,185
TCTAGGTTATCCGCGA,sample,380682,376148,39606,336542,53818,282724,170452,14930,51194,6474,221646,39674,5248,2216,50335,37687
CTGGTCTTATCCGCGA,sample,411801,403398,63423,339975,34450,305525,124534,7953,100249,10628,224783,62161,13926,3975,22718,23036
GTCGTTCTATCCGCGA,sample,165712,163697,12917,150780,15031,135749,90748,6049,25583,2915,116331,10454,3943,1741,20779,11294
CTAGCGACATCCGCGA,sample,213882,210439,22757,187682,44368,143314,88876,6506,30100,2988,118976,14844,7184,2412,20577,27888
TGATTCCGATCCGCGA,sample,268690,264803,26622,238181,36931,201250,135450,10248,32800,3129,168250,19623,7679,3123,29103,26363
TACGCGAGATCCGCGA,sample,184008,179780,23364,156416,28711,127705,79783,5053,25725,2251,105508,14893,8001,2137,22179,19398
CCGCAGTCATCCGCGA,sample,310143,303355,46560,256795,30613,226182,112742,9952,56912,6577,169654,39999,11660,3083,19687,19112
TCTCAGGAATCCGCGA,sample,293861,288622,42588,246034,27008,219026,108746,6917,58840,5542,167586,38981,11025,2869,21557,17784
TGGATCAAATCCGCGA,sample,220170,216510,29469,187041,31796,155245,89314,6237,32595,3498,121909,23601,8491,2129,23455,21672
GGCAGGTTATCCGCGA,sample,384477,377766,49394,328372,47743,280629,160815,10978,59598,6485,220413,42753,10764,2982,30153,31093
GGCGACGAATCCGCGA,sample,245589,241577,27564,214013,26127,187886,89041,7099,48844,4526,137885,38376,11648,2877,17848,17323
TAACGAAGATCCGCGA,sample,369342,362081,54538,307543,29768,277775,138421,10161,72570,6676,210991,49947,12565,3433,24392,20388
GCTGCTTCATCCGCGA,sample,367359,359344,54474,304870,25988,278882,131407,9497,75319,8299,206726,54360,12561,3333,22712,14278
TGCGCTCCATCCGCGA,sample,221358,217648,23097,194551,24334,170217,112822,8425,28972,3104,141794,16894,6591,2189,24314,17634
GCGTTACCATCCGCGA,sample,294828,286836,47266,239570,18509,221061,101157,6222,64038,6629,165195,43015,10957,2805,12913,11959
GTCGCGAAATCCGCGA,sample,189962,186338,23138,163200,19501,143699,83850,6271,30665,2326,114515,20587,5564,1637,18301,13751
CGTCGAGGATCCGCGA,sample,120432,118550,10226,108324,14782,93542,68667,6025,11030,1323,79697,6497,4988,2989,8307,10710
CAGCTTCGATCCGCGA,sample,175096,172263,19455,152808,18205,134603,72072,4921,30357,3500,102429,23753,8954,2296,18287,11737
TTATGACGATCCGCGA,sample,103740,101720,14651,87069,13746,73323,39278,3542,16479,2182,55757,11842,6155,1687,9653,9194
AAGTAGAGATCCGCGA,sample,239811,236508,20908,215600,27922,187678,132159,12817,25131,2985,157290,14586,6664,2235,22029,19912
ATTCTACCATCCGCGA,sample,524284,507275,117814,389461,23816,365645,93867,6734,146361,16688,240228,101995,19754,4492,10402,10494
GACTAACCATCCGCGA,sample,245955,237523,57893,179630,13224,166406,44263,2071,62398,6567,106661,51107,13808,2705,8955,6190
CGTAGAACATCCGCGA,sample,342565,334837,50208,284629,27105,257524,97940,6676,81531,8369,179471,63008,12439,3398,21035,17382
TTAACTGAATCCGCGA,sample,396363,388447,53897,334550,24314,310236,120858,7787,115231,12547,236089,53813,11654,3114,19476,16163
AACCGGTTAGGACTCA,sample,171642,168496,18800,149696,24377,125319,70321,4926,29523,3077,99844,17472,6907,2133,18957,17369
GTCGTTCTAGGACTCA,sample,221293,218143,21198,196945,28831,168114,98348,7768,33306,3880,131654,24812,5551,1988,17907,20493
GACGTATGAGGACTCA,sample,73498,72382,5862,66520,15174,51346,42107,3216,3774,552,45881,1697,3098,2804,8360,11106
CATAATGGAGGACTCA,sample,113158,111249,10913,100336,14702,85634,50966,2769,20506,2407,71472,8986,4479,1756,13179,10344
GAGCCTCCAGGACTCA,sample,40029,38500,6829,31671,3554,28117,11911,840,8997,938,20908,5431,4755,1681,2064,2367
CTAGCGACAGGACTCA,sample,53808,51990,8622,43368,5850,37518,17256,886,11227,1052,28483,7097,5141,1605,4254,3965
CCGTACGCAGGACTCA,sample,106963,105219,11278,93941,16405,77536,50922,3968,13779,1466,64701,7401,4419,1639,13874,11622
TCTCAGGAAGGACTCA,sample,126689,124561,11362,113199,14186,99013,69490,5205,15066,1554,84556,7698,4586,2294,12874,10089
ATGGCGTTAGGACTCA,sample,56096,54737,7976,46761,4984,41777,19057,1140,13475,1754,32532,6351,4743,1623,4099,3329
CGGTTGGTAGGACTCA,sample,84247,82529,9753,72776,10957,61819,39980,2679,11445,1251,51425,6464,4837,1657,10696,7912
ACGCTTAAAGGACTCA,sample,87696,85971,10553,75418,9572,65846,37025,2521,16731,1789,53756,7780,4970,1944,8328,6847
TAGCGAGTAGGACTCA,sample,146427,144334,11314,133020,13634,119386,91556,7600,13082,2112,104638,5036,4616,4332,6031,11437
CTAAGCATAGGACTCA,sample,108451,106775,10741,96034,17120,78914,56443,3799,11628,1199,68071,5845,4503,1997,11696,12436
AGCAGAGCAGGACTCA,sample,85926,84093,9541,74552,6358,68194,39440,2743,15145,1629,54585,9237,6439,3017,4288,4159
GTCGCGAAAGGACTCA,sample,87982,86662,7617,79045,12558,66487,48638,3419,9016,986,57654,4428,3547,1499,13509,10059
CAGCTTCGAGGACTCA,sample,91683,89584,11203,78381,9733,68648,33163,1718,18862,1983,52025,12922,5401,1388,7375,6981
TCTCCTAGAGGACTCA,sample,71920,70744,7338,63406,7009,56397,32600,2960,12747,1404,45347,6686,4950,2113,4579,5047
CGTAGAACAGGACTCA,sample,114783,112765,11282,101483,8094,93389,54439,3542,23148,3050,77587,9210,4664,2037,7719,6088
AGATACTAAGGACTCA,sample,72495,71560,5943,65617,11163,54454,45353,3286,4656,466,50009,693,1173,1059,13616,8941
CCTAACTAAGGACTCA,Pos_Ctrl,125407,119235,14883,104352,4291,100061,84207,7125,6120,653,90327,1956,7301,9821,4965,1681
TCTAGGTTTATTGAAC,sample,133978,132745,8262,124483,21431,103052,82545,5716,9131,1395,91676,4265,4136,3100,10305,15344
GTCGTTCTTATTGAAC,sample,85870,85139,4867,80272,23711,56561,48920,2909,3423,292,52343,1017,1665,1664,17947,16119
AGAGTTCTTATTGAAC,sample,124487,122872,9502,113370,20317,93053,71223,4880,11067,1315,82290,4568,4650,3469,8893,14823
CATAATGGTATTGAAC,sample,62186,60796,9362,51434,10951,40483,20934,1153,10730,1089,31664,6577,5112,1275,7990,7153
GGTAGAGATATTGAAC,sample,86402,83156,18713,64443,5543,58900,16550,1085,22742,2603,39292,15920,8689,2267,2360,3051
CGTCGCCATATTGAAC,sample,13623,13373,1584,11789,2384,9405,7011,534,1118,126,8129,616,2090,1583,1576,1491
TGATTCCGTATTGAAC,sample,77866,76614,7689,68925,13129,55796,37194,2279,10144,986,47338,5193,3624,1385,12739,9518
TACGCGAGTATTGAAC,sample,109226,106970,13906,93064,12825,80239,42461,2585,21760,2300,64221,11133,5168,1835,10132,8553
GACTCAAGTATTGAAC,sample,86093,84194,10217,73977,8962,65015,34984,2131,17295,2123,52279,8482,4967,1919,7825,6072
ATACGTTCTATTGAAC,sample,150725,148218,16276,131942,26118,105824,73455,5512,15357,1954,88812,9546,6138,2660,15827,18360
CCGCAGTCTATTGAAC,sample,72322,70327,10603,59724,9751,49973,24895,2089,12260,1210,37155,9519,5750,1494,8032,6901
GATGCGTTTATTGAAC,sample,71702,70267,8378,61889,13990,47899,31073,2193,8736,882,39809,5015,4086,1756,7834,9311
ATGGCGTTTATTGAAC,sample,86645,84986,9639,75347,8846,66501,32678,2524,20966,2483,53644,7850,4282,1851,6883,6264
CCATTCTTTATTGAAC,sample,96983,94448,13338,81110,8260,72850,33597,1900,22111,2301,55708,12941,5610,1800,6871,5398
GCTCTTCTTATTGAAC,sample,92503,90795,9654,81141,14210,66931,44154,3152,10954,1215,55108,7456,4952,2022,10947,9879
AAGGTCTGTATTGAAC,sample,33992,33160,4336,28824,5172,23652,14127,842,5307,615,19434,2761,3893,2250,2155,3531
CCTAGCGGTATTGAAC,sample,33184,32241,5834,26407,3090,23317,10206,488,6827,753,17033,5043,4011,957,3390,2000
CTAACCGGTATTGAAC,sample,64389,63328,5889,57439,9447,47992,36870,2090,6152,526,43022,2354,2939,1794,9945,7021
GGCGACGATATTGAAC,sample,64813,63048,9379,53669,7640,46029,23665,1655,11282,1026,34947,8401,5252,1336,6998,5454
TAACGAAGTATTGAAC,sample,105145,102375,18082,84293,8902,75391,32953,2054,20550,2093,53503,17741,7534,1567,9549,6016
TGCGCTCCTATTGAAC,sample,67064,64207,17437,46770,4958,41812,9847,538,16353,1697,26200,13377,7916,1192,2164,2446
CGTCGAGGTATTGAAC,sample,79886,78316,8313,70003,7142,62861,41492,2762,10998,1295,52490,6314,4429,1895,7511,5619
CAGCTTCGTATTGAAC,sample,78898,76907,12491,64416,8921,55495,25056,1748,15234,1301,40290,12156,5844,1192,8068,5566
ATTCTACCTATTGAAC,sample,99759,97777,11579,86198,11519,74679,48189,3759,13453,1516,61642,7762,4389,1733,9939,8603
CGCGAGACTATTGAAC,sample,89314,88256,7405,80851,8625,72226,45212,2762,15777,2426,60989,6049,4421,1862,7616,6052
AGATACTATATTGAAC,sample,129888,128168,11727,116441,15828,100613,68597,4630,16394,1620,84991,9372,5786,2347,11810,11661
TTAACTGATATTGAAC,sample,47277,46577,4986,41591,6767,34824,22795,1459,6320,586,29115,3664,3514,1380,7154,4844
TCTAGGTTGTTCAACT,sample,30491,29822,4594,25228,3449,21779,10236,728,5715,608,15951,4492,4362,1822,2090,2134
GTCGTTCTGTTCAACT,sample,64713,63442,6777,56665,10142,46523,30196,2281,7921,778,38117,5347,4852,2873,4981,7011
CATAATGGGTTCAACT,sample,82056,79751,12977,66774,6631,60143,24573,1448,22080,2525,46653,9517,6733,1923,5345,4510
TATACGGAGTTCAACT,sample,54630,53956,3964,49992,11100,38892,32817,1800,3292,233,36109,750,1282,1238,10636,8085
GGAGAAGCGTTCAACT,sample,31379,30688,3460,27228,5391,21837,15176,844,3495,441,18671,1881,2156,1082,5718,3579
GAGCCTCCGTTCAACT,sample,28394,27693,3477,24216,5234,18982,12313,971,3321,422,15634,1955,2701,1419,3319,3623
GGTAGAGAGTTCAACT,sample,38874,37897,5044,32853,5647,27206,16883,1234,5596,534,22479,2959,3083,1201,3860,3982
ATTCAAGGGTTCAACT,sample,58831,57510,6689,50821,8004,42817,27257,1630,7785,939,35042,5206,4267,1823,5141,5900
CCGTACGCGTTCAACT,sample,27016,26414,2999,23415,4351,19064,12141,923,3608,365,15749,2027,2508,1224,2892,3134
TAGCGAGTGTTCAACT,sample,39339,38415,5163,33252,4701,28551,14980,1177,7302,708,22282,4384,4039,1590,3696,3389
CTAAGCATGTTCAACT,sample,39889,38492,6711,31781,4970,26811,11645,811,7943,945,19588,5467,4328,1117,3529,3394
AAGGTCTGGTTCAACT,sample,51379,50258,6132,44126,4012,40114,22433,1375,11111,1405,33544,3790,4262,2295,2489,3084
CCTAGCGGGTTCAACT,sample,6972,6799,987,5812,884,4928,2555,190,1328,120,3883,735,1434,685,502,573
GCCTATTCGTTCAACT,sample,33334,32488,5592,26896,3137,23759,11232,769,6554,702,17786,4502,3724,1211,2396,2257
AGCAGAGCGTTCAACT,sample,22562,21867,4149,17718,2838,14880,8092,529,3514,361,11606,2384,1880,751,2371,1980
ATACCGCCGTTCAACT,sample,33944,33281,3735,29546,3597,25949,14757,891,6817,944,21574,2540,2597,1477,3140,2610
TCTCCTAGGTTCAACT,sample,26848,25891,4152,21739,2288,19451,9051,601,5552,640,14603,3607,2966,963,1872,1698
ATGAATAGGTTCAACT,sample,29316,28671,4081,24590,2739,21851,12885,891,4292,575,17177,3208,2757,1121,3155,1966
AAGTAGAGGTTCAACT,sample,31271,30612,4165,26447,3782,22665,11257,929,6081,617,17338,3781,4020,1626,2190,2626
TAACGCCAGTTCAACT,sample,19285,18894,2459,16435,2383,14052,9068,627,2608,294,11676,1455,1863,847,2630,1899
GACTAACCGTTCAACT,sample,24686,24008,3884,20124,2292,17832,8289,572,5270,477,13559,3224,2612,952,1873,1471
GCGCAATAGTTCAACT,Neg_Ctrl,508,352,199,153,11,142,84,8,32,3,116,15,88,45,11,5
ATATGCAAGTTCAACT,sample,37731,37136,4004,33132,3203,29929,16576,1143,7509,984,24085,3717,3199,1372,2965,1918
GACGTATGCTGAGGTT,sample,15271,14965,1762,13203,3779,9424,6791,599,1335,143,8126,556,2423,1878,1313,2638
CTAGCGACCTGAGGTT,sample,231328,226262,35866,190396,20593,169803,70099,5403,49070,5473,119169,39758,10953,2369,17443,13006
TCATCGAACTGAGGTT,sample,228661,225129,20597,204532,22173,182359,116276,8038,35319,3781,151595,18945,6441,2336,21398,17725
TAGCGAGTCTGAGGTT,sample,185935,181789,29646,152143,19968,132175,58192,4159,39211,4131,97403,26482,10249,2618,13669,13217
GCTCTTCTCTGAGGTT,sample,179783,176901,20244,156657,31212,125445,71717,5359,24840,2801,96557,20728,6763,2390,20225,21626
CTAAGCATCTGAGGTT,sample,108496,106977,9973,97004,20721,76283,56845,3595,8876,918,65721,6049,3952,2029,17643,14577
GGCGACGACTGAGGTT,sample,68695,67393,7115,60278,11923,48355,32791,2186,8623,1040,41414,3715,4457,2649,7356,8375
TAACGAAGCTGAGGTT,sample,166271,163984,14963,149021,15795,133226,69704,4606,38668,4253,108372,15995,6341,2567,10242,11044
ATACCGCCCTGAGGTT,sample,148805,146713,11996,134717,15842,118875,81022,4825,23552,2335,104574,7141,4035,2095,19216,11209
CAGCTTCGCTGAGGTT,sample,155851,154373,8716,145657,28286,117371,99467,8512,5976,979,105443,2437,1353,1328,26274,21349
ATGAATAGCTGAGGTT,sample,154992,153792,12079,141713,23289,118424,75609,6420,21197,2348,96806,12850,6590,2504,13571,16034
AAGTAGAGCTGAGGTT,sample,123375,121989,9942,112047,11356,100691,58601,3777,26662,2717,85263,8934,4792,1916,12824,8488
TCAATCAGCTGAGGTT,sample,115808,114749,6193,108556,18995,89561,75814,6168,5383,1149,81197,1047,1313,1227,24295,13890
AACCGGTTAGACCGTT,sample,83462,81815,7336,74479,15183,59296,40264,2817,10477,1212,50741,4526,3787,2154,9820,10857
TCTAGGTTAGACCGTT,sample,125274,123432,11237,112195,23351,88844,59939,4933,14295,1423,74234,8254,5118,2534,14116,15956
GGAGAAGCAGACCGTT,sample,201130,196620,24553,172067,15838,156229,81843,5294,45321,5275,127164,18496,7618,2816,9428,11248
CTAGCGACAGACCGTT,sample,131678,129508,9457,120051,19853,100198,75183,4129,14559,1792,89742,4535,3344,2253,14358,15190
TCGAACGAAGACCGTT,sample,95429,94129,10107,84022,20186,63836,45416,3452,9855,831,55271,4282,4091,2161,10874,13897
GGTAGAGAAGACCGTT,sample,95447,93335,11718,81617,16722,64895,42172,2849,11238,1265,53410,7371,4493,1516,11962,11570
TGATTCCGAGACCGTT,sample,82123,80636,6502,74134,8996,65138,35663,2194,19128,1742,54791,6411,4207,1997,7371,6644
TACGCGAGAGACCGTT,sample,250599,245819,28296,217523,31057,186466,104924,6669,45204,4348,150128,25321,8485,2834,21610,22021
ATACGTTCAGACCGTT,sample,142016,138927,18315,120612,18106,102506,58154,4504,23084,2003,81238,14761,7019,2061,13823,12895
GGCAGGTTAGACCGTT,sample,109732,108555,9582,98973,25798,73175,60772,4843,5485,581,66257,1494,1403,1226,17121,19486
CCATTCTTAGACCGTT,sample,113152,111391,8748,102643,17660,84983,57424,3450,13983,2051,71407,8075,4758,2044,12041,12832
GCTCTTCTAGACCGTT,sample,192280,189813,15374,174439,30266,144173,100286,8473,21037,2807,121323,11570,6316,2900,22135,22649
GCTGCTTCAGACCGTT,sample,119570,118029,8921,109108,19750,89358,65061,5833,11439,1348,76500,5677,4121,1620,18331,14198
TCTCCTAGAGACCGTT,sample,151553,148534,20074,128460,15026,113434,53803,4618,29913,2948,83716,22152,8055,1595,16786,10016
ATGAATAGAGACCGTT,sample,191589,189225,14782,174443,24354,150089,104181,6628,23650,2871,127831,12759,5011,1853,28763,18626
AGATACTAAGACCGTT,sample,258161,255744,18233,237511,39483,198028,171748,13240,9129,1772,180877,2139,1751,1771,30288,31387
TTAACTGAAGACCGTT,sample,173675,172134,10027,162107,15015,147092,114227,10636,15657,1984,129884,4588,3483,2741,13682,12782
ATATGCAAAGACCGTT,sample,146957,145671,12196,133475,16166,117309,70393,6689,24199,1838,94592,14190,5994,1632,17970,11660
GACGTATGCTTGAGTT,sample,327827,323488,28348,295140,50431,244709,157153,11816,45641,4809,202794,25290,8051,2661,38618,38664
CTAGCGACCTTGAGTT,sample,140422,138075,16564,121511,22951,98560,57156,4022,20641,2150,77797,14591,7056,1820,18699,16016
TCATACCACTTGAGTT,sample,139104,137028,11435,125593,34410,91183,61168,4601,16684,1737,77852,6993,4872,2315,17413,23333
TCTCAGGACTTGAGTT,sample,92260,91069,7452,83617,15321,68296,52984,3399,7513,1290,60497,3110,2967,1580,15217,11596
ATGGCGTTCTTGAGTT,sample,43966,42869,6852,36017,5384,30633,16972,1069,7103,663,24075,4826,3631,1288,5226,3461
CTAACCGGCTTGAGTT,sample,182803,179646,18725,160921,16224,144697,76307,4301,41069,4740,117376,18280,6944,2667,9704,11821
GGCGACGACTTGAGTT,sample,127949,125929,13406,112523,23734,88789,59708,4561,14509,1543,74217,8468,3113,1362,20827,16869
TAACGAAGCTTGAGTT,sample,164519,162267,13753,148514,25464,123050,76065,4886,29792,3157,105857,9150,4100,1794,19449,19380
GTCGCGAACTTGAGTT,sample,208716,204497,27315,177182,27600,149582,80235,6036,34236,3464,114471,25611,9642,2587,20758,19520
CGTCGAGGCTTGAGTT,sample,193642,191663,13059,178604,31471,147133,125191,8937,7716,1857,132907,3432,2175,2065,24214,24232
TCTCCTAGCTTGAGTT,sample,89712,86846,14438,72408,10266,62142,29899,2447,15515,1615,45414,12666,6439,1678,7374,7295
AAGTAGAGCTTGAGTT,sample,143797,141607,13437,128170,20520,107650,67749,5549,22351,2350,90100,9651,5498,1879,18750,15469
TCAATCAGCTTGAGTT,sample,163663,161252,17528,143724,25089,118635,77083,4768,21769,1910,98852,13105,4170,1567,27329,18388
ATTCTACCCTTGAGTT,sample,204349,201087,22421,178666,27928,150738,88845,6923,30285,3652,119130,21033,5819,1838,27767,19942
CGTAGAACCTTGAGTT,sample,210045,205759,26859,178900,18968,159932,81697,5913,38505,5107,120202,28710,9813,2124,18205,13466
AGATACTACTTGAGTT,sample,136794,134565,12668,121897,17949,103948,77212,6146,13246,1447,90458,5897,4072,1830,17603,15155
CATAATGGTCGGAGTT,sample,29250,28668,2082,26586,5742,20844,17509,921,1850,158,19359,406,991,925,5181,4354
TCGAACGATCGGAGTT,sample,28151,27538,3386,24152,4651,19501,13696,836,2853,343,16549,1773,2536,1387,3263,3393
CCATTCTTTCGGAGTT,sample,59691,57849,8584,49265,5732,43533,23416,1539,9886,1043,33302,7649,4624,1414,6989,3917
ACGCTTAATCGGAGTT,sample,42964,41878,4745,37133,4595,32538,19181,1125,7661,933,26842,3638,2997,1414,3692,3559
GCTCTTCTTCGGAGTT,sample,43594,42643,5396,37247,5846,31401,18069,876,7623,736,25692,4097,3021,1181,5306,4374
GGCGTACCTCGGAGTT,sample,47680,46820,4906,41914,5545,36369,23681,1803,6832,599,30513,3454,3085,1498,4619,4404
CGTCGAGGTCGGAGTT,Pos_Ctrl,40817,39042,5063,33979,1475,32504,27345,2297,2003,279,29348,580,5551,5911,1849,650
CAGCTTCGTCGGAGTT,sample,51202,50325,4595,45730,5809,39921,29899,2199,4760,644,34659,2419,2820,1769,5799,4491
CCTAACTATCGGAGTT,sample,25782,25258,2458,22800,3274,19526,13152,1061,3293,348,16445,1672,2158,1267,3153,2595
CTGGTCTTTGAACCTT,Pos_Ctrl,84456,81621,10470,71151,3704,67447,57061,5006,3800,495,60861,1085,6989,8440,4475,1875
TATACGGATGAACCTT,sample,139382,137283,13905,123378,25317,98061,73625,5021,10686,1221,84311,7508,5508,3147,12057,18533
GGAGAAGCTGAACCTT,sample,112150,110919,7574,103345,14619,88726,64103,4429,14004,1616,78107,4574,4205,3180,9704,11117
CATACTCCTGAACCTT,sample,51097,50135,4605,45530,9897,35633,26707,1497,4571,465,31278,2393,2471,1351,9300,7365
GGTAGAGATGAACCTT,Pos_Ctrl,115822,109771,16273,93498,4778,88720,73847,6567,5833,678,79680,1795,7715,9832,5542,2439
TCATCGAATGAACCTT,sample,86011,84548,8473,76075,16968,59107,40544,2843,9331,996,49875,5393,3541,1560,13045,11933
CCGCAGTCTGAACCTT,sample,50854,49472,8765,40707,6982,33725,16166,1005,8591,850,24757,7113,4506,1477,4475,4761
TCTCAGGATGAACCTT,sample,133360,130427,19184,111243,14411,96832,42809,3015,27765,3282,70574,19961,8187,1852,11104,9470
ATGGCGTTTGAACCTT,Pos_Ctrl,93029,88743,13202,75541,3941,71600,59858,5250,4563,502,64421,1427,7116,8580,4107,2062
AGCGTCTTTGAACCTT,sample,71417,70327,5115,65212,10610,54602,43319,3718,4919,756,48238,1890,2328,1850,11795,8446
CGGTTGGTTGAACCTT,sample,66622,65015,10182,54833,7551,47282,23418,1516,12586,1204,36004,8558,5214,1247,9113,5328
GCTCTTCTTGAACCTT,sample,153129,150402,18829,131573,15313,116260,59167,3999,29924,3033,89091,20137,7690,1788,19804,10649
GAGATTCTTGAACCTT,sample,102563,101193,7646,93547,19702,73845,61155,3936,5995,757,67150,2002,2561,2460,11998,14835
CCTAGCGGTGAACCTT,Pos_Ctrl,34786,33371,4267,29104,1410,27694,23253,2087,1656,242,24909,456,5195,5449,1195,620
GGCGACGATGAACCTT,sample,71914,70272,10240,60032,6680,53352,27786,1925,12653,1345,40439,9643,5249,1235,7597,4887
AGCAGAGCTGAACCTT,sample,73217,71946,6991,64955,9930,55025,38599,1821,9527,936,48126,4142,3345,1361,11228,7890
ATACCGCCTGAACCTT,sample,118051,115923,12199,103724,12642,91082,50835,3142,24472,2163,75307,10470,5350,1929,9745,9399
GTCGCGAATGAACCTT,sample,119823,116373,20147,96226,8739,87487,28027,2267,30808,3445,58835,22940,9846,2340,4479,5336
TTATGACGTGAACCTT,sample,46198,45218,5878,39340,3350,35990,19403,1126,10112,1432,29515,3917,4005,2073,2271,2519
AAGTAGAGTGAACCTT,sample,107794,105413,16154,89259,11656,77603,36453,2037,22598,2404,59051,14111,6935,1639,9683,8039
TAACGCCATGAACCTT,sample,108243,106199,13180,93019,15716,77303,46519,3113,16396,1666,62915,9609,5863,2142,11839,11000
ATTCTACCTGAACCTT,Pos_Ctrl,69268,66020,9353,56667,2592,54075,45227,3744,3554,436,48781,1114,6494,7595,2762,1324
GACTAACCTGAACCTT,sample,107492,105172,13610,91562,10038,81524,49026,3494,15675,1761,64701,11568,5787,2140,8836,7027
CGCGAGACTGAACCTT,sample,99859,97877,11242,86635,9088,77547,45687,3187,16515,2030,62202,10128,5063,2098,7060,6389
TTAACTGATGAACCTT,sample,100077,98086,12877,85209,5967,79242,37347,2529,24242,2671,61589,12453,6599,2046,4043,3779
TCTAGGTTACCGAATT,sample,89349,87019,12648,74371,13150,61221,34920,2205,14283,1278,49203,8535,4518,1485,12597,8534
GACGTATGACCGAATT,sample,492382,476660,90001,386659,26011,360648,115668,6764,155010,20539,270678,62667,15818,3957,12594,14894
GAGCCTCCACCGAATT,sample,171129,168670,15141,153529,38650,114879,90189,4951,12447,1612,102636,5680,3581,1549,32917,28145
TCATCGAAACCGAATT,sample,227696,224500,18650,205850,50647,155203,126382,7672,12405,1974,138787,6770,3103,2111,36450,35122
GCAACTAGACCGAATT,sample,94115,92668,10729,81939,13954,67985,36868,2694,17000,1708,53868,9715,6359,2308,8932,10340
ATACGTTCACCGAATT,sample,142014,139795,13697,126098,28012,98086,77218,4265,10442,996,87660,5165,3908,1781,24248,20509
CCGTACGCACCGAATT,sample,96193,94131,12270,81861,10828,71033,39136,2974,16180,1899,55316,10844,5944,2516,6911,7337
CCATTCTTACCGAATT,sample,244666,240977,22166,218811,26483,192328,114027,7142,47191,5574,161218,18394,6641,2739,20362,20002
CTAAGCATACCGAATT,sample,257461,254597,19540,235057,38657,196400,135541,14041,28962,3988,164503,13868,4448,1834,31023,29715
TAACGAAGACCGAATT,sample,283525,280197,25561,254636,25627,229009,139100,8058,53403,5797,192503,22651,8043,2629,23100,19007
GCTGCTTCACCGAATT,sample,185695,183754,15059,168695,32147,136548,94635,6265,21538,2568,116173,11542,5613,2303,23948,23295
TGCGCTCCACCGAATT,sample,242951,240958,18304,222654,32720,189934,125043,10766,30523,3684,155566,19918,7742,2703,23613,22241
CAGCTTCGACCGAATT,Neg_Ctrl,3019,1824,1080,744,85,659,319,27,211,19,530,83,260,142,108,72
CGCGGTCGACCGAATT,sample,167310,164784,14503,150281,14603,135678,79314,4479,34436,4782,113750,12667,5482,1970,13051,10447
GACTAACCACCGAATT,sample,237723,233279,27643,205636,30244,175392,88324,5957,43537,5283,131861,32291,10605,3129,19863,21871
CGTAGAACACCGAATT,sample,179544,176651,16241,160410,25347,135063,93154,7465,22351,2493,115505,9600,3665,1610,26538,20678
TTAACTGAACCGAATT,sample,163584,161812,14186,147626,23910,123716,93282,9933,11945,1832,105227,6724,3394,1598,20508,16924
TCTAGGTTGGTCTGGT,sample,61704,60302,7590,52712,7586,45126,20876,952,13017,1264,33893,9017,5540,1411,6916,4760
CTGGTCTTGGTCTGGT,sample,47624,46790,4250,42540,6769,35771,22875,1450,6725,609,29600,4112,3459,1398,7885,5022
GTCGTTCTGGTCTGGT,Neg_Ctrl,1749,1202,757,445,69,376,239,15,62,15,301,45,199,104,52,36
GACGTATGGGTCTGGT,sample,66489,65359,5355,60004,7809,52195,33634,2192,11560,1598,45194,3211,3208,2085,6370,6169
CATACTCCGGTCTGGT,sample,105626,104405,6681,97724,15008,82716,68728,5252,5790,624,74518,2322,3314,2958,6546,11522
GGTAGAGAGGTCTGGT,sample,64195,62987,6461,56526,8134,48392,30217,2758,9307,1180,39524,4930,3892,1435,8068,5536
CGTCGCCAGGTCTGGT,Neg_Ctrl,1790,1208,727,481,67,414,198,11,129,3,327,73,189,81,43,42
TCATCGAAGGTCTGGT,sample,60180,59167,5364,53803,12065,41738,33872,2300,3429,383,37301,1754,1492,1229,12881,8735
ATTCAAGGGGTCTGGT,sample,1042,977,291,686,90,596,213,14,178,12,391,179,256,91,71,45
CCGCAGTCGGTCTGGT,sample,208770,204020,16882,187138,28499,158639,116628,8007,20426,2762,137054,10816,4806,2274,21466,21162
TCTCAGGAGGTCTGGT,sample,195968,194068,11812,182256,34496,147760,124110,10791,9793,621,133903,2445,1687,1741,31463,25399
TGGATCAAGGTCTGGT,sample,191186,188394,16672,171722,28737,142985,95809,6953,23430,1856,119239,14937,5574,1641,27745,21075
TGCGCGTTGGTCTGGT,Neg_Ctrl,949,777,337,440,56,384,202,20,88,18,290,56,183,100,64,40
CATTCGGTGGTCTGGT,sample,68995,67280,8911,58369,5851,52518,23063,1540,17436,2045,40499,8434,5470,1763,5807,3975
CCTAGCGGGGTCTGGT,sample,55847,54825,5427,49398,7682,41716,28132,2255,6310,735,34442,4284,3638,1313,8609,5660
CTAACCGGGGTCTGGT,Neg_Ctrl,1727,1129,753,376,51,325,197,14,74,6,271,34,174,82,50,44
TGCGCTCCGGTCTGGT,sample,184160,181144,20578,160566,23325,137241,82933,5694,28867,2950,111800,16797,6993,1934,23026,16812
GACTAACCGGTCTGGT,Neg_Ctrl,1682,1024,693,331,42,289,163,18,62,5,225,41,155,88,31,43
CGTAGAACGGTCTGGT,sample,118979,116630,11972,104658,9820,94838,58869,3710,21109,2425,79978,8725,4493,1730,11826,6856
CCTAACTAGGTCTGGT,sample,130868,128164,14570,113594,15938,97656,62755,4719,17213,1867,79968,11102,5452,1794,12541,11962
CTGGTCTTCGACGTTA,sample,395369,389053,46473,342580,67262,275318,159556,11307,54745,6279,214301,43431,10432,2801,58346,47547
AGCTGAATCGACGTTA,sample,575724,566857,47483,519374,56160,463214,293926,17448,108406,12631,402332,30803,7793,3783,42172,42476
CTAGCGACCGACGTTA,sample,197390,192331,24625,167706,25699,142007,68093,3304,41306,4399,109399,24905,8135,2244,20373,19099
ATTCAAGGCGACGTTA,sample,208303,205763,16550,189213,51745,137468,110066,7853,12340,1321,122406,5888,3755,2357,33027,35549
GACTCAAGCGACGTTA,sample,173206,170553,13581,156972,26085,130887,91013,5482,23258,2880,114271,8254,5033,2268,25800,19724
TGCGCGTTCGACGTTA,sample,225871,221637,30543,191094,19225,171869,76986,4902,57335,6270,134321,26376,9911,3262,14351,12254
ACGCTTAACGACGTTA,sample,327286,323918,21790,302128,34135,267993,169504,11417,59287,6839,228791,20946,5338,2472,25487,24735
CATTCGGTCGACGTTA,sample,321715,318833,17065,301768,55341,246427,202095,14511,19153,2996,221248,7672,3156,2205,46634,39797
CTAAGCATCGACGTTA,sample,476920,471845,41799,430046,48751,381295,250834,16334,72429,8147,323263,33551,9454,2887,51320,33020
CCTAGCGGCGACGTTA,sample,173331,172044,9841,162203,34219,127984,106773,10801,7618,1402,114391,1390,1818,1564,26629,25072
CTAACCGGCGACGTTA,sample,334519,331866,17192,314674,50281,264393,226788,17893,13642,1768,240430,4302,1959,2186,45438,37702
TCTCCTAGCGACGTTA,sample,266568,264657,15476,249181,32370,216811,144455,13385,40508,5547,184963,12916,3705,2043,32765,23393
ATATGCAACGACGTTA,sample,66082,65643,3147,62496,12980,49516,40345,4148,3517,431,43862,1075,2095,1903,6833,8833
GTCGTTCTTACTAAGT,sample,195748,192507,19151,173356,23232,150124,102263,8519,23862,2860,126125,12620,6764,3515,11095,17729
GGAGAAGCTACTAAGT,sample,94130,91927,13361,78566,11173,67393,38309,2570,14475,1698,52784,10341,6100,1742,11135,7790
GAGCCTCCTACTAAGT,sample,71277,69220,12076,57144,8281,48863,22725,1373,12978,1345,35703,10442,5860,1680,6753,5345
TCATACCATACTAAGT,sample,151489,148424,23837,124587,15541,109046,48527,3575,30775,3585,79302,22584,9240,2214,12338,9116
TACGCGAGTACTAAGT,sample,37468,36522,4847,31675,3342,28333,18538,1052,4660,610,23198,3473,3263,1725,3120,2286
TCTCAGGATACTAAGT,sample,52062,50477,9203,41274,5020,36254,14540,793,11919,1325,26459,7677,5602,1433,4018,3534
GGCAGGTTTACTAAGT,sample,25247,24542,3656,20886,3203,17683,9330,579,5072,583,14402,2119,2641,1106,2319,2373
ATGGCGTTTACTAAGT,sample,46679,45414,8043,37371,4587,32784,16488,948,8859,953,25347,5536,4913,1355,4600,3045
TGCGCTCCTACTAAGT,sample,70279,69046,5999,63047,9036,54011,39903,2974,6649,612,46552,3873,3936,2474,7064,6810
CGTCGAGGTACTAAGT,sample,52363,51677,4339,47338,7027,40311,30495,2497,4206,368,34701,2745,2971,1930,5826,5401
AAGTAGAGTACTAAGT,sample,87811,86033,11246,74787,8821,65966,37857,3153,14223,1354,52080,9379,5132,1820,7846,6115
TAACGCCATACTAAGT,sample,92491,90724,13543,77181,8680,68501,34952,2750,16536,1759,51488,12504,6160,1388,10009,5603
GACTAACCTACTAAGT,sample,62908,61969,5479,56490,6735,49755,35661,2561,6780,1058,42441,3695,3402,1517,6537,4905
GCGCAATATACTAAGT,sample,95648,93396,15161,78235,6636,71599,30776,2306,20463,2312,51239,15742,7432,1506,7993,4711
ATATGCAATACTAAGT,sample,93954,92755,9445,83310,9236,74074,42903,3389,14495,1914,57398,11373,6611,2095,7900,5837
CATAATGGTTGCCGCT,sample,176219,172573,18804,153769,20990,132779,81731,5321,28232,3937,109963,13558,6273,3110,14739,14512
CATACTCCTTGCCGCT,sample,328664,323804,29983,293821,31806,262015,149471,12879,61859,7239,211330,30567,8007,2256,25954,24577
TCGAACGATTGCCGCT,sample,166557,164433,15149,149284,18907,130377,88764,5759,25990,2037,114754,7827,3565,1394,23791,14523
GGTAGAGATTGCCGCT,sample,127293,123382,17511,105871,11465,94406,47011,2726,23671,2988,70682,18010,5897,1333,14919,7628
TCATCGAATTGCCGCT,sample,151869,148618,18892,129726,16798,112928,68075,4501,22139,2468,90214,15745,6207,1603,19245,11383
GCAACTAGTTGCCGCT,sample,105160,104080,7619,96461,22345,74116,57856,5195,7666,873,65522,2526,3195,2702,12873,16312
ATACGTTCTTGCCGCT,sample,309699,304408,28867,275541,27718,247823,139390,9670,66870,8155,206260,23738,7905,3145,18523,20346
GATGCGTTTTGCCGCT,sample,487401,479009,51631,427378,31265,396113,186315,13441,133916,15138,320231,47303,11306,3591,21978,21271
CCATTCTTTTGCCGCT,sample,320822,317548,17992,299556,66276,233280,197561,12384,18543,1486,216104,3306,2084,1537,65181,45489
AAGGTCTGTTGCCGCT,sample,319743,315047,30446,284601,25253,259348,141306,8569,72352,8242,213658,28879,6879,2560,25932,18906
CTAACCGGTTGCCGCT,sample,118399,116728,9677,107051,22681,84370,61246,4287,12953,1323,74199,4561,3836,2128,19028,16376
TGCGCTCCTTGCCGCT,sample,227928,225489,13538,211951,47311,164640,139272,10805,10256,816,149528,3491,1882,2041,32242,33701
GGCGTACCTTGCCGCT,sample,343396,336276,53212,283064,28215,254849,87153,6238,85919,9039,173072,66500,16007,3556,22467,18349
CAGCTTCGTTGCCGCT,sample,234190,230931,23485,207446,26882,180564,107961,7322,36697,3889,144658,24695,8964,2314,28135,19284
CGCGGTCGTTGCCGCT,sample,176109,173942,15371,158571,21523,137048,92795,8794,20497,2808,113292,12154,5510,1978,20625,16445
ATGAATAGTTGCCGCT,sample,266421,264453,20634,243819,31603,212216,133604,10270,39337,4834,172941,24171,8536,2482,25807,23704
TCAATCAGTTGCCGCT,sample,202393,200165,17253,182912,20912,162000,85769,7795,40686,3321,126455,24429,8519,1961,25111,13186
GACTAACCTTGCCGCT,sample,250373,248398,13420,234978,31035,203943,153173,12017,25490,2512,178663,10751,5909,2912,29493,23494
CGCGAGACTTGCCGCT,sample,216844,214619,15425,199194,23016,176178,115862,9122,36414,4385,152276,10395,4862,2728,15040,16049
AGATACTATTGCCGCT,sample,369575,365803,32704,333099,46999,286100,189681,15677,44768,4069,234449,31905,9085,3041,27689,32558
CATAATGGTTCGACCT,sample,422089,411420,69464,341956,47798,294158,132932,8260,79208,9255,212140,64503,16317,4352,30932,31063
GGAGAAGCTTCGACCT,sample,172447,169743,13881,155862,31311,124551,89301,5719,17996,1841,107297,9694,4602,1960,25089,23303
CATACTCCTTCGACCT,sample,248000,245138,16991,228147,31046,197101,124077,7714,43690,7108,167767,14512,4943,2104,27125,22331
CGTCGCCATTCGACCT,sample,139031,137088,10585,126503,28123,98380,73214,6677,11838,1321,85052,5330,4151,2239,16946,19075
TCATACCATTCGACCT,sample,195987,193043,19040,174003,16632,157371,86172,5241,43625,4806,129797,17527,7007,2736,14360,11252
TACGCGAGTTCGACCT,sample,283491,277425,40611,236814,31951,204863,96184,6886,53692,5294,149876,42807,10157,2513,31539,20445
TCTCAGGATTCGACCT,sample,170204,167245,19231,148014,20311,127703,78679,5485,22754,2677,101433,18108,6727,2185,17111,13766
TGGATCAATTCGACCT,sample,171007,167298,22206,145092,18825,126267,68892,4368,29680,3470,98572,19857,7353,1734,21276,12917
CATTCGGTTTCGACCT,sample,150888,149234,10671,138563,35143,103420,84162,7259,8184,1187,92346,2628,2773,2191,22238,25399
TAGCGAGTTTCGACCT,sample,306459,300346,41722,258624,19398,239226,107254,6504,84266,9048,191520,32154,10278,2945,16417,13037
GAGATTCTTTCGACCT,sample,170231,168092,13103,154989,32127,122862,90648,7588,17064,2290,107712,5272,3430,1979,25804,23159
AAGGTCTGTTCGACCT,sample,170807,168925,12331,156594,19414,137180,82876,6042,34501,4760,117377,9001,3638,1960,18599,14115
ATGAATAGTTCGACCT,sample,223514,221609,13727,207882,31056,176826,136521,12457,18968,2689,155489,6191,3506,1642,29329,23800
AAGTAGAGTTCGACCT,sample,209027,206916,14718,192198,20049,172149,102184,7393,39826,7101,142010,15645,5181,2022,18275,14116
GACTAACCTTCGACCT,sample,320371,317064,25706,291358,35098,256260,185502,11899,32414,3281,217916,23164,7687,2855,25061,24319
TCTAGGTTTCCAGACT,sample,127899,126179,13418,112761,17263,95498,59849,3295,18580,1614,78429,12160,5420,1668,18707,13216
AGAGTTCTTCCAGACT,sample,124686,122898,11294,111604,17602,94002,65353,4776,16265,2125,81618,5483,3997,2427,12214,13949
CATAATGGTCCAGACT,sample,105407,103374,12871,90503,9418,81085,42583,2329,22453,2749,65036,10971,5663,1885,9246,7046
CATACTCCTCCAGACT,sample,83162,81566,8768,72798,11227,61571,38966,2657,12518,1162,51484,6268,4788,1987,6388,8385
TCGAACGATCCAGACT,sample,122469,120915,10507,110408,16572,93836,61091,5043,15824,1459,76915,10419,4116,1424,17706,12817
ATTCAAGGTCCAGACT,sample,132913,130388,17872,112516,8583,103933,42468,3110,36449,4594,78917,17312,7559,2244,6973,6526
TACGCGAGTCCAGACT,sample,54939,53738,7092,46646,6654,39992,19712,1804,11361,1282,31073,5833,4393,1525,5273,4483
TCTCAGGATCCAGACT,sample,48033,47106,5716,41390,5443,35947,24374,1533,5966,594,30340,3480,3334,1703,4206,3882
ATGGCGTTTCCAGACT,sample,65309,64174,5657,58517,10802,47715,33153,2863,6898,1151,40051,3650,3095,1688,7421,7853
CCATTCTTTCCAGACT,sample,49031,47589,9474,38115,3921,34194,12231,813,11610,1192,23841,8348,5221,1330,3263,2229
AGCGTCTTTCCAGACT,sample,75690,74262,9217,65045,9317,55728,32394,1948,12949,1508,45343,6929,4534,1533,9534,7155
AAGGTCTGTCCAGACT,sample,76351,75278,10979,64299,7913,56386,28846,2018,14227,1324,43073,9971,6503,2010,7907,5119
GCCTATTCTCCAGACT,sample,97883,94292,19840,74452,6666,67786,18297,1215,24483,2704,42780,21087,9685,1613,4880,3762
TGCGCTCCTCCAGACT,Pos_Ctrl,43838,41714,6483,35231,1647,33584,27911,2362,2361,296,30272,654,5648,5711,1821,752
GCGTTACCTCCAGACT,sample,45841,44761,7106,37655,4603,33052,14493,1130,9446,1072,23939,6911,4311,1204,2956,3182
GGCGTACCTCCAGACT,sample,46891,46103,5687,40416,4359,36057,20940,1319,9120,929,30060,3749,3688,1729,3624,3183
CGTCGAGGTCCAGACT,Pos_Ctrl,41022,38753,5993,32760,1395,31365,26196,2216,2034,224,28230,695,5498,5579,1725,686
CAGCTTCGTCCAGACT,sample,53761,52078,9618,42460,4692,37768,15227,942,11208,1211,26435,9180,5293,1251,3574,2874
TTATGACGTCCAGACT,sample,59966,58911,6200,52711,4313,48398,27561,1679,12279,1450,39840,5429,4133,1668,3827,3020
TCTCCTAGTCCAGACT,sample,76645,74876,8688,66188,7560,58628,40578,2124,9017,918,49595,5991,4515,1809,6030,5997
ATTCTACCTCCAGACT,sample,95201,93153,12015,81138,7926,73212,49097,2871,11776,1189,60873,8279,5695,2469,4913,5498
AACCGGTTACCATTAT,sample,110495,109092,8278,100814,22751,78063,62440,5214,6648,720,69088,3041,4345,3878,10915,16354
TCTAGGTTACCATTAT,sample,743554,719053,137552,581501,40828,540673,200932,11911,222235,26410,423167,79185,16880,5248,20072,24384
AGCTGAATACCATTAT,sample,223600,219423,22477,196946,33187,163759,102824,7136,34216,3810,137040,15773,6828,2391,27751,24170
TATACGGAACCATTAT,sample,358687,352949,36735,316214,53729,262485,169933,10843,49858,5459,219791,26392,10147,3716,33783,38401
TCGAACGAACCATTAT,sample,254182,251473,15846,235627,54645,180982,148415,9036,15106,1612,163521,6813,3144,2248,45746,40757
TCATCGAAACCATTAT,sample,249073,243656,36672,206984,26201,180783,74976,5018,55347,6117,130323,39325,12696,3823,13495,17662
ATACGTTCACCATTAT,sample,47144,45854,9081,36773,3836,32937,14154,941,9924,1045,24078,6873,5354,1817,3339,2394
CCGCAGTCACCATTAT,sample,205406,201349,25505,175844,25419,150425,81787,5675,35642,2736,117429,24585,6585,1910,25305,17524
TGGATCAAACCATTAT,sample,370793,365948,33591,332357,58362,273995,169418,7836,54628,4454,224046,37659,6865,2284,47252,43729
GGCAGGTTACCATTAT,sample,223883,221186,16912,204274,52370,151904,116197,9078,18502,2489,134699,5638,4410,2783,26981,36092
TGCGCGTTACCATTAT,sample,340513,335419,33396,302023,30690,271333,136481,8237,87706,9824,224187,29085,7724,2567,29600,24257
CGGTTGGTACCATTAT,sample,302229,298598,22620,275978,24256,251722,151521,8427,64058,8231,215579,19485,5717,2430,31264,17167
TAGCGAGTACCATTAT,sample,356171,352019,26049,325970,54882,271088,221495,14959,23010,3907,244505,7717,2730,1995,55266,41693
TAACGAAGACCATTAT,sample,368660,363128,37926,325202,49943,275259,162903,16265,52789,7390,215692,35912,11349,3501,30069,35535
CAGCTTCGACCATTAT,sample,344308,337942,38925,299017,38513,260504,145401,12274,59266,5987,204667,37576,11014,3153,26330,26128
CGCGAGACACCATTAT,sample,246956,243379,21237,222142,32546,189596,130954,8331,28863,3438,159817,18010,4554,1891,33923,24856
ATATGCAAACCATTAT,sample,232167,229771,16210,213561,23658,189903,128026,10014,36892,4055,164918,10916,4473,2689,17920,18059
AACCGGTTCAATGGAT,sample,353911,348878,34452,314426,56399,258027,176105,9263,44030,5152,220135,23477,6101,2070,66022,40768
AGAGTTCTCAATGGAT,sample,293149,289447,36888,252559,42137,210422,94620,7282,53726,6456,148346,48338,10772,3055,24001,25881
GACGTATGCAATGGAT,sample,311330,306436,33184,273252,31916,241336,136073,7986,62684,7916,198757,26677,9428,4266,17577,23119
CATAATGGCAATGGAT,sample,307394,302232,39234,262998,38394,224604,108261,8030,62437,6299,170698,39577,10309,2508,38365,25425
GAGCCTCCCAATGGAT,sample,250071,246675,20439,226236,24892,201344,117722,7055,52525,7185,170247,16857,5914,2666,22249,18946
TCGAACGACAATGGAT,sample,316305,310762,35944,274818,38815,236003,136670,8579,53659,6042,190329,31053,10071,3007,23103,27352
CGTCGCCACAATGGAT,sample,310576,305544,38164,267380,47927,219453,110631,7199,55726,7333,166357,38564,10719,2422,38815,31513
GCAACTAGCAATGGAT,sample,122442,121100,8413,112687,18616,94071,63981,5175,16811,2902,80792,5202,4036,2620,10697,13828
TACGCGAGCAATGGAT,sample,62712,61513,5524,55989,20755,35234,22332,1760,6813,711,29145,3618,2323,1020,7408,11933
ATACGTTCCAATGGAT,sample,243574,240182,19469,220713,26770,193943,119767,8529,43299,5509,163066,16839,5632,2482,25518,20557
CCGCAGTCCAATGGAT,sample,165292,162780,15133,147647,21136,126511,84443,6283,21631,1909,106074,12245,5589,2279,19392,15801
TGGATCAACAATGGAT,sample,148565,145575,20456,125119,20743,104376,56999,4065,26779,2793,83778,13740,6889,2327,13895,14581
CGGTTGGTCAATGGAT,sample,171483,168374,22467,145907,20886,125021,67501,4304,30179,4013,97680,19024,7859,2173,19358,14814
CTAAGCATCAATGGAT,sample,237180,234811,14202,220609,43047,177562,152378,9585,11649,1692,164027,2258,1613,1424,46591,34482
GGCGACGACAATGGAT,sample,256623,250390,37047,213343,23626,189717,86811,8533,49842,5318,136653,39213,11444,2926,18875,15006
GCTGCTTCCAATGGAT,sample,217613,214380,19480,194900,26243,168657,120622,11199,23728,2716,144350,10392,6190,2965,22089,20694
GCCTATTCCAATGGAT,sample,181842,179777,12478,167299,33116,134183,112737,9132,7074,2097,119811,3143,1403,1312,36255,25803
ATACCGCCCAATGGAT,Neg_Ctrl,4966,2800,2102,698,97,601,347,24,152,14,499,64,310,142,101,34
CAGCTTCGCAATGGAT,Neg_Ctrl,3076,1964,1026,938,151,787,500,34,140,16,640,97,411,246,108,51
CGCGGTCGCAATGGAT,sample,187032,184659,16605,168054,20626,147428,89195,8505,32919,3506,122114,13303,4924,1758,18113,14831
TCTCCTAGCAATGGAT,sample,250206,245405,30766,214639,31808,182831,105586,5879,40356,3855,145942,27155,8054,2029,32255,22396
AGATACTACAATGGAT,sample,339559,335168,29336,305832,40075,265757,183000,16807,38927,3675,221927,23348,7806,2370,37485,30243
CCTAACTACAATGGAT,Pos_Ctrl,118859,111805,16537,95268,4007,91261,76272,6666,5673,851,81945,1799,7212,9408,4168,1788
GCGCAATACAATGGAT,sample,438743,432375,46750,385625,33360,352265,176846,10833,109496,15242,286342,39848,8063,2769,30780,20713
AGAGTTCTAGATTCAT,sample,257246,253068,28290,224778,39095,185683,107809,7743,40063,4375,147872,25693,8840,2439,29793,25587
AGCTGAATAGATTCAT,sample,254925,252155,16307,235848,49313,186535,151646,12461,16382,1976,168028,4070,3266,2910,36795,35572
GACGTATGAGATTCAT,sample,142491,140312,12624,127688,25333,102355,68874,4467,18367,2221,87241,8426,4793,1694,24159,18423
CATAATGGAGATTCAT,sample,339072,331642,54297,277345,27947,249398,100494,6624,83472,8949,183966,49859,14281,4630,10633,18804
TATACGGAAGATTCAT,sample,214744,211948,16610,195338,23110,172228,109407,7769,37233,4895,146640,12924,4962,2980,16847,16861
TCATCGAAAGATTCAT,sample,241813,239430,16676,222754,44221,178533,138315,11238,19215,1529,157530,8236,3731,2701,30011,32260
GACTCAAGAGATTCAT,sample,184295,182373,11362,171011,27015,143996,105619,7491,21120,3507,126739,6259,3928,2532,22572,20893
TGGATCAAAGATTCAT,sample,226348,223760,17817,205943,37007,168936,117090,10519,27952,2772,145042,10603,5918,2413,28149,26337
TGCGCGTTAGATTCAT,sample,238241,236018,16844,219174,33913,185261,136551,10002,25360,2271,161911,11077,5737,2611,31092,24862
CCATTCTTAGATTCAT,sample,201219,199563,11950,187613,41659,145954,113737,8139,16518,1144,130255,6416,3542,1710,32592,29730
TAGCGAGTAGATTCAT,sample,151606,149559,13147,136412,25025,111387,73239,4218,19974,3135,93213,10821,4870,1391,21763,18757
AAGGTCTGAGATTCAT,sample,159018,156583,16285,140298,19343,120955,71860,5065,25636,2484,97496,15910,7048,1767,17025,14889
CCTAGCGGAGATTCAT,sample,101380,100408,5655,94753,17055,77698,66869,5049,4276,461,71145,1043,1372,1231,16890,13931
TGCGCTCCAGATTCAT,sample,178986,176886,12213,164673,22803,141870,111333,9187,13651,2020,124984,5679,4540,2956,16365,17691
CGTCGAGGAGATTCAT,sample,138647,137062,9916,127146,24561,102585,88812,5282,6194,1066,95006,1231,1395,1280,25043,19275
TCTCCTAGAGATTCAT,sample,168363,164902,14457,150445,25997,124448,105175,6877,9267,1300,114442,1829,1788,1323,29448,20085
ATGAATAGAGATTCAT,sample,380557,372711,59760,312951,28689,284262,91069,5561,97588,10163,188657,79881,17336,3975,25667,18505
ATTCTACCAGATTCAT,sample,228867,226495,17439,209056,40333,168723,110917,6653,30200,2491,141117,18462,6604,1909,28887,27636
AACCGGTTCAATCTTG,sample,65211,64219,8952,55267,9846,45421,21910,1758,12121,1281,34031,8351,6420,2551,5507,6504
CTGGTCTTCAATCTTG,sample,144163,141645,14989,126656,21943,104713,70361,4439,17703,1749,88064,10461,5395,2264,18559,15424
AGAGTTCTCAATCTTG,sample,98263,96831,9217,87614,16864,70750,45802,3656,13937,1443,59739,5912,4674,2029,13164,11992
AGCTGAATCAATCTTG,sample,107201,105381,8924,96457,11959,84498,56737,3368,17394,1791,74131,5208,3927,2732,7029,9413
CATAATGGCAATCTTG,sample,143824,140977,13769,127208,21322,105886,65007,3892,21553,2186,86560,13248,5530,2033,19817,15808
CTAGCGACCAATCTTG,sample,251889,248513,22114,226399,37289,189110,124643,9884,32095,3048,156738,19440,7950,2665,18626,27080
CGTCGCCACAATCTTG,sample,280529,276759,22170,254589,33252,221337,149965,11868,36078,3875,186043,19551,4791,1695,33227,24789
TCATACCACAATCTTG,sample,337867,331145,43828,287317,29106,258211,105965,8760,77176,7959,183141,58351,13075,2858,22102,18823
GCAACTAGCAATCTTG,sample,76577,75469,8766,66703,14170,52533,29061,2101,12304,1447,41365,7620,5024,1384,10815,10033
TACGCGAGCAATCTTG,sample,372439,365249,52009,313240,36776,276464,122745,8982,77626,8547,200371,58564,13155,3021,39397,24826
GACTCAAGCAATCTTG,sample,311811,307215,30759,276456,33696,242760,171974,14756,32260,3296,204234,20474,7450,3165,24495,24543
TCTCAGGACAATCTTG,sample,293012,286474,42380,244094,31958,212136,95647,4439,56090,5495,151737,50465,10747,2591,30853,21765
TGGATCAACAATCTTG,sample,301882,296745,33462,263283,34082,229201,133267,7017,54233,5848,187500,28836,9039,2595,30536,25005
AGCGTCTTCAATCTTG,sample,274886,269662,35512,234150,15325,218825,92430,5433,71260,8979,163690,40723,9708,2555,11606,7724
CTAACCGGCAATCTTG,sample,216439,213227,19391,193836,15448,178388,101016,5133,48097,6046,149113,18096,5851,2167,15390,11684
GCTGCTTCCAATCTTG,sample,250898,248198,15749,232449,36828,195621,158747,12019,17466,1534,176213,5855,3103,2421,31559,28423
GCCTATTCCAATCTTG,sample,126591,123195,21235,101960,12107,89853,35916,2813,26470,2829,62386,21825,8189,1433,11157,7646
CAGCTTCGCAATCTTG,sample,177149,175163,13063,162100,26247,135853,118246,7727,6467,820,124713,2593,1502,1297,32155,20894
TTATGACGCAATCTTG,sample,278714,273946,33924,240022,22807,217215,112420,7356,53897,6005,166317,37537,8940,2123,23465,14292
CGTAGAACCAATCTTG,sample,210282,204240,32592,171648,18792,152856,83584,7040,33505,3614,117089,25113,9920,3130,15622,12931
GCGCAATACAATCTTG,Neg_Ctrl,2591,1610,994,616,70,546,315,24,136,12,451,59,292,152,56,24
AACCGGTTCGTTCCGA,sample,475731,470415,37290,433125,43536,389589,211744,11193,120638,14662,332382,31352,6395,2776,40300,29608
GTCGTTCTCGTTCCGA,sample,438102,433329,30290,403039,75102,327937,259869,20573,30604,4873,290473,12018,6074,3063,58683,53650
TCGAACGACGTTCCGA,sample,137607,135928,11309,124619,16212,108407,76898,5864,17499,2498,94397,5648,4184,3035,11199,12889
CGTCGCCACGTTCCGA,sample,120763,118491,12825,105666,20839,84827,62315,4031,10529,1330,72844,6622,4788,2579,15811,14276
TGATTCCGCGTTCCGA,sample,363849,358888,34029,324859,53119,271740,171406,12624,59239,6144,230645,22327,7130,2613,37920,39212
GCAACTAGCGTTCCGA,sample,140828,139134,13285,125849,26015,99834,62947,3557,18896,2207,81843,12227,5814,1965,19866,18589
TACGCGAGCGTTCCGA,sample,175645,172711,17132,155579,30094,125485,85312,6859,20399,2776,105711,10139,5554,2253,24253,21307
CCGCAGTCCGTTCCGA,sample,240258,237393,16089,221304,57414,163890,135846,8316,12540,2139,148386,5049,1750,1417,54552,40448
CCATTCTTCGTTCCGA,sample,1015116,995315,156249,839066,56410,782656,231817,15500,310523,37771,542340,187045,22569,7167,40877,30445
GCTCTTCTCGTTCCGA,sample,586471,578596,69481,509115,68332,440783,239969,16569,97313,10196,337282,76736,14692,4131,53816,46590
AAGGTCTGCGTTCCGA,sample,295488,291576,28458,263118,36533,226585,143521,9616,44710,6381,188231,22357,8182,2662,33562,27734
GCGTTACCCGTTCCGA,sample,499205,491208,68456,422752,42723,380029,188830,16227,106044,12397,294874,56531,12318,3475,35006,25385
CAGCTTCGCGTTCCGA,sample,218693,215198,22708,192490,30802,161688,100491,7883,30539,3033,131030,19742,6414,1904,27352,22038
TTATGACGCGTTCCGA,sample,331350,328030,37548,290482,46019,244463,113911,8538,65496,7506,179407,49012,13309,3193,27304,29237
AAGTAGAGCGTTCCGA,sample,419063,414674,33394,381280,31563,349717,201230,13120,84955,10430,286185,39982,8991,2922,34715,21717
ATTCTACCCGTTCCGA,sample,299852,296843,24460,272383,42620,229763,161694,13513,37501,3647,199195,13408,6627,2669,29892,32327
CCTAACTACGTTCCGA,sample,108927,107387,12183,95204,9297,85907,40956,2381,26707,2826,67663,13037,5837,1776,7755,5626
TTAACTGACGTTCCGA,sample,1557,1510,232,1278,172,1106,674,34,225,30,899,143,472,264,156,108
AACCGGTTCAATTCGG,sample,284509,281237,28331,252906,42213,210693,132622,9362,35691,3493,168313,29525,9472,3376,25783,27600
CTGGTCTTCAATTCGG,Pos_Ctrl,198275,190692,25458,165234,7319,157915,134072,11249,8940,1082,143012,2572,8279,11877,10449,3410
GTCGTTCTCAATTCGG,sample,461253,455577,35044,420533,84878,335655,235209,18427,47376,6298,282585,28345,7625,3291,53476,59343
AGCTGAATCAATTCGG,sample,143786,141925,15786,126139,20008,106131,62805,4416,21725,2580,84530,14605,6489,1912,18365,13266
CATAATGGCAATTCGG,sample,261297,259227,14095,245132,53313,191819,148137,10241,19369,2072,167506,12000,6442,3328,45340,36407
CATACTCCCAATTCGG,Pos_Ctrl,142811,133693,18775,114918,4415,110503,93270,7913,6298,847,99568,2175,7364,10315,4393,1469
TCATACCACAATTCGG,sample,382904,377156,39476,337680,42678,295002,169669,11496,64778,6630,234447,42429,10483,3194,32294,28615
TGATTCCGCAATTCGG,sample,49187,48017,6769,41248,6246,35002,20562,1776,7021,771,27583,4872,4218,1554,6060,4315
GACTCAAGCAATTCGG,Pos_Ctrl,45665,43269,6417,36852,1627,35225,29645,2374,2223,291,31868,692,5776,6024,2433,669
TGGATCAACAATTCGG,sample,243774,237297,49066,188231,20701,167530,54284,2836,60734,5907,115018,43769,13597,2837,16377,12464
GGCAGGTTCAATTCGG,sample,121660,119514,12648,106866,22005,84861,54270,4141,15940,1678,70210,8832,6085,2610,14870,15122
GATGCGTTCAATTCGG,sample,228263,220975,49570,171405,19267,152138,40447,2387,56821,5876,97268,46607,13520,3096,8685,10832
ATGGCGTTCAATTCGG,Pos_Ctrl,136178,130695,17249,113446,4534,108912,91780,7769,6448,803,98228,2112,7540,10110,6043,1611
AGCGTCTTCAATTCGG,sample,388703,384685,25278,359407,49985,309422,229475,21043,39441,4365,268916,15098,6234,3854,28952,36821
GAGATTCTCAATTCGG,Pos_Ctrl,158864,151114,20928,130186,5693,124493,104864,8826,7697,1035,112561,2071,7783,10669,7349,2589
AGCAGAGCCAATTCGG,Pos_Ctrl,162796,155324,21580,133744,5190,128554,108391,9368,7413,924,115804,2458,7780,11003,7275,2185
CGTCGAGGCAATTCGG,Pos_Ctrl,110940,105517,14873,90644,3707,86937,73176,6029,5553,708,78729,1471,7275,9354,4247,1364
TAACGCCACAATTCGG,sample,250760,246582,27793,218789,24997,193792,112226,8647,40339,4084,152565,28496,9775,2211,27537,18197
CGTAGAACCAATTCGG,sample,295248,291144,23297,267847,22051,245796,163915,12318,43143,5606,207058,20814,6148,2238,30875,17230
ATATGCAACAATTCGG,sample,398529,393973,26711,367262,34782,332480,245783,18050,39812,5269,285595,23566,7489,2291,45954,25700
AACCGGTTAACTCCGG,sample,283940,280124,24617,255507,63300,192207,127097,8056,33208,4796,160305,19050,5704,2473,35880,42900
TCTAGGTTAACTCCGG,sample,199558,196896,16577,180319,34340,145979,108277,6344,19681,2059,127958,9618,5028,2631,29797,23925
GGTAGAGAAACTCCGG,sample,249767,245246,24476,220770,29366,191404,126633,10347,31600,4104,158233,18720,7823,2176,23106,21131
CGTCGCCAAACTCCGG,sample,166770,164632,9642,154990,19885,135105,113600,9682,9071,1349,122671,1403,1436,1272,25032,15266
TCATCGAAAACTCCGG,sample,249101,242814,38419,204395,15427,188968,73834,6957,62556,5692,136390,39929,11200,2376,15114,9127
TACGCGAGAACTCCGG,sample,181755,177878,18587,159291,25253,134038,95235,6329,20414,2766,115649,9294,4199,2010,31632,17693
ATACGTTCAACTCCGG,sample,278768,272758,39568,233190,29627,203563,93572,8604,55321,5208,148893,40858,11046,2506,25962,19725
TGCGCGTTAACTCCGG,sample,459119,447471,71763,375708,26049,349659,126311,9154,110415,11562,236726,92217,15642,4302,19995,14370
AGCGTCTTAACTCCGG,sample,355714,348871,53136,295735,26238,269497,104403,6356,82343,9707,186746,66688,13401,3423,23981,16708
AAGGTCTGAACTCCGG,sample,366918,359860,49480,310380,44861,265519,125240,8735,70716,6872,195956,53956,14688,3645,30861,30614
CTAACCGGAACTCCGG,sample,253268,249115,29108,220007,26129,193878,125606,9555,33876,4821,159482,20020,7370,2380,28984,19581
GCTGCTTCAACTCCGG,sample,205642,201892,26236,175656,21211,154445,73900,6074,46430,5236,120330,22805,8791,2677,15783,13745
GCCTATTCAACTCCGG,sample,301063,297279,27816,269463,38945,230518,134926,8711,45856,4861,180782,36164,9170,2384,34523,27846
TGCGCTCCAACTCCGG,sample,212514,210210,14732,195478,29254,166224,126969,8967,20014,2167,146983,8107,5222,2656,24740,20312
ATACCGCCAACTCCGG,sample,74558,73495,6120,67375,8244,59131,38815,3469,11615,1072,50430,4160,5281,3970,3374,5919
GCGTTACCAACTCCGG,sample,253209,249972,23087,226885,34790,192095,125750,6316,32149,3478,157899,24402,8302,2230,32477,24050
CGTCGAGGAACTCCGG,sample,169998,167940,12856,155084,21777,133307,103427,7333,14432,1205,117859,6910,3953,1803,29732,16116
CAGCTTCGAACTCCGG,sample,256844,254251,14211,240040,32008,208032,169043,15608,15509,2254,184552,5618,4476,2608,25516,22072
TTATGACGAACTCCGG,sample,208851,206119,14936,191183,26289,164894,123852,8615,18966,2449,142818,11012,5657,2375,22971,19638
TAACGCCAAACTCCGG,sample,200160,198058,14869,183189,27756,155433,117763,9665,15273,1930,133036,10802,4008,1772,25526,19491
CGCGAGACAACTCCGG,sample,229547,225760,19462,206298,28729,177569,129673,8196,23655,2298,153328,13747,5358,2067,29239,19798
AGATACTAAACTCCGG,sample,246987,243059,34234,208825,13023,195802,73368,4943,68460,7440,141828,41591,10904,2922,9833,6872
ATATGCAAAACTCCGG,sample,776,747,157,590,72,518,323,12,107,11,430,65,297,156,62,44
TCTAGGTTCCTGAAGG,sample,327744,321042,46009,275033,29260,245773,86591,6314,78664,9062,165255,65142,13239,3347,12540,16860
CTGGTCTTCCTGAAGG,sample,317829,313236,32078,281158,46019,235139,149561,11812,42380,4449,191941,26937,6990,2470,43798,31108
GTCGTTCTCCTGAAGG,Neg_Ctrl,3658,2339,1395,944,154,790,396,24,243,22,639,105,355,184,85,58
AGAGTTCTCCTGAAGG,sample,243815,237519,37413,200106,19221,180885,66087,4688,65201,7045,131288,37864,10931,2803,14547,12300
GACGTATGCCTGAAGG,sample,254595,249638,26162,223476,37144,186332,112602,7760,36661,3077,149263,26232,6765,2507,26038,25490
CTAGCGACCCTGAAGG,Neg_Ctrl,4571,3059,1902,1157,120,1037,568,46,266,31,834,126,568,245,129,63
TCATCGAACCTGAAGG,sample,284224,279241,29902,249339,28609,220730,114603,7281,63601,7405,178204,27840,6673,2264,31908,19887
TCATACCACCTGAAGG,sample,262401,256277,36369,219908,29345,190563,99668,6578,44412,4405,144080,35500,9110,2340,25025,20885
GCAACTAGCCTGAAGG,sample,114376,112911,10766,102145,17973,84172,54949,4983,14953,1298,69902,7989,5653,2255,9951,13846
ATACGTTCCCTGAAGG,Neg_Ctrl,3242,2208,1152,1056,123,933,496,35,203,24,699,175,458,203,127,83
TGGATCAACCTGAAGG,sample,153963,152083,11226,140857,27116,113741,95325,8223,6768,1213,102093,2212,1349,1356,27928,20223
TGCGCGTTCCTGAAGG,Neg_Ctrl,3581,2380,1392,988,110,878,437,26,210,11,647,194,401,176,101,58
CCATTCTTCCTGAAGG,sample,179088,174154,24672,149482,17527,131955,65981,4175,32630,3982,98611,25187,8297,2079,16510,11216
ACGCTTAACCTGAAGG,sample,267293,260057,37588,222469,26602,195867,94702,5472,52658,5858,147360,37177,11217,2869,22468,18881
CTAAGCATCCTGAAGG,Neg_Ctrl,3576,2369,1452,917,112,805,449,22,218,27,667,89,414,187,91,47
AAGGTCTGCCTGAAGG,sample,155341,152256,15807,136449,26779,109670,79291,5177,16749,1597,96040,6856,4886,2324,20583,19060
TGCGCTCCCCTGAAGG,Neg_Ctrl,2573,1488,889,599,72,527,319,19,93,12,412,84,284,154,74,23
CGTCGAGGCCTGAAGG,sample,160020,158226,8988,149238,19344,129894,110156,9141,8572,488,118728,1537,1469,1415,23438,15873
CAGCTTCGCCTGAAGG,Neg_Ctrl,2459,1467,886,581,68,513,297,30,112,9,409,65,276,126,70,31
TAACGCCACCTGAAGG,sample,140922,139184,9635,129549,22520,107029,85788,8162,10550,819,96338,1710,1301,1198,25100,17713
AGATACTACCTGAAGG,sample,160620,158643,12027,146616,21023,125593,104252,5693,10344,478,114596,4826,1985,1283,26073,18236
GCGCAATACCTGAAGG,sample,276512,272129,30576,241553,17548,224005,111025,7666,65356,7807,176381,32151,8531,2170,17894,11334
AACCGGTTAATATTCG,sample,332934,328075,27854,300221,48058,252163,166510,10785,46227,5762,212737,22879,5552,2290,47109,35908
GACGTATGAATATTCG,sample,193413,190925,14208,176717,41338,135379,104215,7277,14546,1768,118761,7573,4140,1691,34767,28916
CTAGCGACAATATTCG,sample,408882,400566,46883,353683,23523,330160,154704,9551,109800,16656,264504,39449,10386,3400,17798,15880
TACGCGAGAATATTCG,sample,399546,394445,37996,356449,55650,300799,186640,15153,58650,8208,245290,32148,9043,2601,47529,42081
GACTCAAGAATATTCG,sample,240073,236376,23445,212931,31998,180933,112713,7528,37912,4424,150625,18356,6085,2265,32093,23756
ATACGTTCAATATTCG,sample,274300,270132,27629,242503,37649,204854,114162,6861,45672,3931,159834,34228,6424,2140,38408,26487
TCTCAGGAAATATTCG,sample,342735,334182,50500,283682,30490,253192,105537,8496,73443,7875,178980,57841,13953,3173,23175,19470
GATGCGTTAATATTCG,sample,308296,304721,23266,281455,55291,226164,171760,10688,25948,3830,197708,13938,4386,2039,46978,40686
AGCGTCTTAATATTCG,sample,266048,261829,18684,243145,55881,187264,161434,10925,9951,935,171385,4019,2939,2355,37026,39924
CGGTTGGTAATATTCG,sample,232883,230091,16306,213785,35402,178383,136045,8632,18992,3173,155037,11541,5188,1931,34625,24046
GCTCTTCTAATATTCG,sample,137639,133722,22368,111354,14696,96658,42067,2798,28322,2882,70389,20589,8117,1917,11566,9472
TAACGAAGAATATTCG,sample,263362,260144,25696,234448,42535,191913,119468,9745,35682,3608,155150,23410,9915,2798,30553,28134
TCTCCTAGAATATTCG,sample,294699,289935,28697,261238,28266,232972,148063,11613,43569,4088,191632,25639,8320,2286,31740,19988
ATGAATAGAATATTCG,sample,454039,448751,41752,406999,37983,369016,212546,18785,82442,10677,294988,44566,9741,2998,40261,24244
ATTCTACCAATATTCG,Pos_Ctrl,166988,159688,20291,139397,5425,133972,112908,9757,7735,1024,120643,2548,7822,11164,6908,2089
CGTAGAACAATATTCG,sample,719451,701741,108433,593308,30809,562499,167943,10491,209588,23259,377531,151218,20028,6227,14661,15187
ATATGCAAAATATTCG,sample,83676,83173,3507,79666,8518,71148,57444,5214,5798,891,63242,1801,3994,3749,5437,5898
GTCGTTCTAGTCTCCG,sample,105773,104312,8729,95583,17381,78202,55495,3777,10651,1306,66146,6973,3870,1338,21746,13341
GACGTATGAGTCTCCG,sample,309105,303712,35885,267827,38041,229786,111063,6666,63116,7444,174179,41497,12336,2988,34046,26586
CATAATGGAGTCTCCG,sample,187702,184369,22887,161482,22021,139461,66880,4272,39780,4272,106660,24257,8991,2339,23439,14978
GGAGAAGCAGTCTCCG,sample,101001,99421,8271,91150,14950,76200,54262,3695,12318,1138,66580,4787,3875,1935,14200,11391
TGATTCCGAGTCTCCG,sample,320067,316597,26325,290272,50513,239759,162298,12016,41297,3250,203595,20898,7546,2507,41107,36299
GCAACTAGAGTCTCCG,sample,76949,75938,5953,69985,13701,56284,41598,2696,8374,958,49972,2658,3072,1658,13219,9686
CCGCAGTCAGTCTCCG,sample,170903,167839,16897,150942,21110,129832,82720,5471,22905,2861,105625,15875,7615,3019,11078,15021
ATGGCGTTAGTCTCCG,sample,297693,293896,21772,272124,33064,239060,160559,11556,42619,5070,203178,19256,7072,2713,36143,23188
AGCGTCTTAGTCTCCG,sample,328612,324796,27555,297241,27310,269931,163380,7915,64197,8259,227577,26180,7500,2665,30879,18868
ACGCTTAAAGTCTCCG,sample,296024,292701,23963,268738,35214,233524,143785,10779,49200,4363,192985,25397,6579,2140,29806,26411
CTAAGCATAGTCTCCG,sample,354709,350008,31437,318571,28372,290199,178364,11609,59230,8592,237594,32404,9348,3090,25784,19675
GCTGCTTCAGTCTCCG,sample,227333,224524,18522,206002,25636,180366,113585,6986,32211,3826,145796,23758,6802,2141,29968,18397
GCCTATTCAGTCTCCG,sample,178587,176864,11765,165099,31072,134027,110682,10159,9668,979,120350,2539,2579,2221,30384,23159
GTCGCGAAAGTCTCCG,sample,273507,269927,26598,243329,31956,211373,143479,9884,34026,3533,177505,20451,7106,2615,30089,21475
CGCGGTCGAGTCTCCG,sample,270251,265481,35417,230064,16866,213198,77033,5279,66653,6903,143686,57330,12447,2661,14000,10212
TCTCCTAGAGTCTCCG,sample,244697,239440,28300,211140,19841,191299,83975,6173,57547,6601,141522,37003,10657,2590,18887,13505
TCAATCAGAGTCTCCG,sample,277145,274442,16147,258295,27241,231054,198240,15977,9807,2207,208047,4823,3482,3066,25418,20217
CCTAACTAAGTCTCCG,sample,174214,172336,14325,158011,22313,135698,108286,8494,11707,1439,119993,5772,3557,2175,19094,16989
GTCGTTCTTGCCTACG,sample,178646,175481,19745,155736,26019,129717,68492,5242,31183,3280,99675,21520,7904,1913,22844,17174
CATAATGGTGCCTACG,sample,89701,86471,18366,68105,9634,58471,22388,1203,18476,1858,40864,14546,7427,1553,7747,5320
TCGAACGATGCCTACG,sample,108293,106005,15136,90869,13217,77652,42440,3860,17080,1917,59520,12355,7023,2699,8738,8433
TGATTCCGTGCCTACG,sample,91219,89941,6776,83165,18927,64238,53859,4827,3877,435,57736,1240,1866,1767,14873,13920
GCAACTAGTGCCTACG,sample,50696,49875,6422,43453,7140,36313,17936,1213,9183,1034,27119,6947,4800,1247,5698,4974
TCTCAGGATGCCTACG,sample,157508,154934,14917,140017,15846,124171,80955,5104,24590,2236,105545,11286,4669,1763,19219,12119
TGCGCGTTTGCCTACG,sample,175564,172330,22592,149738,17748,131990,72949,4454,30290,3296,103239,21001,8226,2122,19315,12156
AGCGTCTTTGCCTACG,sample,109883,108445,8228,100217,18742,81475,68564,4769,6202,529,74766,1411,2024,1935,16651,13907
GAGATTCTTGCCTACG,sample,97746,96482,5619,90863,14484,76379,64280,5984,4678,637,68958,800,1006,1034,19866,11731
AAGGTCTGTGCCTACG,sample,15246,15069,960,14109,2223,11886,7898,798,1937,272,9835,981,1481,844,1708,1494
TGCGCTCCTGCCTACG,sample,122941,121603,7102,114501,12545,101956,75787,6074,14690,1905,90477,3500,2590,2013,14712,10440
GCGTTACCTGCCTACG,sample,110227,107711,18447,89264,11040,78224,33817,2236,20933,2115,54750,19123,6735,1422,9783,7259
GTCGCGAATGCCTACG,sample,124595,122006,15893,106113,13403,92710,47983,4051,21451,2304,69434,16921,6877,1823,10215,8974
TTATGACGTGCCTACG,sample,263990,260559,28996,231563,21619,209944,123217,10180,40573,4735,163790,31239,8644,2353,22482,15325
GACTAACCTGCCTACG,Neg_Ctrl,1824,1047,693,354,43,311,189,10,61,8,250,43,169,84,51,18
AGATACTATGCCTACG,sample,159167,157568,11354,146214,17020,129194,97739,8382,14389,1998,112128,6686,4621,2182,19479,12079
TTAACTGATGCCTACG,sample,145083,143309,15599,127710,14953,112757,74407,4607,19155,1430,93562,13158,5307,1448,20570,8637
CTGGTCTTCTTAGTTC,sample,150277,147423,17170,130253,21724,108529,64867,5834,21465,2728,86332,13635,5470,2065,18749,14966
TATACGGACTTAGTTC,sample,420596,410856,65493,345363,62244,283119,120032,8925,81526,9056,201558,63580,16339,4174,27876,37683
TCGAACGACTTAGTTC,sample,296897,292525,23688,268837,21692,247145,153783,10587,55384,6133,209167,21258,6835,3218,18915,14606
GGTAGAGACTTAGTTC,sample,203365,200731,15654,185077,40406,144671,103536,7984,20926,2430,124462,9795,4283,2277,23259,28919
TCATCGAACTTAGTTC,sample,381599,375121,39213,335908,62834,273074,172164,13384,50185,5562,222349,31779,10057,3457,33654,44702
TGATTCCGCTTAGTTC,sample,268213,265539,16458,249081,55784,193297,161501,12720,12675,859,174176,5542,3465,2564,40883,40321
GGCGACGACTTAGTTC,sample,139758,136776,17080,119696,17430,102266,61952,4898,18566,2029,80518,14821,7100,2017,13648,12527
GCGTTACCCTTAGTTC,sample,418723,412490,45738,366752,37570,329182,141216,8692,99850,9533,241066,69891,13559,3502,33987,24655
CAGCTTCGCTTAGTTC,sample,333001,328761,27620,301141,47806,253335,170660,16009,38059,4839,208719,23768,9156,3617,24339,33566
TTATGACGCTTAGTTC,sample,165826,163058,19406,143652,20259,123393,79655,4530,22777,2291,102432,14140,7078,2830,9886,13523
TCTCCTAGCTTAGTTC,sample,297122,292100,35338,256762,24922,231840,120084,7602,55459,6953,175543,41742,11715,2892,34501,16715
TCTAGGTTCGAGCTTC,sample,230231,227555,16221,211334,41671,169663,123949,8942,20514,2818,144463,13440,4991,2111,37399,29843
GTCGTTCTCGAGCTTC,sample,68613,67623,5471,62152,13800,48352,39714,3144,4022,610,43736,862,1268,1080,14326,10129
AGAGTTCTCGAGCTTC,sample,153637,150352,15074,135278,18220,117058,61499,3407,34459,4554,95958,13139,5003,2062,16580,12981
GGTAGAGACGAGCTTC,sample,364782,361224,19463,341761,49442,292319,227025,12080,36359,5119,263384,11736,3150,1806,49251,38323
ATTCAAGGCGAGCTTC,sample,225372,222731,14780,207951,29526,178425,144110,10368,14765,3003,158875,6179,3122,1537,31804,23052
TACGCGAGCGAGCTTC,sample,400591,391602,48178,343424,49926,293498,162491,10811,66755,7219,229246,46222,11667,2952,43339,35043
GGCAGGTTCGAGCTTC,sample,566996,560195,43109,517086,115836,401250,247823,22329,82054,9486,329877,39558,9089,3407,70542,77802
AGCGTCTTCGAGCTTC,sample,336433,331561,35221,296340,32928,263412,151900,11014,58235,6475,210135,35788,8700,2287,42856,24049
CATTCGGTCGAGCTTC,sample,381340,377478,22443,355035,47111,307924,244174,20966,25682,3336,269856,13766,5754,2748,40815,29776
GCTCTTCTCGAGCTTC,sample,481237,474985,49344,425641,40192,385449,161925,14131,106667,12040,268592,90686,15218,3924,46507,22818
GAGATTCTCGAGCTTC,sample,183692,180555,16112,164443,13638,150805,85688,4707,39850,6783,125538,13777,5282,2276,15041,9108
AAGGTCTGCGAGCTTC,sample,245160,242306,18274,224032,26412,197620,122417,10028,43759,5810,166176,15606,6668,3131,19897,20651
CCTAGCGGCGAGCTTC,sample,163911,162254,9830,152424,33016,119408,92074,7948,13654,1412,105728,4320,3833,2195,21458,22997
CTAACCGGCGAGCTTC,sample,232387,230038,16578,213460,26745,186715,121415,9165,35819,5549,157234,14767,6105,1834,38279,20688
GGCGACGACGAGCTTC,sample,172330,170151,14700,155451,26916,128535,83590,7022,23465,3045,107055,11413,5516,1975,20388,17737
AGCAGAGCCGAGCTTC,sample,374147,369726,29583,340143,43791,296352,208345,13005,41273,3564,249618,30165,8520,2545,38600,31561
ATACCGCCCGAGCTTC,sample,376246,370844,38513,332331,40356,291975,174801,9850,60986,7202,235787,39136,10379,3136,38908,28029
TTATGACGCGAGCTTC,sample,197690,194886,21574,173312,24836,148476,88503,4813,28982,2775,117485,23403,7796,1725,26391,16139
AAGTAGAGCGAGCTTC,sample,210248,207807,14005,193802,35957,157845,128715,10932,12217,1574,140932,4407,3095,1900,29474,25965
TAACGCCACGAGCTTC,sample,229739,225917,26954,198963,24237,174726,91866,4520,42852,4326,134718,31162,10351,2166,28767,17193
GACTAACCCGAGCTTC,sample,413037,408222,34730,373492,42303,331189,193687,16142,75599,10697,269286,35064,7128,2584,34981,30105
CGCGAGACCGAGCTTC,sample,243180,238103,28294,209809,23488,186321,88839,7029,48921,5012,137760,36520,10887,2420,19018,17290
CCTAACTACGAGCTTC,sample,250864,248153,18316,229837,28547,201290,145582,16193,24922,2794,170504,11799,5860,2045,26967,22363
AACCGGTTGTAGAATG,sample,206320,201803,27012,174791,12801,161990,71869,3835,56862,5983,128731,23441,8316,2603,10883,8310
CTGGTCTTGTAGAATG,Pos_Ctrl,79803,75295,11310,63985,2775,61210,51493,4135,3911,466,55404,1205,6801,7937,4074,1322
TATACGGAGTAGAATG,sample,360927,355702,32439,323263,35185,288078,156481,12816,62998,6180,219479,49603,11581,3158,29180,26387
TCATACCAGTAGAATG,sample,342304,337238,36896,300342,50044,250298,159551,12130,42307,4680,201858,31630,7916,2812,31813,35417
GCAACTAGGTAGAATG,Pos_Ctrl,25270,24548,2092,22456,1151,21305,17572,1782,1299,204,18871,448,4890,5424,994,472
CCGTACGCGTAGAATG,sample,275688,271828,20305,251523,36765,214758,155068,8815,36928,3256,191996,10691,3330,1953,38340,27510
GGCAGGTTGTAGAATG,sample,94719,92010,18600,73410,8822,64588,23518,1385,21836,2400,45354,15449,7558,2329,5412,7175
GCTCTTCTGTAGAATG,Pos_Ctrl,134602,128488,17227,111261,4425,106836,89530,7884,6638,861,96168,1923,7664,10100,5527,1517
CCTAGCGGGTAGAATG,sample,185350,183142,14492,168650,31522,137128,95504,9590,18757,2195,114261,11082,4525,1985,28240,23298
TAACGAAGGTAGAATG,sample,399312,393333,47763,345570,43216,302354,161791,11810,72196,7715,233987,48842,12256,3326,34010,27635
GCTGCTTCGTAGAATG,sample,450101,442561,52045,390516,43708,346808,146268,12228,99243,11104,245511,77965,14182,3969,38984,29513
GCCTATTCGTAGAATG,sample,295102,290652,29503,261149,32835,228314,133379,12777,45641,4651,179020,31866,9859,2906,34047,22192
TGCGCTCCGTAGAATG,sample,260660,256759,28304,228455,29081,199374,99174,7392,54935,6419,154109,31454,9356,2283,26552,19638
CGTCGAGGGTAGAATG,sample,243236,240813,17297,223516,22326,201190,134101,8773,42023,5873,176124,10420,4201,2076,21368,16698
CAGCTTCGGTAGAATG,sample,173348,170918,18295,152623,16613,136010,76027,7074,31359,4230,107386,17320,7229,2494,14458,10513
CGCGGTCGGTAGAATG,Pos_Ctrl,96646,92929,11256,81673,3126,78547,66516,5936,4162,619,70678,1314,7020,9281,3893,1021
ATGAATAGGTAGAATG,sample,301007,297738,25196,272542,34608,237934,142450,11865,48513,4832,190963,30274,10573,2805,35643,24911
CGCGAGACGTAGAATG,sample,402166,398076,26808,371268,37782,333486,262474,19933,31296,3385,293770,16398,6520,2676,26354,26912
GCGCAATAGTAGAATG,sample,289849,286794,23788,263006,30957,232049,143128,10310,43695,4667,186823,30249,10029,2622,29246,21348
TCTAGGTTCAATAGTC,sample,132583,130341,16346,113995,19461,94534,52815,3568,21816,2589,74631,13746,6463,1871,16485,12837
AGAGTTCTCAATAGTC,sample,266786,262404,27572,234832,31377,203455,121906,6978,47744,5271,169650,21556,8565,3196,20610,21138
GGTAGAGACAATAGTC,sample,300427,295729,29825,265904,23573,242331,168146,10840,37003,3715,205149,22627,8132,2445,26985,16623
TCATACCACAATAGTC,sample,561926,551384,58979,492405,44046,448359,269893,19895,91598,10770,361491,56203,12063,4252,33336,30219
TGATTCCGCAATAGTC,sample,127727,126101,10792,115309,21684,93625,70650,5327,11141,1347,81791,5160,4683,2652,13406,15448
CCATTCTTCAATAGTC,sample,320407,316706,25370,291336,41492,249844,178147,10751,38845,6173,216992,15928,4622,2132,49097,29781
ACGCTTAACAATAGTC,sample,296870,291398,35234,256164,32183,223981,129961,9100,46942,3830,176903,34148,7757,2329,33599,23092
AAGGTCTGCAATAGTC,sample,260224,257775,24334,233441,15976,217465,104817,7348,69047,9954,173864,26299,8891,2917,15593,10721
CCTAGCGGCAATAGTC,sample,123308,122046,11490,110556,11537,99019,61863,3797,19499,2284,81362,11576,6210,1682,16203,8079
CTAACCGGCAATAGTC,sample,115905,114914,6809,108105,13791,94314,56852,5888,21786,2791,78638,6997,4022,1852,8854,9299
GGCGACGACAATAGTC,sample,235267,232645,24190,208455,17595,190860,99839,6558,52590,5408,152429,26465,9653,2900,17457,12005
TAACGAAGCAATAGTC,sample,199134,197109,17610,179499,18101,161398,104723,6955,29616,2628,134339,17476,7501,2003,24269,12992
GGCGTACCCAATAGTC,sample,169510,168072,10262,157810,26354,131456,102817,10762,11967,1716,114784,4194,2806,1610,32634,19626
CGCGGTCGCAATAGTC,sample,293879,288192,48357,239835,17478,222357,80225,5065,80986,10499,161211,45582,14453,3830,7714,8938
ATGAATAGCAATAGTC,sample,200524,198909,10775,188134,31487,156647,135000,6975,11184,525,146184,2963,1379,1153,40014,24170
GACTAACCCAATAGTC,sample,194279,192138,13569,178569,24712,153857,114293,11717,17060,2280,131353,8507,4003,1823,25190,16724
AGATACTACAATAGTC,sample,359068,354713,29127,325586,28581,297005,201692,14493,46132,4359,247824,30329,8666,2731,41618,20344
CTGGTCTTCGTTACTC,sample,175807,174556,15261,159295,24478,134817,64096,5124,38439,4041,102535,23117,9580,2950,15904,15396
GTCGTTCTCGTTACTC,Neg_Ctrl,5431,3076,1550,1526,258,1268,790,64,243,38,1033,133,588,345,204,88
CATAATGGCGTTACTC,sample,417447,413438,25563,387875,88436,299439,244625,21159,21690,2882,266315,9083,4933,2922,73021,62373
GAGCCTCCCGTTACTC,sample,658585,651733,53607,598126,67488,530638,355039,21228,93694,8446,448733,52231,11479,3576,64090,47279
CTAGCGACCGTTACTC,sample,507146,501392,36175,465217,38203,427014,284032,23839,76010,8258,360042,34875,8183,2861,32616,27585
ATTCAAGGCGTTACTC,sample,482317,475650,46799,428851,65851,363000,205156,11978,91661,11332,296817,42873,10080,2733,75232,50493
TGATTCCGCGTTACTC,sample,736817,727511,75364,652147,97254,554893,309972,25341,129818,12211,439790,77551,14044,3980,80219,69028
TACGCGAGCGTTACTC,Neg_Ctrl,5036,3197,1682,1515,186,1329,767,47,270,70,1037,175,662,322,160,110
CCGCAGTCCGTTACTC,sample,400529,395508,26277,369231,34166,335065,212420,13979,76962,7866,289382,23838,5672,2691,32039,25498
ATGGCGTTCGTTACTC,sample,442939,438466,29401,409065,83554,325511,257101,17762,32073,4099,289174,14476,6092,3099,57653,61163
CATTCGGTCGTTACTC,sample,383703,379532,25489,354043,69939,284104,225681,15921,26764,3418,252445,12320,6687,3857,47762,54519
TAGCGAGTCGTTACTC,sample,324824,318548,52063,266485,44091,222394,87723,6126,70197,7745,157920,50603,13705,2874,25233,27154
GAGATTCTCGTTACTC,Neg_Ctrl,4412,2631,1420,1211,179,1032,602,43,257,16,859,114,497,273,135,72
CTAAGCATCGTTACTC,sample,561292,553529,57397,496132,66198,429934,245183,16732,94301,12330,339484,61388,11745,3066,63157,44326
CCTAGCGGCGTTACTC,sample,213752,211370,16178,195192,36288,158904,118058,7129,20646,2660,138704,10411,4873,1758,36784,27331
GGCGTACCCGTTACTC,sample,393618,387406,41885,345521,49095,296426,193285,12782,57996,5409,251281,26954,9660,3090,53482,34355
CGTCGAGGCGTTACTC,sample,309709,306296,23091,283205,38613,244592,179689,13784,31081,3235,210770,16803,7294,2610,40666,27932
TTATGACGCGTTACTC,Neg_Ctrl,3702,2339,1302,1037,147,890,563,39,166,19,729,103,470,263,143,85
AAGTAGAGCGTTACTC,sample,387151,382271,28890,353381,35021,318360,228370,13217,51318,7141,279688,18314,6474,2600,43935,25914
CCTAACTACGTTACTC,sample,340159,335696,31842,303854,34947,268907,157835,10275,59327,6653,217162,34817,10476,3577,23483,23421
TTAACTGACGTTACTC,sample,475701,471063,35330,435733,57514,378219,282493,18209,51263,4317,333756,21937,4315,2205,56224,40998
TCTAGGTTTGGACTGC,sample,329776,324839,29797,295042,26004,269038,160598,8177,66346,9656,226944,24261,7051,2976,25628,18563
CTGGTCTTTGGACTGC,sample,203279,200152,18523,181629,42752,138877,84723,6864,30784,3332,115507,13174,7185,2800,21791,28872
CATAATGGTGGACTGC,sample,164064,159386,26296,133090,18532,114558,47779,2823,34004,3766,81783,26186,9637,1933,14578,11524
TATACGGATGGACTGC,sample,256629,252132,27180,224952,36004,188948,115293,9645,37103,5339,152396,21568,9155,2187,39407,26131
GGAGAAGCTGGACTGC,sample,263335,258228,37525,220703,43642,177061,105219,6659,33971,3545,139190,27667,8563,2574,29735,29250
CTAGCGACTGGACTGC,sample,366829,360076,38211,321865,42258,279607,166771,11186,62638,6624,229409,32388,9804,2858,30382,29079
TACGCGAGTGGACTGC,sample,339504,330723,37704,293019,22636,270383,179291,12833,50795,5819,230086,21645,9446,6098,7455,15492
CCGTACGCTGGACTGC,sample,180039,177130,14622,162508,16045,146463,96102,6187,29487,4270,125589,10417,5337,2592,11224,11365
TCTCAGGATGGACTGC,sample,146339,143419,14091,129328,15681,113647,74658,5513,20930,1712,95588,10834,4743,1799,20114,11376
GGCAGGTTTGGACTGC,sample,151772,149714,11775,137939,24538,113401,85957,6249,13070,1920,99027,6205,5657,3479,15841,17758
TGCGCGTTTGGACTGC,sample,174811,170940,21034,149906,19364,130542,72274,4333,30553,3777,102827,19605,7377,2360,17477,12675
TAGCGAGTTGGACTGC,sample,251064,247740,26619,221121,33848,187273,103049,7641,43195,4880,146244,28508,9054,2142,38583,21517
GCTCTTCTTGGACTGC,sample,307222,303705,22019,281686,41566,240120,171545,11119,34951,4174,206496,18331,7269,2487,28874,30279
GAGATTCTTGGACTGC,sample,235523,233365,14047,219318,28739,190579,147476,11870,20017,2225,167493,8991,5266,2749,30970,20372
CGTCGAGGTGGACTGC,sample,179141,177059,10757,166302,19339,146963,121906,9345,10994,1022,132900,3696,3451,2583,11593,14578
TAACGCCATGGACTGC,sample,211906,209209,16143,193066,25449,167617,129711,11391,17128,1436,146839,7951,4667,2102,28425,18555
ATTCTACCTGGACTGC,sample,144345,139831,26210,113621,10862,102759,44662,3246,29893,3508,74555,21450,8843,2222,8658,6206
CCTAACTATGGACTGC,sample,202924,199684,17893,181791,19744,162047,113039,9707,23111,2093,136150,14097,6652,1991,27364,15572
AGCTGAATCCTTGAGC,sample,426735,419026,48127,370899,43336,327563,183944,12903,85329,9322,269273,36065,8615,3206,36447,29218
GACGTATGCCTTGAGC,sample,693960,672649,127704,544945,34465,510480,170602,8501,221467,25986,392069,83924,17458,4402,20654,18428
CATAATGGCCTTGAGC,sample,247260,243745,20736,223009,43850,179159,120013,7702,32342,3833,152355,15269,6787,2874,26542,31388
GGAGAAGCCCTTGAGC,sample,124024,122547,8404,114143,25142,89001,72772,5701,6504,615,79276,3409,3470,2964,17331,17533
GAGCCTCCCCTTGAGC,Pos_Ctrl,120551,113605,19842,93763,4493,89270,75022,6299,5690,656,80712,1603,7542,9363,5508,1883
CTAGCGACCCTTGAGC,sample,402936,395475,54004,341471,51495,289976,154054,13374,66701,8757,220755,47090,11817,3047,49321,34217
TCATCGAACCTTGAGC,sample,334225,327625,45995,281630,34383,247247,129197,8437,63783,7295,192980,38535,10108,3036,30436,21461
GCAACTAGCCTTGAGC,sample,216272,213455,25613,187842,27856,159986,66958,4746,45991,4804,112949,37487,11421,2563,20570,18990
CCGCAGTCCCTTGAGC,sample,250635,243810,37665,206145,22790,183355,77455,6423,53971,6427,131426,39079,9851,2274,19988,14136
GGCAGGTTCCTTGAGC,Pos_Ctrl,161242,152627,25845,126782,5702,121080,102071,8494,7260,1007,109331,2248,7921,10599,6966,2566
TGCGCGTTCCTTGAGC,sample,403889,399592,21696,377896,44389,333507,276193,17010,26033,3334,302226,10937,5001,3343,31405,31616
GCTCTTCTCCTTGAGC,sample,358118,354349,24759,329590,48435,281155,202313,17272,37778,5062,240091,18730,6964,2827,43731,33401
CTAAGCATCCTTGAGC,sample,541546,533294,50201,483093,40027,443066,278714,20917,95987,10697,374701,36751,9744,3328,41300,28046
TAACGAAGCCTTGAGC,sample,281360,278722,15542,263180,51266,211914,178064,13777,15036,2023,193100,3014,1955,1720,45733,39225
GCTGCTTCCCTTGAGC,Pos_Ctrl,128765,122805,18869,103936,4483,99453,84284,7260,5596,692,89880,1621,7501,9905,5552,1780
GCGTTACCCCTTGAGC,sample,411597,407087,28949,378138,32174,345964,210251,13212,84080,10138,294331,28283,6397,2679,31610,20723
CGTCGAGGCCTTGAGC,sample,266782,263423,18862,244561,32871,211690,157566,11040,29561,3211,187127,10312,4130,2427,27804,25127
CGCGGTCGCCTTGAGC,sample,485286,473505,87099,386406,32118,354288,112162,8129,130323,14004,242485,89670,18006,4255,26605,19131
ATGAATAGCCTTGAGC,sample,456068,447700,61302,386398,40010,346388,178497,12063,84552,8972,263049,62304,12540,2954,46628,28369
AAGTAGAGCCTTGAGC,sample,205992,203165,17520,185645,41195,144450,108842,9588,15322,2001,124164,8697,5918,2665,24497,29193
TCAATCAGCCTTGAGC,sample,265431,262696,19783,242913,24685,218228,140024,7854,45773,5612,185797,18965,5412,2131,29103,17436
GACTAACCCCTTGAGC,sample,386188,379916,44605,335311,36499,298812,178799,14516,58011,6030,236810,41456,10700,2603,51023,24711
CCTAACTACCTTGAGC,Pos_Ctrl,172013,161659,24766,136893,5192,131701,110433,9567,8101,1098,118534,2502,7568,10763,5802,1791
ATATGCAACCTTGAGC,sample,93143,92253,8963,83290,12691,70599,46636,3916,11196,1212,57832,7639,5183,1888,8874,8443
TCTAGGTTCGATATCC,sample,435182,430332,37819,392513,82919,309594,193927,13511,58928,6184,252855,37044,9634,3253,55251,58203
CTGGTCTTCGATATCC,sample,199555,197329,16067,181262,32771,148491,93496,5575,29446,3405,122942,16569,6874,2059,29772,24144
TATACGGACGATATCC,sample,622261,611200,82958,528242,58892,469350,152221,12125,160728,17057,312949,127219,19912,5979,40333,36750
GAGCCTCCCGATATCC,sample,317296,313784,26647,287137,48670,238467,162596,10083,38232,3698,200828,23858,7986,2325,49186,32908
CTAGCGACCGATATCC,sample,402285,397004,28546,368458,51982,316476,229256,18040,44153,5492,273409,19535,7542,3477,32360,37755
TCGAACGACGATATCC,sample,25563,24583,7048,17535,1762,15773,2388,124,6507,658,8895,6096,3799,561,236,653
TGATTCCGCGATATCC,sample,240782,237924,16432,221492,56594,164898,128849,11759,13612,1993,142461,8685,6841,4770,13599,37365
GCAACTAGCGATATCC,sample,84658,83906,5548,78358,19501,58857,43612,3662,8160,983,51772,2440,3316,2593,9338,14249
TGGATCAACGATATCC,sample,394161,389998,31552,358446,59613,298833,202579,11193,49747,6175,252326,29139,5605,2163,55744,43569
GGCAGGTTCGATATCC,sample,417305,412454,34983,377471,48781,328690,189907,13414,83385,8402,273292,33582,7708,2556,48256,36090
CCATTCTTCGATATCC,sample,368704,364568,28762,335806,34557,301249,169721,12006,80137,9888,249858,29497,7474,2815,30004,26148
AAGGTCTGCGATATCC,sample,194902,191698,21636,170062,21675,148387,86631,4667,33794,3389,120425,19906,7125,1842,28177,15402
TCTCCTAGCGATATCC,sample,438012,429347,64667,364680,32324,332356,133997,8440,102412,10555,236409,76952,14727,3569,26863,20506
TAACGCCACGATATCC,sample,356102,351630,32508,319122,53390,265732,166051,12621,48112,4333,214163,34615,9576,2992,41326,36485
GCGCAATACGATATCC,sample,237445,234799,15864,218935,29132,189803,140590,11904,23110,1666,163700,12533,4781,2012,26758,21770
TCTAGGTTATCTGACC,sample,120597,119858,6504,113354,25030,88324,67958,4990,9052,1094,77010,5230,4784,2410,19359,16808
GAGCCTCCATCTGACC,sample,152963,149628,21384,128244,17077,111167,60485,4315,25074,2566,85559,18727,7579,1829,20681,10972
CATACTCCATCTGACC,Neg_Ctrl,3091,1892,1168,724,88,636,401,25,112,13,513,85,326,187,89,42
CGTCGCCAATCTGACC,sample,89824,87309,11883,75426,11734,63692,38666,2420,12847,1611,51513,8148,5647,2104,9877,7885
ATTCAAGGATCTGACC,sample,74766,73237,9209,64028,9498,54530,33140,2204,12123,1311,45263,5752,4168,1828,7839,6091
GACTCAAGATCTGACC,sample,247761,244805,17747,227058,40179,186879,137209,10398,20832,3299,158041,15141,5286,2451,34172,29639
CCGCAGTCATCTGACC,sample,165285,162697,11118,151579,11637,139942,109958,7692,15409,2138,125367,4745,3902,2888,9631,9432
TGGATCAAATCTGACC,sample,508583,499276,69971,429305,44091,385214,137855,8979,121236,11756,259091,105388,16682,4657,37577,25501
GATGCGTTATCTGACC,Neg_Ctrl,2546,1409,837,572,73,499,301,19,110,20,411,49,273,155,64,32
ATGGCGTTATCTGACC,sample,321726,318074,30313,287761,27454,260307,144029,8723,66631,7998,210660,32926,8068,2710,25600,19028
TGCGCGTTATCTGACC,sample,183938,182531,11593,170938,23537,147401,97414,7362,30453,3783,127867,8389,3684,1878,24527,17761
CATTCGGTATCTGACC,sample,160820,157832,18967,138865,9978,128887,66922,5166,36986,4561,103908,15252,6764,2999,7549,6534
AAGGTCTGATCTGACC,sample,114775,114049,5873,108176,17189,90987,68317,5990,11596,1317,79913,3767,3415,2157,11526,12501
GCTGCTTCATCTGACC,sample,191346,189607,9791,179816,25745,154071,128002,11806,10553,804,138555,2906,2653,2261,22371,18041
GCCTATTCATCTGACC,Neg_Ctrl,2496,1202,684,518,61,457,267,19,99,12,366,60,221,110,68,16
TGCGCTCCATCTGACC,sample,161633,159500,14452,145048,16285,128763,81707,5396,27345,3271,109052,11044,7461,3533,17056,11189
GTCGCGAAATCTGACC,sample,219907,217576,15074,202502,29003,173499,138056,13150,14747,1348,152803,6198,4270,2403,30107,21808
ATGAATAGATCTGACC,sample,75276,72461,17210,55251,4734,50517,14871,1006,17697,1920,32568,15023,6946,1431,3797,1995
AAGTAGAGATCTGACC,sample,245665,242369,21828,220541,24463,196078,124266,9473,39481,4724,163747,18134,6680,2325,23158,17588
TCAATCAGATCTGACC,sample,183789,181058,19066,161992,15024,146968,85912,6047,33468,3892,119380,17649,6415,2371,14972,9332
TAACGCCAATCTGACC,sample,217598,214418,26105,188313,25937,162376,97949,7217,30921,3931,128870,22358,7663,1968,23543,17991
GCGCAATAATCTGACC,Neg_Ctrl,2268,1183,682,501,50,451,277,26,84,14,361,50,229,123,68,19
ATATGCAAATCTGACC,sample,226447,223772,18303,205469,21599,183870,114539,7315,38917,4333,153456,18766,6235,2257,25021,15058
TCTAGGTTCTTCTTAC,sample,124715,122205,13159,109046,9639,99407,57218,3432,25409,2766,82627,10582,5015,2113,9400,6670
CATACTCCCTTCTTAC,sample,275857,270899,28918,241981,37330,204651,125611,9646,37536,4384,163147,27474,9595,3577,27656,26174
CTAGCGACCTTCTTAC,sample,196184,190501,31818,158683,20721,137962,63284,2734,36945,3994,100229,31005,9760,2081,19756,13575
CGTCGCCACTTCTTAC,sample,448129,439649,50772,388877,42529,346348,175190,11894,100924,14617,276114,43723,10545,3680,26002,29093
ATTCAAGGCTTCTTAC,sample,144168,141294,17060,124234,25258,98976,65441,5600,15405,1988,80846,10542,6477,2455,14972,16766
GCAACTAGCTTCTTAC,sample,169575,167973,13439,154534,25025,129509,82156,6411,26139,3141,108295,11662,6699,2221,20916,18157
TACGCGAGCTTCTTAC,sample,412543,403755,59904,343851,51868,291983,154838,10407,67302,8304,222140,51132,11041,3118,38291,35505
GACTCAAGCTTCTTAC,sample,293891,291269,16479,274790,51787,223003,190196,15283,13665,1538,203861,2321,1990,1662,53560,38044
AAGGTCTGCTTCTTAC,sample,316008,312266,24172,288094,23925,264169,179815,17274,41096,4458,220911,21526,6929,2127,31082,16933
AGCAGAGCCTTCTTAC,sample,313338,309055,34115,274940,34814,240126,132316,10780,54603,6090,186919,36337,10188,3078,32192,23076
GCGTTACCCTTCTTAC,sample,223137,220355,18050,202305,31021,171284,122022,8573,22571,2800,144593,15318,5719,1800,29777,23106
AAGTAGAGCTTCTTAC,sample,180775,177093,21418,155675,20154,135521,81384,7606,27334,2735,108718,16462,7110,1955,20441,14880
TAACGCCACTTCTTAC,sample,234197,230701,24630,206071,27888,178183,117843,7416,30251,3723,148094,18950,6604,2021,24941,18032
ATATGCAACTTCTTAC,sample,170155,168122,16918,151204,21360,129844,77198,8422,25586,3003,102784,15635,6180,1694,17423,14230
TATACGGAACTTCTAC,sample,58584,57573,5247,52326,9701,42625,33303,2542,4136,682,37439,1962,2724,1812,10585,6926
TCATCGAAACTTCTAC,sample,194590,192668,13375,179293,27142,152151,116661,7722,16478,2814,133139,8476,4085,1735,26009,21012
ATTCAAGGACTTCTAC,sample,141140,139141,10636,128505,13130,115375,81252,7065,18256,3214,99508,5588,3454,1904,13055,10637
GACTCAAGACTTCTAC,sample,212091,208293,21912,186381,15937,170444,88307,6901,49678,5760,137985,19798,7007,2545,13663,10380
ATACGTTCACTTCTAC,sample,225359,222982,14260,208722,45506,163216,135480,9644,12138,1342,147618,4612,3753,2605,32952,33263
CCGCAGTCACTTCTAC,sample,219750,215113,35457,179656,22823,156833,56397,4383,50209,5309,106606,40535,12900,3658,11164,12923
CTAAGCATACTTCTAC,sample,326524,321673,37933,283740,36808,246932,142119,8266,51637,5980,193756,38930,10525,2668,36865,23779
CCTAGCGGACTTCTAC,sample,129831,128319,9523,118796,16710,102086,72587,6602,14406,1295,86993,7196,3952,1575,16947,13138
GCCTATTCACTTCTAC,sample,274339,270940,24039,246901,19919,226982,121380,7967,65358,8964,186738,23313,7154,2513,13686,12642
AGCAGAGCACTTCTAC,sample,172917,170927,13040,157887,29453,128434,94446,7526,14834,2410,109280,9218,5504,2790,15737,20112
GTCGCGAAACTTCTAC,sample,323152,317923,44144,273779,28398,245381,100099,10578,69567,7340,169666,57797,12089,2965,18025,18207
CGCGGTCGACTTCTAC,sample,154913,152636,15830,136806,14690,122116,72562,6057,23340,2727,95902,17430,6900,1585,19415,10672
TCTCCTAGACTTCTAC,sample,154018,152354,11496,140858,14701,126157,82013,6145,25423,3716,107436,8860,4206,1739,18758,10723
TCAATCAGACTTCTAC,sample,97669,96603,8545,88058,10434,77624,48780,3737,14466,1528,63246,9113,5376,1494,12480,7172
TAACGCCAACTTCTAC,sample,158951,157610,9895,147715,19883,127832,82896,5961,23685,3428,106581,11862,5105,1843,20372,15557
ATTCTACCACTTCTAC,sample,241088,237782,24601,213181,21412,191769,103526,8137,50463,5976,153989,23667,7001,2174,27666,15149
CGCGAGACACTTCTAC,sample,184830,182513,11840,170673,20113,150560,111415,8265,20668,1731,132083,8481,3674,1994,15808,14273
CGTAGAACACTTCTAC,sample,185795,179572,34022,145550,12169,133381,53216,4666,42508,4678,95724,28313,9990,2419,9020,7042
GTCGTTCTAGAAGTAA,sample,128319,126697,9145,117552,24549,93003,69367,4857,12709,1429,82076,4641,4204,2712,15787,17279
GACGTATGAGAAGTAA,sample,272747,268811,19646,249165,27743,221422,155857,11196,33500,3765,189357,17104,6842,2019,39853,20038
GGTAGAGAAGAAGTAA,sample,1152312,1120234,167557,952677,58145,894532,319915,23376,325630,39561,645545,186050,21293,7204,25295,31219
CCGCAGTCAGAAGTAA,sample,600384,586946,93517,493429,58325,435104,165939,13846,134946,14056,300885,106317,18024,4771,38678,36505
CATTCGGTAGAAGTAA,sample,483114,476518,50364,426154,43559,382595,212816,17472,83879,9613,296695,58815,11130,2917,45038,28388
GCTCTTCTAGAAGTAA,sample,359669,355936,21645,334291,42519,291772,220596,18070,37017,3477,257613,12612,6532,3076,43138,31307
AAGGTCTGAGAAGTAA,sample,320651,317931,18355,299576,31576,268000,188613,14247,45262,5059,233875,14819,4865,1931,38697,22806
GCTGCTTCAGAAGTAA,sample,145885,144021,12969,131052,16814,114238,73512,5219,21248,3135,94760,11124,5625,2573,13566,11926
GGCGTACCAGAAGTAA,sample,194589,191404,24261,167143,20831,146312,72177,5817,38291,4345,110468,25682,9036,2188,16398,12407
CGTCGAGGAGAAGTAA,sample,475066,470235,46275,423960,45080,378880,157367,13934,111255,12207,268622,84117,16573,4726,32877,30424
ATTCTACCAGAAGTAA,sample,219654,217815,12355,205460,23788,181672,114594,14194,34226,4657,148820,14001,5372,2217,16302,16314
CGTAGAACAGAAGTAA,sample,238125,236122,13533,222589,32337,190252,146353,13203,20909,2762,167262,7025,4197,1856,27819,23058
TTAACTGAAGAAGTAA,sample,140935,140087,7512,132575,13336,119239,87288,8847,14687,1979,101975,6438,4117,2104,11143,9288
Short,Non_sample,0,NA,NA,NA,NA,NA,NA,NA,NA,NA,NA,NA,NA,NA,NA,NA
Unselected,Non_sample,2831371,NA,NA,NA,NA,NA,NA,NA,NA,NA,NA,NA,NA,NA,NA,NA
Undetermined,Non_sample,278687549,NA,NA,NA,NA,NA,NA,NA,NA,NA,NA,NA,NA,NA,NA,NA
