Barcode,Sample,Barcoded_Reads,Trimmed_Reads,Unmapped_Reads,Mapped_Reads,Multimapped_Reads,Uniquely_Mapped_Reads,Exon_Reads,Ambiguous_Exon_Reads,Intron_Reads,Ambiguous_Intron_Reads,Gene_Reads,Intergenic_Reads,No_of_Genes,No_of_Transcripts,Mitochondrial_Reads,Ribosomal_Reads
AAGTTCGTCGTTGGTT,sample,122500,121876,3252,118624,45974,72650,44311,3286,17506,2461,61817,5086,3434,2143,9559,26190
GGTTGCGTCGTTGGTT,sample,105826,105122,6467,98655,35643,63012,30363,1988,18338,2384,48701,9939,5392,1759,8364,20529
CCTCTAGACGTTGGTT,sample,109876,109164,3873,105291,37072,68219,39084,2273,18667,1995,57751,6200,3443,1527,11925,23003
TTCGTAATCGTTGGTT,sample,58895,58250,3597,54653,17602,37051,18343,1302,10755,1163,29098,5488,3879,1573,4052,10548
TTCTAATGCGTTGGTT,sample,51206,50789,1402,49387,18723,30664,18977,1235,7567,909,26544,1976,2127,1313,5425,10919
ATGCCTGGCGTTGGTT,sample,31978,31700,1013,30687,12228,18459,10000,828,5498,864,15498,1269,1799,1152,2344,6757
CAACCGCGCGTTGGTT,sample,26346,26115,870,25245,10455,14790,8369,599,3842,499,12211,1481,1815,1035,2319,5618
TTCCGTCTCGTTGGTT,sample,38335,37892,1673,36219,12739,23480,10729,941,7790,676,18519,3344,2626,1091,2159,7483
TCGCATCTCGTTGGTT,sample,80059,79513,2522,76991,25406,51585,29289,2425,15033,1216,44322,3622,2945,1681,6259,15836
GCCTTGCTCGTTGGTT,sample,77339,76755,3110,73645,23017,50628,30013,2460,12215,1734,42228,4206,3157,1716,6633,14008
CATAACCTCGTTGGTT,sample,66367,65946,3137,62809,25730,37079,17750,1146,10454,1264,28204,6465,3731,1310,5844,13878
GACGGAGACGTTGGTT,sample,51236,50879,2016,48863,11078,37785,25549,1906,7128,705,32677,2497,3330,2387,3484,7156
GGCCAGAGCGTTGGTT,sample,88724,88042,4386,83656,26745,56911,28020,2518,17385,1981,45405,7007,3812,1548,7642,16504
GTCCTGCCCGTTGGTT,sample,95027,94275,4557,89718,26766,62952,34698,2752,16417,1968,51115,7117,3906,1465,9408,16952
CTAGGACCCGTTGGTT,sample,6738,6649,472,6177,1822,4355,2031,159,1282,138,3313,745,1231,635,362,1120
GAAGGCGCCGTTGGTT,sample,151,145,10,135,45,90,51,2,28,5,79,4,47,24,11,28
GTCTTAGCCGTTGGTT,sample,215,215,12,203,67,136,74,7,38,1,112,16,52,36,16,38
TCGCCTGACGTTGGTT,sample,159,155,23,132,45,87,62,3,15,0,77,7,46,31,19,26
ATGACCGACGTTGGTT,sample,124,123,8,115,30,85,39,3,29,2,68,12,39,19,7,17
GACCGGAACGTTGGTT,sample,185,183,3,180,48,132,90,1,25,2,115,14,55,33,15,33
TATCAGTTCTATCGTT,sample,56254,55887,1707,54180,12060,42120,21964,1381,13796,2007,35760,2972,2952,1740,6655,8394
AGTACCATCTATCGTT,sample,42814,42609,1260,41349,12508,28841,19925,1581,5218,639,25143,1478,3097,2621,3006,7922
TTCTAATGCTATCGTT,sample,53764,53489,2792,50697,16808,33889,18404,1194,9198,955,27602,4138,3499,1823,5517,9983
TGAGCGCGCTATCGTT,sample,45314,45125,967,44158,20590,23568,17078,1394,3711,517,20789,868,2054,1714,4332,10407
TTAGAAGTCTATCGTT,sample,39253,38836,3918,34918,11957,22961,9935,811,7181,733,17116,4301,3353,1281,2984,6720
CAAGGCCTCTATCGTT,sample,53795,53203,2718,50485,16005,34480,19882,1172,9766,911,29648,2749,2349,1186,5976,9854
GACGGAGACTATCGTT,sample,80640,79941,2551,77390,28261,49129,36390,2258,8281,874,44671,1326,1417,1230,10645,17155
CCAGAGCGCTATCGTT,sample,56463,55844,3295,52549,12305,40244,20860,1869,11484,1298,32344,4733,3662,1716,3814,7895
GTTAGCCGCTATCGTT,sample,133627,132761,6350,126411,19180,107231,81437,5176,11266,1280,92703,8072,4910,2772,14219,13478
CTTGATAGCTATCGTT,sample,55246,54644,7995,46649,8093,38556,11382,862,15396,1614,26778,9302,5423,1484,1791,4800
ACCTCGAGCTATCGTT,sample,34922,34544,2332,32212,6745,25467,11661,908,8469,1298,20130,3131,2961,1280,2611,4474
CATTGCAGCTATCGTT,sample,63343,62824,1521,61303,23465,37838,28047,1862,6174,651,34221,1104,1342,1145,8256,13897
CGAGGCAGCTATCGTT,sample,37341,36899,2922,33977,9708,24269,9612,648,8618,945,18230,4446,3001,966,2203,6062
CGTACGTCCTATCGTT,sample,62952,62335,3702,58633,16959,41674,22295,1587,10843,1143,33138,5806,3217,1209,6332,10701
CTAGGACCCTATCGTT,sample,68429,67919,3010,64909,14321,50588,29061,1911,13829,1528,42890,4259,3285,1827,3930,10072
GCCTGAACCTATCGTT,sample,94093,93053,7082,85971,14851,71120,29386,1816,25615,3386,55001,10917,4633,1348,4742,10625
AACTCGTACTATCGTT,sample,47536,46972,4590,42382,7103,35279,13933,1195,12308,1366,26241,6477,3831,1252,1555,4519
AAGAGCGCCTATCGTT,sample,147,141,10,131,24,107,59,2,18,1,77,27,44,22,17,20
GTACCGTACTATCGTT,sample,204,201,22,179,23,156,84,7,28,8,112,29,52,36,30,19
GGCATATACTATCGTT,sample,112,111,10,101,22,79,51,1,22,0,73,5,39,25,14,17
TATCAGTTGTCTTCTT,sample,120484,119846,2458,117388,53251,64137,46277,3203,11358,1140,57635,2159,1441,1237,14436,28181
ATTCTCTTGTCTTCTT,Pos_Ctrl,37089,36912,1946,34966,2426,32540,26941,2880,1920,209,28861,590,4520,4954,2580,1256
CCTCTAGAGTCTTCTT,Pos_Ctrl,31770,31592,1649,29943,2101,27842,23177,2503,1488,189,24665,485,4301,4526,2209,1021
AGTACCATGTCTTCTT,sample,150695,149830,4685,145145,56010,89135,63203,4417,14832,1655,78035,5028,3248,1818,14147,32641
TTCTAATGGTCTTCTT,sample,84307,83783,1626,82157,33327,48830,37246,2544,6818,775,44064,1447,1552,1294,11994,18955
ATGCCTGGGTCTTCTT,sample,96474,95869,3617,92252,30898,61354,36879,2938,15506,1861,52385,4170,2589,1333,10595,19032
TAGTACGGGTCTTCTT,sample,67202,66730,2788,63942,14191,49751,26710,1985,15187,1588,41897,4281,3134,1770,5068,10059
ACTATACTGTCTTCTT,sample,95789,94708,3483,91225,21630,69595,40632,3015,18336,2154,58968,5458,2742,1084,6113,14475
GTTAGCCGGTCTTCTT,sample,83174,82527,3817,78710,18781,59929,33094,2643,15416,1682,48510,7094,3850,1636,5311,12692
GGAGGACGGTCTTCTT,sample,57621,57082,1793,55289,12904,42385,29901,2531,7201,799,37102,1953,2579,1960,4942,8773
CATTGCAGGTCTTCTT,sample,63213,62740,2983,59757,15855,43902,22300,1588,13635,1632,35935,4747,3375,1331,5535,10422
CGAGGCAGGTCTTCTT,sample,65596,65007,5069,59938,18264,41674,19301,1596,11978,1402,31279,7397,4122,1230,5149,10876
CGTACGTCGTCTTCTT,sample,41407,41053,1894,39159,8610,30549,15297,1251,9649,1132,24946,3220,2614,1383,3238,5847
CTAGGACCGTCTTCTT,sample,74392,73881,2367,71514,19486,52028,29987,2033,14005,1515,43992,4488,2582,1321,7822,13267
AACTCGTAGTCTTCTT,sample,49742,49303,2164,47139,10155,36984,22300,1476,8743,1176,31043,3289,2687,1603,3800,7015
CGTATGAAGTCTTCTT,sample,62239,61563,3391,58172,8029,50143,33502,2585,8500,745,42002,4811,3696,2323,3215,5500
AATATATCGTCTTCTT,sample,20213,20074,712,19362,6518,12844,7356,703,3361,442,10717,982,1688,1122,1476,4029
TGCTTCGCGTCTTCTT,sample,120,113,12,101,18,83,37,4,29,2,66,11,39,21,7,9
GAAGGCGCGTCTTCTT,sample,164,155,13,142,38,104,56,10,31,1,87,6,56,29,13,24
CTTCATGAGTCTTCTT,sample,189,168,21,147,50,97,54,4,24,4,78,11,51,32,10,24
AGGTCGGAGTCTTCTT,Pos_Ctrl,1614,1602,158,1444,177,1267,992,162,53,10,1045,50,459,437,80,70
ATGACCGAGTCTTCTT,sample,174,161,6,155,36,119,67,1,35,0,102,16,61,35,10,27
GACCGGAAGTCTTCTT,sample,118,116,2,114,25,89,56,5,20,1,76,7,37,22,20,18
AAGTTCGTTAGGCTCT,sample,25409,25237,1400,23837,8781,15056,8189,626,4047,587,12236,1607,2256,1167,2078,5001
GGTTGCGTTAGGCTCT,sample,96600,95897,3738,92159,29946,62213,32232,2075,20578,2328,52810,5000,3082,1709,7005,18601
CCTCTAGATAGGCTCT,sample,78694,78094,3500,74594,31189,43405,24012,1580,11868,1270,35880,4675,3323,1250,7449,16758
ACGTTATGTAGGCTCT,sample,156089,155109,4204,150905,56806,94099,58794,4136,22634,2440,81428,6095,2905,1456,17183,33348
TTCTAATGTAGGCTCT,sample,50055,49799,1769,48030,19303,28727,16931,1201,7453,899,24384,2243,2617,1298,5746,10858
CAAGGCCTTAGGCTCT,sample,105844,104960,2861,102099,47174,54925,39813,2938,9424,1394,49237,1356,1545,1390,10845,24826
ACTATACTTAGGCTCT,sample,130453,129623,4459,125164,29793,95371,48985,3637,29918,4589,78903,8242,3366,1915,10056,20352
GACGATAATAGGCTCT,sample,90067,89309,4398,84911,17271,67640,36032,2699,20145,2420,56177,6344,4068,2163,5711,11809
CATTGCAGTAGGCTCT,sample,21144,20934,1064,19870,6331,13539,6948,530,4469,505,11417,1087,2007,1004,1921,3805
CCATGAAGTAGGCTCT,sample,84746,83867,5430,78437,23258,55179,23536,1614,19121,2151,42657,8757,4343,1251,4254,13905
CGTACGTCTAGGCTCT,sample,82811,82082,5443,76639,18633,58006,26371,1716,19136,2058,45507,8725,4615,1477,5983,12123
AGTCCGCATAGGCTCT,sample,112750,111905,5547,106358,30799,75559,39998,2593,22200,2395,62198,8373,3661,1629,10820,20287
GTCCTGCCTAGGCTCT,sample,23980,23738,1868,21870,6241,15629,5863,503,6130,616,11993,2517,2710,1005,1624,3802
TTGGTACCTAGGCTCT,sample,75411,74780,3920,70860,20732,50128,27905,2000,13566,1530,41471,5127,3751,1825,5962,12862
ACGTATTATAGGCTCT,sample,55514,55056,2838,52218,8552,43666,20502,1426,14665,2028,35167,5045,3550,1862,2429,5702
AACTCGTATAGGCTCT,sample,62928,62302,2030,60272,23588,36684,24788,1826,7625,908,32413,1537,1466,1051,7421,13264
AATATATCTAGGCTCT,sample,61573,61097,2508,58589,15128,43461,22375,1719,14069,1928,36444,3370,2329,1379,5003,9969
ACCAATGCTAGGCTCT,sample,87073,86456,2101,84355,31923,52432,39029,2687,7760,1097,46789,1859,1599,1366,9817,18267
TGCTTCGCTAGGCTCT,sample,15629,15528,574,14954,7605,7349,3596,369,2422,265,6018,697,1428,776,889,3510
GTCTTAGCTAGGCTCT,sample,1206,1123,69,1054,297,757,440,34,191,16,631,76,305,199,67,159
GTACCGTATAGGCTCT,sample,113573,112630,5024,107606,21919,85687,39948,3234,28711,2786,68659,11008,4998,1563,5902,15003
TCAATATATAGGCTCT,sample,144663,143635,8340,135295,33345,101950,44718,3013,30155,3183,74873,20881,5924,1582,9427,21633
TATCAGTTTTGACTAT,sample,74673,74162,2634,71528,26072,45456,27989,1896,10982,1396,38971,3193,2749,1627,6136,15309
TCCAACTTTTGACTAT,Neg_Ctrl,2115,1099,810,289,91,198,127,16,28,4,155,23,73,36,40,40
AAGTTCGTTTGACTAT,sample,53889,53475,4034,49441,12977,36464,18888,1276,10032,1068,28920,5200,4033,1858,4537,8222
TCCTCCGTTTGACTAT,sample,76345,75693,4900,70793,16746,54047,30211,2312,13308,1396,43519,6820,4354,2005,5484,11030
AGTACCATTTGACTAT,Neg_Ctrl,3433,2291,1827,464,162,302,170,10,93,8,263,21,111,62,42,32
TTCGTAATTTGACTAT,sample,30312,29919,3918,26001,4990,21011,5861,323,8638,958,14499,5231,3365,921,1254,3199
ACGTTATGTTGACTAT,sample,94530,93759,3698,90061,35452,54609,37066,2277,10230,1332,47296,3704,2440,1240,12756,20030
ATGCCTGGTTGACTAT,sample,65312,64666,3999,60667,18126,42541,21375,1414,13411,1628,34786,4713,2935,1148,6560,11473
TGAGCGCGTTGACTAT,sample,66066,65449,3216,62233,19993,42240,23519,1812,10590,1959,34109,4360,2549,1174,7104,12414
CAACCGCGTTGACTAT,sample,43787,43375,2522,40853,8524,32329,19896,1628,7413,814,27309,2578,3392,2331,2754,5819
TTCCGTCTTTGACTAT,Pos_Ctrl,28355,27989,2952,25037,1689,23348,19138,1895,1665,164,20803,486,4015,3771,1652,908
GCCTTGCTTTGACTAT,sample,52238,51834,2089,49745,22658,27087,18964,1341,4491,453,23455,1838,2216,1485,5841,11902
CATAACCTTTGACTAT,sample,68522,67855,3646,64209,15459,48750,23298,1878,16886,2382,40184,4306,2813,1441,5361,10661
CCGCAACGTTGACTAT,Pos_Ctrl,21467,21121,2218,18903,1312,17591,14539,1353,1207,163,15746,329,3531,3240,1309,654
GACGATAATTGACTAT,sample,32049,31677,2965,28712,5574,23138,9538,622,8175,908,17713,3895,3017,1050,1828,3658
CATGATTCTTGACTAT,sample,52209,51737,2928,48809,14862,33947,20654,1021,8062,923,28716,3287,2949,1437,5194,9158
AATCCGTCTTGACTAT,Pos_Ctrl,32839,32520,2798,29722,1793,27929,22953,2325,1834,238,24787,579,4345,4453,1752,874
AGTCCGCATTGACTAT,sample,163650,162102,8481,153621,27619,126002,64769,4824,38370,3898,103139,14141,5114,1744,8393,20122
CTAGGACCTTGACTAT,sample,61390,60722,1915,58807,19152,39655,26374,1514,8280,677,34654,2810,2016,1234,8238,11654
GTTAGGACTTGACTAT,sample,52413,51915,6470,45445,8862,36583,9899,946,14266,1747,24165,9725,4913,1089,2075,5311
GCCTGAACTTGACTAT,sample,51613,51076,3077,47999,10708,37291,21004,1453,9462,953,30466,4419,3155,1141,4890,7062
ACGTATTATTGACTAT,sample,120165,119288,5552,113736,31122,82614,55218,5097,13369,1507,68587,7423,3672,2050,6954,20066
CGTATGAATTGACTAT,sample,57471,56857,4370,52487,10986,41501,15993,1101,13658,1569,29651,9180,4888,1392,2602,7395
TTGGCCTCTTGACTAT,Pos_Ctrl,18148,17995,1500,16495,1023,15472,12723,1378,959,123,13682,289,3190,3004,853,468
GTCTTAGCTTGACTAT,sample,18271,18138,735,17403,4453,12950,7459,818,3222,409,10681,1042,1951,1249,951,2975
TCGCCTGATTGACTAT,sample,106314,105574,4197,101377,14576,86801,62745,5658,11208,1425,73953,5765,4108,2617,5859,10641
TTATTCGATTGACTAT,Neg_Ctrl,145,142,17,125,31,94,69,6,16,1,85,2,46,28,8,21
ATGACCGATTGACTAT,sample,946,899,34,865,273,592,343,44,123,30,466,52,223,169,47,159
TCCAACTTTGCAGTTG,sample,64384,63943,3675,60268,14913,45355,19906,1456,16318,1888,36224,5787,3791,1602,3713,9361
AAGTTCGTTGCAGTTG,sample,66724,66198,2517,63681,17508,46173,23076,1626,15174,2172,38250,4125,2727,1445,5323,11667
CCTCTAGATGCAGTTG,sample,55755,55303,2306,52997,12962,40035,19149,1388,13340,1563,32489,4595,3630,1844,3446,8583
TGAGCGCGTGCAGTTG,sample,19843,19601,2025,17576,3066,14510,5350,426,5458,600,10808,2676,2952,1088,811,2057
CATAACCTTGCAGTTG,sample,61549,61072,1941,59131,14782,44349,26860,2497,10994,1158,37854,2840,2987,2061,5071,9898
CCAGAGCGTGCAGTTG,sample,78726,78143,2464,75679,21463,54216,36684,2948,9713,1170,46397,3701,2954,1730,7532,13722
GTTAGCCGTGCAGTTG,sample,66339,65749,3780,61969,16868,45101,25954,1857,10800,1168,36754,5322,3396,1275,6610,10436
ACCTCGAGTGCAGTTG,sample,63129,62647,2620,60027,11046,48981,22792,1696,16649,2375,39441,5469,3393,1541,3307,7645
GTCCTGCCTGCAGTTG,sample,45188,44728,1754,42974,12814,30160,16857,928,8177,1258,25034,2940,2404,1178,5030,8125
TTGGTACCTGCAGTTG,sample,58442,57991,2655,55336,10768,44568,23058,1472,14079,1666,37137,4293,3126,1481,4215,7821
CTAGGACCTGCAGTTG,sample,61130,60557,3000,57557,17936,39621,21558,1541,9950,1249,31508,5323,3326,1158,6488,10551
GTTAGGACTGCAGTTG,sample,29223,29077,1077,28000,8571,19429,12296,972,4056,531,16352,1574,1939,1166,2401,5339
ACGTATTATGCAGTTG,sample,76067,75524,2272,73252,22035,51217,33654,2521,10228,1197,43882,3617,1961,1222,8093,14135
AATATATCTGCAGTTG,sample,46488,46122,2247,43875,12691,31184,18088,1139,7650,1066,25738,3241,2903,1465,4134,7830
GAAGGCGCTGCAGTTG,sample,52346,51909,1738,50171,8925,41246,23427,1757,11653,1629,35080,2780,2523,1432,3622,6471
TTGGTTAATGCAGTTG,sample,37728,37457,1003,36454,7967,28487,15933,1535,8487,1052,24420,1480,2269,1485,2100,5740
GGCATATATGCAGTTG,sample,71490,71003,2044,68959,17976,50983,34532,2458,9135,1186,43667,3672,2811,1464,5701,12042
TTATTCGATGCAGTTG,sample,52,51,7,44,7,37,25,1,9,0,34,2,23,17,5,4
ATGACCGATGCAGTTG,sample,232,231,10,221,60,161,81,15,37,3,118,25,71,44,17,38
GACCGGAATGCAGTTG,sample,136,134,10,124,35,89,47,7,21,2,68,12,42,30,7,21
TATCAGTTTCATGCTG,sample,15226,15109,594,14515,5679,8836,5226,418,2168,259,7394,765,1287,718,1777,3198
AAGTTCGTTCATGCTG,sample,23824,23604,2487,21117,4404,16713,5070,423,6929,817,11999,3474,3045,951,1209,2755
GGTTGCGTTCATGCTG,sample,64119,63666,2532,61134,12413,48721,27496,1847,14247,1578,41743,3553,3678,2349,4129,8643
AGTACCATTCATGCTG,sample,26453,26188,2145,24043,7428,16615,8215,482,5262,510,13477,2146,2168,852,2722,4394
TTCGTAATTCATGCTG,sample,47809,47513,2425,45088,14371,30717,16150,1096,8910,981,25060,3580,3009,1579,4193,8972
ACGTTATGTCATGCTG,sample,83289,82751,2106,80645,34552,46093,35304,2049,6870,626,42174,1244,1367,1177,10094,18764
ATGCCTGGTCATGCTG,sample,53481,52921,4908,48013,9598,38415,10095,726,15246,1533,25341,10815,5721,1488,1736,6246
GGACCTCTTCATGCTG,Neg_Ctrl,1462,631,421,210,46,164,88,5,60,2,148,9,80,33,17,8
GCCTTGCTTCATGCTG,sample,54497,53990,2883,51107,13698,37409,20329,1545,11076,1143,31405,3316,3212,1421,5235,8873
CAAGGCCTTCATGCTG,sample,15456,15233,1761,13472,1902,11570,3489,254,5098,584,8587,2145,2435,792,743,1199
GACGGAGATCATGCTG,sample,59830,59304,4599,54705,11014,43691,19003,1426,14165,1669,33168,7428,4128,1305,4687,7444
CCAGAGCGTCATGCTG,sample,71129,70426,5321,65105,9834,55271,28116,1908,14346,1579,42462,9322,4954,1853,3893,6853
GGAGGACGTCATGCTG,sample,23589,23354,706,22648,3908,18740,11090,734,4936,667,16026,1313,1892,1245,1770,2752
CCGCAACGTCATGCTG,sample,38225,37790,4855,32935,4116,28819,7096,505,11976,1232,19072,8010,4895,1005,1363,2366
GGACGTAGTCATGCTG,Neg_Ctrl,650,371,173,198,44,154,89,10,27,2,116,26,56,31,18,17
ACCTCGAGTCATGCTG,sample,46320,45846,3979,41867,7883,33984,12857,910,12044,1496,24901,6677,4288,1347,2618,5189
TGGACGAGTCATGCTG,sample,31840,31572,1549,30023,11191,18832,11204,936,4621,428,15825,1643,1966,1031,2558,6372
GACGATAATCATGCTG,sample,52335,51806,2705,49101,8656,40445,18947,1299,13307,1972,32254,4920,3200,1397,2875,6184
GGCCAGAGTCATGCTG,sample,72692,72103,2324,69779,17171,52608,39330,2833,7077,943,46407,2425,2125,1599,7720,11678
CGAGGCAGTCATGCTG,sample,19566,19351,941,18410,4985,13425,8455,534,2985,348,11440,1103,1568,926,2131,3268
AATCCGTCTCATGCTG,sample,42274,41860,3290,38570,6069,32501,15246,1470,9690,1284,24936,4811,3598,1549,2151,3906
CGTACGTCTCATGCTG,Neg_Ctrl,1423,632,423,209,42,167,95,3,36,3,131,30,69,35,27,18
AGTCCGCATCATGCTG,sample,98564,97522,7149,90373,17977,72396,30482,2289,22710,2286,53192,14629,5764,1348,7016,11843
CGGATTACTCATGCTG,sample,71323,70436,4612,65824,13948,51876,26286,1303,13946,1914,40232,8427,4142,1270,4728,9104
ACGTATTATCATGCTG,sample,41958,41599,1554,40045,7208,32837,22661,1583,6151,515,28812,1927,2409,1886,2548,5112
AACTCGTATCATGCTG,sample,26794,26534,2034,24500,6268,18232,8196,528,5658,753,13854,3097,2612,1016,1696,4027
CGTATGAATCATGCTG,sample,27113,26803,2462,24341,5311,19030,7946,714,6599,652,14545,3119,2876,1074,1544,3440
AATATATCTCATGCTG,Neg_Ctrl,1482,944,700,244,88,156,85,3,54,0,139,14,83,36,21,23
ACCAATGCTCATGCTG,sample,38729,38226,2574,35652,9875,25777,14456,1055,6071,861,20527,3334,2186,943,3817,6387
GAAGGCGCTCATGCTG,sample,18072,17846,1831,16015,3139,12876,4726,305,4639,450,9365,2756,2416,723,961,1966
AAGAGCGCTCATGCTG,sample,58390,57867,3963,53904,8888,45016,22509,2098,12002,1463,34511,6944,4495,1735,2649,6144
GGCATATATCATGCTG,sample,50724,50188,1555,48633,14415,34218,24036,2142,5715,784,29751,1541,1581,1081,4444,9810
TTATTCGATCATGCTG,sample,344,326,23,303,62,241,108,8,78,15,186,32,109,60,16,33
ATGACCGATCATGCTG,sample,47468,47021,2155,44866,10116,34750,19572,1923,8204,1019,27776,4032,2737,1166,3188,6640
GGAGAGTTTTAGGCGG,sample,56749,56184,4439,51745,17776,33969,14475,1029,10928,1241,25403,6296,3868,1159,3877,10486
ATTCTCTTTTAGGCGG,Pos_Ctrl,35627,35318,2677,32641,1939,30702,25427,2450,1991,232,27418,602,4564,4647,2082,957
TCCAACTTTTAGGCGG,sample,76766,76367,3994,72373,27856,44517,33884,2397,5064,666,38948,2506,2878,2323,6989,14810
TCCTCCGTTTAGGCGG,sample,122869,122056,3266,118790,47516,71274,55015,3957,9495,899,64510,1908,1855,1587,17520,27176
CCTCTAGATTAGGCGG,Pos_Ctrl,40581,39981,2871,37110,2335,34775,28592,2772,2409,309,31001,693,4900,5075,2440,1175
ACGTTATGTTAGGCGG,sample,72137,71652,2933,68719,15230,53489,28921,2155,15413,1739,44334,5261,3622,1988,5516,10574
TTCTAATGTTAGGCGG,sample,111569,110890,4765,106125,27331,78794,38974,2921,25467,2928,64441,8504,4633,1717,9353,18154
TCGCATCTTTAGGCGG,sample,75623,74703,7544,67159,13522,53637,21226,1487,17473,2170,38699,11281,5401,1607,3712,8447
GCCTTGCTTTAGGCGG,sample,72853,72161,4185,67976,20563,47413,29354,1939,10326,1213,39680,4581,3291,1587,7352,12739
GACGGAGATTAGGCGG,sample,94580,93681,4262,89419,25878,63541,38539,2773,13543,2425,52082,6261,3212,1469,8710,16984
CTTGATAGTTAGGCGG,sample,92381,91375,5658,85717,20768,64949,33768,2800,17250,2081,51018,9050,4323,1567,7024,13717
TGGACGAGTTAGGCGG,sample,23131,22865,2124,20741,4285,16456,7765,675,5001,641,12766,2374,2901,1475,1393,2644
GACGATAATTAGGCGG,sample,87551,86616,9326,77290,9513,67777,21829,1590,26934,3815,48763,13609,6392,1865,3545,6357
CATTGCAGTTAGGCGG,sample,87079,86259,2271,83988,31236,52752,38256,2232,8938,1567,47194,1759,1446,1048,11271,18563
CCATGAAGTTAGGCGG,sample,112566,111415,5742,105673,31052,74621,42204,3087,20127,2734,62331,6469,3294,1363,10694,20580
ACGACTTCTTAGGCGG,sample,99771,98839,5428,93411,21785,71626,44857,3368,13950,1302,58807,8149,4714,2027,8429,14210
AGTCCGCATTAGGCGG,sample,103843,102877,6235,96642,16145,80497,39881,2416,24718,3512,64599,9970,4441,1806,6135,10424
AATATATCTTAGGCGG,sample,55123,54733,1953,52780,9281,43499,27380,1731,9994,1358,37374,3036,2744,1841,3149,6859
GAAGGCGCTTAGGCGG,sample,34413,34023,2973,31050,8278,22772,8491,574,8250,803,16741,4654,3307,941,2094,4966
GTCTTAGCTTAGGCGG,sample,74287,73664,4479,69185,12619,56566,31246,2593,14194,1520,45440,7013,3757,1448,3354,8286
TTGGTTAATTAGGCGG,sample,44505,44174,3342,40832,9138,31694,12539,823,11863,1187,24402,5282,3347,1172,1911,6009
GTACCGTATTAGGCGG,sample,69286,68664,2923,65741,16109,49632,29675,1890,11363,1454,41038,5250,3415,1445,4838,10655
TCGCCTGATTAGGCGG,sample,65673,65125,2477,62648,16729,45919,27791,1871,11016,1005,38807,4236,2796,1196,5306,10965
AGGTCGGATTAGGCGG,sample,81491,80822,2831,77991,17824,60167,41460,3596,10989,1379,52449,2743,2345,1519,5725,12767
GACCGGAATTAGGCGG,sample,39435,39106,1546,37560,11806,25754,14413,1166,6446,959,20859,2770,2220,1016,1992,7102
GGAGAGTTTCAGATAC,sample,49511,49230,2050,47180,10256,36924,18215,1351,12734,1541,30949,3083,2817,1580,3210,6997
TCCAACTTTCAGATAC,sample,62461,62058,3705,58353,15820,42533,23706,1980,10878,1200,34584,4769,3722,1839,4836,10229
ACGTTATGTCAGATAC,sample,73796,73257,2007,71250,26001,45249,36637,2350,4662,539,41299,1061,1527,1455,9928,15434
TAGTACGGTCAGATAC,sample,20929,20728,982,19746,6244,13502,8836,765,2604,280,11440,1017,1815,1181,2174,3862
CATAACCTTCAGATAC,sample,72567,71952,3036,68916,21822,47094,28497,1918,11109,1498,39606,4072,2914,1311,6819,13958
ACTATACTTCAGATAC,sample,65453,64919,4890,60029,9255,50774,21078,1288,18975,2187,40053,7246,4044,1523,3189,6554
GACGGAGATCAGATAC,sample,68666,67999,2392,65607,24048,41559,28737,1917,8281,774,37018,1850,1452,1048,7066,14250
CCGCAACGTCAGATAC,sample,4438,4361,429,3932,785,3147,1366,65,1011,140,2377,565,852,402,230,515
GGACGTAGTCAGATAC,sample,29227,28964,807,28157,9704,18453,13520,1210,2802,281,16322,640,1043,921,3323,5908
TGGACGAGTCAGATAC,sample,19154,18940,1635,17305,4626,12679,5502,407,4196,426,9698,2148,2030,768,1341,2879
GTCCTGCCTCAGATAC,sample,46462,46011,1495,44516,10464,34052,23542,2023,5893,570,29435,2024,1954,1191,2529,7133
CTAGGACCTCAGATAC,sample,81812,81148,5211,75937,14697,61240,28320,2173,18124,1722,46444,10901,4596,1204,5079,9492
GTTAGGACTCAGATAC,sample,67250,66558,4364,62194,12645,49549,24321,1905,14288,1724,38609,7311,3536,997,3103,8205
GCCTGAACTCAGATAC,sample,91517,90640,9901,80739,8115,72624,22114,1608,29849,4264,51963,14789,6718,1636,1834,4233
AACTCGTATCAGATAC,sample,53216,52744,1827,50917,16950,33967,20662,1883,7718,915,28380,2789,1967,947,4795,9775
CGTATGAATCAGATAC,sample,45694,45156,3769,41387,9014,32373,15024,1382,9670,1187,24694,5110,3366,1107,3441,5933
TTGGCCTCTCAGATAC,sample,17538,17328,2265,15063,2871,12192,3484,262,4958,569,8442,2919,2334,585,471,1719
ACCAATGCTCAGATAC,sample,43787,43321,1840,41481,13623,27858,18451,1390,5482,802,23933,1733,1662,1039,3192,8340
GTCTTAGCTCAGATAC,sample,60920,60453,2142,58311,18263,40048,26341,2109,8245,844,34586,2509,1940,1181,5951,11786
CCAATTCCTCAGATAC,sample,53584,53031,1534,51497,16225,35272,23544,2024,7229,1140,30773,1335,1705,1149,4992,9601
GTACCGTATCAGATAC,sample,74206,73644,4514,69130,15634,53496,26785,2375,14325,2097,41110,7914,4164,1349,3727,10410
TCAATATATCAGATAC,sample,48575,48166,2958,45208,8051,37157,17896,1656,11712,1269,29608,4624,3104,1306,2180,5406
TCGCCTGATCAGATAC,sample,30663,30314,2328,27986,7861,20125,7021,943,7540,1185,14561,3436,2583,808,1172,4747
GACCGGAATCAGATAC,sample,46735,46357,2014,44343,10904,33439,18099,1717,8907,1047,27006,3669,2797,1139,2192,6908
GGAGAGTTTCGCTAGG,sample,75450,74685,2562,72123,28642,43481,30362,1939,8299,1043,38661,1838,1679,1273,8811,16553
ATTCTCTTTCGCTAGG,sample,50034,49457,4624,44833,12023,32810,13237,618,11975,1324,25212,5656,3554,1113,3200,7356
TCCAACTTTCGCTAGG,Neg_Ctrl,2244,1225,899,326,82,244,107,13,44,0,151,80,77,48,18,40
TCCTCCGTTCGCTAGG,sample,58896,58304,2989,55315,20521,34794,21441,1388,7819,971,29260,3175,2225,1191,6119,11850
ACGTAAGTTCGCTAGG,sample,40841,40516,1880,38636,15177,23459,13143,948,6268,910,19411,2190,2597,1432,3515,8597
AGTACCATTCGCTAGG,Neg_Ctrl,3159,2155,1718,437,111,326,176,14,93,11,269,32,124,56,44,46
TTCTAATGTCGCTAGG,sample,63611,63047,2977,60070,18890,41180,24757,1765,10067,1053,34824,3538,2928,1568,5880,11625
CAACCGCGTCGCTAGG,sample,49975,49539,2848,46691,11397,35294,20393,1606,8126,954,28519,4215,3436,1708,4193,7672
AATGGTAATCGCTAGG,sample,65963,65411,3247,62164,10856,51308,28676,1774,14562,1586,43238,4710,3277,1653,5063,7526
TTAGAAGTTCGCTAGG,sample,66127,65494,5135,60359,11891,48468,23231,1658,14937,1619,38168,7023,4544,2061,3335,7677
GGACCTCTTCGCTAGG,sample,37285,36899,1825,35074,13533,21541,11264,919,6270,700,17534,2388,2489,1210,2255,7683
ACTATACTTCGCTAGG,sample,17730,17437,2280,15157,2293,12864,4242,262,5058,642,9300,2660,2376,792,814,1492
GGACGTAGTCGCTAGG,sample,50774,50244,2406,47838,12694,35144,20499,1155,9717,1040,30216,2733,2101,1053,5747,8483
ACCTCGAGTCGCTAGG,sample,53274,52863,2399,50464,16149,34315,24188,1762,5336,757,29524,2272,2420,1567,5472,9934
CATTGCAGTCGCTAGG,sample,59132,58593,2247,56346,16232,40114,22697,1723,10377,1028,33074,4289,2681,1318,4350,10782
CGAGGCAGTCGCTAGG,sample,49961,49464,1335,48129,17360,30769,21712,1727,5210,833,26922,1287,1358,1077,6727,10569
ACGACTTCTCGCTAGG,sample,56134,55753,1626,54127,15807,38320,29194,2072,4753,516,33947,1785,2558,2096,6306,10419
CGTACGTCTCGCTAGG,sample,56227,55696,2129,53567,9249,44318,26975,2045,10818,1498,37793,2982,2715,1764,2425,6457
TTGGTACCTCGCTAGG,sample,68085,67453,3110,64343,16846,47497,27614,2946,12373,1076,39987,3488,2330,1256,5461,10995
CGGATTACTCGCTAGG,sample,83122,82279,3121,79158,16813,62345,42454,3128,10333,1161,52787,5269,3068,1448,6460,11795
GTTAGGACTCGCTAGG,sample,56541,55878,6829,49049,7617,41432,12496,1013,15387,1727,27883,10809,5304,1169,2739,4404
AATATATCTCGCTAGG,sample,61900,61298,5189,56109,11320,44789,19276,1886,13843,1185,33119,8599,4398,1183,4458,7520
ACCAATGCTCGCTAGG,sample,66956,66429,3388,63041,13136,49905,27971,2158,12869,1704,40840,5203,3103,1463,5849,9202
TGCTTCGCTCGCTAGG,sample,31069,30769,3339,27430,4109,23321,8567,550,8230,936,16797,5038,3479,1078,1670,2616
AAGAGCGCTCGCTAGG,sample,85396,84610,9618,74992,14877,60115,19635,1534,22977,2889,42612,13080,6120,1700,3150,9125
GTCTTAGCTCGCTAGG,sample,63653,63115,5674,57441,7876,49565,23012,1637,15682,1486,38694,7748,4965,1802,3225,5372
GTACCGTATCGCTAGG,Pos_Ctrl,18446,18294,1422,16872,1012,15860,13116,1428,924,131,14040,261,3239,3115,886,477
GGCATATATCGCTAGG,sample,47129,46739,2690,44049,11007,33042,19204,1007,8392,928,27596,3511,2905,1270,3768,7074
TTATTCGATCGCTAGG,sample,851,830,53,777,144,633,299,17,236,18,535,63,271,136,66,84
AAGTTCGTCCGTTGCG,sample,60983,60300,6044,54256,16326,37930,16416,1016,12718,1612,29134,6168,4334,1576,4125,9933
TCCTCCGTCCGTTGCG,sample,50406,49857,3783,46074,12496,33578,17305,917,9862,1003,27167,4491,3697,1639,2950,7994
TTCGTAATCCGTTGCG,sample,56046,55636,1589,54047,11569,42478,33551,3052,4101,448,37652,1326,3258,3376,2734,8232
ATGCCTGGCCGTTGCG,sample,37171,36757,3284,33473,8933,24540,10695,676,7897,1053,18592,4219,3193,1091,3408,5573
CAACCGCGCCGTTGCG,sample,34932,34590,1043,33547,13985,19562,13991,860,3654,381,17645,676,1106,954,5671,7719
AATGGTAACCGTTGCG,sample,15482,15327,1066,14261,4289,9972,4684,319,3170,338,7854,1461,1738,779,1452,2627
TTCCGTCTCCGTTGCG,sample,24376,24031,2717,21314,5598,15716,7644,555,4231,455,11875,2831,2654,1087,1942,3437
GACGGAGACCGTTGCG,sample,61285,60648,4217,56431,16820,39611,20184,1652,11320,1275,31504,5180,3504,1278,5094,10437
GGAGGACGCCGTTGCG,sample,72366,71753,2556,69197,24094,45103,28602,1537,9974,1296,38576,3694,2800,1367,5772,14383
GGACGTAGCCGTTGCG,sample,72531,72187,2069,70118,10516,59602,43948,4679,7728,931,51676,2316,3398,3026,3541,8123
GACGATAACCGTTGCG,sample,46160,45617,1288,44329,15805,28524,20504,1537,4617,761,25121,1105,1160,996,6470,9487
GGCCAGAGCCGTTGCG,sample,51438,50939,1655,49284,15649,33635,24689,1857,5308,568,29997,1213,1610,1264,6962,9781
CGAGGCAGCCGTTGCG,sample,19243,19044,1207,17837,4381,13456,7412,636,3367,385,10779,1656,2604,1595,841,2766
AATCCGTCCCGTTGCG,sample,62040,61562,3589,57973,13034,44939,28982,1941,8576,1016,37558,4424,3185,1685,5499,8835
GTCCTGCCCCGTTGCG,sample,62980,62378,5022,57356,10482,46874,22396,1342,13351,1665,35747,8120,4509,1563,4301,7031
CGGATTACCCGTTGCG,sample,62023,61403,2075,59328,16491,42837,28031,2461,8166,1098,36197,3081,2005,1293,6024,10773
GTTAGGACCCGTTGCG,sample,33131,32777,2143,30634,8226,22408,10236,731,7953,812,18189,2676,2876,1269,1477,5182
ACGTATTACCGTTGCG,sample,73394,72732,4455,68277,18007,50270,25303,1953,13579,1576,38882,7859,4204,1481,4673,11974
ACCAATGCCCGTTGCG,sample,37681,37231,2947,34284,7688,26596,12547,725,8224,955,20771,4145,2984,998,3114,5074
TGCTTCGCCCGTTGCG,sample,53707,53246,2150,51096,10930,40166,23093,1450,10938,1613,34031,3072,2021,1251,4798,7928
GAAGGCGCCCGTTGCG,sample,56104,55577,1735,53842,16845,36997,26869,2089,5724,815,32593,1500,1515,1108,4995,10928
CCAATTCCCCGTTGCG,sample,51464,50836,4086,46750,8453,38297,17980,1532,10842,1392,28822,6551,4082,1447,2930,5353
GACCGGAACCGTTGCG,sample,44065,43772,3209,40563,10206,30357,13139,1060,9448,1004,22587,5706,3881,1277,2845,6429
GGAGAGTTAGGCCAAG,sample,107893,107044,5890,101154,33465,67689,44716,2546,12858,1325,57574,6244,3722,2264,10711,20286
AAGTTCGTAGGCCAAG,sample,64745,63969,2444,61525,18124,43401,24682,1711,12824,1131,37506,3053,2984,1671,6545,11713
ACGTTATGAGGCCAAG,sample,87128,86555,2805,83750,29961,53789,39563,3083,7575,808,47138,2760,2465,1827,9561,18051
CAACCGCGAGGCCAAG,sample,75778,74930,9185,65745,17511,48234,15028,1007,17410,1982,32438,12807,6529,1309,3847,10452
GCCTTGCTAGGCCAAG,sample,78642,77880,4005,73875,21167,52708,28931,2202,14760,1734,43691,5081,3125,1529,7163,13777
GGACGTAGAGGCCAAG,sample,74920,74341,4624,69717,26698,43019,23033,2016,11695,1265,34728,5010,3444,1452,5263,14536
ACCTCGAGAGGCCAAG,sample,26778,26548,2025,24523,6285,18238,9252,767,5110,641,14362,2468,2368,1064,1773,3913
GGCCAGAGAGGCCAAG,sample,41540,41186,2463,38723,8706,30017,13467,1385,10973,1070,24440,3122,2723,1233,2581,5826
AATCCGTCAGGCCAAG,sample,80564,79992,4457,75535,15439,60096,31097,2055,18117,2372,49214,6455,3976,1684,7265,10060
TTGGTACCAGGCCAAG,sample,106365,105701,3430,102271,30781,71490,47020,3937,14345,1893,61365,4295,2668,1539,10593,20138
GCCTGAACAGGCCAAG,sample,66700,66238,1786,64452,21457,42995,28876,2509,8260,1001,37136,2349,2294,1325,7987,13251
AATATATCAGGCCAAG,sample,62240,61786,5068,56718,6366,50352,20955,1541,19377,1936,40332,6543,4685,2034,1761,4375
ACCAATGCAGGCCAAG,sample,58655,58168,3157,55011,11516,43495,26183,1734,9805,1272,35988,4501,3559,1759,5175,7572
GAAGGCGCAGGCCAAG,sample,54438,53973,3923,50050,11156,38894,18856,1215,11909,1477,30765,5437,4013,1545,3400,6969
GGCATATAAGGCCAAG,Neg_Ctrl,1468,696,589,107,23,84,45,5,21,6,66,7,41,24,11,12
TATCAGTTAGAACCGC,sample,40498,40093,3353,36740,9443,27297,12357,768,9039,1065,21396,4068,3347,1262,2849,5770
GGTTGCGTAGAACCGC,sample,71794,71032,2122,68910,28667,40243,27963,2077,8035,818,35998,1350,1460,1154,8457,15666
AGTACCATAGAACCGC,sample,93116,92175,6931,85244,23264,61980,32425,2377,18052,1976,50477,7150,4085,1925,7076,14732
TGAGCGCGAGAACCGC,sample,71132,70678,2597,68081,16546,51535,25291,2118,17225,2227,42516,4674,3036,1504,5645,11275
TTCCGTCTAGAACCGC,sample,93638,93038,5547,87491,17114,70377,34928,2700,23209,2375,58137,7165,4946,2448,5578,12125
TCGCATCTAGAACCGC,sample,49976,49609,3180,46429,11015,35414,16201,1137,10886,1434,27087,5756,3858,1302,3386,7054
CATAACCTAGAACCGC,sample,124966,124137,5801,118336,40518,77818,54441,4197,11841,1898,66282,5441,3168,1931,11841,24714
GACGGAGAAGAACCGC,sample,99198,98444,3614,94830,22388,72442,49147,3603,13775,1592,62922,4325,3772,2468,8622,16205
GGAGGACGAGAACCGC,sample,56175,55670,3420,52250,10688,41562,17900,1324,14699,1354,32599,6285,3453,1217,3638,7202
GACGATAAAGAACCGC,sample,27519,27307,1313,25994,8577,17417,9389,815,5001,617,14390,1595,2619,1542,1598,5139
CATTGCAGAGAACCGC,sample,83307,82587,4972,77615,17967,59648,31179,1844,16682,1878,47861,8065,4173,1332,8124,11541
CGAGGCAGAGAACCGC,sample,43812,43391,2639,40752,10815,29937,14823,1106,8781,828,23604,4399,2968,1211,3526,7166
ACGACTTCAGAACCGC,sample,57593,57080,2891,54189,16004,38185,22482,1586,9078,1051,31560,3988,2978,1433,5967,10023
CGTACGTCAGAACCGC,sample,56065,55626,2665,52961,11107,41854,26246,2175,9196,1259,35442,2978,3343,2151,3406,7450
CTAGGACCAGAACCGC,sample,84950,84285,7439,76846,12943,63903,24941,2286,22049,2464,46990,12163,6083,2001,3605,8639
GTTAGGACAGAACCGC,sample,67029,66247,8955,57292,10950,46342,13569,994,19325,2041,32894,10413,5789,1424,2277,6955
AAGAGCGCAGAACCGC,sample,43114,42605,2209,40396,5646,34750,19021,1116,10040,1309,29061,3264,2684,1392,2748,3958
TTGGTTAAAGAACCGC,sample,94647,93699,4861,88838,17191,71647,45041,3863,13632,1941,58673,7170,3752,1591,5132,12287
TCGCCTGAAGAACCGC,sample,75751,75095,3399,71696,14812,56884,35020,2831,12097,1216,47117,5720,2676,1094,7376,10523
AGGTCGGAAGAACCGC,sample,70824,70200,3236,66964,9039,57925,28269,1939,18256,2344,46525,7117,3156,1405,2457,6429
TATCAGTTCATCAAGC,sample,82385,81774,3940,77834,22101,55733,33959,2355,12990,1527,46949,4902,3547,1795,8432,14345
TCCAACTTCATCAAGC,sample,2954,2884,445,2439,412,2027,649,34,745,98,1394,501,562,205,196,249
AAGTTCGTCATCAAGC,sample,28506,28098,3368,24730,5724,19006,8179,537,5748,690,13927,3852,2960,1148,1566,3487
AGTACCATCATCAAGC,sample,107450,106627,3620,103007,38298,64709,48307,3584,9686,926,57993,2206,1869,1487,15125,22771
TTCTAATGCATCAAGC,sample,30628,30337,2169,28168,5529,22639,11082,712,7182,792,18264,2871,3249,1832,1062,3454
TAGTACGGCATCAAGC,sample,74961,74007,15489,58518,8870,49648,8066,570,21815,2399,29881,16798,7802,1079,1836,4656
AATGGTAACATCAAGC,sample,84436,83803,5429,78374,14028,64346,32720,2036,19329,2446,52049,7815,4376,2299,4233,9767
TTAGAAGTCATCAAGC,sample,73655,72985,5529,67456,12143,55313,26293,1657,16632,2343,42925,8388,4901,1967,4866,7854
TTCCGTCTCATCAAGC,sample,73131,72588,1960,70628,29614,41014,31120,2315,5590,878,36710,1111,1602,1413,9483,16565
TCGCATCTCATCAAGC,sample,20591,20449,1018,19431,3872,15559,8352,573,4721,583,13073,1330,2464,1459,1229,2581
GCCTTGCTCATCAAGC,sample,120866,119855,13285,106570,15419,91151,28441,2091,39211,4676,67652,16732,7825,2219,3284,9725
CAAGGCCTCATCAAGC,sample,36564,36229,1917,34312,10635,23677,12054,1181,7319,913,19373,2210,2965,1617,2200,6466
ACTATACTCATCAAGC,sample,86627,85967,2430,83537,33746,49791,35660,2539,8256,950,43916,2386,1452,1154,12290,18791
CTTGATAGCATCAAGC,sample,93024,92181,6176,86005,19928,66077,32673,2584,19577,2377,52250,8866,4775,1560,8079,13420
GACGATAACATCAAGC,sample,72600,72126,4438,67688,14284,53404,25543,1874,16095,1803,41638,8089,4382,1730,6527,9548
CATTGCAGCATCAAGC,sample,115637,114773,8527,106246,14331,91915,32513,2663,38224,5585,70737,12930,5824,1897,3826,9485
CCATGAAGCATCAAGC,sample,31279,31037,1247,29790,8665,21125,13863,1068,4282,427,18145,1485,1919,1255,3228,5653
AGTCCGCACATCAAGC,sample,116958,116052,4176,111876,10800,101076,72242,6375,15430,1371,87672,5658,4151,3250,2779,7297
GTCCTGCCCATCAAGC,sample,91348,90301,5365,84936,16862,68074,38250,2121,17464,2227,55714,8012,4461,1506,4100,10612
TTGGCCTCCATCAAGC,Pos_Ctrl,17107,16936,1418,15518,943,14575,12155,1158,879,98,13034,285,3205,2976,898,469
ACCAATGCCATCAAGC,sample,55141,54517,2626,51891,11849,40042,22385,2983,9772,1434,32157,3468,2728,1109,2666,7928
TCAATATACATCAAGC,sample,81455,80741,1892,78849,24546,54303,39726,4613,7860,908,47586,1196,1172,1053,8669,15384
TCGCCTGACATCAAGC,sample,65406,64835,2413,62422,15671,46751,29756,2582,10318,991,40074,3104,2015,1043,5889,10827
TTATTCGACATCAAGC,sample,13716,13629,1249,12380,1208,11172,2991,298,5047,710,8038,2126,2453,803,259,636
GACCGGAACATCAAGC,sample,76749,76045,3816,72229,20062,52167,34502,2896,9752,723,44254,4294,2228,990,6523,12629
GGAGAGTTAGAGAGCC,sample,62359,61830,5776,56054,12488,43566,15919,1038,17032,1973,32951,7604,4544,1314,3790,7898
ATTCTCTTAGAGAGCC,sample,17038,16843,1876,14967,3757,11210,4844,330,3638,468,8482,1930,1969,743,1369,2329
TCCAACTTAGAGAGCC,sample,26171,25871,3284,22587,4989,17598,6874,559,5936,659,12810,3570,2758,959,1973,3099
ACGTTATGAGAGAGCC,sample,50110,49529,2701,46828,14117,32711,17956,1347,8974,1079,26930,3355,2663,1090,5875,8763
ATGCCTGGAGAGAGCC,sample,46818,46396,2357,44039,14223,29816,18131,1333,7223,736,25354,2393,2510,1463,4458,8604
TTAGAAGTAGAGAGCC,sample,36993,36599,4832,31767,7002,24765,8819,565,9182,1169,18001,5030,3765,1025,2562,4187
TTCCGTCTAGAGAGCC,sample,49531,49067,4379,44688,13273,31415,13844,1006,10756,1109,24600,4700,3146,1156,2976,7891
GGACCTCTAGAGAGCC,sample,34247,33913,1739,32174,11649,20525,12029,703,5429,631,17458,1733,2163,1126,3787,6834
TCGCATCTAGAGAGCC,sample,53625,53171,4386,48785,12398,36387,16640,1195,11435,1325,28075,5792,3798,1370,4059,8056
ACTATACTAGAGAGCC,sample,71456,70837,5439,65398,14112,51286,20936,1627,17086,1951,38022,9686,4918,1293,6118,9272
GACGGAGAAGAGAGCC,sample,63179,62510,3118,59392,18729,40663,24991,1697,9083,1020,34074,3872,2129,1091,6477,11751
GGAGGACGAGAGAGCC,sample,62489,61927,6287,55640,6193,49447,15240,1070,21859,2237,37099,9041,4840,1300,1479,4034
GACGATAAAGAGAGCC,sample,35194,34730,4339,30391,5447,24944,7004,575,9977,1077,16981,6311,3816,1022,925,3135
CGAGGCAGAGAGAGCC,sample,41155,40707,2844,37863,9242,28621,14483,1244,8231,943,22714,3720,3169,1341,2646,5858
ACGACTTCAGAGAGCC,sample,49991,49476,2739,46737,8712,38025,19366,1339,11729,1262,31095,4329,3001,1411,2938,6103
GTCCTGCCAGAGAGCC,sample,37622,37218,2045,35173,6346,28827,17873,1456,6346,588,24219,2564,3109,1898,1539,4381
GAAGGCGCAGAGAGCC,sample,58802,58268,4433,53835,11790,42045,18537,1204,13853,1320,32390,7131,4032,1026,3873,7471
AAGAGCGCAGAGAGCC,sample,45987,45624,2329,43295,7772,35523,16636,1591,11516,1421,28152,4359,3042,1348,2195,5431
GTCTTAGCAGAGAGCC,sample,46291,45999,3196,42803,9387,33416,16049,1392,9089,1187,25138,5699,3866,1186,2787,6041
CCAATTCCAGAGAGCC,sample,30286,30012,1218,28794,5260,23534,12221,784,7073,948,19294,2508,2172,1173,2183,3551
TCGCCTGAAGAGAGCC,sample,47514,47137,1306,45831,12426,33405,23936,1853,4963,782,28899,1871,1708,1188,3827,7906
TTATTCGAAGAGAGCC,sample,10976,10831,476,10355,2828,7527,4353,439,1804,283,6157,648,1040,670,682,1790
GACCGGAAAGAGAGCC,sample,42824,42482,1335,41147,9271,31876,20976,1359,6763,544,27739,2234,1767,1039,3303,6483
GGAGAGTTAGCATTGA,sample,73632,73255,4228,69027,22703,46324,22273,1538,13317,1423,35590,7773,4415,1386,7644,13647
ATTCTCTTAGCATTGA,sample,133713,132904,3921,128983,52786,76197,53652,4181,13589,1617,67241,3158,2835,2134,13396,29229
AAGTTCGTAGCATTGA,sample,153487,152428,4007,148421,55366,93055,62591,4220,19537,1810,82128,4897,2354,1359,25736,33062
TCCTCCGTAGCATTGA,sample,20250,20029,1774,18255,4120,14135,5250,357,5556,602,10806,2370,2521,893,1503,2629
ACGTAAGTAGCATTGA,sample,145086,144044,7592,136452,32237,104215,49771,3318,35829,3863,85600,11434,5263,1917,9212,21145
AGTACCATAGCATTGA,sample,166878,165548,9906,155642,33952,121690,58180,3469,34928,4421,93108,20692,6889,2114,16043,23425
TTCTAATGAGCATTGA,sample,55563,55149,2667,52482,11183,41299,27737,2248,7285,919,35022,3110,3441,2222,6072,7541
TTCCGTCTAGCATTGA,sample,117021,116131,8031,108100,19392,88708,31327,2508,37173,4361,68500,13339,6022,1770,5989,13279
GGACCTCTAGCATTGA,sample,57718,57144,2999,54145,13332,40813,19256,1530,13343,1652,32599,5032,3875,1828,3151,8770
CAAGGCCTAGCATTGA,sample,97590,96846,3708,93138,28849,64289,40427,2679,15047,1788,55474,4348,3402,2043,9873,17968
GGACGTAGAGCATTGA,sample,51020,50594,1676,48918,12448,36470,22897,1696,8360,1017,31257,2500,2429,1482,3771,8592
GGCCAGAGAGCATTGA,sample,98433,97634,3278,94356,24610,69746,48072,3138,12647,1224,60719,4665,3311,1854,9015,16453
CGAGGCAGAGCATTGA,sample,70089,69502,2882,66620,15384,51236,32625,3073,10150,1410,42775,3978,3081,1556,6945,10503
CATGATTCAGCATTGA,sample,134922,133480,4287,129193,26166,103027,66155,5315,22306,2676,88461,6575,2374,1315,8022,18565
AATCCGTCAGCATTGA,sample,139732,138327,7130,131197,25047,106150,53248,5225,28884,3780,82132,15013,5469,1569,9670,17716
AGTCCGCAAGCATTGA,sample,141949,140286,8862,131424,25254,106170,57145,4274,27123,3479,84268,14149,5360,1496,7072,16955
GTCCTGCCAGCATTGA,sample,131467,130239,4884,125355,22878,102477,70758,6119,15556,2076,86314,7968,4164,1970,13240,16252
ACGTATTAAGCATTGA,sample,41091,40710,2127,38583,6824,31759,15513,1547,10327,1434,25840,2938,2615,1291,2474,4481
AATATATCAGCATTGA,Neg_Ctrl,2384,1700,1351,349,74,275,121,13,94,6,215,41,123,71,24,41
ACCAATGCAGCATTGA,sample,69532,68953,2670,66283,20176,46107,28450,2332,9822,1171,38272,4332,3139,1546,6478,12379
TGCTTCGCAGCATTGA,sample,77595,77016,4085,72931,14134,58797,34354,2013,13918,1759,48272,6753,4039,1703,5998,9836
GAAGGCGCAGCATTGA,sample,61114,60478,2411,58067,18236,39831,26800,2276,7482,1419,34282,1854,1438,1031,7236,11248
GTCTTAGCAGCATTGA,sample,73143,72284,4924,67360,13926,53434,22943,1817,17476,1654,40419,9544,4565,1188,4332,9126
TTATTCGAAGCATTGA,sample,42712,42275,759,41516,12361,29155,20402,2757,4675,442,25077,879,1068,936,3600,7691
ATGACCGAAGCATTGA,sample,89127,88360,4430,83930,12704,71226,42774,3375,14949,2086,57723,8042,3944,1604,5482,9138
GACCGGAAAGCATTGA,sample,137133,136079,4640,131439,18544,112895,81660,5799,14973,1482,96633,8981,4410,2037,8699,12610
GGAGAGTTAATTACCA,sample,94096,93229,7879,85350,14326,71024,24421,1635,29142,3478,53563,12348,5355,1629,3042,9737
TCCAACTTAATTACCA,sample,81018,80506,2434,78072,28012,50060,35045,2502,8871,1279,43916,2363,2347,1583,8262,16609
AAGTTCGTAATTACCA,sample,78683,77943,5460,72483,17572,54911,23278,1783,19553,2261,42831,8036,4319,1385,5639,11229
AGTACCATAATTACCA,sample,125432,124541,3250,121291,46867,74424,57533,4136,10077,903,67610,1775,1382,1205,17169,26599
TTCTAATGAATTACCA,sample,73989,73538,2196,71342,24134,47208,35754,2463,6665,835,42419,1491,2161,1911,7187,14804
ATGCCTGGAATTACCA,sample,31084,30841,1878,28963,6001,22962,9538,807,8740,873,18278,3004,2715,1214,2051,3864
AATGGTAAAATTACCA,sample,75772,74940,7214,67726,15382,52344,21631,1586,18221,2001,39852,8905,4334,1392,5733,9343
TCGCATCTAATTACCA,sample,73268,72577,3354,69223,17904,51319,32287,2504,10923,1325,43210,4280,2169,1568,6671,11808
GACGGAGAAATTACCA,sample,75576,74516,5903,68613,15568,53045,22149,1634,18473,2112,40622,8677,4195,1207,4030,10550
CCAGAGCGAATTACCA,sample,54711,53945,4907,49038,11134,37904,13900,998,13970,1636,27870,7400,4061,1048,3906,6890
CTTGATAGAATTACCA,sample,145771,144570,13711,130859,13810,117049,45287,3050,46654,5745,91941,16313,7338,2678,3651,8708
ACCTCGAGAATTACCA,sample,47228,46849,2377,44472,14110,30362,17055,1109,7651,897,24706,3650,2885,1329,4085,8668
TGGACGAGAATTACCA,sample,83647,82912,1871,81041,26474,54567,41372,3511,6763,1442,48135,1479,1319,1270,9042,17188
GTCCTGCCAATTACCA,sample,83913,82955,8652,74303,11217,63086,26557,1871,19917,2222,46474,12519,5978,1721,4586,7702
CTAGGACCAATTACCA,sample,131100,129744,11130,118614,19188,99426,39181,2369,32094,3759,71275,22023,7632,1638,5880,13641
GTTAGGACAATTACCA,sample,21417,21176,1767,19409,4374,15035,8028,579,4165,425,12193,1838,2175,999,1403,2910
CGTATGAAAATTACCA,sample,39095,38596,5858,32738,4557,28181,7617,520,11066,1286,18683,7692,4565,1010,1329,2657
ACCAATGCAATTACCA,sample,57795,57311,2489,54822,14058,40764,25175,2277,9156,883,34331,3273,2430,1317,4733,9392
GAAGGCGCAATTACCA,sample,42931,42473,3263,39210,8099,31111,14301,1022,10093,1168,24394,4527,3465,1310,2524,5155
CCAATTCCAATTACCA,sample,66356,65652,3919,61733,14927,46806,22738,1461,13991,1201,36729,7415,3771,1117,5178,9529
GTACCGTAAATTACCA,sample,80130,79400,4092,75308,14354,60954,33050,2439,16741,2335,49791,6389,3579,1244,5868,9929
TCAATATAAATTACCA,sample,87405,86593,7456,79137,14408,64729,34355,2420,16164,1867,50519,9923,4389,1213,5680,9560
TCGCCTGAAATTACCA,sample,77656,76876,5949,70927,11402,59525,23785,2196,20359,2376,44144,10809,4425,1129,4572,7518
CTTCATGAAATTACCA,sample,84004,83197,4810,78387,12647,65740,39753,2547,14285,1357,54038,7798,3782,1334,6707,8828
AGGTCGGAAATTACCA,sample,75399,74771,4053,70718,13218,57500,32419,2304,13310,1697,45729,7770,3741,1206,5490,9165
TTATTCGAAATTACCA,sample,33701,33301,972,32329,8342,23987,15990,1252,4812,590,20802,1343,1601,1028,2426,5459
GACCGGAAAATTACCA,sample,42588,42010,2958,39052,5788,33264,16882,1354,9329,882,26211,4817,3069,1203,1493,4024
TATCAGTTTAGATGAC,sample,18168,18030,677,17353,4465,12888,8701,691,2478,282,11179,736,2113,1574,1433,2983
ATTCTCTTTAGATGAC,Pos_Ctrl,22223,22115,1532,20583,1544,19039,15748,1791,1048,111,16796,341,3407,3394,1526,856
TCCAACTTTAGATGAC,sample,12140,12058,655,11403,5077,6326,2966,203,2174,304,5140,679,1407,624,781,2593
GGTTGCGTTAGATGAC,sample,73314,72803,2209,70594,24747,45847,30376,2105,9742,1097,40118,2527,2470,1668,8099,14859
TCCTCCGTTAGATGAC,sample,111559,110780,3919,106861,29679,77182,52941,4056,12946,1819,65887,5420,3428,1889,12399,19650
CCTCTAGATAGATGAC,sample,58450,57885,4325,53560,16956,36604,15718,1032,12990,1269,28708,5595,3685,1146,3982,10260
TTCGTAATTAGATGAC,sample,115499,114578,5238,109340,19555,89785,41049,2635,33707,3956,74756,8438,3424,1710,6727,13701
ACGTTATGTAGATGAC,Pos_Ctrl,30400,30098,2380,27718,1859,25859,21241,2132,1731,262,22972,493,4292,4337,1939,972
ATGCCTGGTAGATGAC,sample,63916,63457,2581,60876,19390,41486,27274,2028,8023,869,35297,3292,2811,1674,7544,12263
TTCCGTCTTAGATGAC,Pos_Ctrl,25634,25370,2251,23119,1404,21715,18017,1796,1319,149,19336,434,3757,3697,1615,749
TCGCATCTTAGATGAC,sample,70274,69618,5066,64552,15316,49236,22342,1421,15910,1648,38252,7915,4456,1215,5353,10172
GCCTTGCTTAGATGAC,sample,78753,78199,1854,76345,27135,49210,38724,2436,6219,846,44943,985,1353,1267,10482,16849
ACTATACTTAGATGAC,sample,33947,33722,1367,32355,9619,22736,14782,1106,5028,455,19810,1365,1797,1136,4354,6284
GACGGAGATAGATGAC,sample,15822,15722,723,14999,3011,11988,7779,487,2511,290,10290,921,1789,1219,2231,2017
GTTAGCCGTAGATGAC,sample,18276,18058,1485,16573,5108,11465,5294,386,3666,500,8960,1619,2367,1193,1022,3045
GGAGGACGTAGATGAC,sample,15171,14980,576,14404,4914,9490,6414,599,1852,153,8266,472,1594,1183,1657,2960
CCGCAACGTAGATGAC,sample,18213,17920,1665,16255,5317,10938,5600,429,2918,306,8518,1685,1944,954,1701,3069
ACCTCGAGTAGATGAC,sample,9071,8904,1991,6913,1094,5819,987,62,2592,255,3579,1923,1676,294,207,566
GACGATAATAGATGAC,sample,15566,15345,1941,13404,2760,10644,3712,200,4033,425,7745,2274,2212,708,809,1656
CATTGCAGTAGATGAC,sample,80635,79967,3349,76618,15699,60919,39428,3945,11239,1298,50667,5009,3095,1450,4429,9984
CGAGGCAGTAGATGAC,sample,88716,87803,3719,84084,16691,67393,42771,3128,14258,1635,57029,5601,3027,1236,4855,11706
ACGACTTCTAGATGAC,sample,116876,115612,4785,110827,22399,88428,53025,3875,20596,1905,73621,9027,3825,1450,8318,16076
CATGATTCTAGATGAC,sample,109796,108489,4751,103738,29033,74705,46474,3679,15597,2112,62071,6843,3271,1264,7192,19139
CTAGGACCTAGATGAC,sample,112108,110937,10094,100843,19396,81447,29079,2698,27550,3226,56629,18894,6812,1362,5610,12770
GTTAGGACTAGATGAC,sample,96998,96003,6345,89658,17509,72149,43344,3623,15090,1585,58434,8507,4127,1607,6610,12020
ACGTATTATAGATGAC,sample,93751,92836,5692,87144,17043,70101,37555,2813,19695,2285,57250,7753,3984,1485,4712,11566
TTGGCCTCTAGATGAC,sample,74132,73443,2297,71146,20407,50739,33299,2550,10061,1509,43360,3320,1864,1065,6613,13339
AATATATCTAGATGAC,sample,93783,92903,6925,85978,14566,71412,32858,3083,22255,2407,55113,10809,5259,1502,5323,10183
AAGAGCGCTAGATGAC,sample,33659,33292,2571,30721,4169,26552,10375,747,10336,1299,20711,3795,2972,1262,1393,2777
ATTCTCTTGTTCAGAA,sample,94680,94237,1691,92546,43093,49453,35408,3301,7964,926,43372,1854,1454,1315,8594,22224
TCCAACTTGTTCAGAA,sample,112581,111931,3322,108609,39457,69152,45164,3348,14460,1718,59624,4462,3265,1997,11186,23006
AAGTTCGTGTTCAGAA,sample,90567,89865,2892,86973,20931,66042,35421,2722,20245,2291,55666,5363,3146,1847,8107,13796
GGTTGCGTGTTCAGAA,sample,112662,111898,2782,109116,45280,63836,46168,3015,10943,1514,57111,2196,1381,1159,17215,25438
CCTCTAGAGTTCAGAA,sample,40574,40237,1786,38451,9791,28660,14331,1227,9091,1036,23422,2975,2556,1373,3136,6646
TTCGTAATGTTCAGAA,sample,165258,164105,13139,150966,21058,129908,45637,3263,54213,7066,99850,19729,8163,2465,5670,13718
ACGTTATGGTTCAGAA,sample,85517,84896,4240,80656,26719,53937,28611,2043,15821,1483,44432,5979,3699,1258,8372,15668
TGAGCGCGGTTCAGAA,sample,28127,27932,2159,25773,5791,19982,8307,663,7011,924,15318,3077,2912,1176,1954,3842
AATGGTAAGTTCAGAA,sample,53076,52679,2732,49947,16872,33075,18116,1128,8435,861,26551,4535,3451,1626,4189,9922
GCCTTGCTGTTCAGAA,sample,38864,38564,1816,36748,10165,26583,14784,1169,7053,852,21837,2725,3212,1861,4228,6566
ACTATACTGTTCAGAA,sample,59064,58585,3893,54692,16144,38548,19854,1705,9503,1091,29357,6395,3719,1429,5888,10111
GACGGAGAGTTCAGAA,sample,51809,51285,4226,47059,10918,36141,16441,831,11183,1238,27624,6448,4065,1499,4447,6946
CCAGAGCGGTTCAGAA,sample,28371,28113,2376,25737,4831,20906,9221,692,6913,807,16134,3273,3271,1455,1372,3121
TGGACGAGGTTCAGAA,sample,102154,101223,2438,98785,16832,81953,61862,4892,10467,1323,72329,3409,2274,1727,4992,12333
ACGACTTCGTTCAGAA,sample,78626,77857,3922,73935,16340,57595,39107,2719,10309,885,49416,4575,3567,1787,4618,11478
AGTCCGCAGTTCAGAA,sample,47507,47066,2837,44229,8078,36151,16898,1389,12219,1515,29117,4130,3304,1605,1549,5144
GCCTGAACGTTCAGAA,sample,57451,56750,4009,52741,11709,41032,20357,1361,12038,1328,32395,5948,3540,1290,2555,7488
ACGTATTAGTTCAGAA,sample,83183,82329,3292,79037,19107,59930,36218,2819,14234,1662,50452,4997,2621,1170,7388,13286
GAAGGCGCGTTCAGAA,sample,43043,42616,1701,40915,11508,29407,18188,1827,6665,785,24853,1942,1883,1139,3385,7398
GGCATATAGTTCAGAA,sample,50151,49648,4659,44989,9102,35887,14251,803,11410,1227,25661,8196,4297,996,3749,5774
TCGCCTGAGTTCAGAA,sample,45528,45072,1691,43381,14627,28754,19737,1917,5460,656,25197,984,1209,862,3886,9158
AGGTCGGAGTTCAGAA,Pos_Ctrl,25345,25064,1642,23422,1136,22286,18142,1889,1542,194,19684,519,3786,3891,1094,530
TTATTCGAGTTCAGAA,sample,11432,11304,347,10957,3330,7627,5088,497,1403,209,6491,430,1297,1003,677,2032
GGAGAGTTTTCTGGTT,sample,131542,130049,11137,118912,21368,97544,42751,2721,33839,4375,76590,13858,6440,1952,9281,13763
TATCAGTTTTCTGGTT,sample,105781,104883,3528,101355,35369,65986,48727,2966,9787,1840,58514,2666,2175,1376,16864,21036
TCCAACTTTTCTGGTT,Neg_Ctrl,2640,1139,855,284,78,206,92,0,72,8,164,34,74,31,30,23
AAGTTCGTTTCTGGTT,sample,139334,138073,10339,127734,19148,108586,38282,2531,45685,6150,83967,15938,4784,1824,5566,12986
GGTTGCGTTTCTGGTT,sample,87841,87090,4464,82626,26178,56448,34811,2315,12678,1236,47489,5408,3339,1681,9162,16635
TTCGTAATTTCTGGTT,sample,74718,74169,4412,69757,19235,50522,32928,2429,9304,1183,42232,4678,3940,2485,7659,12514
ACGTTATGTTCTGGTT,sample,63114,62685,2188,60497,21090,39407,28335,1879,6057,792,34392,2344,2506,1721,8541,12425
TTCTAATGTTCTGGTT,Neg_Ctrl,1652,785,496,289,69,220,108,28,49,10,157,25,84,47,21,16
TAGTACGGTTCTGGTT,sample,44920,44530,3249,41281,7948,33333,14012,914,12212,1448,26224,4747,3063,1262,3264,6156
TGAGCGCGTTCTGGTT,sample,62539,62137,1728,60409,20981,39428,29758,2112,5920,570,35678,1068,1485,1336,8497,13314
CAACCGCGTTCTGGTT,sample,23312,23104,1954,21150,8620,12530,4543,402,4758,563,9301,2264,2374,838,1284,4486
GGACCTCTTTCTGGTT,Neg_Ctrl,1537,774,486,288,79,209,92,3,87,2,179,25,90,43,12,22
TCGCATCTTTCTGGTT,sample,36237,35893,1999,33894,5284,28610,17220,1415,7134,889,24354,1952,3540,2517,2025,3659
GACGGAGATTCTGGTT,sample,69945,69343,5382,63961,14336,49625,18180,1253,17136,1780,35316,11276,6013,1894,2703,9150
CCAGAGCGTTCTGGTT,sample,17878,17684,2478,15206,2928,12278,3429,248,4906,468,8335,3227,2808,770,467,1731
GTTAGCCGTTCTGGTT,sample,14540,14473,763,13710,3683,10027,5436,497,2678,322,8114,1094,1995,1152,854,2294
GACGATAATTCTGGTT,sample,61956,61394,4589,56805,10518,46287,26587,1948,10446,1179,37033,6127,4377,2126,3030,6827
GGCCAGAGTTCTGGTT,sample,32372,32029,1439,30590,10814,19776,12777,947,4033,551,16810,1468,1922,1244,3477,6320
CATTGCAGTTCTGGTT,sample,54176,53607,3282,50325,11619,38706,22507,1647,9106,1035,31613,4411,2674,1386,4534,7648
CCATGAAGTTCTGGTT,sample,10625,10424,1412,9012,1923,7089,2572,197,2432,240,5004,1648,1516,510,683,1185
ACGACTTCTTCTGGTT,sample,39609,39153,3136,36017,6697,29320,13405,1179,9686,1069,23091,3981,3255,1298,3291,4354
CTAGGACCTTCTGGTT,sample,58941,58453,2651,55802,10568,45234,30427,1912,8761,819,39188,3315,3235,2148,2601,7422
CGTATGAATTCTGGTT,sample,49630,48975,4644,44331,10002,34329,14436,1253,10926,1035,25362,6679,3745,994,3269,6333
TGCTTCGCTTCTGGTT,sample,75693,75119,2919,72200,16112,56088,40153,2275,8498,954,48651,4208,2425,1502,4246,11436
GTCTTAGCTTCTGGTT,sample,73085,72195,6090,66105,11651,54454,22050,1541,18087,2001,40137,10775,4644,1277,3031,7890
CCAATTCCTTCTGGTT,sample,47489,46760,3843,42917,10790,32127,13719,1324,9737,1028,23456,6319,3611,986,2410,6650
TCAATATATTCTGGTT,sample,72552,71883,3495,68388,20713,47675,24527,2291,13196,1707,37723,5954,3254,1236,3476,13096
TATCAGTTGTTCGGTT,sample,174620,173688,10937,162751,23046,139705,50825,3263,59732,7584,110557,18301,7608,2868,7473,16177
ACGTAAGTGTTCGGTT,sample,143081,141916,7243,134673,37247,97426,58163,4414,21778,2217,79941,10854,5476,2335,11271,23401
AATGGTAAGTTCGGTT,sample,117012,116235,3944,112291,43046,69245,51794,3655,10851,1173,62645,1772,1681,1550,13244,24845
TTAGAAGTGTTCGGTT,sample,116456,115566,8729,106837,13814,93023,33003,2159,36686,4228,69689,16947,6592,2158,4296,9506
GGACCTCTGTTCGGTT,sample,136860,135840,3864,131976,40728,91248,61169,4350,19127,1465,80296,5137,2535,1558,12356,26836
GCCTTGCTGTTCGGTT,sample,74521,73950,4741,69209,14404,54805,21936,1383,20346,2418,42282,8722,5014,1750,5124,9711
GTTAGCCGGTTCGGTT,sample,81243,80534,2267,78267,25033,53234,41851,2665,6540,925,48391,1253,1339,1307,9645,15991
GGAGGACGGTTCGGTT,sample,70342,69480,4484,64996,13069,51927,28047,1811,13276,1498,41323,7295,4213,1811,4534,8988
CCGCAACGGTTCGGTT,sample,44414,44031,3243,40788,11910,28878,12186,902,10632,1131,22818,4027,3693,1509,2195,7181
GGCCAGAGGTTCGGTT,sample,57600,57127,2385,54742,13188,41554,24034,2024,11295,1445,35329,2756,2633,1504,5539,8963
CATGATTCGTTCGGTT,sample,80096,79267,3707,75560,17608,57952,31829,2390,15906,1885,47735,5942,3690,1409,7349,11700
AGTCCGCAGTTCGGTT,sample,61782,61119,2483,58636,19540,39096,27753,1925,6981,924,34734,1513,1738,1250,6047,11963
GTTAGGACGTTCGGTT,sample,84823,84169,4422,79747,15079,64668,26982,1961,25707,2362,52689,7656,3910,1696,3865,10185
ACGTATTAGTTCGGTT,sample,88119,87367,4523,82844,22979,59865,33092,3151,15233,1800,48325,6589,3950,1606,5410,14493
AATATATCGTTCGGTT,sample,46398,45959,1756,44203,12166,32037,20336,1453,7372,748,27708,2128,2474,1562,3456,8054
TGCTTCGCGTTCGGTT,sample,53283,52737,1877,50860,15173,35687,23036,1503,7709,988,30745,2451,1910,1119,5157,9471
AAGAGCGCGTTCGGTT,sample,73066,72435,1755,70680,9931,60749,45657,3527,8393,1276,54050,1896,2660,2285,6489,7253
TTGGTTAAGTTCGGTT,sample,60751,60133,2829,57304,9130,48174,23929,2185,14441,1940,38370,5679,2958,1307,3245,5742
TTATTCGAGTTCGGTT,Neg_Ctrl,994,488,141,347,62,285,199,9,49,9,248,19,125,77,54,22
GACCGGAAGTTCGGTT,sample,64448,64002,2012,61990,14630,47360,31173,2303,10208,817,41381,2859,2445,1485,4411,10286
TCCAACTTTGGCGGTT,sample,8893,8781,544,8237,2275,5962,2826,219,2070,241,4896,606,1206,597,755,1415
AGTACCATTGGCGGTT,sample,96817,96189,3931,92258,31902,60356,29702,1957,20801,2252,50503,5644,3225,1512,6895,18831
ATGCCTGGTGGCGGTT,sample,133438,132561,3630,128931,50156,78775,61396,4777,9212,1247,70608,2143,1459,1389,19068,28540
TAGTACGGTGGCGGTT,sample,8225,8112,800,7312,1436,5876,2389,187,2073,225,4462,1002,1456,595,455,868
TTAGAAGTTGGCGGTT,sample,75524,75108,2948,72160,22940,49220,26615,2416,14046,1556,40661,4587,3515,1497,7066,14254
CCAGAGCGTGGCGGTT,sample,44153,43708,2545,41163,21620,19543,6948,403,7618,954,14566,3620,2983,823,1469,9394
GTTAGCCGTGGCGGTT,sample,114973,114044,3687,110357,34755,75602,44832,2879,20188,2068,65020,5635,2936,1428,11375,21848
CCGCAACGTGGCGGTT,sample,59450,58649,1876,56773,17492,39281,25312,2092,8654,778,33966,2445,2352,1561,3593,10880
CTTGATAGTGGCGGTT,sample,145040,144009,10049,133960,34619,99341,54218,3381,26382,3056,80600,12304,3972,1792,12269,22431
ACGACTTCTGGCGGTT,sample,95406,94647,3922,90725,15532,75193,41046,3431,21532,2584,62578,6600,4065,2100,5166,10865
CGGATTACTGGCGGTT,sample,106191,105144,5984,99160,25178,73982,34712,2923,22589,2579,57301,11179,4860,1536,8849,15669
GTTAGGACTGGCGGTT,sample,97377,96725,4189,92536,19427,73109,32598,1966,25830,3672,58428,9043,3812,1485,5627,13247
CGTATGAATGGCGGTT,sample,82041,81273,2300,78973,28800,50173,34661,3519,9845,683,44506,1465,1241,1047,10643,17816
TTGGCCTCTGGCGGTT,sample,81707,81142,3635,77507,17711,59796,29639,2631,18148,2870,47787,6508,4111,1648,6151,11630
TTGGTTAATGGCGGTT,sample,208724,207178,9898,197280,26110,171170,73968,5286,64809,5611,138777,21496,6400,1842,10869,17288
GGCATATATGGCGGTT,sample,90067,89301,2749,86552,22865,63687,41882,3156,12540,1840,54422,4269,2174,1331,7331,14819
TCAATATATGGCGGTT,sample,134819,133785,6361,127424,36715,90709,54265,4245,20410,2420,74675,9369,3406,1331,10351,22550
ATGACCGATGGCGGTT,sample,37256,37025,1065,35960,10615,25345,16761,1329,5221,661,21982,1373,1726,1054,2066,6863
TCCAACTTTCCTTATT,sample,42638,42415,1549,40866,16253,24613,14549,1117,6237,819,20786,1891,1819,1020,4758,9005
TAGTACGGTCCTTATT,sample,71269,70801,3993,66808,17156,49652,25885,1720,13020,1312,38905,7715,4095,1437,6962,10997
CAAGGCCTTCCTTATT,sample,36660,36337,1578,34759,12099,22660,9573,665,8717,1135,18290,2570,2260,924,1969,7131
ACTATACTTCCTTATT,sample,83238,82836,1984,80852,31549,49303,38914,3234,5315,684,44229,1156,1458,1429,11241,18148
GACGGAGATCCTTATT,sample,65150,64641,2188,62453,18203,44250,28502,2212,9337,1338,37839,2861,2556,1586,5598,11761
CCAGAGCGTCCTTATT,sample,61929,61464,1836,59628,17867,41761,29380,1901,6476,865,35856,3139,2180,1284,7056,11342
GTTAGCCGTCCTTATT,sample,38592,38369,1805,36564,9675,26889,15593,929,6696,925,22289,2746,2761,1566,3354,6259
GGACGTAGTCCTTATT,sample,44596,44244,1512,42732,14182,28550,19463,1437,5438,704,24901,1508,2016,1375,4515,8704
CATTGCAGTCCTTATT,sample,38641,38335,1881,36454,5834,30620,14421,880,10725,1389,25146,3205,2458,1139,2626,4038
AATCCGTCTCCTTATT,sample,55133,54642,4631,50011,9428,40583,17356,1284,13595,1444,30951,6904,3834,1307,3993,6274
AGTCCGCATCCTTATT,sample,120071,119138,8043,111095,20689,90406,40914,3356,24962,3045,65876,18129,6812,1552,7596,13289
CGTATGAATCCTTATT,sample,31221,30948,2214,28734,8432,20302,8840,676,6759,891,15599,3136,2783,1022,1487,5126
TTGGCCTCTCCTTATT,Pos_Ctrl,14046,13939,1188,12751,760,11991,9874,1018,764,103,10638,232,2684,2472,662,405
GAAGGCGCTCCTTATT,sample,61164,60666,3394,57272,11330,45942,26111,1872,11019,1465,37130,5475,3715,1496,2821,7686
AAGAGCGCTCCTTATT,sample,80738,80022,7273,72749,10225,62524,18762,1044,23597,2200,42359,16921,6688,1282,3480,6533
TTGGTTAATCCTTATT,sample,76324,75730,3874,71856,16298,55558,33219,1870,12997,1283,46216,6189,2779,1098,5292,11050
GTACCGTATCCTTATT,sample,60112,59473,6697,52776,8412,44364,14028,816,15799,1698,29827,12023,5677,1144,1541,5106
TTATTCGATCCTTATT,sample,2222,2167,165,2002,921,1081,348,32,372,70,720,259,361,136,79,421
TCCAACTTAATAAGGT,sample,64416,63634,5517,58117,13364,44753,16839,920,17182,1837,34021,7975,4421,1260,5803,8570
AAGTTCGTAATAAGGT,sample,95723,94977,3429,91548,30419,61129,37144,2637,15404,1837,52548,4107,2322,1401,10947,18772
GGTTGCGTAATAAGGT,sample,119423,118433,8065,110368,28357,82011,40214,2818,24458,2776,64672,11745,5664,2075,8939,18050
AGTACCATAATAAGGT,sample,125921,125020,9225,115795,26207,89588,43974,2919,27131,3600,71105,11964,6148,2379,7892,17451
TTCTAATGAATAAGGT,sample,86952,85987,6013,79974,18177,61797,29340,2157,18708,1637,48048,9955,4976,1622,4682,11803
TGAGCGCGAATAAGGT,sample,89298,88562,6047,82515,19924,62591,25680,1611,21694,2644,47374,10962,5201,1421,7728,13094
CAACCGCGAATAAGGT,sample,110552,109516,5294,104222,26632,77590,45221,3275,19647,2220,64868,7227,3549,1578,9455,17287
GCCTTGCTAATAAGGT,sample,86799,86167,3090,83077,27063,56014,38953,2795,9655,1344,48608,3267,2935,2084,8987,16944
GGAGGACGAATAAGGT,sample,138946,137643,7324,130319,34462,95857,44643,3866,28768,3792,73411,14788,5952,1639,13131,22545
CCGCAACGAATAAGGT,Pos_Ctrl,11215,10986,920,10066,610,9456,7702,825,643,68,8345,218,2418,2101,597,268
GGACGTAGAATAAGGT,sample,63673,63134,2675,60459,16661,43798,22520,1841,12344,1405,34864,5688,2842,1114,4902,10844
ACCTCGAGAATAAGGT,sample,95944,95192,5455,89737,28091,61646,32352,2934,15478,2530,47830,8352,3984,1279,10043,17297
GGCCAGAGAATAAGGT,sample,101000,100039,3802,96237,26526,69711,40559,3463,16487,2191,57046,7011,3922,1541,8158,16591
ACGACTTCAATAAGGT,sample,83576,82860,3065,79795,24096,55699,33899,3187,12968,1527,46867,4118,2791,1367,7413,14932
AATCCGTCAATAAGGT,Pos_Ctrl,40661,40307,2665,37642,2146,35496,29283,2825,2315,274,31598,799,4859,5206,2375,1036
AGTCCGCAAATAAGGT,sample,3205,3133,198,2935,931,2004,1061,106,599,56,1660,182,612,360,188,563
GTCCTGCCAATAAGGT,sample,57103,56565,3750,52815,11364,41451,18002,1339,14132,1766,32134,6212,4212,1592,3341,7888
GCCTGAACAATAAGGT,sample,55062,54406,3675,50731,14151,36580,15111,1529,12031,1446,27142,6463,3523,1063,2247,8738
TTGGCCTCAATAAGGT,sample,79264,78631,5774,72857,14497,58360,25201,1741,18132,1734,43333,11552,5427,1398,5016,9419
ACCAATGCAATAAGGT,sample,100026,99116,6658,92458,14883,77575,34675,2585,24300,3004,58975,13011,5629,1475,5784,9774
GTACCGTAAATAAGGT,sample,113421,112339,7622,104717,22108,82609,38894,3432,22978,2673,61872,14632,5295,1310,10291,15043
GGCATATAAATAAGGT,sample,33232,32808,2168,30640,8917,21723,9355,920,7013,913,16368,3522,2559,846,1603,5393
TCGCCTGAAATAAGGT,sample,45696,45317,3405,41912,7455,34457,14899,1026,11813,1240,26712,5479,3681,1296,1843,4775
GACCGGAAAATAAGGT,sample,41380,41125,2100,39025,8169,30856,15995,1404,9041,1187,25036,3229,3117,1606,1911,5696
AGTACCATCAGGACCA,sample,98647,97527,6427,91100,22980,68120,33417,2240,20147,2140,53564,10176,4917,1729,8726,14945
TTAGAAGTCAGGACCA,sample,100743,99701,4737,94964,21478,73486,44542,3592,16585,1814,61127,6953,3541,1626,8561,14609
TTCCGTCTCAGGACCA,sample,68256,67621,3612,64009,11395,52614,24126,1786,17980,2458,42106,6264,3610,1727,4710,7818
CAAGGCCTCAGGACCA,sample,88209,87481,3140,84341,15205,69136,35269,2901,23458,3121,58727,4387,3298,1971,5097,10951
ACCTCGAGCAGGACCA,sample,72911,72338,3766,68572,12371,56201,33057,3114,13820,1303,46877,4907,3837,1989,4952,8677
AATCCGTCCAGGACCA,sample,140739,139719,5117,134602,16324,118278,55674,5101,40059,6588,95733,10856,3876,1663,5877,12005
CGTACGTCCAGGACCA,sample,101432,100332,2661,97671,20483,77188,59184,5335,9169,2081,68353,1419,1296,1198,7925,14526
GTTAGGACCAGGACCA,sample,120131,119193,6022,113171,25098,88073,51920,3705,20760,2283,72680,9405,4505,1633,11178,16998
GCCTGAACCAGGACCA,sample,76980,76245,4078,72167,17031,55136,24705,2044,18322,2448,43027,7617,3829,1436,4209,11639
CGTATGAACAGGACCA,sample,76087,75494,1883,73611,22106,51505,40838,2578,5848,560,46686,1681,1348,1354,7634,14828
AATATATCCAGGACCA,Neg_Ctrl,1963,1304,987,317,58,259,138,20,73,6,211,22,105,54,23,32
TGCTTCGCCAGGACCA,sample,61728,61217,1834,59383,16643,42740,33326,2862,4388,677,37714,1487,1727,1439,7472,11702
GAAGGCGCCAGGACCA,sample,55264,54942,2244,52698,7136,45562,19983,1819,17114,2122,37097,4524,3127,1523,2165,4948
CCAATTCCCAGGACCA,sample,125180,124161,9450,114711,18984,95727,40380,3670,29430,3041,69810,19206,6847,1776,5490,12099
TTGGTTAACAGGACCA,sample,112419,111394,11170,100224,17193,83031,22670,2096,31019,3712,53689,23534,8373,1440,3809,11092
TCGCCTGACAGGACCA,sample,91189,90444,3979,86465,23217,63248,33681,2561,17183,2158,50864,7665,3892,1371,6138,14907
AGGTCGGACAGGACCA,sample,88212,87566,2333,85233,28457,56776,45283,4283,5239,755,50522,1216,1270,1282,8527,17572
TTATTCGACAGGACCA,sample,20964,20848,715,20133,5637,14496,7750,858,3933,571,11683,1384,1728,945,1257,3451
TATCAGTTCCTCGTTG,sample,62053,61482,4950,56532,13853,42679,14556,1093,15424,1911,29980,9695,5024,1469,2971,8450
ATTCTCTTCCTCGTTG,sample,61862,61287,3149,58138,14727,43411,24603,1903,11064,1159,35667,4682,3360,1779,4448,9463
ACGTAAGTCCTCGTTG,sample,58409,57707,5050,52657,14183,38474,13547,1125,14789,1624,28336,7389,4132,1095,2437,8502
CCTCTAGACCTCGTTG,sample,78992,78143,2027,76116,28907,47209,34927,1930,8218,855,43145,1279,1182,907,11899,17179
ACGTTATGCCTCGTTG,sample,76802,76072,5690,70382,16386,53996,27638,2175,15052,2104,42690,7027,4606,2006,5623,10459
AATGGTAACCTCGTTG,sample,107836,106770,14022,92748,16041,76707,21429,1479,29106,3630,50535,21063,7958,1669,5323,9833
GGACCTCTCCTCGTTG,sample,80498,79740,4764,74976,16101,58875,32671,2195,15524,1713,48195,6772,3881,1584,5557,11627
CAAGGCCTCCTCGTTG,sample,75671,74969,4739,70230,17705,52525,31594,2365,12066,1608,43660,4892,3373,1833,5794,11250
CATAACCTCCTCGTTG,sample,79439,78705,3209,75496,17920,57576,34837,3095,13706,1738,48543,4200,3104,1901,6270,12033
CCAGAGCGCCTCGTTG,sample,92938,92031,3727,88304,21121,67183,41443,2856,15745,1977,57188,5162,2402,1354,8151,14679
GTTAGCCGCCTCGTTG,sample,85047,84289,3618,80671,25743,54928,33182,2462,13154,980,46336,5150,3024,1204,7693,15566
GGAGGACGCCTCGTTG,sample,83442,82600,3044,79556,25167,54389,36067,3040,11457,1166,47524,2659,1572,1056,8744,15957
CCGCAACGCCTCGTTG,sample,62038,61376,4367,57009,10503,46506,21887,1380,14565,1825,36452,6849,3651,1384,3392,7045
GGACGTAGCCTCGTTG,Neg_Ctrl,2008,822,657,165,34,131,61,8,29,4,90,29,53,24,15,5
ACCTCGAGCCTCGTTG,sample,48873,48270,4729,43541,8720,34821,10734,744,13505,1469,24239,8369,4346,955,2823,5599
GGCCAGAGCCTCGTTG,sample,82619,81609,6347,75262,16980,58282,24605,1441,19858,2101,44463,10277,4801,1252,5228,10799
CGAGGCAGCCTCGTTG,sample,95285,94283,5982,88301,19967,68334,30990,2770,22443,2047,53433,10084,4547,1329,7587,13236
CATGATTCCCTCGTTG,sample,73062,72124,2335,69789,17255,52534,32351,2008,12683,1447,45034,4045,2526,1315,3956,11578
CGTACGTCCCTCGTTG,Neg_Ctrl,2232,882,650,232,58,174,101,6,44,4,145,19,84,38,20,8
CGGATTACCCTCGTTG,sample,55335,54626,4776,49850,13082,36768,17773,1042,10069,1157,27842,6727,3739,1055,4452,7993
GTTAGGACCCTCGTTG,sample,72469,71789,3243,68546,20092,48454,30496,1658,10694,1352,41190,4254,2748,1190,9113,12467
GCCTGAACCCTCGTTG,sample,47454,46981,4409,42572,8854,33718,13800,1088,10963,1172,24763,6695,3969,993,3266,5839
GTACCGTACCTCGTTG,Pos_Ctrl,3221,3212,203,3009,221,2788,2309,280,163,14,2472,22,934,836,148,107
TCGCCTGACCTCGTTG,sample,54047,53505,6037,47468,6344,41124,11888,940,15929,1758,27817,10609,5265,1194,1680,4021
AGGTCGGACCTCGTTG,sample,34930,34622,1791,32831,7417,25414,14987,1117,6055,757,21042,2498,2116,1160,2555,4894
ATTCTCTTTTGCGGAC,sample,111649,111163,2191,108972,27634,81338,64979,5232,7933,1047,72912,2147,3045,3020,9647,18414
AAGTTCGTTTGCGGAC,sample,53420,53049,2243,50806,11747,39059,17653,1305,14928,1834,32581,3339,3214,1503,4298,7714
ACGTAAGTTTGCGGAC,sample,115009,114350,4452,109898,33992,75906,48639,3803,15521,2027,64160,5916,3173,1592,12049,21807
AGTACCATTTGCGGAC,sample,59283,58833,2782,56051,16613,39438,20441,1801,11956,1377,32397,3863,2913,1284,4942,10269
TTCGTAATTTGCGGAC,sample,78284,77800,2145,75655,17256,58399,29112,2823,19621,2243,48733,4600,2741,1774,2396,11732
GGACCTCTTTGCGGAC,sample,57428,57008,3035,53973,11286,42687,21035,1647,14138,1700,35173,4167,3504,1833,3487,7756
CATAACCTTTGCGGAC,sample,20145,19939,1060,18879,4738,14141,8228,717,3652,409,11880,1135,1666,1011,1746,3096
GACGGAGATTGCGGAC,sample,81293,80656,3140,77516,17098,60418,32376,2047,17750,2275,50126,5970,3225,1564,6061,12131
CCAGAGCGTTGCGGAC,sample,54476,53951,3654,50297,14042,36255,15274,1403,13931,1121,29205,4526,3374,1185,3418,8664
GGAGGACGTTGCGGAC,sample,54433,54018,2924,51094,11130,39964,19821,1337,12593,1587,32414,4626,2683,1113,3047,7597
ACCTCGAGTTGCGGAC,sample,39813,39494,1780,37714,12733,24981,18247,1328,3891,498,22138,1017,1195,909,5892,7983
CGAGGCAGTTGCGGAC,sample,76262,75537,3037,72500,18209,54291,33419,3616,10467,1504,43886,5285,2053,926,4513,12486
CATGATTCTTGCGGAC,sample,55645,55193,2393,52800,15943,36857,18438,1677,11556,1353,29994,3833,2700,1023,3312,9925
AGTCCGCATTGCGGAC,sample,104193,103136,10054,93082,15781,77301,29036,2291,25819,2668,54855,17487,6525,1460,3800,10288
GTCCTGCCTTGCGGAC,sample,70098,69411,3080,66331,14864,51467,31152,2952,12654,1070,43806,3639,2467,994,4177,10241
CGTATGAATTGCGGAC,sample,40814,40370,2018,38352,10108,28244,16450,1140,6831,818,23281,3005,2237,1027,2694,6781
ACCAATGCTTGCGGAC,sample,50220,49864,1589,48275,12734,35541,21892,1703,8935,1264,30827,1747,2117,1492,3523,8504
GTCTTAGCTTGCGGAC,sample,65674,65013,4839,60174,14107,46067,21321,1673,13423,1439,34744,8211,3932,1105,4529,8674
GTACCGTATTGCGGAC,sample,77251,76639,2680,73959,15533,58426,31749,2462,16947,2056,48696,5212,2799,1298,5623,10732
TCGCCTGATTGCGGAC,sample,71678,71134,3841,67293,16153,51140,29435,2491,12233,1307,41668,5674,3296,1311,4480,10621
AGGTCGGATTGCGGAC,sample,98789,97937,6258,91679,20172,71507,38048,3078,16979,2062,55027,11340,5247,1402,6243,13271
AAGTTCGTTCCATTGG,sample,36303,35820,2058,33762,12524,21238,11100,623,6018,617,17118,2880,2465,1152,3163,7318
ACGTAAGTTCCATTGG,sample,56803,56296,3297,52999,11028,41971,26203,2149,9004,1054,35207,3561,3083,2004,5698,7655
AGTACCATTCCATTGG,sample,67153,66568,4181,62387,26514,35873,20051,1224,9206,967,29257,4425,2675,1167,5626,14022
TGAGCGCGTCCATTGG,sample,41550,41139,1283,39856,13949,25907,19120,1104,4443,524,23563,716,1283,968,5255,8673
AATGGTAATCCATTGG,sample,52472,51950,3279,48671,11835,36836,18579,1329,11818,826,30397,4284,3033,1216,4010,7776
TTAGAAGTTCCATTGG,sample,62150,61581,2401,59180,17193,41987,27872,2239,8818,1053,36690,2005,1818,1183,7018,11105
GGACCTCTTCCATTGG,sample,51057,50580,3369,47211,6140,41071,16111,1431,15769,1685,31880,6075,3628,1514,1683,3963
CATAACCTTCCATTGG,sample,25975,25549,3834,21715,4560,17155,5838,391,5899,732,11737,4295,2883,751,2116,2715
ACTATACTTCCATTGG,sample,20266,20095,1163,18932,5474,13458,8550,626,2873,302,11423,1107,1658,1142,2557,3511
GTTAGCCGTCCATTGG,sample,17506,17251,2314,14937,3801,11136,4617,295,3574,377,8191,2273,2227,788,1467,2214
CTTGATAGTCCATTGG,sample,42443,42004,2131,39873,9710,30163,16923,1208,7714,1023,24637,3295,2450,1231,2651,6515
ACCTCGAGTCCATTGG,sample,18123,17881,1130,16751,4333,12418,6288,500,3798,414,10086,1418,1935,932,1543,2763
TGGACGAGTCCATTGG,sample,129677,128353,14697,113656,10824,102832,30250,2045,36935,4142,67185,29460,10240,2184,2588,5984
CGAGGCAGTCCATTGG,sample,42173,41777,1690,40087,7174,32913,19189,1568,8471,1088,27660,2597,2717,1706,2196,5081
CCATGAAGTCCATTGG,sample,25597,25304,3369,21935,4354,17581,6083,335,6456,680,12539,4027,3106,906,1419,2642
ACGACTTCTCCATTGG,sample,68812,68046,3968,64078,14860,49218,26113,1762,12644,1569,38757,7130,3413,1223,6544,10148
AATCCGTCTCCATTGG,sample,69375,68734,3439,65295,14303,50992,28428,1952,13517,1289,41945,5806,3139,1275,7468,9525
AGTCCGCATCCATTGG,sample,69521,68817,2943,65874,14384,51490,30487,2742,12658,1097,43145,4506,3194,1558,4965,9448
TTGGTACCTCCATTGG,sample,62802,62257,4867,57390,12016,45374,18756,999,15453,1684,34209,8482,4561,1242,5027,7491
CGGATTACTCCATTGG,sample,38846,38425,2916,35509,6986,28523,12205,798,9445,1078,21650,4997,3355,1105,1738,4349
AATATATCTCCATTGG,sample,83138,82619,2498,80121,17718,62403,46195,4179,8431,652,54626,2946,2588,1650,9621,12249
GAAGGCGCTCCATTGG,sample,70364,69749,6109,63640,9746,53894,17474,1243,20472,2365,37946,12340,6331,1281,3696,6224
GTCTTAGCTCCATTGG,sample,19997,19866,1923,17943,3901,14042,4650,527,4933,617,9583,3315,2996,977,678,2448
TTGGTTAATCCATTGG,sample,52049,51760,2210,49550,11314,38236,22883,1328,8519,884,31402,4622,3050,1274,4654,7383
GGCATATATCCATTGG,Neg_Ctrl,286,203,46,157,26,131,80,4,24,9,104,14,53,42,18,12
TCAATATATCCATTGG,sample,1248,1228,76,1152,350,802,435,43,221,38,656,65,269,154,80,221
TTATTCGATCCATTGG,sample,79,75,6,69,19,50,30,3,9,2,39,6,26,20,7,7
GGAGAGTTCATAGGCG,sample,144546,143508,4825,138683,37076,101607,69783,4967,18787,1952,88570,6118,3867,2373,14136,24842
TATCAGTTCATAGGCG,sample,50699,50504,1694,48810,17529,31281,20625,1791,5019,962,25644,2884,2694,1505,5606,10532
GGTTGCGTCATAGGCG,sample,60525,60139,2050,58089,15567,42522,22188,1707,13375,1702,35563,3550,2723,1624,4306,10252
ACGTAAGTCATAGGCG,sample,124615,123820,3815,120005,38244,81761,59580,5583,11365,1377,70945,3856,2964,2193,10143,24585
AGTACCATCATAGGCG,sample,88458,87653,6190,81463,27078,54385,29070,2178,14843,1734,43913,6560,3644,1445,9075,16212
ATGCCTGGCATAGGCG,sample,84869,84113,4129,79984,27061,52923,30607,2740,13811,1533,44418,4232,2839,1298,8932,16453
TAGTACGGCATAGGCG,sample,27316,27156,754,26402,11161,15241,11302,824,2275,307,13577,533,1827,1493,3493,6090
TGAGCGCGCATAGGCG,sample,32619,32289,2618,29671,8268,21403,10017,653,6540,762,16557,3431,2855,1104,2864,5367
AATGGTAACATAGGCG,sample,16551,16368,1376,14992,4563,10429,5440,340,2799,309,8239,1541,1790,842,1772,2652
TTAGAAGTCATAGGCG,sample,29323,28959,3365,25594,6023,19571,7874,488,6506,785,14380,3918,3036,1009,2127,3732
TCGCATCTCATAGGCG,sample,31075,30806,2069,28737,6394,22343,9584,582,8265,901,17849,3011,2704,1178,2317,4180
GCCTTGCTCATAGGCG,sample,50930,50353,4033,46320,12250,34070,16677,1244,10238,1119,26915,4792,3457,1334,4512,8026
CATAACCTCATAGGCG,sample,36696,36243,2743,33500,8334,25166,12289,871,7498,891,19787,3617,2977,1302,3220,5299
CCGCAACGCATAGGCG,sample,61241,60692,2948,57744,10507,47237,23784,1782,15292,2125,39076,4254,3455,1714,3398,7326
TGGACGAGCATAGGCG,sample,30531,30202,2561,27641,3723,23918,9558,775,8833,1170,18391,3582,3521,1645,885,2442
GGCCAGAGCATAGGCG,sample,64400,63770,2204,61566,18946,42620,29621,1857,8445,870,38066,1827,1550,1117,8384,12338
ACGACTTCCATAGGCG,sample,63487,62932,2448,60484,20783,39701,27836,1766,7377,868,35213,1854,1685,1270,7272,12660
GTCCTGCCCATAGGCG,sample,66600,65864,3689,62175,16625,45550,26086,2003,11241,968,37327,5252,2681,1101,6382,11004
GTTAGGACCATAGGCG,sample,53448,52979,1746,51233,8645,42588,27413,1941,9691,1097,37104,2446,2662,1837,4040,6383
AACTCGTACATAGGCG,sample,83481,82764,3035,79729,14131,65598,48290,3941,9365,877,57655,3125,2847,1940,6566,10384
AATATATCCATAGGCG,sample,73473,72832,7656,65176,11438,53738,20888,1865,18198,2047,39086,10740,5474,1728,2972,7243
ACCAATGCCATAGGCG,sample,39384,39048,1754,37294,4485,32809,16632,1026,10884,1026,27516,3241,3089,1718,1729,2962
TGCTTCGCCATAGGCG,sample,61558,60876,3703,57173,11872,45301,26989,1732,10965,1240,37954,4375,3099,1355,4741,7950
AAGAGCGCCATAGGCG,sample,97256,96298,7715,88583,15650,72933,30536,2194,24507,2598,55043,13098,5623,1493,4801,10093
GTCTTAGCCATAGGCG,sample,75566,74790,4076,70714,16793,53921,31168,2809,12825,1332,43993,5787,3234,1144,7491,11123
CCAATTCCCATAGGCG,sample,33676,33168,4772,28396,4694,23702,6859,578,8891,1053,15750,6321,3692,770,1762,2725
TTGGTTAACATAGGCG,sample,70576,69997,4217,65780,16148,49632,27337,2154,12012,1326,39349,6803,3792,1377,6745,10909
GGCATATACATAGGCG,sample,67329,66599,4742,61857,12846,49011,20598,1908,16561,2031,37159,7913,3565,1100,4470,8410
TCGCCTGACATAGGCG,sample,90735,89822,6423,83399,14300,69099,34615,2397,19270,2317,53885,10500,5044,1721,4100,9888
AGGTCGGACATAGGCG,sample,67148,66458,3647,62811,11046,51765,25919,2122,15414,2122,41333,6188,3231,1308,2802,7754
ATTCTCTTTTGGAGAG,Pos_Ctrl,42404,41867,4195,37672,2548,35124,28884,2776,2333,364,31217,767,4840,4852,2554,1338
TCCAACTTTTGGAGAG,sample,57981,57431,2427,55004,19904,35100,23495,1763,6745,680,30240,2417,2256,1428,6644,11558
TCCTCCGTTTGGAGAG,sample,5936,5862,459,5403,2209,3194,1446,84,1071,133,2517,460,957,431,384,1149
CCTCTAGATTGGAGAG,sample,42097,41608,3263,38345,10692,27653,13361,964,8303,976,21664,4049,2949,1112,3304,6614
ATGCCTGGTTGGAGAG,sample,8467,8324,1194,7130,1422,5708,1752,175,2116,220,3868,1445,1457,518,300,796
TAGTACGGTTGGAGAG,sample,55930,55360,4914,50446,13135,37311,13906,1255,13195,1545,27101,7410,4240,1445,2675,7932
TTAGAAGTTTGGAGAG,sample,70228,69729,4376,65353,11738,53615,28229,1965,14209,1513,42438,7699,4725,2478,4741,7924
TTCCGTCTTTGGAGAG,Pos_Ctrl,31727,31462,2591,28871,1823,27048,22249,2293,1703,249,23952,554,4271,4304,2028,892
TCGCATCTTTGGAGAG,sample,97953,97162,4320,92842,31453,61389,34312,2160,16085,1487,50397,7345,3826,1257,9529,18582
CAAGGCCTTTGGAGAG,sample,35881,35444,3439,32005,6696,25309,9387,769,8737,1060,18124,5356,3500,1210,2246,4332
ACTATACTTTGGAGAG,sample,173020,171534,8589,162945,29211,133734,72934,5774,34461,3980,107395,16585,6187,1808,10164,19899
CCGCAACGTTGGAGAG,sample,64662,64017,4538,59479,12112,47367,21796,1503,15377,1624,37173,7067,3913,1662,3852,8194
CATTGCAGTTGGAGAG,sample,80937,80124,4497,75627,15566,60061,34327,2392,15264,1607,49591,6471,3952,1684,7080,10883
CGAGGCAGTTGGAGAG,sample,44700,44142,2477,41665,7528,34137,20842,1762,7353,1074,28195,3106,3003,1977,2551,5123
CATGATTCTTGGAGAG,sample,66230,65544,2236,63308,19715,43593,30688,2588,7491,812,38179,2014,1589,1163,8119,12585
AATCCGTCTTGGAGAG,sample,51475,50893,3691,47202,8404,38798,20712,1321,10652,1299,31364,4814,3598,1606,3892,5680
CGTACGTCTTGGAGAG,sample,59094,58391,4901,53490,9563,43927,18513,1188,15134,1526,33647,7566,4197,1372,2894,6488
AGTCCGCATTGGAGAG,sample,61621,60979,5106,55873,9111,46762,22372,1619,14900,1531,37272,6340,4187,1743,3657,6354
TTGGTACCTTGGAGAG,sample,50311,49861,2224,47637,13545,34092,19636,1548,8634,1055,28270,3219,2574,1258,5737,8693
CTAGGACCTTGGAGAG,sample,54226,53702,3026,50676,8470,42206,26623,1735,8858,1049,35481,3941,3523,2156,2978,5583
GCCTGAACTTGGAGAG,sample,70740,70003,3475,66528,16389,50139,29133,2486,12240,1922,41373,4358,3034,1449,6963,11010
TTGGCCTCTTGGAGAG,sample,34117,33811,2374,31437,11145,20292,10438,677,5641,637,16079,2899,2937,1207,3128,6343
AATATATCTTGGAGAG,sample,87964,87172,7028,80144,13713,66431,31825,2061,20690,2146,52515,9709,5378,1596,5577,8921
ACCAATGCTTGGAGAG,sample,45026,44505,2826,41679,10720,30959,16282,1045,8789,1001,25071,3842,2765,1105,3506,6715
TCAATATATTGGAGAG,sample,58082,57643,3357,54286,9070,45216,27767,1912,9829,996,37596,4712,3593,1754,3585,6004
GACCGGAATTGGAGAG,sample,100076,99322,6898,92424,13046,79378,23595,1942,29595,3148,53190,21098,7548,1716,3148,8596
GGTTGCGTTTCAAGCC,sample,59897,59370,3839,55531,16788,38743,22409,1879,9268,1133,31677,4054,3810,1923,5381,10088
ACGTTATGTTCAAGCC,sample,22826,22546,2646,19900,3790,16110,6159,315,5901,472,12060,3263,2589,842,1944,2292
ATGCCTGGTTCAAGCC,sample,60749,60258,2852,57406,11232,46174,24374,1896,13782,1805,38156,4317,3255,1738,3939,7988
TTAGAAGTTTCAAGCC,sample,75843,75371,2253,73118,15309,57809,40041,3273,10360,1099,50401,3036,2917,2367,5515,10712
GGACCTCTTTCAAGCC,sample,69210,68561,4029,64532,21669,42863,25051,2182,10280,1016,35331,4334,2540,1283,6648,12768
TCGCATCTTTCAAGCC,sample,25947,25707,2050,23657,5316,18341,8163,663,5709,581,13872,3225,2498,1070,1703,3387
CATAACCTTTCAAGCC,sample,76837,76128,4603,71525,20195,51330,24663,1641,16729,1836,41392,6461,3320,1219,7932,12673
CCAGAGCGTTCAAGCC,sample,56748,56015,5263,50752,11789,38963,13203,1121,15084,1598,28287,7957,4244,1040,3317,7500
GGAGGACGTTCAAGCC,sample,79719,78952,6170,72782,13869,58913,27853,2313,20705,2237,48558,5805,4022,1761,4173,9308
TGGACGAGTTCAAGCC,sample,40159,39951,1961,37990,12124,25866,13157,991,7262,668,20419,3788,3000,1428,2673,7682
CATGATTCTTCAAGCC,sample,46904,46529,2428,44101,6762,37339,16596,1364,13588,1611,30184,4180,3307,1638,2086,4727
AGTCCGCATTCAAGCC,sample,19688,19437,2425,17012,2970,14042,5603,398,4767,628,10370,2646,2627,976,849,1717
GTCCTGCCTTCAAGCC,sample,61534,61008,3444,57564,13313,44251,19717,1402,13695,1624,33412,7813,3304,1162,5605,8982
GTTAGGACTTCAAGCC,sample,43073,42645,2488,40157,13107,27050,14289,1000,7560,1069,21849,3132,2785,1337,2295,7809
GCCTGAACTTCAAGCC,sample,59180,58738,2791,55947,16065,39882,26287,1979,7417,857,33704,3342,3045,1731,5072,10265
CGTATGAATTCAAGCC,sample,50731,50273,2604,47669,10578,37091,21386,1511,9777,1053,31163,3364,2640,1377,4783,7169
TTGGCCTCTTCAAGCC,Pos_Ctrl,14619,14480,1211,13269,810,12459,10181,1056,829,109,11010,284,2789,2511,772,372
AATATATCTTCAAGCC,sample,15049,14877,2055,12822,2533,10289,3114,235,3889,441,7003,2610,2165,593,914,1457
GTCTTAGCTTCAAGCC,sample,92323,91633,4024,87609,16378,71231,41106,2866,17481,2254,58587,7524,3242,1375,8614,11560
TTGGTTAATTCAAGCC,sample,68011,67480,3031,64449,6740,57709,35186,2910,13898,1535,49084,4180,3910,2606,3379,4460
TCGCCTGATTCAAGCC,sample,57893,57406,3068,54338,11341,42997,24190,2307,9460,1016,33650,6024,3707,1414,4970,7507
AGGTCGGATTCAAGCC,sample,45664,45330,1573,43757,10835,32922,21630,1594,7401,844,29031,1453,1892,1366,3299,7486
GACCGGAATTCAAGCC,sample,63698,63148,1240,61908,18318,43590,32271,3455,6482,678,38753,704,966,930,5378,11634
TCCAACTTAACTTAAC,Neg_Ctrl,2232,1074,672,402,105,297,94,4,131,50,225,18,77,29,36,45
GGTTGCGTAACTTAAC,sample,31147,30748,3535,27213,2872,24341,7111,520,11166,1504,18277,4040,3630,1368,683,1669
ACGTAAGTAACTTAAC,sample,74443,73676,4876,68800,13286,55514,21902,1937,22250,2968,44152,6457,3967,1400,5149,9298
CCTCTAGAAACTTAAC,sample,42127,41602,3116,38486,10412,28074,9809,765,11281,1294,21090,4925,3393,1156,1092,6459
AGTACCATAACTTAAC,sample,4219,4135,761,3374,622,2752,747,69,1055,125,1802,756,744,268,183,330
TTCTAATGAACTTAAC,sample,45971,45682,1896,43786,14563,29223,18917,1356,6130,756,25047,2064,2628,1849,4057,8807
TGAGCGCGAACTTAAC,sample,64790,63968,10891,53077,8280,44797,12492,986,16673,2015,29165,12631,6768,1858,2367,4811
AATGGTAAAACTTAAC,sample,48476,47980,3363,44617,12210,32407,15412,862,9698,1264,25110,5171,3219,1067,4246,7486
TTAGAAGTAACTTAAC,sample,78133,77434,6948,70486,13929,56557,21882,1268,20641,2234,42523,10532,5383,1590,4398,9116
GGACCTCTAACTTAAC,Neg_Ctrl,1672,836,628,208,38,170,72,8,62,4,134,24,67,28,21,22
CAAGGCCTAACTTAAC,sample,71634,70950,4156,66794,22214,44580,24669,1458,11316,1815,35985,5322,3081,1151,8520,13284
ACTATACTAACTTAAC,sample,70214,69567,7398,62169,14677,47492,17527,1332,15713,1807,33240,11113,5368,1307,6100,9241
CCGCAACGAACTTAAC,sample,64854,64340,2594,61746,11520,50226,37130,2541,7153,719,44283,2683,2915,2329,3699,7674
GGACGTAGAACTTAAC,sample,54192,53662,4715,48947,10909,38038,19187,1536,10165,1376,29352,5774,3953,1681,3579,7322
GACGATAAAACTTAAC,sample,41386,40913,3302,37611,9577,28034,14115,881,7735,786,21850,4517,3111,1076,4409,5948
GGCCAGAGAACTTAAC,sample,53606,53102,4475,48627,10476,38151,15866,1298,13094,1403,28960,6490,3960,1194,3873,6951
CGAGGCAGAACTTAAC,sample,38701,38342,1974,36368,9031,27337,15532,1026,7623,688,23155,2468,2650,1319,3849,5948
CATGATTCAACTTAAC,sample,93392,92672,4880,87792,20555,67237,38077,2568,18987,2194,57064,5411,2756,1437,7498,13924
AATCCGTCAACTTAAC,sample,83531,82787,4397,78390,18221,60169,31743,2731,16146,1707,47889,7842,4218,1471,7120,11907
TTGGCCTCAACTTAAC,sample,53370,52978,2800,50178,9556,40622,18781,1686,13705,2073,32486,4377,2604,1187,3294,6389
ACCAATGCAACTTAAC,sample,74818,74202,3998,70204,13293,56911,26855,2465,17580,2328,44435,7683,4001,1231,3908,9060
TCGCCTGAAACTTAAC,sample,51536,51206,1922,49284,12879,36405,21957,1911,8271,1053,30228,3213,2713,1302,3904,8191
CTTCATGAAACTTAAC,sample,57731,57368,2842,54526,12248,42278,20855,1941,12884,1582,33739,5016,3271,1217,3492,7935
AGGTCGGAAACTTAAC,sample,53224,52829,1844,50985,14323,36662,22469,1951,7896,948,30365,3398,2303,1090,3275,8971
TTATTCGAAACTTAAC,sample,496,473,23,450,105,345,229,16,70,10,299,20,139,107,63,67
GACCGGAAAACTTAAC,sample,34641,34331,829,33502,9389,24113,16593,1361,4594,599,21187,966,1090,886,2858,5953
CCTCTAGAATACTTGA,sample,37831,37406,2244,35162,10845,24317,12701,768,7119,707,19820,3022,2481,996,3770,6682
TTCGTAATATACTTGA,sample,97380,96595,2688,93907,32606,61301,45073,2944,9749,1744,54822,1791,1590,1209,16230,20045
TTCTAATGATACTTGA,sample,38133,37706,5344,32362,5186,27176,10104,831,9010,994,19114,6237,4702,1698,1655,3008
TTAGAAGTATACTTGA,sample,74616,74103,2979,71124,7698,63426,44429,3914,11099,1305,55528,2679,4431,3870,3177,5638
GACGATAAATACTTGA,sample,32727,32475,1175,31300,11727,19573,13345,1072,3757,533,17102,866,1324,963,2782,6605
CGAGGCAGATACTTGA,sample,73131,72512,3747,68765,21611,47154,25777,2512,12135,1220,37912,5510,3131,1090,6550,13519
CCATGAAGATACTTGA,sample,76458,75714,4302,71412,16267,55145,27238,2403,16283,2033,43521,7188,3838,1521,4564,11089
ACGACTTCATACTTGA,sample,109897,108976,5557,103419,24399,79020,40963,3353,21227,3029,62190,10448,4288,1484,9709,16214
AATCCGTCATACTTGA,sample,82035,81489,5197,76292,17998,58294,26154,1908,18879,2412,45033,8941,4767,1778,3902,11349
CGTACGTCATACTTGA,sample,125990,124891,6128,118763,22318,96445,51204,4459,27785,4102,78989,8895,4535,1886,8423,16135
GTCCTGCCATACTTGA,sample,92931,92124,4633,87491,24341,63150,32887,2768,18178,1753,51065,7564,3802,1322,7352,15509
CGGATTACATACTTGA,sample,107001,106091,4507,101584,29628,71956,49174,3372,12536,1700,61710,5174,3031,1330,11793,18658
GTTAGGACATACTTGA,sample,43119,42718,2569,40149,8864,31285,15394,1321,9837,1111,25231,3622,2867,1333,2764,5793
ACGTATTAATACTTGA,sample,66333,65839,2107,63732,15518,48214,29233,2214,11782,1926,41015,3059,2033,1276,5589,10761
AACTCGTAATACTTGA,sample,60164,59608,2254,57354,15303,42051,26294,2591,9397,974,35691,2795,2065,1176,4758,10235
AATATATCATACTTGA,Neg_Ctrl,1447,775,461,314,67,247,110,3,46,6,156,82,85,57,20,21
GTCTTAGCATACTTGA,sample,74817,74096,5271,68825,11221,57604,28216,2912,16744,1678,44960,8054,4266,1583,3917,7551
GGCATATAATACTTGA,sample,27851,27574,1180,26394,3878,22516,14095,1177,4893,628,18988,1723,2275,1536,1215,2850
AGGTCGGAATACTTGA,sample,75753,75106,2079,73027,18392,54635,41396,4478,6931,739,48327,1091,1163,1053,8097,12992
ATGACCGAATACTTGA,sample,69721,69041,2233,66808,17816,48992,30623,2749,10508,1370,41131,3742,2364,1174,4807,11424
TATCAGTTATCCGCGA,sample,113432,112538,11121,101417,23244,78173,33811,2300,26488,2809,60299,12765,4970,1640,8874,15032
CCTCTAGAATCCGCGA,sample,109755,109125,4021,105104,31404,73700,45045,3721,16930,1707,61975,6297,3707,1716,10747,20562
TTCGTAATATCCGCGA,sample,89293,88625,4466,84159,23577,60582,36160,2710,14118,1675,50278,5919,3687,1783,7508,15290
ATGCCTGGATCCGCGA,sample,58926,58321,4562,53759,13123,40636,19103,1350,12309,1366,31412,6508,4085,1655,3606,8123
AATGGTAAATCCGCGA,sample,111352,110549,3564,106985,35615,71370,52885,3451,11811,1360,64696,1863,1395,1196,16599,22995
TTAGAAGTATCCGCGA,sample,70734,70210,3929,66281,12496,53785,23838,2010,19073,2425,42911,6439,3548,1593,4590,8261
TTCCGTCTATCCGCGA,sample,93751,93045,2595,90450,32534,57916,41942,3382,9134,1486,51076,1972,1623,1311,11353,19824
GCCTTGCTATCCGCGA,sample,58924,58314,6593,51721,11700,40021,13435,807,15796,2183,29231,7800,4814,1297,3513,7247
CAAGGCCTATCCGCGA,sample,97613,96741,7425,89316,19968,69348,33739,2432,20987,2106,54726,10084,4901,1727,8173,13827
GGAGGACGATCCGCGA,sample,17753,17641,645,16996,3843,13153,8365,710,2759,342,11124,977,2051,1561,672,2609
ACGACTTCATCCGCGA,sample,52889,52338,7414,44924,6365,38559,9419,650,16458,1796,25877,10236,5297,1098,1656,3655
AATCCGTCATCCGCGA,sample,62885,62334,5016,57318,10089,47229,18012,1445,17815,2015,35827,7942,4498,1391,2033,6578
AGTCCGCAATCCGCGA,sample,91767,91232,3868,87364,13975,73389,40121,3618,20219,2507,60340,6924,3931,1625,3937,9393
TTGGTACCATCCGCGA,sample,145064,143431,7010,136421,30185,106236,51844,4520,29555,3435,81399,16882,3986,1249,8943,20227
ACCAATGCATCCGCGA,sample,50632,50128,3265,46863,10682,36181,15687,1421,12128,1716,27815,5229,3267,1072,2322,7022
TGCTTCGCATCCGCGA,sample,47364,47017,2164,44853,7963,36890,21095,1685,10410,846,31505,2854,2863,1629,3079,5773
TCAATATAATCCGCGA,sample,53916,53498,2846,50652,13875,36777,20163,1392,10360,1115,30523,3747,2826,1186,4375,8675
AGGTCGGAATCCGCGA,sample,55375,54920,3350,51570,13430,38140,18924,1611,11199,1021,30123,5385,3562,1282,2558,8509
ATTCTCTTAGGACTCA,sample,60888,60435,3511,56924,12357,44567,24020,1907,12873,1941,36893,3826,3475,1984,4193,7964
TTCTAATGAGGACTCA,sample,60605,60058,5282,54776,10695,44081,17344,1233,15666,2079,33010,7759,5017,1835,3077,7313
TAGTACGGAGGACTCA,sample,33130,32800,2024,30776,10376,20400,10449,790,6053,777,16502,2331,2830,1444,2195,6069
TTCCGTCTAGGACTCA,sample,58745,58298,2215,56083,13658,42425,27761,2125,9098,1014,36859,2427,3291,2385,4049,9388
GCCTTGCTAGGACTCA,sample,51982,51529,2911,48618,13046,35572,17170,1242,11513,1377,28683,4270,3594,1776,2434,8334
GGAGGACGAGGACTCA,sample,55608,55046,2540,52506,16822,35684,19760,1785,9611,1281,29371,3247,3171,1679,3410,10230
CCGCAACGAGGACTCA,sample,40449,40031,3711,36320,9286,27034,10217,834,9712,1382,19929,4889,4030,1528,1309,5563
CTTGATAGAGGACTCA,sample,113374,112439,4040,108399,20108,88291,48952,4360,25676,2649,74628,6654,3336,1681,6320,13791
ACCTCGAGAGGACTCA,sample,77684,76984,2045,74939,22559,52380,40783,3288,6238,888,47021,1183,1648,1505,10872,15090
TGGACGAGAGGACTCA,sample,66898,66332,2623,63709,14272,49437,25442,2376,15485,2173,40927,3961,2907,1588,2507,9655
GACGATAAAGGACTCA,sample,77216,76447,4525,71922,18976,52946,25052,1472,16038,1615,41090,8769,4732,1356,5866,11796
CATTGCAGAGGACTCA,sample,78169,77585,3478,74107,13301,60806,32977,2429,17822,2060,50799,5518,3755,2088,3739,8956
ACGACTTCAGGACTCA,sample,108015,107141,5068,102073,18590,83483,43522,2736,25429,3147,68951,8649,4635,1824,6531,12722
AATCCGTCAGGACTCA,sample,19293,19028,1567,17461,3680,13781,6785,528,4014,444,10799,2010,2358,1240,776,2381
AGTCCGCAAGGACTCA,sample,110101,109151,4302,104849,24998,79851,51650,4240,16969,1675,68619,5317,3211,1542,10996,16800
GTCCTGCCAGGACTCA,sample,122923,121826,8099,113727,24132,89595,42954,3667,22840,3198,65794,16936,7128,1976,7337,15732
TTGGTACCAGGACTCA,sample,144070,142806,11450,131356,20547,110809,40845,2328,37895,4601,78740,25140,8057,2062,6809,13396
GTTAGGACAGGACTCA,sample,121460,120278,9288,110990,24348,86642,34684,3417,28090,3296,62774,17155,6135,1541,7766,15612
TGCTTCGCAGGACTCA,sample,37742,37451,1923,35528,6126,29402,16720,1455,7495,827,24215,2905,2698,1525,1631,4116
GAAGGCGCAGGACTCA,sample,39010,38674,2543,36131,8693,27438,14632,1189,6965,837,21597,3815,2733,921,4195,5912
GTCTTAGCAGGACTCA,sample,83185,82465,3116,79349,13428,65921,38724,2403,17016,1793,55740,5985,3675,1501,5094,9683
AGGTCGGAAGGACTCA,Pos_Ctrl,23948,23724,1401,22323,1083,21240,17526,1799,1275,165,18801,475,3671,3749,1115,409
TTATTCGAAGGACTCA,sample,2841,2793,108,2685,575,2110,1397,107,426,24,1823,156,541,421,200,390
TCCTCCGTTATTGAAC,sample,49893,49605,3137,46468,14706,31762,14544,1062,10245,1187,24789,4724,3674,1360,4425,9039
CCTCTAGATATTGAAC,sample,128346,127443,8387,119056,32662,86394,45112,2734,21724,2557,66836,14267,6416,1784,10801,21062
AGTACCATTATTGAAC,sample,132415,131358,8627,122731,26410,96321,49365,3797,27017,3050,76382,13092,5860,2007,9166,18214
ATGCCTGGTATTGAAC,sample,148303,147379,15312,132067,21820,110247,28002,1618,42636,4480,70638,33511,9878,1955,6440,13725
CAACCGCGTATTGAAC,sample,3998,3951,413,3538,713,2825,1049,87,1067,147,2116,475,896,374,206,451
AATGGTAATATTGAAC,sample,68450,67912,2954,64958,15475,49483,29772,1801,12995,1676,42767,3239,3411,2255,3979,10450
TTCCGTCTTATTGAAC,sample,83042,82410,4912,77498,16787,60711,31430,2497,17521,2093,48951,7170,4334,1904,4514,11261
TCGCATCTTATTGAAC,sample,100514,99623,7625,91998,26543,65455,33213,2600,17592,1880,50805,10170,5019,1402,9177,16363
CTTGATAGTATTGAAC,sample,33114,32824,1634,31190,7970,23220,12851,800,5621,670,18472,3278,1956,1041,4582,5544
CATTGCAGTATTGAAC,sample,280751,278429,22676,255753,16442,239311,70245,4088,107104,11123,177349,46751,11955,2793,4585,8280
CTAGGACCTATTGAAC,sample,138854,137465,9136,128329,13117,115212,45017,3253,41913,4535,86930,20494,7323,1988,4047,8030
CGGATTACTATTGAAC,sample,74375,73573,5330,68243,13138,55105,26685,2674,15818,1634,42503,8294,4524,1671,3656,8585
ACGTATTATATTGAAC,sample,142987,141465,8574,132891,16434,116457,63379,4817,29739,3868,93118,14654,5608,1917,6506,10294
AACTCGTATATTGAAC,sample,138267,136821,9944,126877,16079,110798,47300,3896,37029,4500,84329,18073,6651,1751,3978,10370
ACCAATGCTATTGAAC,sample,76539,75780,3321,72459,12152,60307,34337,2893,15229,2134,49566,5714,3119,1399,4392,8346
CCAATTCCTATTGAAC,sample,70401,69503,1839,67664,13787,53877,41444,3211,7201,617,48645,1404,1185,1088,7040,9423
TCAATATATATTGAAC,sample,78365,77595,4141,73454,16870,56584,33348,3201,13084,1290,46432,5661,3203,1172,10665,10903
AGGTCGGATATTGAAC,sample,63815,63173,5188,57985,7736,50249,21097,1515,16267,2165,37364,9205,4780,1413,4180,4738
GACCGGAATATTGAAC,sample,72813,72192,2125,70067,10034,60033,32469,2972,17092,2548,49561,4952,2137,1209,4093,6621
GGAGAGTTGTTCAACT,sample,53181,52709,3231,49478,10115,39363,18778,1188,12014,1426,30792,5957,3633,1170,5533,6817
AGTACCATGTTCAACT,sample,24465,24189,1856,22333,4826,17507,7465,518,6133,695,13598,2696,2359,973,1563,3151
TTCGTAATGTTCAACT,sample,51034,50609,2337,48272,12848,35424,18720,1322,9937,1204,28657,4241,2362,1056,5413,8172
ACGTTATGGTTCAACT,sample,39559,39360,1096,38264,14256,24008,17709,1109,3647,380,21356,1163,1963,1545,5769,8494
TAGTACGGGTTCAACT,sample,44195,43775,2818,40957,9523,31434,15761,1248,10414,881,26175,3130,2748,1197,3818,6261
GCCTTGCTGTTCAACT,sample,29196,28801,2244,26557,4630,21927,12595,1032,5287,483,17882,2530,1825,772,1969,3302
CAAGGCCTGTTCAACT,sample,41158,40645,4757,35888,4208,31680,10311,721,12318,1324,22629,7006,3961,931,1202,2496
CCAGAGCGGTTCAACT,sample,34430,34150,1700,32450,5325,27125,14536,991,8332,1177,22868,2089,2434,1502,2455,3778
GTTAGCCGGTTCAACT,sample,15471,15279,914,14365,3382,10983,5399,374,3653,431,9052,1126,1699,797,1475,2361
CCGCAACGGTTCAACT,sample,25113,24863,1585,23278,5332,17946,9253,783,5316,552,14569,2042,2622,1302,2291,3411
GGACGTAGGTTCAACT,sample,22877,22644,1571,21073,5480,15593,8371,515,4458,495,12829,1754,2219,1091,2143,3495
TGGACGAGGTTCAACT,sample,38348,37987,2556,35431,7754,27677,14834,1240,7298,688,22132,3617,2511,1080,4074,5214
GACGATAAGTTCAACT,sample,29086,28749,1812,26937,6308,20629,10356,583,6108,766,16464,2816,2260,893,2878,4200
CGAGGCAGGTTCAACT,sample,28841,28474,1818,26656,4016,22640,11479,1311,6529,725,18008,2596,1916,780,1724,2694
TTGGTACCGTTCAACT,sample,42096,41571,4070,37501,6187,31314,13444,821,9144,1004,22588,6901,4060,1232,2481,4214
CTAGGACCGTTCAACT,sample,43400,42929,6473,36456,5869,30587,7761,569,12163,1172,19924,8922,5147,907,2030,3578
AACTCGTAGTTCAACT,sample,29533,29254,1541,27713,4659,23054,14018,1432,5140,644,19158,1820,1513,846,2764,3453
ACCAATGCGTTCAACT,sample,22747,22453,930,21523,3019,18504,9491,687,5876,819,15367,1631,1901,1063,656,2176
AAGAGCGCGTTCAACT,sample,29865,29556,1807,27749,5193,22556,13464,913,5624,675,19088,1880,1784,942,3270,3525
GTACCGTAGTTCAACT,sample,35169,34839,1430,33409,5807,27602,18075,1654,5336,668,23411,1869,2206,1372,4213,3960
TCAATATAGTTCAACT,sample,44895,44544,2946,41598,6093,35505,18704,1285,9614,1202,28318,4700,3524,1543,2944,4136
TTATTCGAGTTCAACT,Neg_Ctrl,170,72,36,36,10,26,20,0,4,1,24,1,18,10,1,1
GGAGAGTTCTGAGGTT,sample,158366,156978,7346,149632,34641,114991,70110,5333,25596,3232,95706,10720,4533,1863,16622,24021
TATCAGTTCTGAGGTT,sample,183630,182367,4492,177875,56948,120927,98703,7462,10175,1429,108878,3158,2102,2132,21941,36350
TCCTCCGTCTGAGGTT,sample,123134,122075,5682,116393,24620,91773,54697,4954,21728,2522,76425,7872,4606,2232,10846,18602
AGTACCATCTGAGGTT,sample,162166,161067,7024,154043,38433,115610,71827,6498,24442,2649,96269,10194,4503,1918,14420,25364
TTCGTAATCTGAGGTT,sample,164858,163824,9402,154422,35631,118791,53502,4072,37855,5952,91357,17410,6316,1977,13464,24245
TTCTAATGCTGAGGTT,sample,105404,104737,2420,102317,24343,77974,50096,3906,18453,2267,68549,3252,2645,2005,11726,17325
ATGCCTGGCTGAGGTT,sample,25692,25478,1920,23558,5015,18543,7276,491,7454,754,14730,2568,2828,1031,2355,3096
CAACCGCGCTGAGGTT,sample,98561,97761,4760,93001,20385,72616,39397,2801,20696,2308,60093,7414,4297,1843,7995,13833
TTAGAAGTCTGAGGTT,sample,137746,136690,6110,130580,28664,101916,57084,4050,26986,2556,84070,11240,4594,2053,11701,19649
TCGCATCTCTGAGGTT,sample,86257,85752,3511,82241,23184,59057,35993,2960,13117,1766,49110,5221,3814,2033,10751,15130
GCCTTGCTCTGAGGTT,sample,98305,97562,6041,91521,19336,72185,30174,2418,22714,2324,52888,14555,6329,2067,6938,12834
CAAGGCCTCTGAGGTT,sample,96760,95974,5427,90547,25860,64687,36513,2410,18056,1897,54569,5811,3535,1528,11165,16424
GGAGGACGCTGAGGTT,sample,21976,21681,1801,19880,5007,14873,7595,601,4167,458,11762,2052,2577,1310,1792,3199
GGACGTAGCTGAGGTT,sample,15675,15439,1381,14058,3008,11050,5413,414,3414,370,8827,1439,2014,909,1177,1870
TGGACGAGCTGAGGTT,sample,99430,98631,5782,92849,20639,72210,42224,2696,16458,1875,58682,8957,4640,2030,8557,13756
GACGATAACTGAGGTT,sample,98445,97419,3031,94388,29861,64527,48240,3635,9688,1079,57928,1885,1515,1329,14970,19003
CGAGGCAGCTGAGGTT,sample,44063,43602,3639,39963,7314,32649,17265,1400,8442,1101,25707,4441,4262,2246,2362,4988
GTTAGGACCTGAGGTT,sample,114473,113376,5785,107591,17033,90558,54041,4097,21843,1973,75884,8604,4486,2107,11048,11944
AATATATCCTGAGGTT,sample,149975,148545,10340,138205,24147,114058,58161,5454,31466,3493,89627,15484,4884,1707,13362,16127
ACCAATGCCTGAGGTT,sample,136607,135485,4488,130997,19820,111177,83070,6126,15831,1847,98901,4303,2774,2256,12470,14175
TGCTTCGCCTGAGGTT,sample,39883,39398,2699,36699,7576,29123,15825,1435,7769,692,23594,3402,2658,1060,3668,5026
GAAGGCGCCTGAGGTT,sample,62506,61976,2569,59407,8829,50578,28008,2505,14275,1406,42283,4384,2736,1366,4882,6428
AAGAGCGCCTGAGGTT,sample,64507,63844,3992,59852,10015,49837,24996,2155,14372,1469,39368,6845,4130,1409,4147,6807
CCAATTCCCTGAGGTT,sample,73361,72585,4403,68182,10799,57383,27676,1979,16770,1518,44446,9440,4736,1353,7328,6977
TTGGTTAACTGAGGTT,sample,78197,77530,2576,74954,17581,57373,39447,3729,10077,1348,49524,2772,2273,1448,8729,12157
GTACCGTACTGAGGTT,sample,114412,113726,2343,111383,22445,88938,72090,7639,6616,1139,78706,1454,1691,1959,7137,17049
TCGCCTGACTGAGGTT,sample,133190,132043,4608,127435,18531,108904,78936,5302,17074,1407,96010,6185,3971,2223,7959,12905
TTATTCGACTGAGGTT,sample,37800,37528,1685,35843,4882,30961,16216,1682,9037,969,25253,3057,2859,1458,2303,3204
ATGACCGACTGAGGTT,sample,112603,111771,3078,108693,17553,91140,64729,5039,15178,2144,79907,4050,2768,1757,7779,11975
AGTACCATAGACCGTT,sample,127956,126788,4659,122129,40696,81433,59435,4670,12063,1541,71498,3724,1619,1190,20520,26164
ATGCCTGGAGACCGTT,sample,83839,83124,3307,79817,13730,66087,35094,2598,20395,2358,55489,5642,3249,1764,8173,9767
TAGTACGGAGACCGTT,sample,128289,127351,7890,119461,27038,92423,44132,3081,28268,3812,72400,13130,5614,1779,12696,17948
AATGGTAAAGACCGTT,sample,130093,129105,5487,123618,29685,93933,60371,4897,18783,2319,79154,7563,3619,1810,14612,20693
GCCTTGCTAGACCGTT,sample,116987,115975,3240,112735,35508,77227,54508,4084,14448,1160,68956,3027,2405,1418,14536,22380
CATAACCTAGACCGTT,sample,137862,136752,6279,130473,28174,102299,62921,5413,20235,2224,83156,11506,4929,2056,14607,19129
CCGCAACGAGACCGTT,sample,66711,66165,2535,63630,12058,51572,33293,3186,10891,1543,44184,2659,3579,2838,4279,8071
CTTGATAGAGACCGTT,sample,132830,131791,7516,124275,32841,91434,52484,4749,21559,2946,74043,9696,3883,1600,14115,21011
ACCTCGAGAGACCGTT,sample,12289,12197,765,11432,5191,6241,2951,151,2214,254,5165,671,1518,594,1349,2543
TGGACGAGAGACCGTT,sample,110349,109651,4673,104978,26866,78112,49554,3836,17297,1800,66851,5625,3327,1825,9224,17895
GACGATAAAGACCGTT,sample,110232,109558,3806,105752,32554,73198,48158,4130,13905,1558,62063,5447,3236,1751,11590,21483
GGCCAGAGAGACCGTT,sample,50714,50364,2438,47926,12909,35017,20502,1419,8332,1055,28834,3709,2989,1413,5974,7854
AATCCGTCAGACCGTT,sample,71996,71304,5030,66274,13163,53111,26031,1981,16253,1900,42284,6946,4061,1508,6864,8699
GCCTGAACAGACCGTT,sample,98795,97575,9504,88071,10603,77468,27819,2575,29018,3716,56837,14340,6653,1960,4076,6724
AACTCGTAAGACCGTT,sample,135144,133967,9200,124767,20503,104264,53507,3851,28918,3216,82425,14772,5464,2003,9642,13648
AATATATCAGACCGTT,sample,98318,97322,10866,86456,9754,76702,20735,1753,31306,3329,52041,19579,7434,1486,2423,5392
TGCTTCGCAGACCGTT,sample,91023,90034,2801,87233,20451,66782,50884,5020,8232,1082,59116,1564,1438,1344,9304,14591
GTACCGTAAGACCGTT,sample,88936,88169,4457,83712,12919,70793,39832,3585,16933,1957,56765,8486,4118,1435,8644,9585
CTTCATGAAGACCGTT,sample,66428,65727,2315,63412,11040,52372,33132,2526,11764,1353,44896,3597,2538,1173,5578,7714
GGAGAGTTCTTGAGTT,sample,197076,195934,4663,191271,54232,137039,94978,8137,25379,2995,120357,5550,3549,2429,17111,35095
TATCAGTTCTTGAGTT,sample,197569,196512,7299,189213,51419,137794,89562,6616,26794,2922,116356,11900,5214,2629,20227,33731
TTCGTAATCTTGAGTT,sample,204618,203408,6412,196996,46640,150356,114074,7929,21871,2416,135945,4066,2696,2413,19799,32822
AATGGTAACTTGAGTT,sample,188293,187142,5012,182130,58417,123713,95163,8920,15106,1891,110269,2633,1855,1656,25576,36544
TTAGAAGTCTTGAGTT,sample,156334,155260,8830,146430,24335,122095,55597,4211,39638,4680,95235,17969,6652,2342,12400,15347
TTCCGTCTCTTGAGTT,sample,250346,247740,10073,237667,41001,196666,119784,10491,43193,5374,162977,17824,5369,2179,11397,28811
CCAGAGCGCTTGAGTT,sample,95410,94709,4612,90097,28513,61584,37352,2926,14873,1604,52225,4829,3602,2022,8590,17169
GTTAGCCGCTTGAGTT,sample,110330,109457,5066,104391,32130,72261,43543,3389,15605,2104,59148,7620,4105,1549,12862,20594
GGAGGACGCTTGAGTT,sample,99278,98404,5834,92570,14979,77591,33478,2601,29729,3296,63207,8487,4696,1932,5540,9985
CCGCAACGCTTGAGTT,sample,21296,21093,1044,20049,6820,13229,7847,658,3138,323,10985,1263,1957,1142,2592,4052
GGACGTAGCTTGAGTT,sample,66154,65611,2722,62889,16920,45969,27781,2357,11292,1302,39073,3237,2924,1853,6583,11000
ACCTCGAGCTTGAGTT,sample,65861,65395,3029,62366,16699,45667,27499,2421,10634,1160,38133,3953,3165,1779,8093,10996
CCATGAAGCTTGAGTT,sample,166522,164762,18815,145947,27862,118085,41648,2633,39392,4412,81040,30000,9998,2224,8645,17901
AACTCGTACTTGAGTT,sample,172752,171134,5647,165487,18777,146710,97691,7190,28257,3326,125948,10246,3623,2116,9943,14274
AATATATCCTTGAGTT,sample,226058,224198,13816,210382,22407,187975,113738,12518,35326,3644,149064,22749,7282,2642,7368,13891
TGCTTCGCCTTGAGTT,sample,34955,34557,2760,31797,5696,26101,12550,1001,7714,839,20264,3997,2921,957,3394,3708
GAAGGCGCCTTGAGTT,sample,30542,30140,2535,27605,5536,22069,9548,838,7171,786,16719,3726,2975,959,1314,3385
TTGGTTAACTTGAGTT,sample,62595,62008,1927,60081,29717,30364,20053,1786,6450,979,26503,1096,1837,1220,4090,14268
GGCATATACTTGAGTT,sample,123555,122177,5769,116408,19937,96471,59436,4489,21046,2145,80482,9355,4092,1632,8938,13496
TCAATATACTTGAGTT,sample,80643,79947,3706,76241,13586,62655,38773,3759,13346,1706,52119,5071,3289,1920,8670,9655
CTTCATGACTTGAGTT,sample,96634,95308,9545,85763,10546,75217,27344,2823,25330,2911,52674,16809,5454,1275,5754,6754
GGAGAGTTTCGGAGTT,sample,39708,39320,2325,36995,11036,25959,14124,1058,6606,804,20730,3367,2772,1112,4763,6718
TTCTAATGTCGGAGTT,sample,55721,55082,1712,53370,18092,35278,26122,1876,5702,626,31824,952,1124,1036,8080,11310
ATGCCTGGTCGGAGTT,sample,81538,80781,2871,77910,16011,61899,40724,2816,12923,1013,53647,4423,3291,1787,6717,10720
TGAGCGCGTCGGAGTT,sample,32853,32457,1867,30590,8576,22014,12598,915,5326,457,17924,2718,2194,838,4701,5452
CAACCGCGTCGGAGTT,sample,57504,56935,3358,53577,12359,41218,25870,1928,7952,1350,33822,4118,2865,1391,5628,8676
TTAGAAGTTCGGAGTT,sample,67367,66727,2342,64385,21271,43114,33263,2432,5555,585,38818,1279,1233,1104,10430,13365
CCGCAACGTCGGAGTT,sample,54132,53622,3559,50063,8321,41742,20528,1660,12334,1261,32862,5959,4261,1824,3608,5960
CTTGATAGTCGGAGTT,sample,53742,53182,2588,50594,15186,35408,21981,1626,7721,1008,29702,3072,2607,1411,5272,9386
ACCTCGAGTCGGAGTT,sample,50311,49786,2641,47145,9265,37880,21492,1422,9545,873,31037,4548,3435,1637,4193,6329
GGCCAGAGTCGGAGTT,sample,7233,7133,1043,6090,1446,4644,1527,114,1634,186,3161,1183,1307,426,383,825
CATTGCAGTCGGAGTT,sample,67741,67087,4451,62636,13660,48976,24890,2324,12919,1622,37809,7221,4150,1641,5874,8987
TTGGTACCTCGGAGTT,sample,30475,30127,1659,28468,5683,22785,11447,1004,6875,802,18322,2657,2333,936,3844,3878
CTAGGACCTCGGAGTT,sample,31967,31657,1570,30087,6273,23814,11935,817,7853,867,19788,2342,2474,1198,2164,4338
CGGATTACTCGGAGTT,sample,83812,83101,3583,79518,14806,64712,41502,4008,12320,1563,53822,5319,3321,1699,6129,10205
GTTAGGACTCGGAGTT,sample,142693,141543,10914,130629,12680,117949,41702,2989,49728,6860,91430,16670,6966,1987,5071,8374
TTGGCCTCTCGGAGTT,Pos_Ctrl,23148,22991,1056,21935,1126,20809,17337,1861,1107,155,18444,349,3670,3771,1417,372
AATATATCTCGGAGTT,sample,68256,67774,2408,65366,9333,56033,37768,3000,9969,1334,47737,3962,3126,1798,7674,6477
GTACCGTATCGGAGTT,sample,4839,4769,621,4148,692,3456,1278,71,1243,128,2521,736,934,371,288,357
CTTCATGATCGGAGTT,sample,80203,79548,3081,76467,12875,63592,40085,2943,13289,1451,53374,5824,3269,1338,6978,8902
GACCGGAATCGGAGTT,sample,53027,52525,1597,50928,11502,39426,24602,2900,8215,1234,32817,2475,1876,995,3651,7542
GGAGAGTTTGAACCTT,sample,93623,92835,3650,89185,15200,73985,35532,2018,26175,3411,61707,6849,3342,1642,5700,10572
ATTCTCTTTGAACCTT,Pos_Ctrl,59400,58774,4205,54569,3043,51526,42467,4098,3403,430,45870,1128,5489,6116,3939,1612
AAGTTCGTTGAACCTT,sample,70015,69019,4840,64179,14858,49321,24042,1668,14643,1706,38685,7262,3982,1373,6892,9805
TTCGTAATTGAACCTT,sample,285754,282553,22924,259629,32086,227543,100631,5565,70531,7908,171162,42908,8860,2011,15097,19090
ATGCCTGGTGAACCTT,sample,114646,113806,4078,109728,32490,77238,50921,3887,15299,1978,66220,5153,3220,1590,13539,20668
TAGTACGGTGAACCTT,Pos_Ctrl,36982,36766,2030,34736,2020,32716,27521,2808,1684,186,29205,517,4476,4862,2596,893
TGAGCGCGTGAACCTT,sample,62151,61681,2733,58948,16860,42088,24480,2015,10045,1028,34525,4520,3160,1316,7809,10627
CAACCGCGTGAACCTT,sample,83421,82760,3829,78931,13997,64934,31576,1879,22403,2452,53979,6624,3757,1467,7565,9772
GGACCTCTTGAACCTT,sample,95464,94927,3949,90978,17655,73323,54185,4608,8916,1083,63101,4531,4113,3002,5436,13088
CAAGGCCTTGAACCTT,sample,107133,106412,4562,101850,18111,83739,54877,4512,16886,2105,71763,5359,3968,2270,7680,12786
GTTAGCCGTGAACCTT,sample,95245,94392,6366,88026,20334,67692,31085,2327,19730,3012,50815,11538,5026,1431,9881,13281
CCGCAACGTGAACCTT,Pos_Ctrl,25341,24972,1686,23286,1235,22051,18449,1765,1288,139,19737,410,3913,3874,1541,544
GGCCAGAGTGAACCTT,sample,100456,99405,5913,93492,21428,72064,34606,2918,20975,2358,55581,11207,4626,1245,9245,14203
CCATGAAGTGAACCTT,sample,55574,55143,2474,52669,9866,42803,24530,2104,11583,1304,36113,3282,2821,1802,4177,7190
AATCCGTCTGAACCTT,Pos_Ctrl,23036,22841,1326,21515,1162,20353,16821,1825,1200,125,18021,382,3697,3655,1437,449
TTGGTACCTGAACCTT,sample,88954,88271,6532,81739,17513,64226,35296,2506,16407,1938,51703,8079,4121,1798,6604,11502
CTAGGACCTGAACCTT,sample,67487,66763,2756,64007,13502,50505,33356,2295,9932,886,43288,4036,2685,1487,4460,9272
GAAGGCGCTGAACCTT,sample,57770,57221,2012,55209,13283,41926,29118,2242,6943,827,36061,2796,2223,1299,5428,9286
AAGAGCGCTGAACCTT,sample,97404,96350,5381,90969,18413,72556,42825,3420,15481,1421,58306,9409,4538,1364,11005,11971
GTCTTAGCTGAACCTT,sample,99676,98848,2339,96509,21417,75092,56894,5072,9972,1240,66866,1914,1283,1177,12683,15401
GTACCGTATGAACCTT,Pos_Ctrl,40360,39965,2063,37902,1800,36102,29777,3151,2251,311,32028,612,4676,5205,1940,498
CTTCATGATGAACCTT,sample,97011,96116,4549,91567,16712,74855,41395,2566,18663,2065,60058,10166,3662,1188,8225,11782
ATGACCGATGAACCTT,sample,100058,99434,2775,96659,17277,79382,56714,4939,12220,1568,68934,3941,2696,1976,7433,11685
ACGTAAGTACCGAATT,sample,227233,225703,14667,211036,51029,160007,86596,8018,42189,5337,128785,17867,5293,1949,26344,32625
TTCGTAATACCGAATT,sample,177143,175749,5751,169998,42602,127396,78898,5553,29717,3873,108615,9355,3805,1619,18013,28345
TTCTAATGACCGAATT,sample,164298,163080,5525,157555,41837,115718,77434,5675,22031,2151,99465,8427,3183,1783,20122,28871
ATGCCTGGACCGAATT,sample,155409,154357,8579,145778,31604,114174,62495,4245,31812,3865,94307,11757,4771,1798,14781,20631
CAACCGCGACCGAATT,sample,108187,106637,5431,101206,23890,77316,44482,5113,17135,1881,61617,8705,3892,1398,7575,15409
TTCCGTCTACCGAATT,sample,78897,78226,4776,73450,9066,64384,28364,2050,23229,2256,51593,8485,5008,2169,3289,6103
GGACCTCTACCGAATT,sample,124038,122940,5944,116996,20012,96984,53596,3932,26035,3137,79631,10284,4446,1965,9386,14130
GCCTTGCTACCGAATT,sample,122176,121130,6550,114580,24924,89656,48550,2765,25681,3249,74231,9411,4307,1560,11969,17222
CATAACCTACCGAATT,sample,128742,127705,6053,121652,24999,96653,51209,4211,28042,3838,79251,9353,3716,1661,12402,17600
CCGCAACGACCGAATT,sample,47084,46577,2338,44239,7117,37122,19874,1469,11110,1320,30984,3349,2791,1584,3068,5089
ACCTCGAGACCGAATT,sample,82469,81755,3208,78547,19358,59189,40240,3140,11287,1261,51527,3261,2928,1667,8153,13033
TGGACGAGACCGAATT,sample,100831,99917,5232,94685,13056,81629,53589,4267,15487,1547,69076,6739,4622,2714,5473,8832
GACGATAAACCGAATT,sample,133262,131968,9269,122699,20718,101981,49732,4676,28721,3570,78453,15282,5787,1801,11958,14450
CGTACGTCACCGAATT,sample,11460,11283,526,10757,1814,8943,4037,364,3355,376,7392,811,1542,766,906,1238
AGTCCGCAACCGAATT,sample,79644,78679,7054,71625,14945,56680,28018,2020,16657,1874,44675,8111,3924,1195,7902,9987
CGGATTACACCGAATT,sample,86068,85296,3390,81906,10059,71847,42862,3680,16819,1989,59681,6497,3748,2230,5139,7112
GTTAGGACACCGAATT,sample,89979,89114,5296,83818,14139,69679,36371,3999,18372,1814,54743,9123,4460,1635,6670,9114
AATATATCACCGAATT,Neg_Ctrl,1933,975,546,429,90,339,127,10,168,11,295,23,112,54,33,27
GAAGGCGCACCGAATT,sample,85004,84228,2663,81565,17755,63810,48270,4274,8312,1505,56582,1449,1395,1108,7961,13106
AAGAGCGCACCGAATT,sample,73374,72605,4468,68137,14868,53269,32800,2583,10916,1579,43716,5391,2575,1015,8461,10142
CTTCATGAACCGAATT,sample,119132,118048,6681,111367,20553,90814,54391,4395,18500,2760,72891,10768,3157,1341,9801,13785
ATGACCGAACCGAATT,sample,102096,101252,4889,96363,14803,81560,46962,4800,18561,1996,65523,9241,4883,1807,5996,10211
GACCGGAAACCGAATT,sample,41037,40613,2193,38420,7919,30501,17082,1193,8187,1052,25269,2987,2237,881,4002,5334
GGAGAGTTGGTCTGGT,sample,63977,63632,2638,60994,14060,46934,25490,1640,14074,2067,39564,3663,3508,1813,6520,9260
ATTCTCTTGGTCTGGT,sample,118925,117980,4400,113580,31567,82013,40592,3327,25626,2499,66218,9969,3999,1391,4928,20142
TCCAACTTGGTCTGGT,Neg_Ctrl,1769,716,427,289,69,220,103,3,57,2,160,55,78,43,29,16
TAGTACGGGGTCTGGT,sample,93219,92392,3197,89195,30958,58237,43292,2727,9940,671,53232,1607,1298,1049,14283,19456
TGAGCGCGGGTCTGGT,Neg_Ctrl,1312,595,458,137,25,112,29,1,60,1,89,21,32,16,15,10
CAACCGCGGGTCTGGT,sample,70269,69466,2545,66921,14143,52778,30219,2296,14920,1838,45139,3505,2836,1467,3822,9990
AATGGTAAGGTCTGGT,sample,38766,38378,1934,36444,8826,27618,15107,1118,7725,668,22832,3000,2382,1074,4014,5984
TCGCATCTGGTCTGGT,sample,85249,84671,2727,81944,7777,74167,41916,2879,20745,2352,62661,6275,3728,2509,2416,5280
GCCTTGCTGGTCTGGT,sample,76296,75852,2149,73703,22543,51160,36410,2505,8586,1145,44996,2514,2462,1921,9277,14411
CATAACCTGGTCTGGT,sample,128560,127585,6963,120622,30801,89821,48292,3709,23797,3309,72089,10714,4985,1765,10467,20479
CCAGAGCGGGTCTGGT,sample,46602,46023,3854,42169,8982,33187,15834,1015,9466,1203,25300,5669,4273,1752,3647,5807
GGAGGACGGGTCTGGT,sample,78608,77786,3910,73876,15217,58659,32486,1983,15840,1572,48326,6778,3829,1390,6617,10365
GGACGTAGGGTCTGGT,Neg_Ctrl,1550,671,521,150,38,112,55,1,32,6,87,18,53,23,15,11
GGCCAGAGGGTCTGGT,sample,69928,69300,3105,66195,10260,55935,31430,2337,15917,1983,47347,4268,2887,1665,5284,7400
AATCCGTCGGTCTGGT,sample,20036,19819,1489,18330,3570,14760,6736,570,4938,641,11674,1875,1857,774,1651,2472
CGTACGTCGGTCTGGT,Neg_Ctrl,1318,576,374,202,32,170,77,9,56,15,133,13,64,35,7,8
GTCCTGCCGGTCTGGT,sample,81730,80892,3926,76966,13845,63121,34553,2718,16777,2150,51330,6923,3616,1286,6555,9865
TTGGTACCGGTCTGGT,sample,63393,62733,2738,59995,10293,49702,26861,2390,14057,1507,40918,4887,3116,1340,3377,6650
TTGGCCTCGGTCTGGT,sample,42400,42069,2376,39693,7581,32112,16569,938,9611,1153,26180,3841,3020,1094,4368,4980
TGCTTCGCGGTCTGGT,sample,63802,63200,3568,59632,9770,49862,28124,1517,12084,1280,40208,6857,3615,1270,2611,6452
GGCATATAGGTCTGGT,Neg_Ctrl,1233,584,361,223,40,183,87,0,50,7,137,39,73,33,13,10
AGGTCGGAGGTCTGGT,sample,85513,84884,4705,80179,10161,70018,30435,2544,25348,2771,55783,8920,4157,1605,3557,6896
TTATTCGAGGTCTGGT,sample,46472,46205,1175,45030,5706,39324,27254,2870,6893,848,34147,1459,2537,2267,3155,3936
ATGACCGAGGTCTGGT,sample,89971,89353,3824,85529,14987,70542,40397,3938,17816,2680,58213,5711,2983,1349,5923,10411
GGAGAGTTCGACGTTA,sample,118365,117305,5060,112245,29796,82449,47672,3997,21064,2611,68736,7105,3360,1480,14630,19631
ATTCTCTTCGACGTTA,sample,124126,123028,8210,114818,21207,93611,39812,2925,33495,4883,73307,12496,5313,1683,10726,13938
AAGTTCGTCGACGTTA,sample,163437,161917,9210,152707,41771,110936,73393,5118,20386,1919,93779,10120,2848,1507,21242,26524
TCCTCCGTCGACGTTA,sample,83309,82586,4318,78268,17344,60924,26320,2510,22702,2797,49022,6595,4296,1931,5326,11508
ACGTAAGTCGACGTTA,sample,124256,122955,7887,115068,25722,89346,42497,2388,25835,3328,68332,15298,5486,1413,13666,16868
CCTCTAGACGACGTTA,sample,130830,129858,6570,123288,22168,101120,53570,4790,30251,2966,83821,9543,4548,2354,7734,15532
AGTACCATCGACGTTA,sample,157304,156015,7978,148037,38049,109988,63342,4416,27319,3314,90661,11597,4575,1726,18674,24802
CAACCGCGCGACGTTA,sample,47764,47476,2818,44658,13848,30810,17216,1385,8337,789,25553,3083,3551,1997,3315,8207
TTAGAAGTCGACGTTA,sample,42296,41849,3189,38660,7480,31180,15206,1109,9167,969,24373,4729,3176,1239,3542,4786
GGACCTCTCGACGTTA,sample,122684,121731,5331,116400,25060,91340,53644,4967,22644,3109,76288,6976,3871,1667,12262,17628
CCAGAGCGCGACGTTA,sample,137544,136377,7687,128690,23150,105540,63418,5042,23672,2739,87090,10669,5326,2125,9739,16422
GGAGGACGCGACGTTA,sample,120865,120042,5309,114733,34431,80302,49913,3092,17989,2368,67902,6940,3619,1424,14671,21480
ACCTCGAGCGACGTTA,sample,95701,94872,4225,90647,17163,73484,35123,2395,21978,2775,57101,11213,4918,1162,7009,11750
CATGATTCCGACGTTA,sample,80279,79671,4560,75111,11489,63622,29654,2931,20532,2483,50186,8022,4549,1762,4778,7933
ACGTATTACGACGTTA,sample,66539,66127,2433,63694,8685,55009,25617,2905,19136,2089,44753,5262,2780,1379,2150,5621
TTGGTTAACGACGTTA,sample,72636,72010,2017,69993,20800,49193,37950,4007,5482,689,43432,1065,1098,1028,7380,12888
ATGACCGACGACGTTA,sample,53491,53159,1728,51431,8284,43147,22488,2110,13676,1898,36164,2975,2226,1251,2703,5652
AAGTTCGTTACTAAGT,sample,45145,44584,4401,40183,7030,33153,16228,1194,9461,1235,25689,5035,4057,1894,3185,4273
TCCTCCGTTACTAAGT,sample,80617,80086,2040,78046,19541,58505,44567,3285,7662,734,52229,2257,2713,2278,8267,13421
CCTCTAGATACTAAGT,sample,79241,78742,2743,75999,25860,50139,37022,2650,8501,981,45523,985,1486,1317,11208,16375
AGTACCATTACTAAGT,sample,92405,91690,5575,86115,13854,72261,28804,2044,28223,3161,57027,10029,4225,1541,5692,9834
CAACCGCGTACTAAGT,sample,53151,52676,1576,51100,16691,34409,26504,2171,4197,634,30701,903,1227,1148,9482,10632
TTAGAAGTTACTAAGT,sample,86559,86054,2879,83175,14839,68336,42675,3900,15135,1740,57810,4886,3719,2863,3998,10270
TTCCGTCTTACTAAGT,sample,106292,105215,3622,101593,20254,81339,50694,4668,17063,2217,67757,6697,3267,1295,8693,13233
GGACCTCTTACTAAGT,sample,132107,130668,7176,123492,16466,107026,52164,4072,31644,3519,83808,15627,5566,1765,3758,10798
TCGCATCTTACTAAGT,sample,133230,131869,6654,125215,18784,106431,62213,5538,24352,2841,86565,11487,4834,1662,7164,11643
CATAACCTTACTAAGT,sample,198391,196446,9312,187134,23958,163176,107685,9219,29312,3185,136997,13775,4754,1915,9954,16431
ACCTCGAGTACTAAGT,sample,47693,47291,1395,45896,13450,32446,24405,1828,4728,476,29133,1009,1209,1103,7706,8796
GGCCAGAGTACTAAGT,sample,37913,37521,1993,35528,8730,26798,15962,1130,6634,810,22596,2262,2340,1325,3859,5699
CGAGGCAGTACTAAGT,sample,91385,90554,4084,86470,13027,73443,47053,3470,15190,1612,62243,6118,3640,1771,8412,9018
AGTCCGCATACTAAGT,sample,70477,69871,3705,66166,15196,50970,32308,2017,11448,1320,43756,3877,2376,1198,9976,10285
GTCCTGCCTACTAAGT,sample,66455,65810,3219,62591,10260,52331,31341,1990,11806,1597,43147,5597,3535,1407,5881,6630
CTAGGACCTACTAAGT,sample,73450,72837,2970,69867,9217,60650,33823,2342,17943,2484,51766,4058,3074,1641,4487,6077
CGGATTACTACTAAGT,sample,122234,121163,6083,115080,14447,100633,55925,4082,25513,2602,81438,12511,5561,1905,8449,9389
ACGTATTATACTAAGT,sample,69137,68401,4549,63852,8232,55620,26750,1861,16972,1976,43722,8061,3857,1176,5367,5489
ACCAATGCTACTAAGT,sample,82688,81777,4219,77558,12000,65558,38716,2150,16017,1648,54733,7027,3759,1493,8065,8869
GAAGGCGCTACTAAGT,sample,93633,92784,4631,88153,12813,75340,41860,2416,21093,2446,62953,7525,3785,1462,8030,9018
GTCTTAGCTACTAAGT,sample,81905,81082,6408,74674,10393,64281,27721,2133,21181,2114,48902,11132,5306,1629,5112,6691
TCAATATATACTAAGT,sample,66041,65580,3128,62452,6109,56343,29970,2087,17094,1880,47064,5312,3876,2037,2524,3944
CTTCATGATACTAAGT,sample,67530,66841,1616,65225,15438,49787,35531,4347,7485,799,43016,1625,1144,1003,8843,10763
TTATTCGATACTAAGT,sample,63211,62581,2588,59993,7864,52129,32133,2698,11868,1281,44001,4149,2965,1192,4305,5223
GACCGGAATACTAAGT,sample,36572,36213,2104,34109,4641,29468,17312,1447,5992,637,23304,4080,3056,1318,2162,3014
ACGTAAGTTTGCCGCT,sample,83320,82732,4033,78699,25634,53065,29876,2080,14170,1962,44046,4977,3937,1912,7908,15457
TTCTAATGTTGCCGCT,sample,109222,108155,6838,101317,32077,69240,39667,2708,16909,1941,56576,8015,3137,1237,13511,19996
ATGCCTGGTTGCCGCT,sample,77713,77129,2976,74153,17084,57069,29929,2333,18395,2150,48324,4262,3368,1937,5178,10609
CATAACCTTTGCCGCT,sample,76222,75566,3605,71961,15273,56688,36844,2515,11901,1395,48745,4033,3562,2318,5592,10702
ACTATACTTTGCCGCT,sample,78133,77494,4029,73465,17485,55980,30961,2646,15134,1869,46095,5370,3911,2009,6950,11895
GACGGAGATTGCCGCT,sample,64164,63567,3739,59828,11814,48014,30780,1887,9858,1064,40638,4425,3954,2443,5824,8133
GTTAGCCGTTGCCGCT,sample,61130,60449,3900,56549,17126,39423,22443,1773,10016,1148,32459,4043,2462,1315,6928,10892
GACGATAATTGCCGCT,sample,139069,137885,6173,131712,28909,102803,64650,4184,21751,2878,86401,9340,4706,2039,13446,20426
GGCCAGAGTTGCCGCT,sample,60639,59963,2509,57454,13221,44233,23777,2350,13254,1903,37031,2949,2374,1372,3478,8864
CCATGAAGTTGCCGCT,sample,151904,150798,6884,143914,26786,117128,76225,5543,23751,2426,99976,9183,4643,2590,13580,18588
CATGATTCTTGCCGCT,sample,110880,110113,3455,106658,14519,92139,63228,4026,16808,1862,80036,6215,3986,2882,7268,10457
CTAGGACCTTGCCGCT,sample,141667,140417,4307,136110,26512,109598,72950,7223,20345,2998,93295,6082,3333,1879,10257,19409
GTTAGGACTTGCCGCT,sample,216759,215111,10381,204730,35293,169437,88858,5681,44949,3642,133807,26307,6388,2141,17989,24686
ACGTATTATTGCCGCT,sample,177287,176218,6300,169918,27170,142748,98292,7745,24050,3020,122342,9641,5051,3146,11209,19428
TGCTTCGCTTGCCGCT,sample,145089,144179,4509,139670,21204,118466,77677,6237,22818,2609,100495,9125,5040,2471,11893,15151
GTCTTAGCTTGCCGCT,sample,100381,99821,4192,95629,20205,75424,45988,3612,16534,2103,62522,7187,4230,1775,8383,13742
CCAATTCCTTGCCGCT,sample,63220,62760,1966,60794,11534,49260,30550,2627,11848,1754,42398,2481,2090,1568,5023,7576
GTACCGTATTGCCGCT,sample,130135,129363,3676,125687,24001,101686,80378,6814,10160,1092,90538,3242,2019,1679,14781,17134
AAGTTCGTTTCGACCT,sample,110443,109253,4948,104305,30092,74213,45558,3293,17525,2443,63083,5394,3549,1751,12424,19035
ACGTAAGTTTCGACCT,sample,57698,57083,1979,55104,14528,40576,24913,2047,10451,1146,35364,2019,2813,1879,4267,9519
ATGCCTGGTTCGACCT,sample,63907,63478,1856,61622,11846,49776,35985,3344,7595,1161,43580,1691,3000,2870,5601,8287
TTAGAAGTTTCGACCT,sample,119040,118082,8199,109883,13160,96723,37545,2677,38027,4591,75572,13883,5605,1931,7012,9478
CAAGGCCTTTCGACCT,sample,74034,73256,5307,67949,16945,51004,27669,1648,13665,1546,41334,6476,3598,1305,9567,11123
GGAGGACGTTCGACCT,sample,91409,90582,3803,86779,28020,58759,38852,3171,12582,1296,51434,2858,1737,1118,13352,17850
CCGCAACGTTCGACCT,sample,79446,78698,4593,74105,11838,62267,27803,2028,23320,2503,51123,6613,3855,1551,5512,8244
ACCTCGAGTTCGACCT,sample,14873,14707,1638,13069,2199,10870,4762,276,3561,377,8323,1894,2131,952,724,1429
GGCCAGAGTTCGACCT,sample,60226,59703,3147,56556,12904,43652,28247,2204,9081,933,37328,3187,3165,1921,6077,8717
CCATGAAGTTCGACCT,sample,90635,89918,3189,86729,11156,75573,43208,3241,21425,3062,64633,4637,3656,2371,4573,8161
ACGACTTCTTCGACCT,sample,44976,44505,2740,41765,9878,31887,18058,1229,8328,1011,26386,3261,2787,1156,5915,6597
AATCCGTCTTCGACCT,sample,121809,120566,4931,115635,33084,82551,58139,3454,14494,2262,72633,4202,1920,1216,15744,21628
AGTCCGCATTCGACCT,sample,168129,166660,9996,156664,31039,125625,71526,6209,30575,3889,102101,13426,4784,1993,15251,20853
GTCCTGCCTTCGACCT,sample,110174,109240,5439,103801,16304,87497,50790,3636,23273,2883,74063,6915,4035,2106,8066,11470
CTAGGACCTTCGACCT,sample,112531,111617,5347,106270,30280,75990,47848,3654,15313,1705,63161,7470,4582,2301,8736,18723
GCCTGAACTTCGACCT,sample,150354,149323,7230,142093,22188,119905,63633,5120,31240,4392,94873,15520,4136,1887,12259,15599
ACGTATTATTCGACCT,sample,200117,198756,5791,192965,41622,151343,127841,9132,8979,1396,136820,3995,2157,2196,19408,30783
TTGGCCTCTTCGACCT,sample,119855,118751,6249,112502,21648,90854,47846,4330,24016,2919,71862,11743,4581,1384,9692,15290
GTCTTAGCTTCGACCT,sample,114415,113572,5831,107741,23910,83831,45724,3819,20751,2176,66475,11361,5428,1985,7477,16162
TCAATATATTCGACCT,sample,158108,157063,5393,151670,23141,128529,83040,7334,26953,2856,109993,8346,3926,1867,13677,16413
TCGCCTGATTCGACCT,sample,117911,116974,7212,109762,19963,89799,40320,2952,27767,3129,68087,15631,6219,1618,9595,13398
TTATTCGATTCGACCT,sample,29501,29304,875,28429,11481,16948,11265,1142,3265,606,14530,670,1357,946,2467,6275
ATTCTCTTTCCAGACT,sample,145752,144772,5328,139444,45265,94179,60411,4045,22117,2220,82528,5386,2662,1422,20626,27895
TCCTCCGTTCCAGACT,sample,130991,129986,5258,124728,34554,90174,62032,4631,14622,1861,76654,7028,3276,1673,19425,22543
TTCGTAATTCCAGACT,sample,81334,80781,2877,77904,25154,52750,32337,2772,12313,1341,44650,3987,2626,1575,8036,15508
AATGGTAATCCAGACT,sample,95366,94694,3197,91497,35304,56193,41573,3428,9070,648,50643,1474,1242,1178,14039,20561
TTCCGTCTTCCAGACT,sample,94456,93536,5281,88255,13220,75035,37495,2670,22602,2155,60097,10113,4605,1246,6647,8711
GCCTTGCTTCCAGACT,sample,98692,97965,5399,92566,24319,68247,36595,3029,19004,3472,55599,6147,2663,1427,9739,15744
CCGCAACGTCCAGACT,sample,33501,33193,1066,32127,8670,23457,16497,1161,4389,597,20886,813,1420,1082,4621,5866
GGACGTAGTCCAGACT,sample,38863,38510,2362,36148,7973,28175,12812,1033,9416,878,22228,4036,2659,1014,3909,5536
CTTGATAGTCCAGACT,sample,20392,20124,1925,18199,3671,14528,6506,460,4461,487,10967,2614,2281,840,1920,2263
TGGACGAGTCCAGACT,sample,27784,27552,1200,26352,5431,20921,11739,990,6000,722,17739,1470,1848,1117,3059,3801
CATTGCAGTCCAGACT,sample,43982,43483,4483,39000,6350,32650,11122,745,11482,1229,22604,8072,4239,1094,3270,4208
CGAGGCAGTCCAGACT,sample,48192,47772,1802,45970,12640,33330,22147,1678,6486,996,28633,2023,1986,1396,5266,8512
CCATGAAGTCCAGACT,sample,28899,28636,1344,27292,9618,17674,10492,983,4153,556,14645,1490,2343,1569,2259,5714
ACGACTTCTCCAGACT,sample,82513,81754,5237,76517,13211,63306,31338,2493,18895,2077,50233,8503,4773,1569,8555,9261
CATGATTCTCCAGACT,sample,47187,46687,4152,42535,10061,32474,11970,725,11454,1431,23424,6894,4273,1174,3341,6290
CGTACGTCTCCAGACT,sample,73346,72605,3218,69387,16505,52882,35349,2934,10007,1056,45356,3536,2269,1369,9883,10941
AGTCCGCATCCAGACT,sample,38026,37597,2726,34871,5385,29486,13543,722,9757,1324,23300,4140,2915,1190,2677,3671
TTGGTACCTCCAGACT,sample,67639,67027,2035,64992,9757,55235,33045,2611,15376,1539,48421,2664,2376,1663,5912,7114
CGGATTACTCCAGACT,sample,62519,61872,3129,58743,11609,47134,30388,1855,9089,970,39477,4832,2934,1457,5942,8163
GTTAGGACTCCAGACT,Pos_Ctrl,35272,34930,2252,32678,1693,30985,25647,2592,1834,236,27481,676,4437,4618,2176,585
CGTATGAATCCAGACT,sample,119796,118561,4231,114330,22163,92167,63147,7189,15223,1595,78370,5013,2450,1332,11836,14949
TTGGCCTCTCCAGACT,Pos_Ctrl,62960,62462,3180,59282,2755,56527,46604,5154,3291,377,49895,1101,5390,6651,2638,1096
TGCTTCGCTCCAGACT,sample,74206,73516,6056,67460,10110,57350,25715,2348,18072,2283,43787,8932,4610,1490,3859,6193
TCAATATATCCAGACT,sample,93810,92882,4941,87941,16898,71043,40097,3757,17304,1879,57401,8006,3577,1263,8545,11665
TCGCCTGATCCAGACT,sample,48818,48333,2106,46227,4490,41737,21910,1752,12880,1507,34790,3688,3054,1717,1896,3038
ATGACCGATCCAGACT,sample,46943,46424,2363,44061,7244,36817,20584,1145,10458,1079,31042,3551,2872,1283,3116,5154
GGAGAGTTACCATTAT,sample,49439,48900,4214,44686,7061,37625,13555,1123,15426,1746,28981,5775,3998,1450,2803,4684
AAGTTCGTACCATTAT,sample,139796,138039,8317,129722,35483,94239,51602,4562,23544,3301,75146,11230,5005,1776,13295,22862
CCTCTAGAACCATTAT,sample,134737,133622,4474,129148,18916,110232,67445,5994,28860,3126,96305,4807,4069,2927,6923,15013
AGTACCATACCATTAT,sample,185483,184046,7712,176334,60560,115774,86296,4579,17918,1848,104214,5133,2028,1414,27145,36735
TTCTAATGACCATTAT,sample,174110,172889,5572,167317,51135,116182,85444,6516,16956,2141,102400,5125,3037,1972,19224,33239
GGACCTCTACCATTAT,sample,115052,113967,10087,103880,16964,86916,29462,2620,34873,3766,64335,16195,6965,2044,4870,9943
TCGCATCTACCATTAT,sample,129747,128800,6136,122664,31838,90826,59758,4314,16362,1367,76120,9025,4476,2231,14972,21353
GCCTTGCTACCATTAT,sample,126201,125147,5525,119622,30533,89089,54244,4070,20912,2363,75156,7500,4300,2059,10467,19724
CAAGGCCTACCATTAT,sample,148948,147801,5455,142346,48146,94200,67121,3983,17466,1904,84587,3726,1781,1289,21322,29503
CATAACCTACCATTAT,sample,110468,109563,4778,104785,24858,79927,45581,3568,20685,2250,66266,7843,4290,2142,8251,16496
CCAGAGCGACCATTAT,sample,176864,175091,13537,161554,27779,133775,52370,4705,46679,5501,99049,24520,7760,1869,10668,18795
GTTAGCCGACCATTAT,sample,113251,112439,4592,107847,10405,97442,55404,3866,27308,3772,82712,7092,4692,3284,4300,7006
GGAGGACGACCATTAT,sample,128535,127375,6815,120560,30216,90344,51686,3747,24112,3229,75798,7570,4257,1830,11353,20318
CCGCAACGACCATTAT,sample,106703,105705,3015,102690,32458,70232,53691,3718,9125,1050,62816,2648,1599,1357,16470,20423
GGACGTAGACCATTAT,sample,98563,97885,3576,94309,17917,76392,51078,3855,15282,1870,66360,4307,3481,2641,6832,12474
CTTGATAGACCATTAT,sample,125005,123950,8410,115540,19569,95971,53794,3172,22419,2206,76213,14380,6123,2246,14725,13052
GGCCAGAGACCATTAT,sample,26498,26211,2885,23326,5420,17906,5578,467,7228,808,12806,3825,3502,1125,1570,3396
CATGATTCACCATTAT,sample,77057,76280,4790,71490,11660,59830,32860,2674,15465,1663,48325,7168,4766,2299,4342,7718
AATCCGTCACCATTAT,sample,99444,98505,5037,93468,22467,71001,39154,2485,19050,2733,58204,7579,4007,1572,10602,14931
CGTACGTCACCATTAT,sample,130419,129155,6923,122232,24313,97919,55172,3556,24888,3045,80060,11258,5030,1747,13862,17429
GTTAGGACACCATTAT,sample,94154,93187,6032,87155,19271,67884,36816,2634,16472,1623,53288,10339,4496,1267,11124,12409
CGTATGAAACCATTAT,sample,127073,125918,6630,119288,19291,99997,56415,4009,25576,2845,81991,11152,4773,1761,9139,13449
TGCTTCGCACCATTAT,sample,73373,72623,3698,68925,12514,56411,32965,2273,13196,1558,46161,6419,3605,1401,6079,8427
GTCTTAGCACCATTAT,sample,75892,75223,4284,70939,14433,56506,31184,2139,15738,1467,46922,5978,3551,1262,5566,9340
TCAATATAACCATTAT,sample,144242,143055,5818,137237,23609,113628,70023,6526,24501,2882,94524,9696,3944,1656,11122,16407
ATGACCGAACCATTAT,sample,139432,138268,10603,127665,14795,112870,41676,2941,41561,5375,83237,21317,7224,1702,7441,9356
GGAGAGTTCAATGGAT,sample,141117,140031,8958,131073,29328,101745,49360,3816,31680,3849,81040,13040,5598,2015,12761,19168
TATCAGTTCAATGGAT,sample,42987,42616,4559,38057,8385,29672,9570,690,12043,1212,21613,6157,4605,1783,1077,5281
ATTCTCTTCAATGGAT,sample,91575,91055,2824,88231,19201,69030,48857,4063,11994,1610,60851,2506,3824,3625,5171,13288
TCCAACTTCAATGGAT,sample,162839,161513,6708,154805,39113,115692,69539,4763,28441,3143,97980,9806,4344,1792,19748,26262
AGTACCATCAATGGAT,sample,172823,170424,6824,163600,37344,126256,98170,7813,15387,2256,113557,2630,1308,967,19916,25427
ACGTTATGCAATGGAT,sample,195679,193440,10027,183413,39096,144317,90514,8579,29753,2746,120267,12725,4352,1548,14669,27925
ATGCCTGGCAATGGAT,sample,160374,159086,7659,151427,25334,126093,79332,4996,27512,3035,106844,11218,5478,2927,9020,17400
GGACCTCTCAATGGAT,sample,87946,87428,2779,84649,10645,74004,52343,3785,12498,1481,64841,3897,4441,3719,4092,7829
GCCTTGCTCAATGGAT,sample,87467,86849,4267,82582,16740,65842,31345,2606,23287,2251,54632,6353,4025,1751,6016,11812
CATAACCTCAATGGAT,sample,123271,122338,3578,118760,38523,80237,59724,5570,11127,1082,70851,2734,1486,1398,14263,24055
GTTAGCCGCAATGGAT,sample,78871,78116,2936,75180,22935,52245,38726,2995,7774,1139,46500,1611,1462,1147,10742,14790
GGAGGACGCAATGGAT,sample,61042,60475,2179,58296,15787,42509,27289,2311,8956,1204,36245,2749,2800,1800,5178,10091
ACGACTTCCAATGGAT,sample,126137,125004,5023,119981,27193,92788,69103,7559,10840,1624,79943,3662,1954,1616,12803,19170
CATGATTCCAATGGAT,sample,136562,135526,8028,127498,32918,94580,59100,4275,18552,1930,77652,10723,3462,1463,17282,20864
CTAGGACCCAATGGAT,sample,127295,126282,3252,123030,22834,100196,82910,7339,7906,961,90816,1080,1831,2105,13001,16602
CGGATTACCAATGGAT,sample,104249,103419,3006,100413,34320,66093,50676,4381,7796,1010,58472,2230,1497,1381,11489,21222
GCCTGAACCAATGGAT,Neg_Ctrl,2308,1173,851,322,76,246,118,12,91,3,209,22,108,54,19,19
ACGTATTACAATGGAT,sample,101005,100077,8260,91817,13082,78735,32794,3395,25784,2982,58578,13780,5887,1735,5976,8991
AACTCGTACAATGGAT,sample,94412,93548,6188,87360,19347,68013,37661,2393,17041,1805,54702,9113,4028,1223,9077,12997
AATATATCCAATGGAT,Neg_Ctrl,2611,1570,993,577,90,487,316,15,95,8,411,53,167,102,41,45
TGCTTCGCCAATGGAT,sample,65397,64735,3522,61213,12452,48761,26109,2626,12707,2154,38816,5165,3444,1253,4051,8074
TTGGTTAACAATGGAT,sample,89695,88936,2927,86009,9523,76486,44577,3214,20822,2813,65399,5060,3055,1934,4662,6470
GGCATATACAATGGAT,sample,100903,99641,3917,95724,10759,84965,60599,4860,12596,1428,73195,5482,4150,2494,6837,7374
TCGCCTGACAATGGAT,sample,56788,56304,2433,53871,7396,46475,22741,1693,15055,2067,37796,4919,2659,1281,2549,4763
AGGTCGGACAATGGAT,Pos_Ctrl,30282,30049,1577,28472,1440,27032,22441,2439,1508,236,23949,408,4131,4600,1614,535
TTATTCGACAATGGAT,sample,78775,78148,3752,74396,13521,60875,35222,2976,15025,1764,50247,5888,3166,1195,6372,9234
ATTCTCTTAGATTCAT,sample,143947,142585,4419,138166,37888,100278,76957,6415,12958,1809,89915,2139,1710,1611,17136,25721
TCCAACTTAGATTCAT,sample,94415,93636,4986,88650,13029,75621,41754,4400,19737,2374,61491,7356,4792,2841,4153,9573
GGTTGCGTAGATTCAT,sample,119082,118077,6027,112050,25078,86972,49630,3461,22898,2751,72528,8232,4410,2089,10246,17176
CCTCTAGAAGATTCAT,sample,113506,112183,5703,106480,26121,80359,48942,2325,18913,2257,67855,7922,3584,1482,13382,18088
GGACCTCTAGATTCAT,sample,145593,144297,13578,130719,12907,117812,42657,2686,49319,5195,91976,17955,7664,2345,5427,7928
TCGCATCTAGATTCAT,sample,39829,39392,2467,36925,6210,30715,14065,1131,10463,1272,24528,3784,3277,1638,910,4149
CCAGAGCGAGATTCAT,sample,80325,79490,5572,73918,9948,63970,29135,2447,21934,2368,51069,8086,4764,1749,6114,6755
GGAGGACGAGATTCAT,sample,49863,49534,2456,47078,7778,39300,21338,1909,11183,1408,32521,3462,3720,2400,2782,5631
GGACGTAGAGATTCAT,sample,33310,32968,2096,30872,5155,25717,10893,896,9459,1132,20352,3337,3112,1463,1660,3412
ACCTCGAGAGATTCAT,sample,45283,44920,2542,42378,11168,31210,14598,1245,10879,1151,25477,3337,2989,1292,3158,7540
TGGACGAGAGATTCAT,sample,83699,83026,6007,77019,10755,66264,32272,2429,20642,2283,52914,8638,4963,2112,4136,7368
GACGATAAAGATTCAT,sample,101373,100484,2933,97551,28875,68676,52429,3435,9937,940,62366,1935,1327,1177,16641,18782
GGCCAGAGAGATTCAT,sample,79015,78506,3162,75344,18602,56742,41902,2926,8120,830,50022,2964,2696,1981,8172,12755
CCATGAAGAGATTCAT,sample,80502,79779,3009,76770,10360,66410,46782,3806,10036,1365,56818,4421,3360,2275,6515,6813
TTGGTACCAGATTCAT,sample,84672,83889,2881,81008,19067,61941,38945,3662,14226,1537,53171,3571,2521,1440,8507,12945
CGTATGAAAGATTCAT,sample,131594,130606,4426,126180,18471,107709,59371,5507,29371,4128,88742,9332,3005,1582,9215,14346
TTGGCCTCAGATTCAT,sample,105681,104902,5428,99474,15203,84271,45630,3157,21912,2199,67542,11373,5321,1846,7915,9783
AAGAGCGCAGATTCAT,sample,72386,71801,3547,68254,7369,60885,26232,2898,22285,2193,48517,7277,3936,1612,2468,5211
GTACCGTAAGATTCAT,sample,10197,10080,1266,8814,1338,7476,2708,168,2539,299,5247,1762,1515,555,550,1214
TCGCCTGAAGATTCAT,sample,71420,70846,3366,67480,9303,58177,32926,3170,14556,1813,47482,5712,3504,1333,5257,6480
TTATTCGAAGATTCAT,sample,22679,22522,1138,21384,4428,16956,9669,727,3938,352,13607,2270,2093,1000,1419,2938
TATCAGTTCAATCTTG,sample,77768,77361,3054,74307,22581,51726,32345,2052,11171,1743,43516,4415,3112,1552,9930,14648
TCCAACTTCAATCTTG,sample,188864,187728,5648,182080,38124,143956,101828,8631,22100,2176,123928,9221,4240,2394,17067,26559
GGTTGCGTCAATCTTG,sample,155719,154541,4471,150070,52431,97639,71223,5213,16227,1175,87450,3801,1769,1300,21736,31547
ACGTTATGCAATCTTG,sample,129744,128649,4921,123728,30698,93030,55019,4163,24256,2626,79275,6966,3714,1628,12475,20717
TTAGAAGTCAATCTTG,sample,160861,159691,11596,148095,26327,121768,50300,4391,42837,5294,93137,18946,6760,2073,9924,16803
TTCCGTCTCAATCTTG,sample,139717,138876,4453,134423,32879,101544,67174,5396,20944,2537,88118,5493,2797,1786,14077,21943
CAAGGCCTCAATCTTG,sample,88344,87379,7485,79894,16581,63313,29199,1615,18377,2205,47576,11917,5405,1453,8130,10712
GACGGAGACAATCTTG,sample,40951,40645,2360,38285,5444,32841,14833,1309,11902,1259,26735,3538,3321,1657,2440,3763
GTTAGCCGCAATCTTG,sample,96514,95743,4040,91703,24605,67098,43111,3243,14659,1525,57770,4560,2410,1254,12338,16586
GGAGGACGCAATCTTG,sample,48128,47659,3044,44615,9677,34938,20937,1572,7681,930,28618,3818,2986,1392,4231,6543
ACCTCGAGCAATCTTG,sample,69436,68852,3166,65686,11748,53938,28992,2011,16127,2007,45119,4801,3468,1989,3963,7918
ACGACTTCCAATCTTG,sample,49839,49361,1894,47467,15305,32162,19794,1754,7150,956,26944,2508,1947,1162,5087,9201
GTCCTGCCCAATCTTG,sample,84271,83312,5781,77531,13517,64014,32675,2538,17443,1960,50118,9398,4400,1358,5868,8840
GCCTGAACCAATCTTG,sample,61634,60321,3238,57083,11997,45086,27449,2095,9460,976,36909,5106,2808,1140,6436,8543
ACGTATTACAATCTTG,sample,151218,149766,8804,140962,19576,121386,56971,5012,37668,4715,94639,17020,5401,1616,10010,13753
AACTCGTACAATCTTG,sample,114420,113358,6418,106940,16952,89988,47648,3068,25401,2626,73049,11245,4922,1464,10273,11968
ACCAATGCCAATCTTG,sample,89176,88399,3421,84978,14483,70495,49064,3975,11283,1412,60347,4761,3377,2060,4722,10073
GAAGGCGCCAATCTTG,sample,75413,74623,5967,68656,13453,55203,25274,1771,17006,1561,42280,9591,5277,1329,3748,8711
GTCTTAGCCAATCTTG,sample,70685,70072,2292,67780,13725,54055,36585,3604,10559,959,47144,2348,1868,1553,6447,8886
TTATTCGACAATCTTG,Neg_Ctrl,1171,447,334,113,30,83,56,7,15,0,71,5,46,29,18,3
ATGACCGACAATCTTG,sample,122766,121948,4127,117821,8144,109677,74913,5863,20872,2630,95785,5399,4336,2997,4082,5045
GACCGGAACAATCTTG,sample,90333,89642,2416,87226,12140,75086,54910,4927,10486,1206,65396,3557,2469,1756,6793,8875
GGTTGCGTCGTTCCGA,sample,94441,93596,2887,90709,14799,75910,39769,3079,25058,3275,64827,4729,2718,1867,8596,11006
CCTCTAGACGTTCCGA,sample,110189,109207,8379,100828,24328,76500,32795,2471,27417,2981,60212,10836,5395,1716,8584,15651
TTCGTAATCGTTCCGA,sample,247136,245217,24900,220317,27232,193085,58235,4039,79218,8499,137453,43094,11922,3094,8399,16721
CAACCGCGCGTTCCGA,sample,70698,70133,2213,67920,22732,45188,33931,2195,7003,643,40934,1416,1435,1266,9105,14026
TTAGAAGTCGTTCCGA,sample,106465,105651,6435,99216,18581,80635,47139,3294,19192,2409,66331,8601,4698,2228,8918,12893
TTCCGTCTCGTTCCGA,sample,125141,124023,10297,113726,18595,95131,39606,2585,33617,3782,73223,15541,5837,1575,9902,12367
GGACCTCTCGTTCCGA,sample,66378,65820,2926,62894,9605,53289,30439,2155,14837,1711,45276,4147,3568,2196,3531,6581
CAAGGCCTCGTTCCGA,sample,47850,47259,4792,42467,9144,33323,13126,1022,10969,1083,24095,7123,3999,1073,3285,5678
CATAACCTCGTTCCGA,sample,100141,99462,3237,96225,28300,67925,46241,2878,13394,1737,59635,3675,2068,1252,15389,18618
CTTGATAGCGTTCCGA,sample,95037,94316,3293,91023,12998,78025,55817,5226,10497,1098,66314,5387,3789,2205,5886,9386
GGCCAGAGCGTTCCGA,sample,51681,51273,2673,48600,9614,38986,20022,1273,12108,1193,32130,4390,3431,1666,4079,6635
CATGATTCCGTTCCGA,sample,82278,81618,3790,77828,13335,64493,37144,3177,15685,1916,52829,6571,3875,1769,5131,9158
GTTAGGACCGTTCCGA,sample,75333,74530,2196,72334,10152,62182,34146,2530,18875,1791,53021,4840,2442,1373,5055,7399
GCCTGAACCGTTCCGA,sample,53040,52589,3599,48990,6634,42356,17060,1486,14771,1980,31831,7059,3801,1344,2315,4100
ACGTATTACGTTCCGA,sample,106321,105280,5177,100103,19278,80825,47609,3865,19330,1481,66939,8540,4196,1455,7610,12940
GAAGGCGCCGTTCCGA,sample,69458,68850,4674,64176,6590,57586,21494,1824,22422,2990,43916,8856,4261,1482,1594,4284
GTCTTAGCCGTTCCGA,sample,23687,23536,1087,22449,3854,18595,9544,921,5555,814,15099,1761,2577,1577,1091,2633
CTTCATGACGTTCCGA,sample,68594,67912,2575,65337,11387,53950,34208,2831,11425,1259,45633,4227,2642,1337,4168,7892
GACCGGAACGTTCCGA,sample,145,143,4,139,24,115,50,3,44,0,94,18,46,30,12,13
TATCAGTTCAATTCGG,sample,148130,146340,4062,142278,46359,95919,75568,4468,12291,1483,87859,2109,1694,1533,22475,29629
ATTCTCTTCAATTCGG,Pos_Ctrl,78518,77602,5601,72001,4074,67927,56107,5287,4495,596,60602,1442,6195,7256,4768,1963
TCCAACTTCAATTCGG,sample,149024,147441,6890,140551,41500,99051,62938,5645,20061,2468,82999,7939,3799,2148,14215,26694
AAGTTCGTCAATTCGG,sample,177776,175819,8901,166918,43896,123022,86281,7545,18280,1894,104561,9022,4834,2579,14369,28319
TCCTCCGTCAATTCGG,sample,103403,102456,4048,98408,31362,67046,51573,3870,8599,949,60172,2055,1904,1537,14443,20489
ACGTAAGTCAATTCGG,sample,130368,129052,12231,116821,20526,96295,35623,2254,35216,3277,70839,19925,6852,1824,8183,12942
CCTCTAGACAATTCGG,sample,55360,54839,2898,51941,8448,43493,21577,1407,13671,2006,35248,4832,3983,2201,2530,5771
AGTACCATCAATTCGG,sample,94173,93298,3537,89761,30021,59740,42703,3371,9479,1464,52182,2723,1584,1262,13245,18853
ACGTTATGCAATTCGG,Pos_Ctrl,44628,44007,3250,40757,2273,38484,31681,3046,2683,321,34364,753,5187,5512,2819,1154
ATGCCTGGCAATTCGG,sample,82281,81484,3790,77694,18395,59299,36224,3101,13665,1896,49889,4413,3568,1910,6379,12298
TGAGCGCGCAATTCGG,sample,58719,58076,4282,53794,11221,42573,23195,1993,10239,1019,33434,6127,4195,1555,6366,7761
CAACCGCGCAATTCGG,sample,26960,26619,3526,23093,4479,18614,6314,439,7132,935,13446,3794,3444,1138,1193,2667
TTAGAAGTCAATTCGG,sample,232810,230922,7779,223143,26512,196631,121161,9912,44684,7130,165845,13744,4101,2381,10041,18149
TTCCGTCTCAATTCGG,sample,168898,167056,12858,154198,26935,127263,46779,4215,41352,4750,88131,30167,8168,1580,10094,18542
GCCTTGCTCAATTCGG,Pos_Ctrl,124343,123182,5882,117300,5047,112253,92779,9839,6696,832,99475,2107,6484,9089,5304,1627
CAAGGCCTCAATTCGG,sample,211730,209538,17899,191639,20338,171301,40444,3240,66126,6652,106570,54839,11719,2485,4548,11905
GACGGAGACAATTCGG,sample,1254,1210,164,1046,232,814,380,13,288,21,668,112,310,141,85,145
CCAGAGCGCAATTCGG,sample,63840,63212,3282,59930,17005,42925,25633,1962,10196,1411,35829,3723,2810,1666,7142,11044
GTTAGCCGCAATTCGG,sample,57990,57137,5241,51896,9444,42452,13586,1211,16014,1835,29600,9806,4978,1240,2406,5917
CCGCAACGCAATTCGG,Pos_Ctrl,22151,21787,1602,20185,1275,18910,15685,1473,1197,132,16882,423,3690,3413,1676,644
CTTGATAGCAATTCGG,sample,36216,35830,2397,33433,5385,28048,12052,771,10587,1272,22639,3366,3205,1581,1999,3693
ACCTCGAGCAATTCGG,sample,105761,104910,4234,100676,27064,73612,46540,4083,14848,1923,61388,6218,2942,1424,12481,17490
TGGACGAGCAATTCGG,sample,113185,112402,6362,106040,28351,77689,37144,2757,23701,3374,60845,10713,5164,1636,9165,18295
CCATGAAGCAATTCGG,Pos_Ctrl,94687,93938,4108,89830,4202,85628,70836,7867,4614,573,75450,1738,5938,8075,4512,1224
CGTACGTCCAATTCGG,sample,83426,82759,2917,79842,27031,52811,40739,3301,7006,473,47745,1292,1642,1397,11089,16693
AGTCCGCACAATTCGG,sample,145844,144752,8608,136144,17464,118680,46536,3449,46486,5044,93022,17165,5585,1736,7876,12758
GTCCTGCCCAATTCGG,sample,119575,118550,5100,113450,19624,93826,52624,3555,23237,3016,75861,11394,4912,1868,7993,14177
TTGGTACCCAATTCGG,sample,110068,109300,3350,105950,32024,73926,57820,3203,10198,1105,68018,1600,1282,1070,16875,19812
CGGATTACCAATTCGG,Pos_Ctrl,57943,57516,2534,54982,2788,52194,43181,4884,2813,370,45994,946,5314,6431,3089,981
GTTAGGACCAATTCGG,sample,105990,105072,3788,101284,22344,78940,51235,4791,16440,1875,67675,4599,2950,1359,11942,15022
TTGGCCTCCAATTCGG,Pos_Ctrl,60062,59733,2808,56925,2905,54020,44879,5034,2770,379,47649,958,5427,6639,3286,1139
ACCAATGCCAATTCGG,sample,132889,131888,4994,126894,30955,95939,65880,6662,15257,1341,81137,6799,3781,1835,9068,20636
AAGAGCGCCAATTCGG,sample,129185,128011,4339,123672,30642,93030,58738,5528,21019,2080,79757,5665,2603,1332,12625,20727
GTCTTAGCCAATTCGG,sample,30493,30182,2290,27892,4676,23216,9671,800,7865,840,17536,4040,3240,1157,1698,2976
TTGGTTAACAATTCGG,sample,117449,116496,4699,111797,27704,84093,45554,4540,23387,2455,68941,8157,3541,1441,6985,18794
ATGACCGACAATTCGG,sample,14428,14318,452,13866,3218,10648,5321,533,3315,594,8636,885,1673,979,557,2105
GACCGGAACAATTCGG,sample,4996,4880,125,4755,1168,3587,2746,264,439,46,3185,92,609,563,343,794
TCCAACTTAACTCCGG,sample,186723,185425,8806,176619,55897,120722,59566,3954,33755,3705,93321,19742,6494,1747,20349,35468
TCCTCCGTAACTCCGG,sample,97191,96290,4537,91753,20411,71342,42096,2977,16645,1918,58741,7706,4040,1780,9124,14289
ACGTAAGTAACTCCGG,sample,32329,31978,2476,29502,9912,19590,8587,692,6050,734,14637,3527,2961,1138,2514,5814
CCTCTAGAAACTCCGG,sample,92280,91385,3167,88218,32011,56207,40487,3413,8789,1057,49276,2461,1572,1275,12923,19486
ACGTTATGAACTCCGG,sample,122151,120942,11479,109463,20100,89363,31674,2660,31380,3490,63054,20159,7408,1793,8092,12635
ATGCCTGGAACTCCGG,sample,78695,78057,2478,75579,23989,51590,42362,3367,4268,486,46630,1107,1888,2001,8776,15585
AATGGTAAAACTCCGG,sample,90052,89310,3568,85742,16089,69653,39976,2680,19453,2066,59429,5478,3319,1856,7099,11499
GGACCTCTAACTCCGG,sample,72628,71864,4516,67348,16329,51019,26930,1671,13476,2325,40406,6617,3176,1416,6873,10698
GTTAGCCGAACTCCGG,sample,51922,51433,3446,47987,11765,36222,18509,1358,9982,1007,28491,5366,3875,1621,4271,7537
GGAGGACGAACTCCGG,sample,57222,56793,2882,53911,12917,40994,23503,1440,10604,1166,34107,4281,3363,1726,5754,8666
CCGCAACGAACTCCGG,sample,6173,6115,173,5942,1502,4440,2419,202,1436,167,3855,216,1124,667,483,1009
TGGACGAGAACTCCGG,sample,116396,115551,6506,109045,31563,77482,48407,3101,15450,1537,63857,8987,3201,1354,13657,19587
CATTGCAGAACTCCGG,sample,51851,51487,2403,49084,9601,39483,19963,1395,12441,1652,32404,4032,3696,2169,2191,6186
ACGACTTCAACTCCGG,sample,113967,113029,8296,104733,15548,89185,34013,2285,30065,3576,64078,19246,7751,2401,4528,10300
CTAGGACCAACTCCGG,sample,135396,134277,5717,128560,26684,101876,61166,5003,22418,3050,83584,10239,4627,2012,11280,18144
GCCTGAACAACTCCGG,sample,105171,104259,3612,100647,32869,67778,49213,3561,10739,1776,59952,2489,1420,1086,14914,20475
AACTCGTAAACTCCGG,sample,52637,52249,2099,50150,13282,36868,20476,1777,10497,1401,30973,2717,3179,1842,3137,8885
TTGGCCTCAACTCCGG,sample,93865,93067,3508,89559,23809,65750,44060,3845,11646,1731,55706,4468,2607,1365,10133,15918
TGCTTCGCAACTCCGG,sample,42372,41852,3123,38729,9107,29622,11663,887,9592,1043,21255,6437,3672,1068,2181,5749
CCAATTCCAACTCCGG,sample,51801,51411,1864,49547,9284,40263,30462,2313,4889,540,35351,2059,2375,1612,4209,6683
GGCATATAAACTCCGG,sample,59379,58850,2775,56075,6801,49274,33979,2575,7876,798,41855,4046,3407,2242,1855,4572
TTATTCGAAACTCCGG,sample,48199,47869,1528,46341,11002,35339,26289,2296,4588,715,30877,1451,1744,1244,4770,7460
ATGACCGAAACTCCGG,sample,55388,54827,2921,51906,12654,39252,17377,1684,13971,1462,31348,4758,3131,901,2454,8062
TCCAACTTCCTGAAGG,Neg_Ctrl,2729,1215,966,249,61,188,112,11,46,4,158,15,77,37,28,10
CCTCTAGACCTGAAGG,sample,127085,126156,6536,119620,27880,91740,46788,3643,25911,3154,72699,12244,4779,1874,9143,18247
AGTACCATCCTGAAGG,sample,111030,110098,4695,105403,35853,69550,44481,3035,14888,1726,59369,5420,2378,1264,12893,21518
TTCGTAATCCTGAAGG,sample,72116,71353,7075,64278,12815,51463,22736,1858,15521,1641,38257,9707,5567,1792,3381,7909
TTCTAATGCCTGAAGG,Neg_Ctrl,1742,890,579,311,67,244,80,10,84,6,164,64,70,46,25,17
TAGTACGGCCTGAAGG,sample,96920,96154,4404,91750,20722,71028,43972,3290,16763,1846,60735,5157,3601,1756,10275,13978
GCCTTGCTCCTGAAGG,sample,74374,73462,5246,68216,12902,55314,22633,1983,19112,2150,41745,9436,4457,1446,4659,8977
CAAGGCCTCCTGAAGG,Neg_Ctrl,1857,914,660,254,59,195,77,6,72,7,149,33,85,32,16,13
GACGGAGACCTGAAGG,sample,99629,98789,5531,93258,16707,76551,45562,3007,17054,1924,62616,9004,4998,2326,7690,11053
GGACGTAGCCTGAAGG,Neg_Ctrl,1866,924,672,252,37,215,40,4,81,70,121,20,43,24,9,7
CTTGATAGCCTGAAGG,sample,13916,13737,1262,12475,2155,10320,4466,349,3370,436,7836,1699,1924,778,1143,1394
ACCTCGAGCCTGAAGG,sample,63211,62537,4343,58194,14755,43439,23213,1803,11561,1502,34774,5360,3436,1335,6492,9222
GACGATAACCTGAAGG,sample,61484,60902,2516,58386,18690,39696,27647,1788,7143,1084,34790,2034,1369,1031,8746,11742
ACGACTTCCCTGAAGG,Neg_Ctrl,2116,1087,796,291,88,203,106,5,53,7,159,32,87,38,34,19
CATGATTCCCTGAAGG,sample,51403,50906,2523,48383,7728,40655,18393,1421,15503,1837,33896,3501,2814,1441,3068,5134
AATCCGTCCCTGAAGG,sample,85119,84056,6179,77877,12193,65684,30508,2716,19130,1961,49638,11369,5257,1601,3390,8171
CGTACGTCCCTGAAGG,sample,38065,37467,1372,36095,11677,24418,14209,1197,6381,1080,20590,1551,1729,1034,2081,6876
GTTAGGACCCTGAAGG,Neg_Ctrl,1744,893,594,299,64,235,99,16,65,7,164,48,101,53,21,15
ACGTATTACCTGAAGG,sample,95529,94736,7409,87327,19605,67722,26897,2320,23714,2778,50611,12013,5571,1411,5368,13117
TTGGCCTCCCTGAAGG,sample,83467,82548,5375,77173,12547,64626,33361,2996,16729,2062,50090,9478,4148,1134,6983,8020
AATATATCCCTGAAGG,Neg_Ctrl,1996,1161,873,288,55,233,136,3,62,5,198,27,111,49,36,14
TGCTTCGCCCTGAAGG,sample,53073,52427,2998,49429,10926,38503,21580,1475,9399,1429,30979,4620,2824,1164,4544,7142
GAAGGCGCCCTGAAGG,sample,106612,105443,8769,96674,13949,82725,36822,3267,22086,2546,58908,18004,6728,1786,5474,9703
CCAATTCCCCTGAAGG,sample,55273,54188,3975,50213,8830,41383,19540,1255,12580,1275,32120,6733,3515,1198,3101,5719
TCGCCTGACCTGAAGG,sample,77741,76895,3628,73267,14866,58401,37201,2948,12167,970,49368,5115,2754,1334,7476,10220
AGTACCATAATATTCG,sample,170968,169590,8148,161442,31139,130303,64943,3765,41334,6310,106277,13951,4361,1886,12181,20978
TTCGTAATAATATTCG,sample,27589,27337,1515,25822,6554,19268,11980,1271,3958,511,15938,1548,3005,2183,1415,4501
TTAGAAGTAATATTCG,sample,52911,52549,2277,50272,11078,39194,20875,1496,11802,1550,32677,3471,3190,1940,3920,7474
TTCCGTCTAATATTCG,sample,220482,218229,12199,206030,31463,174567,94626,4723,41055,4643,135681,29520,7724,1808,42017,21244
CAAGGCCTAATATTCG,sample,92773,91958,3479,88479,17284,71195,36965,2650,24102,2552,61067,4926,3897,2015,7966,12024
CATAACCTAATATTCG,sample,120501,119520,4210,115310,20995,94315,65459,5287,15586,1828,81045,6155,4161,2506,12353,14420
GGAGGACGAATATTCG,sample,95922,94950,6311,88639,17918,70721,38563,2542,17529,2452,56092,9635,4738,1776,9747,11845
GGACGTAGAATATTCG,sample,50297,50006,2008,47998,15734,32264,18115,1278,8005,952,26120,3914,2932,1406,4617,9446
CGAGGCAGAATATTCG,sample,94345,93485,4284,89201,22242,66959,36481,3147,18382,2036,54863,6913,4065,1737,6024,14884
CCATGAAGAATATTCG,sample,104857,103941,5134,98807,23621,75186,43722,3046,17221,2163,60943,9034,4232,1561,14406,16052
ACGACTTCAATATTCG,sample,83243,82401,3594,78807,23356,55451,34812,2203,13334,1399,48146,3703,2661,1309,8511,14777
CATGATTCAATATTCG,sample,138652,137485,5288,132197,26734,105463,70619,5603,20157,2154,90776,6930,3750,2186,12733,18340
TTGGTACCAATATTCG,sample,100398,99473,4919,94554,19195,75359,41755,3186,20099,1943,61854,8376,4185,1497,8189,12645
CTAGGACCAATATTCG,sample,99981,99183,4530,94653,11143,83510,53123,4028,16843,1886,69966,7630,4366,2308,6091,7348
GTTAGGACAATATTCG,sample,84874,84261,3190,81071,26854,54217,38369,2908,8468,774,46837,3698,2945,2080,8991,16237
AACTCGTAAATATTCG,sample,132592,131381,7223,124158,26970,97188,53630,5155,23169,2334,76799,12900,4948,1459,14198,18533
AATATATCAATATTCG,sample,128895,127623,5801,121822,22269,99553,59276,5080,22758,1989,82034,10450,3685,1395,8770,15679
TGCTTCGCAATATTCG,sample,74662,74048,2325,71723,16998,54725,41952,3520,6738,654,48690,1861,1658,1372,6049,11826
GTCTTAGCAATATTCG,sample,99317,98442,4849,93593,16499,77094,48867,3640,15500,1940,64367,7147,4447,1966,6557,11278
GTACCGTAAATATTCG,Pos_Ctrl,64762,64068,3284,60784,2946,57838,47628,5072,3509,405,51137,1224,5549,6731,3030,908
GGCATATAAATATTCG,sample,102696,101767,4568,97199,19208,77991,42950,4199,20511,2443,63461,7888,4097,1630,6565,12969
TCAATATAAATATTCG,sample,111081,110097,3839,106258,25210,81048,52765,4017,16554,1833,69319,5879,3728,1792,4101,16849
CTTCATGAAATATTCG,sample,87723,86932,2626,84306,22088,62218,41166,3803,13186,1462,54352,2601,1594,1064,7972,15174
TCCTCCGTAGTCTCCG,sample,144102,143137,5657,137480,33918,103562,67734,4270,20758,2323,88492,8477,4538,2232,14148,22317
ACGTAAGTAGTCTCCG,sample,13484,13426,411,13015,4252,8763,5155,387,2387,351,7542,483,2105,1263,886,2617
ACGTTATGAGTCTCCG,sample,158471,157569,4212,153357,57880,95477,67290,5521,15169,2218,82459,5279,2918,1610,22190,33693
TTCTAATGAGTCTCCG,sample,157950,157108,4389,152719,36702,116017,83276,5757,18723,1847,101999,6414,3915,2447,14834,24595
ATGCCTGGAGTCTCCG,sample,87298,86777,2401,84376,20850,63526,38047,3211,16558,1855,54605,3855,3499,2603,5414,14020
AATGGTAAAGTCTCCG,sample,175467,174230,6032,168198,61924,106274,76459,5283,18504,1917,94963,4111,1889,1280,22558,37663
TTCCGTCTAGTCTCCG,sample,63188,62635,4150,58485,11766,46719,19923,1452,15161,1574,35084,8609,4512,1391,4822,7386
GCCTTGCTAGTCTCCG,sample,69761,69025,4141,64884,16486,48398,24205,1344,13606,1859,37811,7384,4028,1210,5471,10381
CAAGGCCTAGTCTCCG,sample,133997,132967,7037,125930,36039,89891,46449,3444,25077,2707,71526,12214,5414,2062,8584,23641
CATAACCTAGTCTCCG,sample,121086,120136,5321,114815,20544,94271,48419,4242,28489,3711,76908,9410,5264,2371,5930,13593
ACTATACTAGTCTCCG,sample,111134,110325,5285,105040,25056,79984,44921,3080,21080,2687,66001,8216,4256,1733,12006,16548
ACCTCGAGAGTCTCCG,sample,48266,47813,3105,44708,12380,32328,14168,1110,10656,1170,24824,5224,3703,1232,4602,7690
GGCCAGAGAGTCTCCG,sample,75975,75257,3732,71525,17401,54124,32332,2269,12661,1058,44993,5804,3035,1220,9902,11647
CATTGCAGAGTCTCCG,sample,114124,113207,2846,110361,17487,92874,67294,4816,14533,1712,81827,4519,3511,2575,10805,12500
CCATGAAGAGTCTCCG,sample,58807,58263,3257,55006,11354,43652,22535,1543,13850,1653,36385,4071,3195,1312,5972,7861
AGTCCGCAAGTCTCCG,sample,68375,67833,3234,64599,10609,53990,35480,2503,10337,1073,45817,4597,3545,1824,6481,7353
CTAGGACCAGTCTCCG,sample,120094,119097,6539,112558,18945,93613,46862,2924,27633,3496,74495,12698,6110,1911,7583,13255
GCCTGAACAGTCTCCG,sample,51562,51072,2265,48807,11898,36909,23102,1673,8025,936,31127,3173,2948,1598,4341,8016
CGTATGAAAGTCTCCG,sample,76884,76294,3612,72682,21507,51175,28804,2953,12481,1835,41285,5102,3067,1227,7264,13888
CCAATTCCAGTCTCCG,sample,67008,66194,5041,61153,11029,50124,20733,1650,16338,1751,37071,9652,4890,1133,3573,7278
TTGGTTAAAGTCTCCG,sample,52233,51750,2551,49199,8931,40268,20282,2021,12086,1363,32368,4516,2777,1109,3614,6531
GGCATATAAGTCTCCG,sample,42218,41788,3212,38576,9180,29396,14150,999,8342,1082,22492,4823,2971,968,2580,6020
TCAATATAAGTCTCCG,sample,72820,72134,2463,69671,17397,52274,35778,3647,7990,1796,43768,3063,1679,946,10304,11860
TATCAGTTTGCCTACG,sample,59475,58991,4326,54665,16709,37956,15087,1129,13319,1361,28406,7060,4597,1518,3364,10084
ACGTAAGTTGCCTACG,sample,116006,114685,10344,104341,11938,92403,33575,3504,31408,3229,64983,20687,7151,1577,4442,7780
AGTACCATTGCCTACG,sample,142900,141333,5591,135742,31241,104501,80088,7577,11518,1552,91606,3766,1390,1004,11344,21454
ACGTTATGTGCCTACG,sample,117028,115871,3960,111911,22820,89091,53551,5102,20637,2381,74188,7420,2780,1289,6002,15858
CAACCGCGTGCCTACG,sample,71194,70570,3627,66943,16956,49987,29179,1847,11367,1457,40546,6137,3877,1764,6012,11601
GGACCTCTTGCCTACG,sample,57894,57412,1884,55528,11571,43957,29814,2029,8907,1037,38721,2170,2198,1594,5390,8365
TCGCATCTTGCCTACG,sample,18284,18143,578,17565,4805,12760,7301,587,3618,427,10919,827,1463,951,1410,3063
GACGGAGATGCCTACG,sample,44765,44406,1844,42562,11216,31346,20966,1698,6330,731,27296,1621,2095,1413,5439,7313
CATTGCAGTGCCTACG,sample,42516,41990,1716,40274,9367,30907,21734,1656,4791,452,26525,2274,2000,1138,5133,5983
CATGATTCTGCCTACG,sample,49461,48949,2435,46514,11443,35071,21396,1846,7824,901,29220,3104,2935,1480,3762,7396
CTAGGACCTGCCTACG,sample,77324,76533,4655,71878,10848,61030,31658,2276,18735,1890,50393,6471,3597,1604,3303,7274
ACGTATTATGCCTACG,sample,55028,54418,4592,49826,8866,40960,12780,1461,16607,1758,29387,8354,4416,1107,1439,5672
AACTCGTATGCCTACG,sample,33884,33597,2081,31516,6715,24801,13501,1369,6297,816,19798,2818,2714,1470,2471,4550
ACCAATGCTGCCTACG,sample,54276,53686,1539,52147,13055,39092,31113,2412,4063,359,35176,1145,1232,1213,5904,8952
GGCATATATGCCTACG,Neg_Ctrl,652,317,222,95,20,75,44,1,24,0,68,6,33,22,12,9
AGGTCGGATGCCTACG,sample,107452,106445,12369,94076,10240,83836,16777,828,34215,3929,50992,28087,10066,1672,3617,5725
CCTCTAGACTTAGTTC,sample,197954,195950,19057,176893,32068,144825,47968,3195,53975,6974,101943,32713,10707,2977,8395,19869
TTCGTAATCTTAGTTC,sample,153183,151851,9074,142777,37353,105424,51503,2965,31604,3580,83107,15772,5902,1928,11864,23720
ACGTTATGCTTAGTTC,sample,135152,133840,9982,123858,19873,103985,39082,2445,39900,5179,78982,17379,6862,2118,6355,13320
TTCTAATGCTTAGTTC,sample,103806,102961,3482,99479,22208,77271,46817,3744,19844,2406,66661,4460,2989,2044,8577,14836
CAACCGCGCTTAGTTC,sample,110835,109026,7721,101305,18643,82662,33261,3185,27532,2687,60793,15997,6086,1319,4863,11729
TTAGAAGTCTTAGTTC,sample,126595,125378,4915,120463,21416,99047,62098,4700,21549,2900,83647,7800,4120,2129,8531,15698
GCCTTGCTCTTAGTTC,sample,51788,51260,3421,47839,13416,34423,14577,934,11900,1542,26477,5470,3802,1261,2916,8399
CAAGGCCTCTTAGTTC,sample,73482,72729,4030,68699,18532,50167,27011,2619,13721,1200,40732,5616,3510,1351,8383,11688
CATAACCTCTTAGTTC,sample,85367,84503,4059,80444,10607,69837,33910,2207,22950,2887,56860,7883,3727,1804,4596,7542
GTTAGCCGCTTAGTTC,sample,19125,18874,1939,16935,3193,13742,6130,503,3949,530,10079,2630,2578,1058,1446,2024
GGAGGACGCTTAGTTC,sample,105625,104762,5181,99581,29096,70485,45529,3338,14285,1687,59814,5646,2720,1302,13604,18234
GACGATAACTTAGTTC,sample,92008,91071,3129,87942,28923,59019,36748,2783,14411,1839,51159,3238,2570,1303,9362,17776
GGCCAGAGCTTAGTTC,sample,107729,106817,5777,101040,20260,80780,40985,3707,23860,2796,64845,9432,4873,1789,10205,14394
CATTGCAGCTTAGTTC,sample,73132,72616,2119,70497,5539,64958,46638,4168,10439,1368,57077,2345,3910,3429,3067,3676
CCATGAAGCTTAGTTC,sample,98752,98038,4524,93514,16075,77439,41564,3579,22063,2338,63627,7895,3900,1901,8236,10918
CATGATTCCTTAGTTC,sample,96151,95288,6309,88979,13977,75002,42220,3819,16665,1840,58885,10458,5121,2289,5200,9060
GTTAGGACCTTAGTTC,sample,115876,114912,10222,104690,16986,87704,37679,2997,27501,2583,65180,16944,7654,2058,6843,10708
CGTATGAACTTAGTTC,sample,89431,88631,3804,84827,17935,66892,34103,3022,19916,3081,54019,6770,3416,1358,5296,11920
AAGAGCGCCTTAGTTC,sample,59317,58865,3818,55047,11973,43074,19913,1398,12624,1396,32537,7743,4225,1245,3876,7761
GTCTTAGCCTTAGTTC,sample,126266,125129,10513,114616,14752,99864,31592,2694,35802,4050,67394,25726,8644,2101,4641,9507
GGCATATACTTAGTTC,sample,77968,77171,2943,74228,16053,58175,33945,2625,15324,1865,49269,4416,2625,1177,4971,11367
ATGACCGACTTAGTTC,sample,69520,68896,2174,66722,17367,49355,27689,2192,13668,1331,41357,4475,2521,1077,4235,11312
GGAGAGTTCGAGCTTC,sample,234330,232745,20626,212119,39281,172838,63487,4630,55951,5568,119438,43202,12132,3002,13818,25165
TATCAGTTCGAGCTTC,sample,129991,129023,4326,124697,23635,101062,57856,3528,27832,3973,85688,7873,3461,2054,9813,16836
GGTTGCGTCGAGCTTC,sample,135140,134122,4341,129781,46995,82786,59489,4980,12527,1501,72016,4289,3159,2370,13453,28039
CCTCTAGACGAGCTTC,sample,141740,140482,5414,135068,28983,106085,71340,6634,17850,2707,89190,7554,3690,1267,12783,19827
TTCGTAATCGAGCTTC,sample,61030,60359,3287,57072,18819,38253,18736,1575,11743,1383,30479,4816,3033,1022,5512,11123
ACGTTATGCGAGCTTC,sample,86716,86058,3719,82339,20828,61511,30219,2675,17941,2240,48160,8436,5762,2805,4557,14375
CAACCGCGCGAGCTTC,sample,101371,100435,3002,97433,33837,63596,49603,3940,7047,860,56650,2146,1298,1235,15117,20465
CAAGGCCTCGAGCTTC,sample,102918,101690,7704,93986,20663,73323,36830,2100,19174,2234,56004,12985,5587,1386,9572,14048
GACGGAGACGAGCTTC,sample,142352,141411,4733,136678,25033,111645,76470,6062,19498,1582,95968,8033,4304,2270,12462,17539
CCAGAGCGCGAGCTTC,sample,89152,88377,3160,85217,27133,58084,43691,3335,7894,1193,51585,1971,1605,1371,9430,17355
ACCTCGAGCGAGCTTC,sample,51968,51471,2189,49282,4394,44888,18933,1708,17116,2136,36049,4995,3578,1853,633,3079
GGCCAGAGCGAGCTTC,sample,75672,75168,3452,71716,24369,47347,35140,2840,6474,830,41614,2063,1942,1541,7800,14317
CGAGGCAGCGAGCTTC,sample,78246,77505,2419,75086,18837,56249,34621,2956,13242,1387,47863,4043,2773,1589,7348,12290
CGTACGTCCGAGCTTC,sample,89038,88302,2760,85542,10996,74546,42379,3100,21994,2509,64373,4564,3170,1843,2866,7954
CTAGGACCCGAGCTTC,sample,69970,69280,2223,67057,12838,54219,32267,1783,14374,2011,46641,3784,2421,1300,4754,8544
TTGGCCTCCGAGCTTC,sample,103950,103034,6557,96477,16426,80051,41795,3572,21167,2205,62962,11312,4821,1611,6972,11207
TGCTTCGCCGAGCTTC,sample,55176,54635,2740,51895,9497,42398,23754,1970,10808,1181,34562,4685,3468,1430,3729,6198
GAAGGCGCCGAGCTTC,sample,82365,81760,2319,79441,11889,67552,46482,3151,12677,1698,59159,3544,2592,1757,7201,8558
AAGAGCGCCGAGCTTC,sample,84885,84210,2145,82065,18707,63358,48406,3854,7687,948,56093,2463,2532,2120,10834,12975
TTGGTTAACGAGCTTC,sample,77007,76467,3100,73367,15813,57554,33767,2921,13478,1658,47245,5730,3908,1880,5269,10854
GGAGAGTTGTAGAATG,sample,71293,70668,2534,68134,21772,46362,30833,2868,8764,900,39597,2997,2270,1204,9717,13616
ATTCTCTTGTAGAATG,Pos_Ctrl,45486,45022,2783,42239,2122,40117,33502,3086,2462,281,35964,786,5067,5444,3115,1010
TCCTCCGTGTAGAATG,sample,52208,51539,3397,48142,12373,35769,18437,1198,11216,692,29653,4226,2971,990,6206,7976
ACGTAAGTGTAGAATG,sample,121878,120825,8004,112821,19173,93648,44323,3028,29966,3569,74289,12762,6030,2376,6557,13307
AGTACCATGTAGAATG,sample,45024,44618,3937,40681,12100,28581,13864,877,8686,887,22550,4267,3748,1845,2733,7402
TTCGTAATGTAGAATG,sample,158875,157655,7776,149879,27604,122275,62364,4794,38205,5112,100569,11800,4360,1945,12337,19466
TAGTACGGGTAGAATG,sample,68187,67713,2336,65377,19957,45420,34788,2861,5795,605,40583,1371,2034,1995,7044,12812
TGAGCGCGGTAGAATG,sample,17751,17575,1598,15977,2677,13300,5672,495,4588,576,10260,1969,2224,946,1193,1888
GGACCTCTGTAGAATG,Pos_Ctrl,46693,46168,2701,43467,2406,41061,33907,3309,2582,368,36489,895,5143,5609,2857,1010
GCCTTGCTGTAGAATG,sample,75975,75197,3021,72176,20420,51756,35586,2759,9423,1022,45009,2966,2371,1286,10406,13363
CATAACCTGTAGAATG,sample,96278,95543,3172,92371,24551,67820,46924,4338,11814,1795,58738,2949,2262,1831,10581,16493
ACCTCGAGGTAGAATG,sample,27333,26978,1219,25759,5372,20387,13943,1020,3637,459,17580,1328,1548,901,2813,3818
CATTGCAGGTAGAATG,sample,76776,75933,4790,71143,16954,54189,29869,1875,12794,1491,42663,8160,4296,1240,6890,11076
CGAGGCAGGTAGAATG,Pos_Ctrl,29230,28930,1412,27518,1441,26077,21794,2280,1353,176,23147,474,4201,4422,1861,545
CCATGAAGGTAGAATG,sample,56407,55965,2684,53281,13056,40225,21378,1423,12670,1438,34048,3316,3283,1789,3748,8732
CGTACGTCGTAGAATG,sample,68771,68108,4417,63691,11094,52597,24654,1816,16620,1555,41274,7952,4376,1139,6339,7374
CTAGGACCGTAGAATG,sample,118430,117246,8804,108442,12352,96090,31905,1971,38446,4177,70351,19591,7307,1574,4653,7917
ACCAATGCGTAGAATG,Pos_Ctrl,24739,24536,1243,23293,1121,22172,18450,1840,1364,141,19814,377,3900,4101,1182,350
TGCTTCGCGTAGAATG,sample,58361,57834,2695,55139,8758,46381,25012,1838,12663,1730,37675,5138,3064,1314,3499,6015
GAAGGCGCGTAGAATG,sample,92956,92068,3945,88123,17463,70660,43490,3224,16105,1572,59595,6269,2913,1200,8477,12266
GGAGAGTTCAATAGTC,sample,138849,138088,4760,133328,21342,111986,57410,5303,35480,4183,92890,9610,4306,2209,9574,14681
TCCAACTTCAATAGTC,sample,157664,156482,4099,152383,55402,96981,73884,5025,13288,1612,87172,3172,1692,1428,22985,33826
AAGTTCGTCAATAGTC,sample,87864,87399,1893,85506,27832,57674,42709,3258,9238,1052,51947,1417,2619,2467,7955,17221
ATGCCTGGCAATAGTC,sample,39353,38999,2352,36647,11262,25385,14515,1038,6166,529,20681,3137,2764,1138,4652,6790
TTAGAAGTCAATAGTC,sample,177824,176137,16599,159538,23372,136166,37686,3446,50173,5140,87859,39721,10146,1777,7031,14215
GACGGAGACAATAGTC,sample,50606,50219,2227,47992,16307,31685,19481,1396,7442,841,26923,2525,2191,1319,6403,9987
CTTGATAGCAATAGTC,sample,56100,55629,3977,51652,11721,39931,21106,1586,10593,1371,31699,5275,3722,1613,5119,7702
TGGACGAGCAATAGTC,sample,20145,20022,460,19562,10899,8663,6222,491,1428,212,7650,310,1278,1001,2041,4650
CGAGGCAGCAATAGTC,sample,109579,108538,5348,103190,24292,78898,50930,5206,14311,1798,65241,6653,3409,1257,10435,16300
ACGACTTCCAATAGTC,sample,122094,120743,4356,116387,22867,93520,60336,5202,18407,1960,78743,7615,3082,1316,8995,15524
TTGGTACCCAATAGTC,sample,118570,117736,9837,107899,16805,91094,35330,2277,29440,2991,64770,21056,8282,1947,9537,11514
CGGATTACCAATAGTC,sample,121356,120355,6174,114181,16886,97295,50971,2995,26970,2818,77941,13541,5726,1592,9397,11023
AACTCGTACAATAGTC,sample,116153,115078,5260,109818,29011,80807,59663,5252,13349,1133,73012,1410,1155,984,13092,19409
AATATATCCAATAGTC,sample,127798,127020,5766,121254,26395,94859,60932,6101,17495,1943,78427,8388,3626,1890,11157,17937
TGCTTCGCCAATAGTC,sample,66886,66359,3940,62419,11035,51384,28249,2348,12285,1917,40534,6585,3747,1536,4915,7147
AAGAGCGCCAATAGTC,sample,54294,53706,3335,50371,9038,41333,19920,1464,12932,1405,32852,5612,3638,1255,4457,5939
CCAATTCCCAATAGTC,sample,101428,100508,3080,97428,20037,77391,57417,4644,10813,1366,68230,3151,2603,1933,11587,14417
GTACCGTACAATAGTC,sample,106188,105231,3930,101301,24151,77150,49319,4210,16023,1414,65342,6184,2261,1154,13288,16054
GGCATATACAATAGTC,sample,81110,80309,4279,76030,18131,57899,30975,2887,15310,1628,46285,7099,3714,1218,7237,11695
GACCGGAACAATAGTC,sample,30550,30334,1112,29222,6973,22249,14276,1445,4503,560,18779,1465,1733,1051,3029,4472
ATTCTCTTCGTTACTC,sample,205132,203612,8480,195132,45898,149234,87476,6905,37817,4127,125293,12909,5183,2029,23502,30891
TCCAACTTCGTTACTC,Neg_Ctrl,3230,1416,948,468,152,316,162,10,89,5,251,50,131,64,48,23
AAGTTCGTCGTTACTC,sample,161345,159928,14136,145792,24232,121560,42633,3018,46176,5105,88809,24628,7969,2281,7855,15827
ACGTAAGTCGTTACTC,sample,54950,54400,3943,50457,11281,39176,16504,1221,13814,1755,30318,5882,4006,1569,3473,7145
CCTCTAGACGTTACTC,sample,79399,78724,2927,75797,27722,48075,33237,2710,8270,935,41507,2923,2598,1649,8958,16667
TAGTACGGCGTTACTC,sample,29155,28852,2042,26810,3888,22922,8555,664,9495,998,18050,3210,3138,1199,882,2548
AATGGTAACGTTACTC,sample,89880,89212,6929,82283,15972,66311,30646,2237,22903,2950,53549,7575,4661,2061,5821,11478
TTCCGTCTCGTTACTC,sample,136232,135099,7592,127507,29047,98460,50079,4006,27567,3273,77646,13535,5028,1955,12780,19573
TCGCATCTCGTTACTC,Neg_Ctrl,2220,1127,617,510,77,433,107,8,84,9,191,225,108,61,31,40
GCCTTGCTCGTTACTC,sample,81393,80530,6042,74488,16047,58441,28128,2325,17736,2031,45864,8221,4915,1785,7058,10373
ACTATACTCGTTACTC,sample,87588,87194,3398,83796,25260,58536,34954,2266,14508,1876,49462,4932,3435,1582,10285,16155
GGAGGACGCGTTACTC,sample,47255,46580,5267,41313,8834,32479,11457,648,11508,1253,22965,7613,4816,1302,3154,5816
CTTGATAGCGTTACTC,sample,69831,69060,6098,62962,14519,48443,20687,1487,15379,1716,36066,9174,5068,1512,4276,9349
CCATGAAGCGTTACTC,Neg_Ctrl,2896,1716,1337,379,79,300,121,12,106,6,227,55,107,48,32,39
ACGACTTCCGTTACTC,sample,115053,113997,6613,107384,23200,84184,43598,2972,24557,2884,68155,10173,4311,1671,8280,15212
CATGATTCCGTTACTC,sample,139308,137977,10131,127846,24951,102895,40975,2633,33993,3928,74968,21366,6655,1694,11577,16452
AGTCCGCACGTTACTC,sample,96935,95997,4688,91309,14450,76859,42680,2660,21984,2950,64664,6585,3500,1680,9594,10468
CGGATTACCGTTACTC,sample,86845,86179,3038,83141,26578,56563,39296,2573,11287,1116,50583,2291,2746,2005,9460,16838
GTTAGGACCGTTACTC,sample,132268,131116,7927,123189,23600,99589,50941,3384,27580,2991,78521,14693,5570,1756,11636,16013
GCCTGAACCGTTACTC,sample,119907,118597,5362,113235,28820,84415,56787,4272,15824,2270,72611,5262,2716,1317,17674,19820
TTGGCCTCCGTTACTC,sample,101308,100616,4092,96524,11882,84642,57997,4515,14652,1799,72649,5679,4829,3483,5865,7753
AATATATCCGTTACTC,sample,127357,126217,6956,119261,27399,91862,49384,4587,24016,2807,73400,11068,4900,1568,12139,18960
TGCTTCGCCGTTACTC,Neg_Ctrl,1776,748,432,316,74,242,103,13,62,6,165,58,106,53,23,18
AAGAGCGCCGTTACTC,sample,76324,75624,2074,73550,17524,56026,43295,2925,7149,1753,50444,904,1473,1301,8768,11989
TTGGTTAACGTTACTC,sample,102517,101829,3745,98084,18378,79706,50810,4569,16056,1807,66866,6464,3460,1786,7244,12824
GTACCGTACGTTACTC,sample,101202,100294,6976,93318,16464,76854,37665,3437,21633,2375,59298,11744,5432,1804,6396,10644
TCGCCTGACGTTACTC,sample,73951,73209,2946,70263,14000,56263,31665,2902,14342,1807,46007,5547,3431,1560,4475,9587
CTTCATGACGTTACTC,sample,48570,48130,3199,44931,9539,35392,19054,1203,9553,1043,28607,4539,3339,1224,4851,6345
AGGTCGGACGTTACTC,sample,111161,110196,4102,106094,21287,84807,53987,5446,18149,1710,72136,5515,2892,1292,11677,15010
TCCAACTTTGGACTGC,sample,122397,121302,3865,117437,47410,70027,51153,4107,11422,1094,62575,2251,1450,1139,18775,26687
ACGTTATGTGGACTGC,sample,52692,52323,2307,50016,11293,38723,20513,1485,11395,1570,31908,3760,3807,2341,2895,7527
TGAGCGCGTGGACTGC,sample,81199,80616,4085,76531,22223,54308,30529,2307,14315,1549,44844,5608,4200,1682,8075,14543
TCGCATCTTGGACTGC,sample,15880,15683,1136,14547,3246,11301,4738,425,4133,493,8871,1512,1994,841,1043,2009
GCCTTGCTTGGACTGC,sample,56533,55763,3487,52276,12638,39638,15247,1319,15374,1583,30621,6115,3407,966,3350,8201
CCAGAGCGTGGACTGC,sample,81090,80483,2359,78124,25615,52509,43336,2578,4621,686,47957,1288,1722,1748,12544,16136
GACGATAATGGACTGC,sample,64200,63599,4949,58650,11935,46715,19440,1219,15801,1837,35241,8418,4550,1369,4820,7950
ACGACTTCTGGACTGC,sample,100184,99434,5453,93981,13677,80304,35297,2477,29661,3368,64958,9501,4403,1682,7615,9588
AGTCCGCATGGACTGC,sample,135415,134173,11530,122643,19824,102819,38176,2940,37233,4439,75409,20031,7282,1811,9811,13078
TTGGTACCTGGACTGC,sample,40107,39704,2739,36965,10218,26747,9458,647,10514,1475,19972,4653,3325,1075,1683,6272
GTTAGGACTGGACTGC,sample,69455,68927,3698,65229,14487,50742,26578,2293,14030,1904,40608,5937,4236,1842,6851,9539
TTGGCCTCTGGACTGC,sample,70155,69264,3581,65683,17202,48481,27586,2454,12146,1275,39732,5020,3025,1191,5049,11344
GAAGGCGCTGGACTGC,sample,70361,69666,2582,67084,12479,54605,30744,2244,14497,1942,45241,5178,3242,1385,6312,8878
AAGAGCGCTGGACTGC,sample,70259,69442,4067,65375,13803,51572,27947,2183,12768,1470,40715,7204,4193,1273,5714,9350
TTGGTTAATGGACTGC,sample,49248,48730,2510,46220,11572,34648,16412,1203,11748,1342,28160,3943,3211,1350,2300,7574
AGGTCGGATGGACTGC,sample,55373,54893,3121,51772,7928,43844,21890,2012,12860,1689,34750,5393,3470,1439,2746,5480
TTATTCGATGGACTGC,sample,65280,64859,3291,61568,11172,50396,31166,2338,10801,1294,41967,4797,3305,1479,5384,7609
GGTTGCGTCCTTGAGC,sample,139880,138607,8956,129651,20125,109526,57747,3971,29785,3967,87532,14056,7024,2453,8384,14358
TCCTCCGTCCTTGAGC,sample,67365,66848,2124,64724,23371,41353,27231,2208,8467,1073,35698,2374,2639,1731,7157,13898
TTCGTAATCCTTGAGC,Pos_Ctrl,51869,51396,3444,47952,2789,45163,37464,3616,2673,445,40137,965,5301,5886,3302,1314
TAGTACGGCCTTGAGC,sample,45434,45052,2566,42486,15974,26512,13267,801,8551,880,21818,3013,2780,1118,3829,9120
TGAGCGCGCCTTGAGC,sample,46074,45746,1541,44205,9940,34265,22738,1799,6686,1003,29424,2039,2540,2019,4257,6010
CAACCGCGCCTTGAGC,sample,98769,97974,4021,93953,30458,63495,37107,2816,16430,1696,53537,5446,2974,1412,10472,19029
GCCTTGCTCCTTGAGC,sample,14843,14624,1913,12711,2020,10691,3734,311,4100,407,7834,2139,2314,856,755,1188
CATAACCTCCTTGAGC,sample,125495,124312,7012,117300,27796,89504,50434,3704,22953,2738,73387,9675,5159,1846,12124,18035
ACTATACTCCTTGAGC,sample,85635,84960,3495,81465,17611,63854,36830,2979,16992,2258,53822,4795,3286,1775,8729,12157
GACGGAGACCTTGAGC,sample,58054,57569,2093,55476,20878,34598,24658,2104,5551,618,30209,1667,2641,2128,4536,11912
CCAGAGCGCCTTGAGC,sample,66869,66304,3035,63269,19711,43558,25420,2083,10837,1610,36257,3608,3216,1673,6583,12061
GTTAGCCGCCTTGAGC,Pos_Ctrl,26432,26148,1809,24339,1428,22911,19024,1800,1371,183,20395,533,4132,3956,1820,705
GGACGTAGCCTTGAGC,sample,86958,86208,6528,79680,16661,63019,29105,1902,18903,2169,48008,10940,5204,1639,7567,11160
CTTGATAGCCTTGAGC,sample,43352,42983,2248,40735,12694,28041,16872,1156,6794,811,23666,2408,2583,1235,5099,7893
GACGATAACCTTGAGC,sample,71975,71416,3171,68245,15441,52804,28132,1876,15484,1939,43616,5373,3414,1494,7023,10555
CCATGAAGCCTTGAGC,sample,11504,11372,770,10602,2474,8128,4235,341,2294,294,6529,964,1725,903,1025,1658
CGTACGTCCCTTGAGC,sample,51903,51487,2776,48711,6791,41920,19969,1700,14206,2018,34175,4027,3417,1669,3538,4548
GTCCTGCCCCTTGAGC,sample,85468,84723,5043,79680,16550,63130,34045,2716,16298,2187,50343,7884,4368,1702,8226,10631
TTGGTACCCCTTGAGC,Pos_Ctrl,48832,48526,2559,45967,2419,43548,36243,3826,2350,358,38593,771,5150,5898,3500,979
GTTAGGACCCTTGAGC,sample,34406,34127,2630,31497,7141,24356,11940,1034,6915,683,18855,3784,3644,1712,3363,4500
GAAGGCGCCCTTGAGC,sample,59935,59386,1943,57443,8146,49297,25672,2213,15745,1745,41417,3922,2518,1512,2842,5861
AGGTCGGACCTTGAGC,Pos_Ctrl,29637,29399,1639,27760,1384,26376,21721,2470,1474,196,23195,515,4136,4512,1612,482
TTATTCGACCTTGAGC,sample,59260,58920,1478,57442,10628,46814,35071,3079,6004,822,41075,1838,2531,2036,3920,7387
TATCAGTTCGATATCC,sample,157436,156204,10057,146147,24391,121756,59424,4326,41816,4578,101240,11612,6179,3059,9364,16863
GGTTGCGTCGATATCC,sample,125903,124893,3519,121374,46102,75272,57964,3790,9898,1154,67862,2466,1439,1282,19121,27120
TCCTCCGTCGATATCC,sample,138854,137852,5470,132382,30591,101791,65176,4961,21724,2683,86900,7247,3949,2188,12963,21508
AGTACCATCGATATCC,sample,25965,25647,2126,23521,6442,17079,8840,617,4780,686,13620,2156,2181,1010,2328,3909
CAACCGCGCGATATCC,sample,68700,68182,2533,65649,17167,48482,33232,2563,8985,1044,42217,2658,3384,2292,6430,11693
TCGCATCTCGATATCC,sample,87808,87007,8385,78622,12973,65649,27067,2063,20345,2183,47412,13991,6874,1911,6273,8298
ACTATACTCGATATCC,sample,103306,102671,4435,98236,18004,80232,50226,4065,18675,2083,68901,5183,4414,2769,8244,12548
GTTAGCCGCGATATCC,sample,129004,128098,4396,123702,39152,84550,64166,4779,11522,1217,75688,2866,1936,1525,19659,25669
GGAGGACGCGATATCC,sample,121648,120738,3680,117058,30371,86687,52868,3265,22312,3280,75180,4962,2413,1323,18832,21212
TGGACGAGCGATATCC,sample,120848,120067,4658,115409,26966,88443,51858,3579,23040,2479,74898,7487,3782,1938,10435,18537
GACGATAACGATATCC,sample,124300,123526,2586,120940,44034,76906,59575,4943,10109,885,69684,1394,1432,1413,16629,26178
CCATGAAGCGATATCC,sample,126345,125487,4873,120614,17944,102670,52920,3336,32400,4483,85320,9531,4559,2015,10935,13141
AATCCGTCCGATATCC,sample,127023,126087,6302,119785,25847,93938,53086,3361,24903,2898,77989,9690,4774,1562,15080,17256
CGTACGTCCGATATCC,sample,114674,114030,3287,110743,30333,80410,60804,4707,10233,1471,71037,3195,3098,2434,11912,19957
GTCCTGCCCGATATCC,sample,51601,51301,1348,49953,17066,32887,24359,2290,4473,482,28832,1283,1883,1664,5393,10467
AACTCGTACGATATCC,sample,72965,72390,3898,68492,17035,51457,29471,3093,11554,1278,41025,6061,3542,1296,7113,10898
AATATATCCGATATCC,sample,106272,105572,4874,100698,24275,76423,44494,3577,19283,1874,63777,7195,4052,1463,10677,16117
ACCAATGCCGATATCC,sample,73608,73086,3025,70061,17845,52216,31960,2714,11486,1245,43446,4811,3188,1462,5198,11320
AAGAGCGCCGATATCC,sample,65292,64755,2781,61974,14861,47113,23206,2366,14208,1632,37414,5701,3178,1349,4565,9940
AGGTCGGACGATATCC,sample,518,494,34,460,87,373,222,13,97,12,319,29,151,88,68,59
TTATTCGACGATATCC,sample,3208,3155,91,3064,648,2416,1390,135,701,103,2091,87,636,425,163,429
TCCTCCGTATCTGACC,sample,107877,106655,5095,101560,26761,74799,44720,4380,15209,1829,59929,8661,3602,1039,10055,17286
ACGTAAGTATCTGACC,sample,167153,165441,7984,157457,27180,130277,66437,5429,37564,5141,104001,15706,4194,1454,10607,18264
TTCGTAATATCTGACC,sample,134360,132966,7937,125029,24196,100833,40778,3353,35237,4605,76015,16860,5815,1237,7804,15276
ACGTTATGATCTGACC,Neg_Ctrl,2303,935,494,441,102,339,164,11,114,23,278,27,132,59,33,18
ATGCCTGGATCTGACC,sample,59862,59354,2972,56382,9453,46929,22188,1838,15882,2133,38070,4888,3216,1698,3658,6241
TAGTACGGATCTGACC,sample,59381,58709,10551,48158,6517,41641,8395,657,18791,1932,27186,11866,6566,1247,1810,3876
CAACCGCGATCTGACC,sample,11730,11567,694,10873,2650,8223,4314,410,2419,294,6733,786,1464,802,1226,1763
CATAACCTATCTGACC,sample,103659,102662,8816,93846,19816,74030,30889,2688,22630,1980,53519,15843,6039,1496,8035,12844
CCAGAGCGATCTGACC,sample,59642,59138,2240,56898,15447,41451,26199,1988,9112,1647,35311,2505,1925,1263,7918,10536
GGAGGACGATCTGACC,Neg_Ctrl,1542,766,428,338,79,259,142,11,69,6,211,31,111,62,32,26
GGACGTAGATCTGACC,sample,79538,78935,2905,76030,20215,55815,38699,4129,8592,977,47291,3418,2210,1538,10094,13652
GGCCAGAGATCTGACC,sample,87554,86726,7309,79417,14686,64731,25545,2069,21225,2646,46770,13246,6250,1594,6846,9929
CATTGCAGATCTGACC,sample,73830,73250,3263,69987,16674,53313,28122,2131,16351,1620,44473,5089,3208,1318,7650,11488
CCATGAAGATCTGACC,sample,57317,56673,5519,51154,10028,41126,16689,1515,12689,1597,29378,8636,4606,1146,4306,6362
ACGACTTCATCTGACC,sample,65173,64587,3239,61348,14641,46707,26876,2125,11738,1182,38614,4786,3175,1394,7967,9327
CATGATTCATCTGACC,sample,54700,54169,3904,50265,10431,39834,17117,1181,14027,1471,31144,6038,4051,1264,4595,7174
AGTCCGCAATCTGACC,sample,40826,40449,1946,38503,8185,30318,22715,1420,4024,508,26739,1651,2568,1937,3721,5590
GTCCTGCCATCTGACC,sample,53099,52609,3579,49030,13161,35869,20187,1097,8795,869,28982,4921,3154,976,6237,8120
CTAGGACCATCTGACC,Neg_Ctrl,1840,996,673,323,64,259,148,13,60,7,208,31,113,66,30,38
GCCTGAACATCTGACC,sample,5358,5304,320,4984,1089,3895,1767,146,1276,143,3043,563,1043,536,335,682
AACTCGTAATCTGACC,sample,79233,78717,6580,72137,10911,61226,27659,2074,18408,2442,46067,10643,5729,2051,4594,7132
AATATATCATCTGACC,sample,120996,120279,6568,113711,19671,94040,50689,4978,22803,2394,73492,13176,5504,1911,7560,13457
AAGAGCGCATCTGACC,sample,97808,97115,4182,92933,17777,75156,44215,4311,19202,1932,63417,5496,3460,1617,8015,12197
GTCTTAGCATCTGACC,sample,79276,78713,3971,74742,17963,56779,34927,2773,11308,1600,46235,6171,3094,1237,7503,12173
TTGGTTAAATCTGACC,sample,65308,64703,4362,60341,10711,49630,17891,1486,17891,2063,35782,10299,5052,1152,2707,7017
GGCATATAATCTGACC,sample,83675,83045,2820,80225,17193,63032,40902,3286,12979,1373,53881,4492,2344,1232,9620,11843
TCGCCTGAATCTGACC,sample,93660,93011,3679,89332,16196,73136,49454,3291,13766,1445,63220,5180,3685,2049,5958,11167
AGGTCGGAATCTGACC,sample,102784,102072,6546,95526,13566,81960,37368,2965,25501,2670,62869,13456,6333,1649,6587,9654
TTATTCGAATCTGACC,Neg_Ctrl,883,345,230,115,24,91,45,4,20,11,65,11,43,23,10,5
ATTCTCTTCTTCTTAC,sample,78838,78043,12116,65927,14814,51113,16827,1291,17528,1949,34355,13518,7173,2292,3324,8709
AAGTTCGTCTTCTTAC,sample,95417,94706,4973,89733,20621,69112,40699,2920,16531,1645,57230,7317,4064,2107,9222,13573
GGTTGCGTCTTCTTAC,sample,125689,124644,5605,119039,22802,96237,60947,4073,20655,2265,81602,8297,4200,2057,10828,15648
TCCTCCGTCTTCTTAC,sample,84193,83608,2816,80792,17707,63085,37558,2899,16555,1964,54113,4109,2966,2001,7759,12068
ACGTAAGTCTTCTTAC,sample,129747,128669,4652,124017,38760,85257,54504,4443,19082,2048,73586,5180,3042,1467,15113,24161
AGTACCATCTTCTTAC,sample,145212,144105,4858,139247,50079,89168,66842,4879,13422,1354,80264,2671,1735,1390,23188,30415
ACGTTATGCTTCTTAC,sample,113376,112592,5432,107160,29240,77920,35128,2589,26662,3848,61790,9693,4322,1674,6746,18326
TAGTACGGCTTCTTAC,sample,22908,22669,1391,21278,5431,15847,9476,627,3927,377,13403,1440,1890,959,2847,3456
CAACCGCGCTTCTTAC,sample,129329,128101,3451,124650,22228,102422,69007,5237,20607,2680,89614,4891,2579,1840,7403,15885
TTCCGTCTCTTCTTAC,sample,172158,171186,4953,166233,63770,102463,82585,5928,10713,1468,93298,1769,1342,1213,35268,37778
GCCTTGCTCTTCTTAC,sample,80636,79899,3442,76457,20083,56374,35252,2670,12135,1577,47387,4740,3216,1609,9272,13636
CAAGGCCTCTTCTTAC,sample,98880,98153,2809,95344,31038,64306,48646,4122,8716,1211,57362,1611,1422,1337,12601,19504
CATAACCTCTTCTTAC,sample,124554,123355,9374,113981,21619,92362,39554,3467,29800,3536,69354,16005,6340,1793,9606,14547
GTTAGCCGCTTCTTAC,sample,63392,62980,2364,60616,18674,41942,30289,2111,6859,761,37148,1922,2360,1816,6368,12012
CCGCAACGCTTCTTAC,sample,18921,18685,1786,16899,3550,13349,6201,383,4290,595,10491,1880,2336,967,1635,2333
GGACGTAGCTTCTTAC,sample,83726,82964,10061,72903,14953,57950,22018,1663,20460,2115,42478,11694,5211,1271,6775,9121
ACCTCGAGCTTCTTAC,sample,87838,87143,2762,84381,24082,60299,45035,4274,7748,923,52783,2319,1893,1539,8839,16166
CGAGGCAGCTTCTTAC,sample,61489,60968,3191,57777,12417,45360,28198,2180,9205,1414,37403,4363,3228,1725,6753,8595
CATGATTCCTTCTTAC,sample,82032,81385,3243,78142,18364,59778,39459,3111,12675,1117,52134,3416,2818,1541,9701,12690
GTCCTGCCCTTCTTAC,sample,68507,67839,5128,62711,11858,50853,22549,1942,15872,1926,38421,8564,4670,1491,4383,7658
GCCTGAACCTTCTTAC,sample,81927,81376,2826,78550,12778,65772,36279,2742,19058,2539,55337,5154,3195,1558,5556,9083
CGTATGAACTTCTTAC,sample,130259,129037,8376,120661,24296,96365,57845,4200,20484,2386,78329,11450,5103,1740,11042,16825
AATATATCCTTCTTAC,sample,72628,71967,4568,67399,8620,58779,32794,2805,14023,1606,46817,7551,4962,2429,3543,5830
ACCAATGCCTTCTTAC,sample,73503,72702,5578,67124,11449,55675,25966,2329,16671,2304,42637,8405,4461,1343,4468,7866
GGAGAGTTACTTCTAC,sample,96638,96053,2075,93978,34958,59020,45149,3170,7611,925,52760,2165,1441,1381,10715,20444
TCCAACTTACTTCTAC,sample,119488,118642,5118,113524,35234,78290,46976,2805,16682,1483,63658,10344,3495,1240,13744,22046
CCTCTAGAACTTCTAC,sample,101810,101096,5556,95540,17661,77879,30226,2657,27953,3081,58179,13962,6045,1950,3802,12195
TTCTAATGACTTCTAC,sample,85058,84407,5452,78955,15473,63482,31126,2062,19356,1937,50482,9001,5161,1972,7934,10544
TAGTACGGACTTCTAC,sample,59087,58732,2171,56561,20471,36090,23053,1700,8634,827,31687,1876,2570,1510,7015,11920
AATGGTAAACTTCTAC,sample,106431,105742,3263,102479,31499,70980,49474,4471,12010,1706,61484,3319,2784,1934,10708,20080
CCAGAGCGACTTCTAC,sample,64132,63637,2741,60896,13837,47059,29592,2160,11814,1460,41406,2033,2172,1527,7280,9355
GTTAGCCGACTTCTAC,sample,119139,118206,7759,110447,20888,89559,41324,3225,28599,3592,69923,12819,5631,1745,9582,14669
GGAGGACGACTTCTAC,sample,29339,29017,2171,26846,8116,18730,7959,667,6178,636,14137,3290,2819,1158,2137,4839
CTTGATAGACTTCTAC,sample,95086,94433,4374,90059,20400,69659,38007,2733,19380,2208,57387,7331,3882,1477,12075,13924
TTGGTACCACTTCTAC,sample,95494,94730,3573,91157,27795,63362,42675,3522,12885,1514,55560,2766,1859,1157,11129,18165
CTAGGACCACTTCTAC,sample,33624,33306,1388,31918,9177,22741,14227,1209,4817,792,19044,1696,1886,967,4305,5801
CGGATTACACTTCTAC,sample,42882,42575,1362,41213,4842,36371,22876,1928,8346,1171,31222,2050,2940,2366,2534,3680
ACGTATTAACTTCTAC,sample,114740,113846,8642,105204,15004,90200,41997,2555,26049,3051,68046,16548,6705,2067,6655,9660
GTCTTAGCACTTCTAC,sample,84719,84107,3062,81045,14426,66619,45802,3773,10925,1761,56727,4358,2903,1652,6035,10092
CCAATTCCACTTCTAC,sample,61544,60769,3103,57666,11767,45899,26309,2264,10516,1353,36825,5457,2930,1038,5193,8436
TCAATATAACTTCTAC,sample,45354,45040,2738,42302,7466,34836,17010,1292,10668,1364,27678,4502,3827,1497,2319,4957
CTTCATGAACTTCTAC,sample,77505,76918,2716,74202,13570,60632,36266,3037,15068,1768,51334,4493,2886,1393,5163,9622
ATGACCGAACTTCTAC,sample,98135,97546,3961,93585,18566,75019,48081,5026,13621,1640,61702,6651,3789,1898,10154,12948
GGTTGCGTAGAAGTAA,sample,165036,163943,4404,159539,38416,121123,80030,6457,26195,3505,106225,4936,2604,2129,16838,25508
TAGTACGGAGAAGTAA,sample,155570,154664,4591,150073,51969,98104,73444,5613,11927,2512,85371,4608,2360,1670,18039,32335
CAAGGCCTAGAAGTAA,sample,11835,11676,1277,10399,1917,8482,3616,223,2767,291,6383,1585,1667,615,892,1110
CATAACCTAGAAGTAA,sample,160433,159368,5102,154266,54712,99554,74683,5598,14094,1611,88777,3568,1898,1384,23660,32723
GACGGAGAAGAAGTAA,sample,155849,154651,11405,143246,29508,113738,45647,2106,37031,4614,82678,24340,7863,1845,13834,19039
GTTAGCCGAGAAGTAA,sample,68645,68072,2324,65748,21194,44554,28280,1754,11308,1184,39588,2028,1885,1192,9284,13290
GGAGGACGAGAAGTAA,sample,97005,96335,5751,90584,21513,69071,31257,2040,21770,2381,53027,11623,5411,1666,10250,14532
TGGACGAGAGAAGTAA,sample,107346,106671,3236,103435,17806,85629,59690,6108,13647,1960,73337,4224,2963,1797,8446,12655
AATCCGTCAGAAGTAA,sample,186021,184770,8976,175794,30690,145104,78662,6839,41257,4583,119919,13763,5165,1986,15474,22142
CGTACGTCAGAAGTAA,sample,39184,38836,2474,36362,8892,27470,14511,1422,7214,842,21725,3481,2964,1358,3335,5842
CTAGGACCAGAAGTAA,sample,92734,92188,3460,88728,30915,57813,37417,2700,11794,1355,49211,4547,2986,1835,8898,18760
GTTAGGACAGAAGTAA,sample,98208,97444,3465,93979,22409,71570,40455,3351,18977,2226,59432,6561,3296,1477,6496,14650
CGTATGAAAGAAGTAA,sample,120368,119595,4755,114840,9272,105568,56951,4060,34147,3964,91098,6446,4817,3066,3526,5932
TGCTTCGCAGAAGTAA,sample,88768,88246,3524,84722,13108,71614,42936,3602,18250,2073,61186,4753,3559,2119,6431,9732
AGGTCGGAAGAAGTAA,sample,168291,166931,14537,152394,12533,139861,46398,3837,49709,5159,96107,34758,9672,2125,6709,7608
ATGACCGAAGAAGTAA,sample,26402,26294,1025,25269,2706,22563,11573,1064,6798,871,18371,2257,2633,1776,815,1786
Short,Non_sample,0,NA,NA,NA,NA,NA,NA,NA,NA,NA,NA,NA,NA,NA,NA,NA
Unselected,Non_sample,0,NA,NA,NA,NA,NA,NA,NA,NA,NA,NA,NA,NA,NA,NA,NA
Undetermined,Non_sample,140692075,NA,NA,NA,NA,NA,NA,NA,NA,NA,NA,NA,NA,NA,NA,NA
