Barcode,Sample,Barcoded_Reads,Trimmed_Reads,Unmapped_Reads,Mapped_Reads,Multimapped_Reads,Uniquely_Mapped_Reads,Exon_Reads,Ambiguous_Exon_Reads,Intron_Reads,Ambiguous_Intron_Reads,Gene_Reads,Intergenic_Reads,No_of_Genes,No_of_Transcripts,Mitochondrial_Reads,Ribosomal_Reads
AACCGGTTCGTTGGTT,sample,82997,82541,1782,80759,17631,63128,48648,4507,7238,779,55886,1956,1976,1677,11136,12063
AGCTGAATCGTTGGTT,sample,187893,186760,8379,178381,25179,153202,106157,7976,22701,2160,128858,14208,5438,2203,27019,18675
CATAATGGCGTTGGTT,sample,117223,116561,6690,109871,19508,90363,54107,4043,18264,1827,72371,12122,5839,1763,14956,13084
CTAGCGACCGTTGGTT,sample,125052,123935,5213,118722,14659,104063,76303,7900,11537,1411,87840,6912,3389,1443,12635,10812
ATTCAAGGCGTTGGTT,sample,67953,67528,5134,62394,7773,54621,28927,2079,13764,1386,42691,8465,5271,1963,9331,4921
ATACGTTCCGTTGGTT,sample,145494,144610,5841,138769,15676,123093,75349,4881,28217,3365,103566,11281,4504,1930,20428,11447
CCGCAGTCCGTTGGTT,sample,96541,95930,3555,92375,14388,77987,50590,3061,16272,2026,66862,6038,3343,1609,13919,10567
ATGGCGTTCGTTGGTT,sample,68098,67622,3237,64385,8968,55417,30615,2549,14821,1412,45436,6020,3309,1644,7900,6594
AGCGTCTTCGTTGGTT,sample,91223,90686,3517,87169,14987,72182,54712,3995,7830,1006,62542,4639,2900,1645,14252,11534
GCCTATTCCGTTGGTT,sample,237,230,9,221,37,184,129,18,25,2,154,10,84,54,29,25
TGCGCTCCCGTTGGTT,sample,206,203,8,195,15,180,112,12,31,1,143,24,72,45,34,13
GTCGCGAACGTTGGTT,sample,160,157,6,151,25,126,89,5,19,4,108,9,61,41,13,19
CGCGGTCGCGTTGGTT,sample,154,152,10,142,19,123,83,6,24,1,107,9,51,33,25,7
AAGTAGAGCGTTGGTT,sample,208,202,32,170,17,153,85,10,23,6,108,29,71,44,25,11
GCGCAATACGTTGGTT,sample,197,196,19,177,16,161,102,2,36,2,138,19,70,43,21,16
AACCGGTTCTATCGTT,sample,161042,160277,3045,157232,26410,130822,113182,7892,6379,839,119561,2530,2517,2558,26642,19714
GTCGTTCTCTATCGTT,sample,107632,106755,10239,96516,8956,87560,35662,2451,26094,3006,61756,20347,7372,2058,6149,4964
AGAGTTCTCTATCGTT,sample,71625,71154,2811,68343,9974,58369,39848,3055,10119,962,49967,4385,2875,1714,10682,7039
AGCTGAATCTATCGTT,sample,123848,122286,4505,117781,12570,105211,69105,5471,20927,2777,90032,6931,3428,2028,14577,8606
GGAGAAGCCTATCGTT,sample,86263,85793,2486,83307,18517,64790,53718,3108,5003,642,58721,2319,2581,1866,17568,13197
CTAGCGACCTATCGTT,sample,128514,127767,4269,123498,20592,102906,83957,5920,7744,687,91701,4598,3573,2690,19690,14520
CCGCAGTCCTATCGTT,sample,94834,94148,2823,91325,18400,72925,58794,4471,5591,802,64385,3267,2643,1981,16117,12915
CCATTCTTCTATCGTT,sample,40617,40173,2383,37790,4520,33270,22012,1209,6044,797,28056,3208,2357,1011,8700,3240
CCTAGCGGCTATCGTT,sample,66955,66553,3034,63519,11628,51891,40928,3036,4885,393,45813,2649,2361,1427,12515,7996
TGCGCTCCCTATCGTT,sample,297,265,24,241,39,202,134,13,23,1,157,31,89,62,28,28
GTCGCGAACTATCGTT,sample,168,165,9,156,19,137,107,4,18,3,125,5,55,44,35,9
CAGCTTCGCTATCGTT,sample,204,198,11,187,30,157,104,15,25,4,129,9,66,40,39,19
CGCGGTCGCTATCGTT,sample,130,125,11,114,13,101,76,5,14,0,90,6,51,31,19,10
AAGTAGAGCTATCGTT,sample,184,178,10,168,16,152,104,4,27,5,131,12,74,34,25,15
ATTCTACCCTATCGTT,sample,113,108,10,98,12,86,63,6,9,1,72,7,47,35,16,9
CTGGTCTTGTCTTCTT,Pos_Ctrl,7118,7085,287,6798,414,6384,5313,604,328,35,5641,104,1739,1655,348,185
AGCTGAATGTCTTCTT,sample,97572,96834,2664,94170,20876,73294,61115,5113,4427,486,65542,2153,2280,2104,13545,14321
GACGTATGGTCTTCTT,sample,78804,78162,2834,75328,12187,63141,40476,3130,13275,1527,53751,4733,3039,1578,10863,8656
TATACGGAGTCTTCTT,Pos_Ctrl,35717,35533,1611,33922,1879,32043,26825,2818,1639,230,28464,531,4632,5115,2176,865
CATACTCCGTCTTCTT,sample,65925,65369,2109,63260,11015,52245,36046,2889,8782,967,44828,3561,2968,1776,5462,8014
GCAACTAGGTCTTCTT,sample,28215,27978,807,27171,4007,23164,16197,1199,4043,651,20240,1074,1784,1559,4175,2904
GACTCAAGGTCTTCTT,sample,74826,74358,2879,71479,12306,59173,44847,2608,7734,819,52581,3165,2998,1855,12219,8881
CCGTACGCGTCTTCTT,sample,42952,42577,2833,39744,6249,33495,23861,1608,4145,471,28006,3410,2801,1560,8270,4709
GATGCGTTGTCTTCTT,sample,119475,118661,2596,116065,18259,97806,79703,6344,7224,695,86927,3840,2231,1617,20070,13790
ATGGCGTTGTCTTCTT,sample,83942,83159,4713,78446,8807,69639,39621,2791,17705,1736,57326,7786,3605,1492,6430,6058
TGCGCGTTGTCTTCTT,sample,36445,36114,3383,32731,4098,28633,14513,911,6942,694,21455,5573,3303,1018,4418,2757
CCATTCTTGTCTTCTT,sample,37696,37325,3477,33848,4087,29761,16140,862,6842,633,22982,5284,3534,1428,4799,2392
CGGTTGGTGTCTTCTT,sample,65320,64751,2941,61810,9987,51823,37120,2607,7522,956,44642,3618,3369,2306,8876,7006
ACGCTTAAGTCTTCTT,sample,82378,81793,3189,78604,9234,69370,48992,3224,11339,989,60331,4826,3073,1799,13003,6548
CATTCGGTGTCTTCTT,sample,61014,60526,2582,57944,8396,49548,35333,2196,6920,880,42253,4219,2819,1465,6763,5871
GCTCTTCTGTCTTCTT,sample,72673,71947,4146,67801,10766,57035,39657,2922,8358,1138,48015,4960,3510,1691,10477,7254
CTAAGCATGTCTTCTT,sample,34012,33735,1578,32157,3304,28853,18330,1231,6363,840,24693,2089,2151,1169,3256,2337
GGCGACGAGTCTTCTT,sample,65166,64603,3904,60699,7430,53269,34988,2137,10224,1063,45212,4857,3329,1562,9086,5252
AGCAGAGCGTCTTCTT,sample,68779,68230,3420,64810,8202,56608,41391,2816,7490,579,48881,4332,2911,1350,11295,5451
GACTAACCGTCTTCTT,sample,186,181,15,166,19,147,97,7,34,1,131,8,72,46,17,12
CGCGAGACGTCTTCTT,sample,232,232,12,220,22,198,132,12,25,1,157,28,78,63,30,14
CCTAACTAGTCTTCTT,Pos_Ctrl,255,254,19,235,16,219,125,7,39,14,164,34,88,57,21,12
ATATGCAAGTCTTCTT,sample,83,79,3,76,5,71,53,3,7,0,60,8,29,21,10,5
CTGGTCTTTAGGCTCT,sample,191030,179348,13716,165632,23674,141958,92570,6166,28361,3470,120931,11391,4947,1797,32727,15516
AGCTGAATTAGGCTCT,sample,132433,131633,5942,125691,22959,102732,63862,4618,17877,2062,81739,14313,5893,2085,18084,15430
GACGTATGTAGGCTCT,sample,160788,160059,4757,155302,20093,135209,89746,6900,27871,3210,117617,7482,4255,2809,18801,14778
GAGCCTCCTAGGCTCT,sample,235178,233629,6431,227198,30124,197074,162693,11136,13351,1523,176044,8371,4397,2798,32795,21756
GGTAGAGATAGGCTCT,sample,77066,76634,1708,74926,16947,57979,45822,4759,4969,616,50791,1813,2571,2611,9193,11503
TACGCGAGTAGGCTCT,sample,91509,90713,3378,87335,11662,75673,59546,3975,7890,970,67436,3292,3213,2393,15197,8656
ACGCTTAATAGGCTCT,sample,94013,93187,2950,90237,8613,81624,55187,3521,16233,2398,71420,4285,3206,2190,12742,6056
GCTCTTCTTAGGCTCT,sample,107517,106644,3068,103576,17840,85736,66045,4799,10247,1355,76292,3290,2600,1974,17580,12568
GAGATTCTTAGGCTCT,sample,106323,105529,2982,102547,20637,81910,68579,4587,5440,631,74019,2673,2633,1910,20923,14981
CCTAGCGGTAGGCTCT,sample,71427,70701,4498,66203,7975,58228,37992,2369,9811,1139,47803,6917,3909,1699,7855,5333
GGCGACGATAGGCTCT,sample,56678,55926,5899,50027,6035,43992,17166,1030,14893,1758,32059,9145,4691,1290,4545,3853
AGCAGAGCTAGGCTCT,sample,143956,142275,15206,127069,10257,116812,47220,3761,35562,4273,82782,25996,8659,2004,11678,5910
ATACCGCCTAGGCTCT,sample,128555,127384,5201,122183,18508,103675,79258,6014,10705,1201,89963,6497,3368,1872,19963,13861
GTCGCGAATAGGCTCT,sample,142156,141066,6813,134253,19967,114286,78259,5210,17443,2229,95702,11145,4699,1820,22607,13931
CGTCGAGGTAGGCTCT,sample,45015,44725,1405,43320,8613,34707,27987,2071,3043,398,31030,1208,2167,1921,5355,6174
CAGCTTCGTAGGCTCT,sample,84096,83572,2164,81408,12671,68737,51540,4260,8281,1044,59821,3612,3576,2729,9262,8612
TTATGACGTAGGCTCT,sample,43409,43052,1702,41350,5363,35987,24977,1744,5861,726,30838,2679,2406,1358,6745,3537
AAGTAGAGTAGGCTCT,sample,108743,107875,7238,100637,7641,92996,45984,3588,28081,3120,74065,12223,5976,2077,8668,4417
TCAATCAGTAGGCTCT,sample,74207,73652,2697,70955,8739,62216,44240,5020,8081,941,52321,3934,2838,1564,9753,6109
CGCGAGACTAGGCTCT,sample,514,502,34,468,60,408,286,27,62,4,348,29,158,115,77,39
GCGCAATATAGGCTCT,sample,353,343,41,302,51,251,165,11,45,3,210,27,121,72,40,26
TTAACTGATAGGCTCT,sample,175,174,12,162,22,140,94,8,20,3,114,15,68,43,25,15
ATATGCAATAGGCTCT,sample,151,147,14,133,14,119,81,5,19,3,100,11,54,29,22,7
TCTAGGTTTTGACTAT,sample,107509,105340,7514,97826,9712,88114,46776,3241,24282,2807,71058,11008,5115,2043,10373,6088
GTCGTTCTTTGACTAT,Neg_Ctrl,973,501,229,272,43,229,151,5,32,12,183,29,94,53,43,18
AGAGTTCTTTGACTAT,sample,122894,121770,4522,117248,20384,96864,75812,4535,9871,1186,85683,5460,3273,2181,19514,15023
AGCTGAATTTGACTAT,sample,173922,172772,6788,165984,27968,138016,107381,7498,14480,1731,121861,6926,3228,1941,30041,19888
CATAATGGTTGACTAT,sample,127388,126169,7241,118928,14513,104415,70274,4440,18390,2175,88664,9136,4462,1873,20464,10514
TATACGGATTGACTAT,sample,116573,115785,3275,112510,29714,82796,68827,4506,5420,581,74247,3462,1926,1458,25557,20740
GGAGAAGCTTGACTAT,Neg_Ctrl,1133,692,380,312,47,265,180,21,35,0,215,29,111,77,35,24
TCATCGAATTGACTAT,sample,51022,50652,2602,48050,6221,41829,26960,1921,8480,731,35440,3737,3042,1704,7871,4492
TGATTCCGTTGACTAT,Pos_Ctrl,27253,26906,2186,24720,1301,23419,19501,1694,1631,183,21132,410,4170,4017,1507,625
GCAACTAGTTGACTAT,sample,20259,20013,755,19258,3094,16164,12057,690,2059,370,14116,988,1746,1398,3722,2269
TACGCGAGTTGACTAT,sample,75366,74764,3817,70947,7954,62993,39619,2461,13700,1448,53319,5765,3129,1582,10791,5530
CCGTACGCTTGACTAT,sample,141212,140020,5348,134672,12654,122018,96073,5701,12890,1336,108963,6018,3909,2818,15532,9236
ATGGCGTTTTGACTAT,Pos_Ctrl,35115,34630,2789,31841,1584,30257,25103,2279,1977,247,27080,651,4598,4687,1783,759
CCATTCTTTTGACTAT,sample,82913,81964,5932,76032,8408,67624,37312,2069,18182,1902,55494,8159,4078,1544,11608,5700
CCTAGCGGTTGACTAT,Pos_Ctrl,16076,15885,1352,14533,780,13753,11427,1094,874,127,12301,231,3086,2740,917,445
GGCGACGATTGACTAT,sample,75529,74892,4552,70340,7518,62822,44586,2659,8709,1010,53295,5858,3894,2058,7450,5584
GCTGCTTCTTGACTAT,sample,67560,66749,4575,62174,6919,55255,33177,2140,12492,1306,45669,6140,3326,1238,7892,4276
GCCTATTCTTGACTAT,sample,77859,77135,4509,72626,9786,62840,43415,4151,8045,907,51460,6322,3431,1465,10872,7050
CGTCGAGGTTGACTAT,Pos_Ctrl,29085,28630,2030,26600,1270,25330,20940,2087,1572,190,22512,541,4220,4390,1333,585
CGCGGTCGTTGACTAT,sample,81857,81193,2943,78250,11751,66499,53630,3941,5489,598,59119,2841,2111,1420,12261,8857
TCAATCAGTTGACTAT,sample,62405,61861,2698,59163,6003,53160,36704,2719,9246,950,45950,3541,2449,1442,7124,3848
GACTAACCTTGACTAT,sample,81677,80918,4444,76474,7526,68948,45094,3738,11028,1346,56122,7742,4284,1773,6202,5474
CGTAGAACTTGACTAT,sample,5588,5433,742,4691,514,4177,1423,111,1451,156,2874,1036,1142,345,415,233
AGATACTATTGACTAT,sample,934,915,45,870,116,754,577,40,89,2,666,46,273,217,110,90
CCTAACTATTGACTAT,sample,486,475,26,449,74,375,247,21,66,20,313,21,146,93,51,54
GCGCAATATTGACTAT,Neg_Ctrl,366,365,24,341,47,294,188,18,62,9,250,17,124,79,41,32
GACGTATGTGCAGTTG,sample,84611,83228,2124,81104,15723,65381,57734,3795,2735,401,60469,716,1737,2015,14458,11023
ATTCAAGGTGCAGTTG,sample,48254,47791,3181,44610,6723,37887,21653,1299,9349,1100,31002,4486,3060,1140,8215,4523
GACTCAAGTGCAGTTG,sample,26146,25902,2016,23886,2219,21667,10746,610,6721,751,17467,2839,2628,1157,2862,1417
CCGCAGTCTGCAGTTG,sample,85519,84665,4600,80065,9887,70178,44088,3095,14332,1148,58420,7515,3948,1697,11799,6477
TGGATCAATGCAGTTG,sample,36115,35777,3086,32691,3620,29071,15658,1065,6868,869,22526,4611,3216,1199,4420,2363
TGCGCGTTTGCAGTTG,sample,33723,33524,970,32554,5211,27343,19657,1766,3961,610,23618,1349,1970,1603,4130,3694
ACGCTTAATGCAGTTG,sample,51595,50608,5066,45542,5913,39629,25763,1989,7040,872,32803,3965,2980,1305,8245,3808
CCTAGCGGTGCAGTTG,sample,21193,20983,1256,19727,2535,17192,10458,804,3422,407,13880,2101,2346,1226,2658,1774
CTAACCGGTGCAGTTG,sample,48165,47703,1396,46307,7936,38371,30048,2205,4297,475,34345,1346,1809,1286,9195,5767
ATACCGCCTGCAGTTG,sample,26380,25916,1818,24098,3962,20136,10191,701,5867,639,16058,2738,2145,686,2879,2531
CGTCGAGGTGCAGTTG,sample,39446,39027,2268,36759,3640,33119,17036,1476,9917,1057,26953,3633,3520,1750,1407,2394
CGCGGTCGTGCAGTTG,sample,65901,65274,3862,61412,5948,55464,33308,2803,10957,1090,44265,7306,4141,1428,6897,4148
TCTCCTAGTGCAGTTG,sample,78789,78084,5161,72923,6851,66072,40072,3421,12431,1502,52503,8646,4521,1438,10061,4334
ATGAATAGTGCAGTTG,sample,88550,87877,2795,85082,10076,75006,52787,2662,13386,1600,66173,4571,2442,1163,12736,6968
AAGTAGAGTGCAGTTG,sample,81980,81251,3287,77964,7770,70194,53053,4073,7948,572,61001,4548,2933,1515,9849,5103
TAACGCCATGCAGTTG,sample,82513,81818,2476,79342,6798,72544,59748,4735,4603,745,64351,2713,2626,2241,9397,4896
AGATACTATGCAGTTG,sample,30317,30044,843,29201,4438,24763,18821,1625,2857,348,21678,1112,1463,1330,2995,3152
TCTAGGTTTCATGCTG,sample,18056,17928,1406,16522,2966,13556,5599,415,4320,482,9919,2740,2661,975,1484,1920
GGAGAAGCTCATGCTG,sample,41800,41379,1005,40374,9102,31272,26991,2275,1384,233,28375,389,1221,1333,7287,6435
TCGAACGATCATGCTG,sample,33738,33455,1084,32371,4684,27687,18973,1359,5215,606,24188,1534,1791,1220,5746,3397
GCAACTAGTCATGCTG,Neg_Ctrl,392,153,104,49,4,45,27,7,8,0,35,3,26,21,2,0
TGGATCAATCATGCTG,sample,33140,32913,1799,31114,4174,26940,17860,1228,4473,480,22333,2899,2508,1206,6239,2904
GGCAGGTTTCATGCTG,sample,48902,48480,2145,46335,6382,39953,29205,1750,5298,693,34503,3007,2389,1277,11327,4462
ATGGCGTTTCATGCTG,sample,62548,62054,4610,57444,7448,49996,27392,2107,11157,965,38549,8375,4428,1471,6505,5049
TGCGCGTTTCATGCTG,Neg_Ctrl,583,262,124,138,20,118,62,8,27,0,89,21,56,39,13,4
AGCGTCTTTCATGCTG,sample,84304,83489,4635,78854,7141,71713,49369,2835,10837,1007,60206,7665,4056,1756,11797,4761
CATTCGGTTCATGCTG,sample,52892,52489,2020,50469,5177,45292,34145,2492,5415,609,39560,2631,2800,2150,6654,3664
GCTCTTCTTCATGCTG,sample,69871,69291,3950,65341,8313,57028,41030,3103,7146,686,48176,5063,2998,1384,11148,6278
GAGATTCTTCATGCTG,sample,18156,17985,899,17086,2250,14836,10474,846,2138,235,12612,1143,1774,1277,2343,1565
CCTAGCGGTCATGCTG,sample,28811,28492,896,27596,3792,23804,19396,1361,1610,243,21006,1194,1401,1252,4574,2785
CTAACCGGTCATGCTG,Neg_Ctrl,482,228,111,117,12,105,76,5,10,7,86,7,42,31,27,5
TGCGCTCCTCATGCTG,sample,54010,53511,2494,51017,6758,44259,35678,2672,3454,298,39132,2157,1453,1056,8663,4806
ATACCGCCTCATGCTG,sample,24591,24335,816,23519,2480,21039,15490,969,2963,371,18453,1246,1613,1157,2675,1744
CAGCTTCGTCATGCTG,Neg_Ctrl,547,264,114,150,18,132,98,5,8,13,106,8,57,45,19,6
TCTCCTAGTCATGCTG,sample,39449,38863,5874,32989,3905,29084,10816,945,9219,940,20035,7164,4605,1156,2175,2320
AACCGGTTTTAGGCGG,sample,94597,94107,2521,91586,21786,69800,53354,4120,8902,1004,62256,2420,3146,2778,11260,15069
CTGGTCTTTTAGGCGG,Pos_Ctrl,37040,36727,1707,35020,1787,33233,27865,2741,1806,199,29671,622,4677,5118,2163,754
AGAGTTCTTTAGGCGG,sample,152708,151836,5218,146618,23195,123423,95544,7093,12451,1481,107995,6854,3998,1874,26499,16699
TATACGGATTAGGCGG,Pos_Ctrl,11266,11210,447,10763,631,10132,8476,959,489,79,8965,129,2474,2499,658,276
ATGGCGTTTTAGGCGG,sample,34716,34270,2647,31623,2512,29111,15878,917,7333,856,23211,4127,3124,1236,4354,1729
CATTCGGTTTAGGCGG,sample,15267,15089,1289,13800,1054,12746,5864,409,3977,470,9841,2026,2106,965,906,611
GCTCTTCTTTAGGCGG,sample,138200,136872,5814,131058,13569,117489,82572,6133,17835,2653,100407,8296,3199,1445,17299,11290
GAGATTCTTTAGGCGG,sample,131227,130232,7593,122639,11386,111253,66557,5592,22631,3369,89188,13104,5455,1823,11008,7876
AAGGTCTGTTAGGCGG,sample,75364,74611,2726,71885,6753,65132,44154,2574,12684,1699,56838,4021,2786,1772,9814,4950
CCTAGCGGTTAGGCGG,sample,54218,53604,1928,51676,7363,44313,33450,1826,5914,642,39364,2481,2198,1513,9182,5503
GGCGACGATTAGGCGG,sample,95029,94087,4801,89286,11515,77771,55343,3844,11054,1162,66397,6368,3763,1514,17401,8539
TAACGAAGTTAGGCGG,sample,101272,100468,3390,97078,16915,80163,62389,5408,7444,767,69833,4155,2933,1916,15718,12553
GCTGCTTCTTAGGCGG,sample,97361,96456,3160,93296,11420,81876,64767,5127,7712,779,72479,3491,2620,1686,15810,8048
GCGTTACCTTAGGCGG,sample,93364,92423,4363,88060,10245,77815,54674,3091,13113,1156,67787,5781,3435,1566,14685,7182
CGTCGAGGTTAGGCGG,sample,123496,122190,8870,113320,8421,104899,52291,3740,30274,3353,82565,15241,6157,1716,10012,5727
TTATGACGTTAGGCGG,sample,124630,123704,7350,116354,11797,104557,65824,4024,20133,2193,85957,12383,4749,1449,17026,7967
TCTCCTAGTTAGGCGG,sample,42627,41972,3836,38136,6576,31560,13420,988,9597,899,23017,6656,3940,967,3129,3869
ATTCTACCTTAGGCGG,sample,66761,66003,3826,62177,7240,54937,37837,3092,8221,803,46058,4984,3676,1536,9981,5004
CGTAGAACTTAGGCGG,sample,85545,84649,4374,80275,6904,73371,51260,3427,10615,1137,61875,6932,3762,1521,6600,4600
AGATACTATTAGGCGG,sample,67877,66912,6332,60580,4731,55849,28834,1921,15025,1579,43859,8490,4004,1284,4579,2965
AACCGGTTTCAGATAC,sample,43479,43205,1311,41894,8292,33602,24833,2534,3937,384,28770,1914,2008,1375,7567,5819
AGCTGAATTCAGATAC,sample,86642,86148,3871,82277,11276,71001,47480,3206,13064,1465,60544,5786,2668,1346,14842,7930
CATAATGGTCAGATAC,sample,38912,38691,1457,37234,4285,32949,23471,1740,5258,581,28729,1899,2694,2007,5566,2958
GGTAGAGATCAGATAC,sample,104426,103774,2636,101138,18991,82147,70505,4829,4495,375,75000,1943,1614,1530,17753,14704
TCATACCATCAGATAC,sample,82079,81564,2587,78977,12402,66575,53390,4321,5241,770,58631,2853,2391,1567,14542,9427
TACGCGAGTCAGATAC,sample,93053,92431,3537,88894,9913,78981,58203,5315,9730,1080,67933,4653,2846,2002,10724,7392
GATGCGTTTCAGATAC,sample,26956,26726,814,25912,3287,22625,17562,1296,2110,250,19672,1407,1350,1020,5666,2443
AGCGTCTTTCAGATAC,sample,61247,60794,2520,58274,5129,53145,41931,2735,4763,484,46694,3232,2057,1126,8816,3900
CGGTTGGTTCAGATAC,sample,77404,76698,3992,72706,5508,67198,49335,4352,7145,718,56480,5648,2999,1290,8958,3548
GCTCTTCTTCAGATAC,sample,68137,67618,2133,65485,6306,59179,44875,3748,6675,612,51550,3269,2467,1453,8408,4959
CGTCGAGGTCAGATAC,sample,34807,34420,2694,31726,3383,28343,18288,1358,4922,619,23210,3156,2905,1517,4152,2063
CAGCTTCGTCAGATAC,sample,82683,82028,2827,79201,6840,72361,53698,4151,9367,1414,63065,3731,2322,1634,10250,4971
TTATGACGTCAGATAC,sample,90822,90015,5403,84612,7565,77047,50815,4056,13758,1582,64573,6836,3872,1604,8866,5308
ATTCTACCTCAGATAC,sample,57321,56645,5914,50731,4404,46327,21590,1667,12575,1187,34165,9308,4456,1016,5596,2473
GACTAACCTCAGATAC,sample,18976,18742,1914,16828,2082,14746,8345,717,3424,443,11769,1817,2499,1412,1206,1305
CCTAACTATCAGATAC,sample,78223,77507,4501,73006,6132,66874,48564,3027,7681,1523,56245,6079,3153,1295,9453,4159
ATATGCAATCAGATAC,sample,93,89,8,81,9,72,55,0,10,1,65,6,35,30,20,7
AACCGGTTTCGCTAGG,sample,75864,75188,4103,71085,9988,61097,41307,2583,9334,968,50641,6905,3400,1323,14376,7130
CTGGTCTTTCGCTAGG,sample,77695,77028,5419,71609,6387,65222,37294,2374,14877,1702,52171,8975,4582,2091,8448,3932
GTCGTTCTTCGCTAGG,Neg_Ctrl,641,295,158,137,23,114,81,3,15,0,96,15,51,38,20,4
GGAGAAGCTCGCTAGG,Neg_Ctrl,730,365,218,147,30,117,88,3,15,3,103,8,49,32,31,7
CATACTCCTCGCTAGG,sample,54365,53864,2741,51123,8162,42961,29925,1890,6404,658,36329,4084,3067,1739,5767,5791
TGATTCCGTCGCTAGG,sample,43441,42931,1836,41095,4920,36175,24848,1796,6006,777,30854,2748,2510,1306,3931,3418
GCAACTAGTCGCTAGG,sample,19103,18842,1550,17292,1897,15395,7131,478,4389,544,11520,2853,2695,1069,1509,1223
TACGCGAGTCGCTAGG,sample,75184,74687,2926,71761,9578,62183,45742,3624,8321,816,54063,3680,2837,1699,11947,7294
GGCAGGTTTCGCTAGG,sample,21946,21757,578,21179,2605,18574,16545,1058,753,42,17298,176,773,928,4282,1996
CGGTTGGTTCGCTAGG,sample,37328,36917,3065,33852,3492,30360,14086,725,8898,1007,22984,5644,2607,698,1722,2018
ACGCTTAATCGCTAGG,sample,38388,37948,3179,34769,3283,31486,18030,925,6592,720,24622,5219,2962,902,4036,2062
CATTCGGTTCGCTAGG,sample,24784,24480,1761,22719,5293,17426,9331,869,4169,415,13500,2642,1964,734,1651,3293
CCTAGCGGTCGCTAGG,sample,34774,34371,1932,32439,3053,29386,20782,1677,3961,362,24743,2604,2626,1714,3528,2074
GCTGCTTCTCGCTAGG,sample,62549,61964,1972,59992,9867,50125,42466,3795,2516,539,44982,809,889,1085,9965,7388
CGTCGAGGTCGCTAGG,sample,32300,31879,1836,30043,2570,27473,16643,1005,5532,518,22175,3775,2717,1042,3338,1662
AAGTAGAGTCGCTAGG,sample,68465,67922,2619,65303,5754,59549,48150,3425,4892,770,53042,2312,3269,3026,8458,4370
ATTCTACCTCGCTAGG,Pos_Ctrl,21413,20984,1640,19344,876,18468,15230,1323,1208,200,16438,507,3708,3492,932,470
CGTAGAACTCGCTAGG,sample,46998,46517,2927,43590,6524,37066,23453,1947,6634,875,30087,4157,2727,1291,4879,4481
GCGCAATATCGCTAGG,sample,59481,59000,2990,56010,5809,50201,32364,2530,9226,1072,41590,5009,3084,1561,7701,3965
TTAACTGATCGCTAGG,sample,9956,9808,478,9330,1350,7980,5558,459,1147,154,6705,662,1012,733,1261,852
ATATGCAATCGCTAGG,sample,73,73,2,71,3,68,48,5,8,2,56,5,28,19,14,4
AACCGGTTCCGTTGCG,sample,139064,137874,6977,130897,14842,116055,71955,4340,25781,2910,97736,11069,4563,1758,23149,9899
TCTAGGTTCCGTTGCG,sample,128149,127250,6454,120796,16975,103821,73231,5502,14712,1678,87943,8698,4262,1622,24336,13112
GTCGTTCTCCGTTGCG,sample,118267,117579,3280,114299,23744,90555,73520,5383,7310,1115,80830,3227,2922,2245,19192,16761
CATAATGGCCGTTGCG,sample,47149,46760,2249,44511,9309,35202,26535,1564,4321,474,30856,2308,3293,2459,6202,6459
GGAGAAGCCCGTTGCG,sample,129033,128009,11590,116419,10030,106389,45913,2789,36793,4832,82706,16062,7292,2144,8611,6010
CATACTCCCCGTTGCG,sample,43225,42872,2951,39921,5776,34145,21667,1582,6381,680,28048,3835,3234,1557,6405,4035
TCGAACGACCGTTGCG,sample,105676,104931,4369,100562,12633,87929,62508,4278,12850,1568,75358,6725,4077,1881,18008,9065
GGTAGAGACCGTTGCG,sample,43182,42736,4466,38270,3823,34447,11910,829,12851,1260,24761,7597,3939,985,1604,2369
ATTCAAGGCCGTTGCG,sample,81959,81355,5172,76183,9657,66526,41892,2896,12845,1464,54737,7429,4282,1796,11224,6739
TGATTCCGCCGTTGCG,sample,87104,86579,2997,83582,13660,69922,57878,3816,5012,366,62890,2850,2441,1876,13802,10271
GCTCTTCTCCGTTGCG,sample,113184,112459,4983,107476,13928,93548,66553,5191,12618,1246,79171,7940,4441,2281,17705,9916
GAGATTCTCCGTTGCG,sample,60620,60127,4273,55854,5145,50709,27791,2065,12719,1495,40510,6639,4380,2022,6048,3402
AAGGTCTGCCGTTGCG,sample,74311,73893,3376,70517,8592,61925,38167,2720,13174,1966,51341,5898,3436,1634,11650,6192
GCCTATTCCCGTTGCG,sample,122610,121777,4572,117205,9802,107403,71655,5875,19619,3117,91274,7137,3105,1844,10206,7571
GCGTTACCCCGTTGCG,sample,89268,88619,4249,84370,7248,77122,57920,4741,7979,881,65899,5601,4008,2350,14581,4727
GGCGTACCCCGTTGCG,sample,115612,114840,3387,111453,10016,101437,83202,6246,7025,682,90227,4282,2886,2138,14339,6796
GTCGCGAACCGTTGCG,sample,91406,90614,4893,85721,6504,79217,43734,2927,22235,2433,65969,7888,4343,1740,7595,4356
CGTCGAGGCCGTTGCG,sample,73259,72559,5345,67214,6463,60751,34091,2119,14789,2053,48880,7699,4336,1378,9595,4258
CAGCTTCGCCGTTGCG,sample,103915,103185,2685,100500,13467,87033,73828,5343,5769,537,79597,1556,2091,2012,13333,9730
CGCGGTCGCCGTTGCG,sample,67876,67194,3558,63636,6090,57546,43336,2884,6970,659,50306,3697,2689,1332,8710,4166
ATGAATAGCCGTTGCG,sample,96379,95528,5150,90378,7949,82429,57762,4949,11612,1516,69374,6590,3883,1861,12292,5316
TAACGCCACCGTTGCG,sample,72921,72233,3888,68345,6757,61588,39613,2141,12946,1663,52559,5225,3158,1315,9597,3972
GCGCAATACCGTTGCG,sample,112015,111125,5171,105954,11957,93997,68203,5780,11515,976,79718,7523,4212,1869,12268,8995
CTGGTCTTAGGCCAAG,sample,99721,99263,1865,97398,19329,78069,64733,5651,5366,703,70099,1616,2003,1994,16270,12967
TATACGGAAGGCCAAG,sample,65287,64963,3041,61922,11161,50761,35391,2536,8215,978,43606,3641,2979,1491,10550,7928
GGAGAAGCAGGCCAAG,sample,82048,81571,2823,78748,13238,65510,47257,3857,9283,948,56540,4165,3286,1986,11116,9734
CTAGCGACAGGCCAAG,sample,122083,121287,5561,115726,16397,99329,63230,3919,20070,2086,83300,10024,4646,1768,17852,11422
GGTAGAGAAGGCCAAG,sample,156916,156044,6749,149295,22948,126347,88128,6935,18511,2608,106639,10165,4638,1941,23675,16172
TCATCGAAAGGCCAAG,sample,130065,129365,4365,125000,18710,106290,86208,5812,8096,1359,94304,4815,3107,2085,20868,13892
ATTCAAGGAGGCCAAG,sample,102103,101355,5814,95541,14733,80808,56888,2612,11538,981,68426,8789,4251,1648,17701,10537
ATACGTTCAGGCCAAG,sample,46700,46320,2393,43927,6157,37770,25001,1705,7645,880,32646,2539,3032,1870,6328,4687
CCGCAGTCAGGCCAAG,sample,13340,13122,2040,11082,1241,9841,4251,174,2744,314,6995,2358,2021,699,1520,680
CCATTCTTAGGCCAAG,sample,167564,164952,11604,153348,30335,123013,102468,8766,7525,559,109993,3695,1926,1579,29423,20530
CTAACCGGAGGCCAAG,sample,96784,96131,3349,92782,10346,82436,59792,4191,13309,1438,73101,3706,2771,2169,14574,7699
GGCGACGAAGGCCAAG,sample,66694,66140,2628,63512,9622,53890,44102,2884,3941,597,48043,2366,2754,2333,10670,6881
TGCGCTCCAGGCCAAG,sample,108784,107907,5730,102177,12258,89919,60412,4587,15415,1568,75827,7937,4122,1668,12277,8641
ATACCGCCAGGCCAAG,sample,63585,62950,2160,60790,7944,52846,44672,2973,3266,387,47938,1548,1836,1380,9385,6177
GCGTTACCAGGCCAAG,sample,90503,89688,4548,85140,7407,77733,53539,3069,12776,1474,66315,6875,3870,1886,8464,4562
GGCGTACCAGGCCAAG,sample,110318,109256,7218,102038,9535,92503,56605,4761,16756,1670,73361,12711,5695,1695,12682,6040
GTCGCGAAAGGCCAAG,sample,88534,87654,3735,83919,8580,75339,53760,3320,10627,1064,64387,6568,3615,1492,7238,5929
CAGCTTCGAGGCCAAG,sample,90857,88954,10173,78781,9206,69575,52000,3076,8618,920,60618,4961,3378,1648,12437,5955
CGCGGTCGAGGCCAAG,sample,72732,71854,2808,69046,6169,62877,51203,2561,5569,731,56772,2813,2696,1871,8299,4281
TTATGACGAGGCCAAG,sample,59076,58329,6024,52305,5124,47181,26096,1259,10744,1054,36840,8028,4040,1189,7185,3208
AAGTAGAGAGGCCAAG,sample,58974,58432,2984,55448,6898,48550,33530,2519,7629,872,41159,4000,3478,1963,8123,4888
TCAATCAGAGGCCAAG,sample,87214,86319,6840,79479,7488,71991,41822,2641,15172,1612,56994,10744,4888,1739,9340,4758
ATTCTACCAGGCCAAG,sample,88558,87685,3751,83934,10618,73316,53148,3403,10727,1145,63875,4893,2842,1536,14072,7368
GACTAACCAGGCCAAG,Neg_Ctrl,1185,686,405,281,44,237,153,10,48,4,201,22,106,69,31,48
AGATACTAAGGCCAAG,sample,129757,128734,5581,123153,12238,110915,86231,4471,13074,823,99305,6316,2481,1508,17422,9915
ATATGCAAAGGCCAAG,sample,1699,1611,95,1516,181,1335,998,56,167,11,1165,103,374,308,242,114
TCTAGGTTAGAACCGC,sample,140756,140111,5043,135068,26581,108487,80236,5565,14286,2072,94522,6328,3287,1845,23136,18952
AGAGTTCTAGAACCGC,sample,133944,133162,4301,128861,26624,102237,84727,6186,6481,1042,91208,3801,2042,1437,27993,18474
TATACGGAAGAACCGC,sample,182474,181584,6182,175402,34769,140633,107040,8320,15901,1491,122941,7881,3652,1977,28140,24174
CGTCGCCAAGAACCGC,sample,53082,52812,2113,50699,9464,41235,29783,2333,5603,493,35386,3023,2689,1560,7909,6581
TGGATCAAAGAACCGC,sample,82002,81488,3280,78208,12633,65575,50556,3692,7259,897,57815,3171,3199,2477,10916,9121
ATGGCGTTAGAACCGC,sample,87984,87293,7147,80146,12621,67525,38216,1944,14408,1427,52624,11530,4780,1268,12896,8440
TGCGCGTTAGAACCGC,sample,121564,120797,3903,116894,16481,100413,82538,6104,7693,964,90231,3114,2854,2380,21111,12501
CCATTCTTAGAACCGC,sample,82148,81538,5618,75920,7718,68202,39284,2285,16191,1834,55475,8608,5107,2553,7038,4978
ACGCTTAAAGAACCGC,sample,93631,92892,4765,88127,9895,78232,54104,3173,13097,1648,67201,6210,3670,1815,15338,6853
CATTCGGTAGAACCGC,sample,83419,82838,3100,79738,10783,68955,51193,3719,9110,1235,60303,3698,2987,2100,12664,7826
CTAAGCATAGAACCGC,sample,109835,108979,4823,104156,12080,92076,69726,3299,11164,1220,80890,6667,3483,1964,16982,8728
GGCGACGAAGAACCGC,sample,21630,21344,3693,17651,1783,15868,5951,451,5378,591,11329,3497,3101,938,2018,1023
TGCGCTCCAGAACCGC,sample,83270,82474,4131,78343,11862,66481,50857,3133,8040,763,58897,3688,2764,1349,12621,8802
GGCGTACCAGAACCGC,sample,81507,79924,8247,71677,7722,63955,46473,4019,7285,1480,53758,4698,2945,1683,8634,4892
CGTCGAGGAGAACCGC,sample,98707,97780,5071,92709,10331,82378,56993,2780,13777,1310,70770,7518,3894,1715,13414,6730
ATGAATAGAGAACCGC,sample,79957,79236,4223,75013,7170,67843,46586,3395,10268,1808,56854,5786,3766,1782,10154,4959
AAGTAGAGAGAACCGC,sample,82267,81462,4859,76603,7999,68604,44896,3387,12101,1222,56997,6998,3837,1555,9574,5618
TAACGCCAAGAACCGC,sample,73283,72698,1782,70916,9166,61750,53340,4529,2944,196,56284,741,974,1223,12479,7181
CGTAGAACAGAACCGC,sample,102633,101889,3214,98675,11790,86885,70187,4444,7174,694,77361,4386,2418,1367,17183,9383
AGATACTAAGAACCGC,sample,169310,168031,7531,160500,13190,147310,101084,7156,28026,2713,129110,8331,2888,1948,17580,9516
GCGCAATAAGAACCGC,sample,103675,102513,8335,94178,7661,86517,50339,3108,19463,2452,69802,11155,5492,1699,8980,4723
ATATGCAAAGAACCGC,sample,51640,51276,2873,48403,6145,42258,23506,1942,10630,1271,34136,4909,3736,1574,4808,4301
TCTAGGTTCATCAAGC,sample,38195,37945,1806,36139,7357,28782,19848,1596,4458,452,24306,2428,2419,1321,6118,4976
GTCGTTCTCATCAAGC,sample,79265,78824,2875,75949,13297,62652,50836,3219,5164,697,56000,2736,2542,1844,13384,9122
GAGCCTCCCATCAAGC,sample,89567,88943,5813,83130,15080,68050,46777,2802,9970,945,56747,7556,4238,1647,14060,10826
CGTCGCCACATCAAGC,sample,43767,43301,5790,37511,4701,32810,15546,878,8983,1073,24529,6330,4633,1540,4877,2979
TCATCGAACATCAAGC,sample,69425,68899,4975,63924,7054,56870,31220,2208,14031,1695,45251,7716,4308,1701,8650,4748
GCAACTAGCATCAAGC,sample,9745,9616,579,9037,1574,7463,5338,321,1036,127,6374,641,1195,832,2211,1050
CCGCAGTCCATCAAGC,sample,53266,52797,3291,49506,7678,41828,28114,1461,7220,751,35334,4282,3006,1304,9689,5634
GGCAGGTTCATCAAGC,sample,30651,30219,1979,28240,2324,25916,15657,1186,5789,662,21446,2622,2155,1141,3957,1567
CGGTTGGTCATCAAGC,sample,77239,76771,2264,74507,12637,61870,53437,3141,3355,333,56792,1604,1882,1577,17402,8760
TGCGCTCCCATCAAGC,sample,99370,98497,5838,92659,13017,79642,57162,4181,9696,946,66858,7657,3412,1343,12647,8983
CGTCGAGGCATCAAGC,Pos_Ctrl,27844,27184,2232,24952,1119,23833,19769,1794,1597,245,21366,428,4124,4107,1173,474
CAGCTTCGCATCAAGC,sample,93842,93029,3111,89918,9528,80390,66730,4680,5481,849,72211,2650,1787,1455,15587,6776
TCTCCTAGCATCAAGC,sample,90256,89208,7064,82144,6759,75385,43668,3106,15677,1625,59345,11309,5002,1440,9481,4500
CGCGAGACCATCAAGC,sample,64048,63468,2384,61084,5412,55672,46167,3109,3938,414,50105,2044,2345,1786,9352,3730
AGATACTACATCAAGC,sample,103163,102369,4080,98289,10442,87847,63184,4449,12670,1699,75854,5845,3598,2093,11149,7370
GCGCAATACATCAAGC,sample,60119,59490,2538,56952,6876,50076,34809,2252,8276,1079,43085,3660,2603,1229,8784,4887
TCTAGGTTAGAGAGCC,sample,88869,88382,3805,84577,10658,73919,52228,3138,11523,1329,63751,5701,3482,1774,13266,7310
CTGGTCTTAGAGAGCC,sample,37409,37100,2080,35020,5314,29706,20025,1708,4642,671,24667,2660,2310,1139,6280,3517
CATAATGGAGAGAGCC,sample,54283,54004,1857,52147,10142,42005,33804,2101,4034,519,37838,1547,2511,2125,10363,7523
CTAGCGACAGAGAGCC,sample,62298,61820,2368,59452,8348,51104,36108,2322,8500,1227,44608,2947,2481,1511,12289,5825
GGTAGAGAAGAGAGCC,sample,27067,26759,2879,23880,3729,20151,11917,790,3860,363,15777,3221,2668,1110,3678,2438
TGATTCCGAGAGAGCC,sample,39992,39632,2174,37458,4972,32486,21527,1638,5818,910,27345,2593,2533,1523,6346,3177
GCAACTAGAGAGAGCC,sample,15213,14924,1655,13269,955,12314,4605,431,4800,626,9405,1852,2485,1130,425,507
CCGCAGTCAGAGAGCC,sample,21099,20876,1317,19559,3111,16448,10011,789,3495,396,13506,1757,1863,894,3583,2128
GATGCGTTAGAGAGCC,sample,33773,33497,1776,31721,3899,27822,21033,1226,3647,423,24680,1493,1859,1197,7512,2590
TAGCGAGTAGAGAGCC,sample,103398,102477,4521,97956,13241,84715,72156,5170,4312,725,76468,2352,2201,2052,17764,10225
GCTCTTCTAGAGAGCC,sample,99176,98176,4419,93757,13004,80753,62526,4643,9429,1118,71955,3037,2171,1531,17134,9375
GAGATTCTAGAGAGCC,sample,51427,50340,5708,44632,8975,35657,24231,1590,5867,650,30098,3319,2995,1846,6773,5669
GGCGACGAAGAGAGCC,sample,96443,95865,3601,92264,10966,81298,62092,3895,10178,1020,72270,4113,3213,2282,11620,8081
GCTGCTTCAGAGAGCC,sample,91454,90812,4787,86025,8873,77152,53887,3644,12667,1358,66554,5596,3497,1980,11877,5824
AAGTAGAGAGAGAGCC,sample,50079,49651,2581,47070,4590,42480,28375,2272,7076,736,35451,4021,2595,1324,6017,3105
CGCGAGACAGAGAGCC,sample,29089,28767,1537,27230,2199,25031,15841,1287,5007,562,20848,2334,2253,1152,3178,1484
CCTAACTAAGAGAGCC,sample,100943,100347,4641,95706,8173,87533,56762,5397,14677,1765,71439,8932,4532,1779,11680,5418
ATATGCAAAGAGAGCC,sample,37818,37508,4964,32544,2644,29900,8929,732,11192,1326,20121,7721,4508,948,2003,1426
AACCGGTTAGCATTGA,sample,177269,176115,8586,167529,22149,145380,97010,7703,23576,2385,120586,14706,6000,2140,24120,14828
TCTAGGTTAGCATTGA,sample,224980,223577,11758,211819,26183,185636,122053,7764,28514,3155,150567,24150,8053,2459,33776,19361
CATAATGGAGCATTGA,sample,83923,83358,1957,81401,16231,65170,52696,3057,6185,803,58881,2429,1887,1546,16264,11567
GGTAGAGAAGCATTGA,sample,130289,129444,3482,125962,24093,101869,85892,6190,6417,1026,92309,2344,2017,1973,25799,18244
TCTCAGGAAGCATTGA,sample,132507,131629,4399,127230,18869,108361,84787,7238,11892,1036,96679,3408,3090,2488,20078,13458
GATGCGTTAGCATTGA,sample,66657,66058,3996,62062,7656,54406,36251,2599,9886,1112,46137,4558,3119,1544,10328,5364
ATGGCGTTAGCATTGA,sample,132107,130867,7492,123375,17111,106264,63945,4665,20142,3155,84087,14357,5164,1418,19720,11667
TGCGCGTTAGCATTGA,sample,135066,134017,6821,127196,13348,113848,69448,5488,25224,2984,94672,10704,4316,1670,17297,8709
CCATTCTTAGCATTGA,sample,155114,153518,8844,144674,13177,131497,86570,5121,26148,2126,112718,11532,4562,1963,20712,8665
TAGCGAGTAGCATTGA,sample,152336,151549,4305,147244,21306,125938,97848,10038,10899,1842,108747,5311,2794,1856,21655,15565
GCTCTTCTAGCATTGA,sample,33037,32796,1297,31499,3984,27515,19489,1654,4365,441,23854,1566,2142,1485,4673,2960
GAGATTCTAGCATTGA,sample,170613,169531,3950,165581,23317,142264,115588,8921,10282,1535,125870,5938,3289,2450,26545,16275
GGCGACGAAGCATTGA,sample,171254,170131,5078,165053,20886,144167,117021,8682,12856,946,129877,4662,2950,2134,26165,16060
GGCGTACCAGCATTGA,sample,145681,144627,6357,138270,11954,126316,74620,4187,30232,4759,104852,12518,5165,2139,12775,7743
GTCGCGAAAGCATTGA,sample,179543,178414,4771,173643,21226,152417,130834,10501,6430,710,137264,3942,2710,2601,25182,16720
CAGCTTCGAGCATTGA,Neg_Ctrl,1373,807,271,536,46,490,340,17,73,8,413,52,206,135,78,29
TTATGACGAGCATTGA,sample,78235,77397,3558,73839,7974,65865,44832,2208,10910,1253,55742,6662,3262,1233,7800,5387
GACTAACCAGCATTGA,sample,167255,165846,8599,157247,9816,147431,86125,7541,32342,4177,118467,17246,6189,2139,14237,5676
CGCGAGACAGCATTGA,sample,141126,139924,7439,132485,13447,119038,76881,5500,21624,2461,98505,12572,5157,1685,12646,9499
CCTAACTAAGCATTGA,sample,137472,136274,6967,129307,9748,119559,73308,4824,25800,3206,99108,12421,5182,1564,13275,6611
CTGGTCTTAATTACCA,sample,71853,71299,2693,68606,12296,56310,43117,2718,6599,823,49716,3053,3004,2138,9299,8925
CATAATGGAATTACCA,sample,103770,103085,3338,99747,19970,79777,67253,4876,4826,465,72079,2357,1856,1417,22026,14511
GGAGAAGCAATTACCA,sample,52642,52257,2361,49896,8859,41037,31250,1656,5171,577,36421,2383,2411,1496,9870,6032
GAGCCTCCAATTACCA,sample,120248,119396,5201,114195,19096,95099,71912,4508,12314,1756,84226,4609,2893,1512,21969,14150
TCATACCAAATTACCA,sample,99412,98034,2914,95120,16852,78268,64456,4513,6316,774,70772,2209,2201,1660,19559,12233
ATACGTTCAATTACCA,sample,141442,140744,4761,135983,19398,116585,88347,5657,14897,1908,103244,5776,3059,1750,23829,14374
TGCGCGTTAATTACCA,sample,44674,44165,2734,41431,4612,36819,24370,1616,6199,774,30569,3860,2718,1289,6560,2993
CGGTTGGTAATTACCA,sample,14062,13950,927,13023,1472,11551,8278,647,1392,172,9670,1062,1252,834,2399,1040
ACGCTTAAAATTACCA,sample,38530,37841,3814,34027,3907,30120,20668,1316,5109,767,25777,2260,1927,1142,6161,2548
CATTCGGTAATTACCA,sample,23718,23120,2624,20496,3001,17495,8556,538,5016,459,13572,2926,2248,755,2407,1616
ATACCGCCAATTACCA,sample,106178,105297,3483,101814,8386,93428,71332,5243,11239,1183,82571,4431,2876,1965,11694,6007
CAGCTTCGAATTACCA,sample,100383,99384,6039,93345,6051,87294,51651,3864,21241,2756,72892,7782,4396,2332,7192,3744
TTATGACGAATTACCA,sample,63326,62656,5054,57602,5128,52474,30597,2013,11750,1373,42347,6741,4150,1487,6365,3620
TAACGCCAAATTACCA,sample,53142,52538,4707,47831,4148,43683,21042,1352,12668,1181,33710,7440,3465,1029,3192,2385
CGCGAGACAATTACCA,sample,42895,42394,2063,40331,2806,37525,24291,1749,7378,1217,31669,2890,2135,1183,4571,1876
GCGCAATAAATTACCA,sample,91527,90719,4129,86590,8442,78148,56888,4362,11367,820,68255,4711,2513,1397,11069,6197
ATATGCAAAATTACCA,sample,99661,98858,5881,92977,7142,85835,48777,3219,21052,2988,69829,9799,4258,1517,6149,4798
AACCGGTTTAGATGAC,sample,3903,3855,175,3680,705,2975,2194,206,381,29,2575,165,624,549,487,490
CTGGTCTTTAGATGAC,Pos_Ctrl,9715,9625,428,9197,597,8600,7176,846,384,42,7560,152,2112,2017,579,250
CATACTCCTAGATGAC,Pos_Ctrl,39298,38989,1642,37347,1611,35736,29955,3310,1625,252,31580,594,4651,5579,1565,671
TGATTCCGTAGATGAC,Pos_Ctrl,30156,29831,1972,27859,1381,26478,22201,2192,1463,179,23664,443,4339,4465,1711,669
GCAACTAGTAGATGAC,sample,26475,26278,778,25500,2950,22550,13470,1249,5458,860,18928,1513,1916,1377,3088,2013
ATACGTTCTAGATGAC,sample,136455,135567,5488,130079,15837,114242,72297,5091,24926,2730,97223,9198,4164,1770,18683,10396
GATGCGTTTAGATGAC,sample,47443,47118,1256,45862,4915,40947,33356,2720,3105,323,36461,1443,2191,2014,7295,3877
CCATTCTTTAGATGAC,sample,55688,55256,3251,52005,4315,47690,28232,2081,11674,1735,39906,3968,3191,1883,5065,2794
GCGTTACCTAGATGAC,sample,120829,119697,7081,112616,11567,101049,65389,5237,17629,1707,83018,11087,5074,1702,14971,7406
GGCGTACCTAGATGAC,sample,72111,71451,5086,66365,7865,58500,39467,2968,8722,1001,48189,6342,3644,1530,10082,5300
TCTCCTAGTAGATGAC,sample,94351,93270,7981,85289,9427,75862,43447,3308,15438,2027,58885,11642,5097,1428,7854,6266
TAACGCCATAGATGAC,sample,130726,129909,5799,124110,10206,113904,72205,4401,23305,2985,95510,11008,4614,1654,14449,6697
CGTAGAACTAGATGAC,sample,164763,163904,5496,158408,16288,142120,102724,8875,18801,2054,121525,9666,4549,1666,18987,10701
GCGCAATATAGATGAC,sample,83360,82695,4068,78627,7880,70747,51445,4298,8480,1179,59925,5345,3226,1417,11568,5482
TTAACTGATAGATGAC,sample,122686,121914,5100,116814,9975,106839,74083,5660,17296,1984,91379,7816,3859,1689,17349,6378
CTGGTCTTGTTCAGAA,sample,7747,7682,202,7480,1663,5817,4556,420,477,67,5033,297,1003,940,952,1094
TATACGGAGTTCAGAA,sample,60601,60297,1637,58660,9751,48909,37798,3245,5167,517,42965,2182,2086,1411,9148,6627
GAGCCTCCGTTCAGAA,sample,3168,3138,112,3026,563,2463,1918,197,241,38,2159,69,542,517,518,359
TCGAACGAGTTCAGAA,sample,26165,26027,958,25069,4752,20317,13599,1393,3183,379,16782,1763,2005,1324,3348,3078
TCATACCAGTTCAGAA,sample,35800,35420,1179,34241,8665,25576,16265,1171,5357,566,21622,2217,1537,692,4240,5376
GACTCAAGGTTCAGAA,sample,105047,104496,2212,102284,13682,88602,73568,5275,6941,838,80509,1980,1943,1828,21511,9746
CCGTACGCGTTCAGAA,sample,109518,108615,8927,99688,8117,91571,40761,3032,31081,3715,71842,12982,6760,2358,8161,4807
TGCGCGTTGTTCAGAA,sample,41919,41629,1817,39812,5514,34298,25034,1421,4728,651,29762,2464,2343,1414,7066,4019
TAGCGAGTGTTCAGAA,sample,65304,64721,3111,61610,5323,56287,39665,2884,7570,876,47235,5292,3020,1144,9618,3270
GCTCTTCTGTTCAGAA,sample,82316,81621,3194,78427,6108,72319,48936,5044,11286,1334,60222,5719,3370,1364,8122,4317
GAGATTCTGTTCAGAA,sample,67676,67202,1845,65357,4837,60520,48013,4950,4292,691,52305,2574,1936,1487,6717,3231
CTAAGCATGTTCAGAA,sample,74800,74219,3619,70600,6037,64563,42346,3748,10705,1776,53051,5988,2945,1099,7187,3912
CCTAGCGGGTTCAGAA,sample,53653,53107,3251,49856,5030,44826,30982,1824,6804,791,37786,4425,3153,1376,7281,3393
CTAACCGGGTTCAGAA,sample,70494,69960,1891,68069,10424,57645,47761,4770,2966,305,50727,1843,1444,1361,10297,7828
GCCTATTCGTTCAGAA,sample,60365,59854,2980,56874,8509,48365,33203,2431,6770,1081,39973,4880,2945,1388,9595,5905
TCAATCAGGTTCAGAA,sample,44689,44281,1839,42442,4895,37547,29049,2055,3655,427,32704,2361,1970,1221,7720,3232
CCTAACTAGTTCAGAA,Pos_Ctrl,31390,30569,2058,28511,1040,27471,22698,2126,1874,240,24572,533,4275,4483,1234,453
GTCGTTCTTTCTGGTT,Neg_Ctrl,1067,501,223,278,58,220,156,9,32,16,188,7,99,62,39,15
AGAGTTCTTTCTGGTT,sample,111481,110710,3500,107210,16829,90381,74411,3910,7606,1081,82017,3373,1986,1483,23586,12816
CATAATGGTTCTGGTT,sample,118112,117339,7092,110247,12509,97738,60299,3657,21375,2662,81674,9745,4800,2200,12534,8630
GAGCCTCCTTCTGGTT,sample,137950,136650,8594,128056,12496,115560,69831,5525,20551,2509,90382,17144,6201,1770,13786,7962
CTAGCGACTTCTGGTT,Neg_Ctrl,1437,569,259,310,52,258,177,14,39,1,216,27,110,76,45,8
TCATACCATTCTGGTT,sample,106112,105317,5440,99877,12625,87252,57234,3811,16334,2170,73568,7703,3607,1476,18014,8847
GCAACTAGTTCTGGTT,Neg_Ctrl,764,302,177,125,22,103,71,6,23,1,94,2,50,34,16,3
TACGCGAGTTCTGGTT,sample,104560,103957,3152,100805,11537,89268,71623,4648,7896,999,79519,4102,2700,1978,15096,8194
GACTCAAGTTCTGGTT,sample,81180,80558,3421,77137,6877,70260,40758,3479,17473,1706,58231,6844,3443,1705,8290,5016
ATGGCGTTTTCTGGTT,sample,15572,15381,1226,14155,1626,12529,7361,414,2985,297,10346,1472,1731,871,2622,1098
CATTCGGTTTCTGGTT,sample,97935,97171,6500,90671,10851,79820,45721,2798,16290,1603,62011,13408,5655,1680,13872,7287
GCTCTTCTTTCTGGTT,sample,115731,114986,3461,111525,13154,98371,80770,5548,7689,799,88459,3565,2667,2382,15837,9679
GAGATTCTTTCTGGTT,sample,92160,91696,2436,89260,13622,75638,62101,4822,5554,695,67655,2466,2959,2920,13349,10067
GCTGCTTCTTCTGGTT,sample,57555,57016,3855,53161,5697,47464,27515,1858,11059,1203,38574,5829,4062,1858,5352,3417
GCCTATTCTTCTGGTT,sample,79201,78699,2337,76362,6698,69664,53760,4747,7336,913,61096,2908,2755,2062,9317,4437
GCGTTACCTTCTGGTT,sample,21757,21536,1444,20092,2476,17616,11226,785,3151,378,14377,2076,2163,999,2741,1599
GGCGTACCTTCTGGTT,sample,58789,58064,3332,54732,7085,47647,35820,2858,5331,556,41151,3082,2300,1198,7616,4950
CAGCTTCGTTCTGGTT,sample,33751,33445,1833,31612,3468,28144,17377,1481,5937,546,23314,2803,2386,1236,4477,2459
CGCGGTCGTTCTGGTT,sample,5087,5035,268,4767,717,4050,2819,374,525,82,3344,250,964,844,499,490
TCTCCTAGTTCTGGTT,sample,89129,88338,3332,85006,8240,76766,59156,4255,7548,914,66704,4893,3803,2446,9716,5903
TCAATCAGTTCTGGTT,sample,68640,67953,3984,63969,5425,58544,34228,1783,13756,2124,47984,6653,3614,1381,8070,2745
TAACGCCATTCTGGTT,sample,80259,79544,3203,76341,7690,68651,53019,4030,7301,758,60320,3543,2990,1715,9572,5615
CCTAACTATTCTGGTT,sample,120155,118809,5671,113138,15039,98099,78335,5547,7728,1158,86063,5331,1983,1476,16343,9888
GCGCAATATTCTGGTT,sample,79376,78470,7054,71416,5681,65735,32237,2136,17650,2305,49887,11407,5207,1368,7175,3668
GACGTATGGTTCGGTT,sample,136368,135479,3222,132257,25979,106278,85618,6896,8478,1051,94096,4235,2593,1713,26293,18896
CATAATGGGTTCGGTT,sample,93975,93410,3688,89722,10397,79325,63777,4675,6008,771,69785,4094,3096,1768,15776,7615
TATACGGAGTTCGGTT,sample,168152,167359,3182,164177,25056,139121,117453,8788,8256,966,125709,3658,2565,2390,24788,18683
GAGCCTCCGTTCGGTT,sample,130476,129404,4352,125052,17228,107824,81887,5983,12146,1245,94033,6563,3444,1754,23723,12281
TCGAACGAGTTCGGTT,sample,148145,147065,11384,135681,20553,115128,64515,4284,25730,3016,90245,17583,8059,2319,18208,13999
GGTAGAGAGTTCGGTT,sample,132607,131774,4487,127287,21319,105968,83290,5570,10110,1154,93400,5844,3141,1669,24470,16011
TCATCGAAGTTCGGTT,sample,93958,93443,3319,90124,14657,75467,57361,4326,8804,1070,66165,3906,3297,2232,13517,10520
GACTCAAGGTTCGGTT,sample,18035,17817,1075,16742,2775,13967,9616,664,2156,230,11772,1301,1741,1082,2833,1798
ATACGTTCGTTCGGTT,sample,38537,38233,1428,36805,3466,33339,18570,1291,10071,1208,28641,2199,2913,2016,2758,2517
CCGTACGCGTTCGGTT,sample,52873,52289,3207,49082,6394,42688,27356,1575,8891,1033,36247,3833,3274,1871,7094,4362
GATGCGTTGTTCGGTT,sample,120819,119916,7022,112894,14967,97927,66276,3992,15559,1537,81835,10563,4840,1944,13981,10448
CTAAGCATGTTCGGTT,sample,56591,56050,3168,52882,4943,47939,27675,2102,11005,1456,38680,5701,2898,1024,4805,3159
AAGGTCTGGTTCGGTT,sample,99591,98826,4076,94750,8235,86515,54867,3997,17926,2012,72793,7713,3392,1415,8231,5718
AGCAGAGCGTTCGGTT,sample,70424,69829,4504,65325,9692,55633,33650,2721,10855,979,44505,7428,4134,1412,7386,6759
TGCGCTCCGTTCGGTT,sample,72573,71949,3071,68878,9795,59083,41478,3151,9078,924,50556,4452,3092,1459,11036,7030
ATACCGCCGTTCGGTT,sample,49214,48613,3048,45565,5638,39927,21858,1330,10164,1302,32022,5273,3139,1223,3706,3745
GGCGTACCGTTCGGTT,sample,54195,53610,4404,49206,3772,45434,24935,2087,10711,1210,35646,6491,4470,1774,4056,2394
CAGCTTCGGTTCGGTT,sample,125229,124191,4394,119797,13052,106745,82353,6155,9946,1628,92299,6663,2500,1522,21869,10194
TTATGACGGTTCGGTT,sample,78179,77650,2190,75460,8774,66686,55927,3617,4560,664,60487,1918,1694,1514,11679,6848
TCTCCTAGGTTCGGTT,sample,105817,104841,3885,100956,8470,92486,65456,4643,14902,1700,80358,5785,3017,1777,12719,5919
ATGAATAGGTTCGGTT,sample,70516,69860,3313,66547,8048,58499,40718,3642,9293,740,50011,4106,2263,1186,9630,6218
AAGTAGAGGTTCGGTT,sample,68394,67773,3372,64401,5403,58998,36267,2267,12964,1728,49231,5772,3538,1623,6763,3504
ATTCTACCGTTCGGTT,sample,82143,81250,4554,76696,7459,69237,48039,3255,10494,1291,58533,6158,3336,1721,7969,5005
CGCGAGACGTTCGGTT,sample,63573,62618,6378,56240,4884,51356,24766,1479,14406,1539,39172,9166,4570,1410,6099,2834
GCGCAATAGTTCGGTT,Neg_Ctrl,851,629,192,437,55,382,279,17,52,6,331,28,147,104,60,23
TCTAGGTTTGGCGGTT,sample,162401,161343,4812,156531,18591,137940,106365,7959,16320,1752,122685,5544,3319,2162,26228,12924
GACGTATGTGGCGGTT,sample,157657,156471,7472,148999,21446,127553,82846,6247,21738,1859,104584,14863,5821,1627,28986,14923
GAGCCTCCTGGCGGTT,sample,77124,76385,4668,71717,10325,61392,31721,2839,16699,1595,48420,8538,4755,1683,6371,6918
ATTCAAGGTGGCGGTT,sample,203548,201951,8746,193205,20171,173034,120902,11895,22516,2252,143418,15469,5429,1883,20061,13323
GACTCAAGTGGCGGTT,sample,19974,19743,1092,18651,2597,16054,12278,707,1912,205,14190,952,1805,1316,4119,1753
CCGCAGTCTGGCGGTT,sample,95516,94540,6618,87922,13671,74251,42518,3769,15197,1380,57715,11387,5321,1446,15055,9110
TCTCAGGATGGCGGTT,sample,96185,95528,3737,91791,15209,76582,60847,4243,6991,1048,67838,3453,3286,2404,14211,10614
GGCAGGTTTGGCGGTT,sample,52026,51566,2998,48568,10385,38183,26490,2340,6117,661,32607,2575,2504,1563,5633,6636
GATGCGTTTGGCGGTT,sample,102332,101634,3675,97959,10772,87187,56096,4145,18943,1844,75039,6159,3691,2460,13545,7689
AGCGTCTTTGGCGGTT,sample,177900,176652,5295,171357,27802,143555,118149,10346,9502,2167,127651,3391,2242,1898,31799,20025
ACGCTTAATGGCGGTT,sample,103076,102314,5159,97155,13620,83535,56380,5471,12685,1623,69065,7376,4056,1883,15959,9999
GCTCTTCTTGGCGGTT,sample,172634,171491,5618,165873,13488,152385,114139,8110,19608,2360,133747,8168,4815,3400,21406,9447
GAGATTCTTGGCGGTT,sample,48663,48226,2122,46104,7631,38473,31368,1950,2827,362,34195,1966,1820,1498,10501,5505
CTAAGCATTGGCGGTT,sample,41492,41003,3078,37925,5346,32579,18912,1609,6897,782,25809,4379,2937,1469,3043,3277
GCGTTACCTGGCGGTT,sample,92473,90939,8137,82802,9990,72812,31892,1719,20772,2076,52664,16353,5562,1291,5699,6596
GTCGCGAATGGCGGTT,sample,110713,109891,2909,106982,16160,90822,75430,5293,6453,741,81883,2905,2974,2129,18161,11561
AAGTAGAGTGGCGGTT,sample,166909,165677,6849,158828,14863,143965,106277,6466,17468,2376,123745,11378,5497,2543,23377,11013
CCTAACTATGGCGGTT,sample,272631,271073,9335,261738,19135,242603,147969,9219,62277,8263,210246,14875,3988,2205,18967,14604
CTGGTCTTTCCTTATT,sample,46546,46262,1700,44562,5653,38909,28099,2089,5533,806,33632,2382,2102,1410,8695,3964
AGAGTTCTTCCTTATT,sample,20505,20289,1135,19154,2078,17076,11018,688,3317,389,14335,1664,1766,1026,3135,1410
AGCTGAATTCCTTATT,sample,89854,89251,2884,86367,16898,69469,56312,4187,5449,664,61761,2857,2648,2105,15267,12191
TCGAACGATCCTTATT,sample,23519,23323,1310,22013,3973,18040,12563,803,2585,335,15148,1754,1764,978,4643,2754
TCATCGAATCCTTATT,sample,21964,21763,1138,20625,2752,17873,10992,573,4322,428,15314,1558,1773,954,2600,1890
TCATACCATCCTTATT,sample,34748,34445,2152,32293,3628,28665,14853,1067,8178,1139,23031,3428,2441,1037,4783,2425
CCGTACGCTCCTTATT,sample,85847,85266,4394,80872,13872,67000,54059,3208,5545,522,59604,3666,2242,1327,18032,9554
TCTCAGGATCCTTATT,sample,46434,46124,1824,44300,7347,36953,28094,1737,4337,462,32431,2323,2309,1342,8507,5457
ATGGCGTTTCCTTATT,sample,29153,28926,1608,27318,5110,22208,15893,957,3143,409,19036,1806,1821,941,6796,3499
TGCGCGTTTCCTTATT,sample,20100,19988,817,19171,2139,17032,13589,921,1519,151,15108,852,1837,1606,2405,1565
CATTCGGTTCCTTATT,sample,47669,47354,1504,45850,9708,36142,29767,2405,2511,393,32278,1066,1897,1747,9565,6975
GCTCTTCTTCCTTATT,sample,42928,42666,1295,41371,3903,37468,29998,2452,2788,386,32786,1844,2258,2033,6043,2851
GAGATTCTTCCTTATT,sample,25838,25680,1867,23813,2243,21570,11072,773,5636,709,16708,3380,2797,1251,2021,1404
CTAAGCATTCCTTATT,sample,367,356,18,338,40,298,201,16,56,3,257,22,111,81,38,31
CCTAGCGGTCCTTATT,sample,765,758,36,722,163,559,365,32,97,26,462,39,192,144,106,116
CTAACCGGTCCTTATT,sample,44431,44128,1828,42300,6019,36281,25696,1939,5586,500,31282,2560,2372,1236,8070,4150
GCCTATTCTCCTTATT,sample,36267,35939,2180,33759,2633,31126,15263,1049,9794,1011,25057,4009,2675,1123,2614,1743
CGTCGAGGTCCTTATT,Pos_Ctrl,21033,20710,1404,19306,889,18417,15263,1409,1253,199,16516,293,3603,3527,928,399
CAGCTTCGTCCTTATT,sample,49175,48771,2268,46503,5485,41018,30228,2579,4957,694,35185,2560,2143,1329,7006,4060
CGCGGTCGTCCTTATT,sample,9282,9128,1282,7846,894,6952,2973,201,2042,208,5015,1528,1430,478,748,481
ATTCTACCTCCTTATT,sample,40938,40461,3202,37259,4134,33125,20903,1739,5596,571,26499,4316,3003,1102,5175,2818
TTAACTGATCCTTATT,sample,18150,17935,1866,16069,1648,14421,8654,555,2661,359,11315,2192,1593,678,2412,1051
ATATGCAATCCTTATT,sample,1644,1564,53,1511,262,1249,899,80,180,19,1079,71,387,310,185,173
GGAGAAGCAATAAGGT,sample,96665,95907,3290,92617,12946,79671,59069,3722,10668,851,69737,5361,3273,1667,16400,8835
TCGAACGAAATAAGGT,sample,33908,33683,2673,31010,3888,27122,14996,1037,6631,776,21627,3682,3849,2269,2595,2389
GACTCAAGAATAAGGT,sample,49140,48760,2714,46046,6263,39783,27335,2097,6011,540,33346,3800,2630,1307,8956,4610
CCGCAGTCAATAAGGT,sample,119710,118793,4063,114730,12967,101763,65653,4577,21022,2573,86675,7938,3665,2162,13466,8487
ATGGCGTTAATAAGGT,Pos_Ctrl,459,453,16,437,41,396,297,25,44,3,341,27,171,122,42,31
AGCGTCTTAATAAGGT,sample,125958,125145,7591,117554,13639,103915,57661,4176,26267,3216,83928,12595,5095,1613,17389,8978
GCTCTTCTAATAAGGT,sample,156174,155132,6315,148817,19464,129353,97254,7158,14998,1540,112252,8403,4263,1920,26233,13168
GAGATTCTAATAAGGT,sample,164801,163757,3971,159786,20360,139426,114456,10268,9970,1210,124426,3522,2396,1960,26336,15685
CTAAGCATAATAAGGT,sample,112323,111605,3585,108020,14680,93340,73929,4517,9068,947,82997,4879,3002,1836,22726,10099
AAGGTCTGAATAAGGT,sample,115391,114657,3236,111421,13129,98292,79844,5288,8308,1023,88152,3829,3110,2232,17010,10025
CCTAGCGGAATAAGGT,Pos_Ctrl,19734,19558,1090,18468,914,17554,14702,1301,1037,153,15739,361,3460,3403,1029,386
GTCGCGAAAATAAGGT,sample,122568,121752,2732,119020,15343,103677,88899,8335,4403,311,93302,1729,2316,2658,15100,11922
CGTCGAGGAATAAGGT,sample,49518,49083,2522,46561,5352,41209,26976,1591,7754,770,34730,4118,3154,1856,4743,3511
TCAATCAGAATAAGGT,sample,146580,145352,7359,137993,13565,124428,89499,7397,14319,1836,103818,11377,5490,2575,15525,8336
TAACGCCAAATAAGGT,sample,153112,151840,7103,144737,11093,133644,90326,6581,23238,2925,113564,10574,4937,2277,13530,8539
CGCGAGACAATAAGGT,sample,46610,46141,2886,43255,8949,34306,20285,1415,8063,639,28348,3904,2638,1277,1894,5821
TTAACTGAAATAAGGT,sample,54733,54183,2293,51890,6806,45084,31688,2911,6350,638,38038,3497,2442,1002,7729,4440
AACCGGTTCAGGACCA,sample,43044,42598,2582,40016,4927,35089,24056,1403,5623,714,29679,3293,2835,1482,8172,3603
CTGGTCTTCAGGACCA,sample,42921,42570,2338,40232,5045,35187,23997,1447,5809,743,29806,3191,2865,1565,7837,3367
GACGTATGCAGGACCA,sample,92660,91935,3203,88732,12855,75877,59715,3933,7865,737,67580,3627,2711,1728,18969,9803
CATAATGGCAGGACCA,sample,95148,94355,7408,86947,9445,77502,37003,2940,24488,2616,61491,10455,5791,2104,8310,6145
CTAGCGACCAGGACCA,sample,98850,98139,2583,95556,19258,76298,67388,4466,3414,206,70802,824,1376,1591,23332,14305
TCATCGAACAGGACCA,sample,81547,81012,2297,78715,11008,67707,53706,3663,7067,905,60773,2366,2540,2089,13516,8524
TGATTCCGCAGGACCA,sample,93859,93129,3521,89608,14114,75494,63416,4122,4893,651,68309,2412,2109,1628,19034,10418
GACTCAAGCAGGACCA,sample,88910,88254,3434,84820,13185,71635,56675,3700,6501,845,63176,3914,2569,1577,18389,9928
ATACGTTCCAGGACCA,sample,118941,118058,5867,112191,12402,99789,71516,4298,14665,1953,86181,7357,3661,1961,17870,8372
CCGCAGTCCAGGACCA,sample,28450,28198,1077,27121,3839,23282,18682,1268,2157,279,20839,896,2148,1915,5585,2540
ATGGCGTTCAGGACCA,sample,108141,107274,6258,101016,11368,89648,60268,4630,14202,1643,74470,8905,4820,2463,16169,7942
AGCGTCTTCAGGACCA,sample,126351,125230,5619,119611,15916,103695,76106,5698,12851,1456,88957,7584,3208,1503,20578,11634
TAGCGAGTCAGGACCA,sample,156225,154870,9074,145796,14019,131777,92215,6294,19543,2424,111758,11301,5658,2344,18067,10120
CTAAGCATCAGGACCA,sample,126513,125551,4146,121405,19285,102120,85597,5284,7499,753,93096,2987,2704,1812,21225,14827
CCTAGCGGCAGGACCA,sample,62893,62398,3164,59234,4854,54380,34327,2012,11441,1202,45768,5398,3269,1580,6956,3208
GGCGACGACAGGACCA,sample,84268,83510,2774,80736,10300,70436,57810,4362,5488,868,63298,1908,1745,1486,15532,7917
TAACGAAGCAGGACCA,sample,129550,128686,4224,124462,19250,105212,84731,5871,9507,1576,94238,3527,2438,1782,21170,14761
ATACCGCCCAGGACCA,sample,81051,80412,3806,76606,10740,65866,49255,3659,7445,1011,56700,4496,3728,2346,8650,7739
GTCGCGAACAGGACCA,sample,134315,133224,4796,128428,13834,114594,85102,6298,15955,2575,101057,4664,2691,1857,17015,10061
CAGCTTCGCAGGACCA,Neg_Ctrl,1208,813,318,495,51,444,302,23,74,7,376,38,189,117,95,57
CGCGGTCGCAGGACCA,sample,42714,42322,3497,38825,4322,34503,20109,1111,7422,763,27531,5098,3675,1204,6201,2901
ATGAATAGCAGGACCA,sample,92422,91638,4606,87032,9001,78031,55901,4045,10852,1209,66753,6024,3452,1471,11641,5454
AAGTAGAGCAGGACCA,sample,46459,46088,2206,43882,4748,39134,29609,2135,4124,539,33733,2727,2313,1294,7132,3443
ATTCTACCCAGGACCA,sample,48015,47270,3564,43706,4840,38866,22257,2006,8942,1079,31199,4582,2691,1095,5131,3019
GACTAACCCAGGACCA,sample,112675,111464,6561,104903,10548,94355,62239,5546,15733,1995,77972,8842,4519,1711,13311,6935
CGCGAGACCAGGACCA,sample,36974,36630,3656,32974,3207,29767,14055,1018,8167,790,22222,5737,3566,1034,4432,2003
CGTAGAACCAGGACCA,sample,113719,112397,8427,103970,10643,93327,50630,3317,21319,2301,71949,15760,6248,1433,10638,6430
AGATACTACAGGACCA,sample,131983,130849,6202,124647,12158,112489,80942,6850,15826,2093,96768,6778,3289,1367,16909,8819
TTAACTGACAGGACCA,sample,23732,23470,1101,22369,3854,18515,14324,1210,1897,300,16221,784,1017,956,3062,2543
AACCGGTTCCTCGTTG,sample,59792,59390,2246,57144,9661,47483,32789,2342,7808,1194,40597,3350,2612,1407,8809,6543
CATAATGGCCTCGTTG,sample,119184,118466,3950,114516,14942,99574,69463,5038,18157,1321,87620,5595,2193,1581,20816,11092
TCGAACGACCTCGTTG,sample,82982,82372,3938,78434,12091,66343,47401,2840,9840,1183,57241,5079,3000,1294,15541,9248
ATTCAAGGCCTCGTTG,sample,77562,76830,3925,72905,8028,64877,39755,2265,14888,1844,54643,6125,3325,1564,10275,5475
GCAACTAGCCTCGTTG,sample,23403,23056,1061,21995,1927,20068,9719,745,6618,806,16337,2180,1957,982,1717,1131
CCGTACGCCCTCGTTG,sample,113015,112152,4042,108110,10869,97241,78982,4640,7660,669,86642,5290,3455,2154,23910,7273
GATGCGTTCCTCGTTG,sample,28773,28546,1406,27140,2943,24197,13108,1010,6463,759,19571,2857,1882,881,2188,1996
ATGGCGTTCCTCGTTG,sample,22845,22563,1346,21217,2640,18577,12261,795,3292,279,15553,1950,2151,1232,2706,1775
TGCGCGTTCCTCGTTG,Neg_Ctrl,744,440,265,175,15,160,100,6,29,2,129,23,63,39,27,13
ACGCTTAACCTCGTTG,sample,50637,50260,2536,47724,6679,41045,28686,2079,6568,591,35254,3121,2347,1200,9617,4416
CCTAGCGGCCTCGTTG,sample,54975,54650,2135,52515,4204,48311,27432,2151,13209,1556,40641,3963,3072,1827,4538,2729
CTAACCGGCCTCGTTG,Neg_Ctrl,710,388,194,194,24,170,123,6,30,2,153,9,87,49,27,17
AGCAGAGCCCTCGTTG,sample,60551,59925,6759,53166,4854,48312,23935,1779,12173,1233,36108,9192,4399,1226,5173,2995
ATACCGCCCCTCGTTG,sample,87776,86948,5220,81728,7929,73799,54400,3872,9004,1085,63404,5438,3758,2017,11857,5202
CGTCGAGGCCTCGTTG,sample,96456,95436,7032,88404,7770,80634,50377,2946,15240,1620,65617,10451,5402,2084,7917,4459
ATTCTACCCCTCGTTG,Pos_Ctrl,41821,41210,2377,38833,1426,37407,30908,2954,2499,295,33407,751,4859,5561,1475,516
CGCGAGACCCTCGTTG,sample,99133,97867,3884,93983,9324,84659,63899,7068,8815,855,72714,4022,1875,1213,14658,7221
AACCGGTTTTGCGGAC,sample,7714,7529,320,7209,2114,5095,3968,393,470,67,4438,197,960,879,678,1259
TCTAGGTTTTGCGGAC,sample,173179,172315,6836,165479,27403,138076,93983,7086,21623,2799,115606,12585,5237,1903,25535,19192
CTGGTCTTTTGCGGAC,sample,54182,52453,3240,49213,10344,38869,29755,2422,3902,391,33657,2399,2238,1285,9343,6879
GTCGTTCTTTGCGGAC,sample,63311,62907,3265,59642,9657,49985,30751,2841,9779,1148,40530,5466,3917,1371,10485,6672
AGAGTTCTTTGCGGAC,sample,109996,109434,2509,106925,21539,85386,71740,5930,5142,678,76882,1896,2394,2334,16043,15582
AGCTGAATTTGCGGAC,sample,57057,56620,2359,54261,7517,46744,37583,2429,3956,428,41539,2348,2256,1611,12836,5221
GACGTATGTTGCGGAC,sample,78340,77640,4510,73130,9620,63510,44601,3107,8476,1224,53077,6102,4122,1805,13391,6484
CATAATGGTTGCGGAC,sample,98292,97709,3782,93927,13752,80175,61921,4188,8576,978,70497,4512,3084,1790,18481,9917
TATACGGATTGCGGAC,sample,94545,93981,2398,91583,9367,82216,65893,5721,7026,606,72919,2970,3285,2645,9030,6700
GAGCCTCCTTGCGGAC,sample,187252,185993,10779,175214,13391,161823,119680,12392,17851,1804,137531,10096,4911,1931,14304,7783
GGTAGAGATTGCGGAC,sample,79450,78581,5299,73282,8804,64478,45760,3030,8765,1270,54525,5653,3757,1578,14027,6086
CGTCGCCATTGCGGAC,sample,142988,142105,5617,136488,14356,122132,92103,7172,14866,1450,106969,6541,3574,2382,17412,10198
TCATCGAATTGCGGAC,sample,90734,89991,5327,84664,12081,72583,47156,3530,13332,1490,60488,7075,4213,1580,13695,8688
ATTCAAGGTTGCGGAC,sample,128394,124991,7547,117444,13483,103961,70140,4837,16424,1979,86564,10581,4473,1468,21993,8940
TCTCAGGATTGCGGAC,sample,82264,81753,2375,79378,11022,68356,55856,3286,6019,725,61875,2470,2038,1459,15320,7983
ATGGCGTTTTGCGGAC,sample,36885,36576,3654,32922,3614,29308,13553,977,8326,952,21879,5500,3500,968,3290,2265
TGCGCGTTTTGCGGAC,sample,48374,48033,1875,46158,5426,40732,32708,1987,3992,393,36700,1652,1903,1352,8660,3983
AGCGTCTTTTGCGGAC,sample,119595,118364,8346,110018,8466,101552,58854,6125,19934,2645,78788,13994,5377,1707,9855,5534
TAGCGAGTTTGCGGAC,sample,119437,117395,10372,107023,8106,98917,69275,5391,13197,2250,82472,8804,4686,1821,12064,5123
AAGGTCTGTTGCGGAC,sample,99742,99145,2645,96500,14555,81945,72315,4893,3436,323,75751,978,1098,1278,20720,10874
CCTAGCGGTTGCGGAC,sample,72570,72095,2386,69709,8609,61100,50049,3355,5077,595,55126,2024,1633,1429,13063,6586
GGCGACGATTGCGGAC,sample,45169,44501,3207,41294,6025,35269,21046,1458,7186,806,28232,4773,3024,988,3985,4020
GCCTATTCTTGCGGAC,sample,39198,38840,1315,37525,4875,32650,26582,2224,2442,325,29024,1077,1549,1305,6814,3555
AGCAGAGCTTGCGGAC,sample,38326,38019,2127,35892,3239,32653,22797,1531,5292,740,28089,2293,2658,1681,3732,2171
GGCGTACCTTGCGGAC,sample,37889,37564,1402,36162,6525,29637,23584,1509,2996,354,26580,1194,1806,1172,7692,4522
CAGCTTCGTTGCGGAC,sample,83311,82414,4513,77901,6536,71365,48374,2976,12298,1339,60672,6378,3764,1655,8242,4032
CGCGGTCGTTGCGGAC,sample,55329,54704,2755,51949,4438,47511,30379,1868,9762,1530,40141,3972,2735,1188,6260,2674
AAGTAGAGTTGCGGAC,sample,52923,52327,3617,48710,3138,45572,30215,1985,7480,852,37695,5040,3408,1600,4866,1740
TAACGCCATTGCGGAC,sample,70169,68957,7476,61481,4953,56528,28625,2317,13196,1458,41821,10932,4841,1287,7188,2481
GACTAACCTTGCGGAC,sample,138958,137589,9330,128259,8176,120083,65355,4327,32815,4276,98170,13310,5328,1864,7356,4371
CGTAGAACTTGCGGAC,sample,109239,108209,4828,103381,12030,91351,73367,4541,7741,724,81108,4978,3160,1586,13578,8943
AGATACTATTGCGGAC,sample,115819,114521,8718,105803,7551,98252,57843,3754,22220,2466,80063,11969,5480,2172,8988,4637
TTAACTGATTGCGGAC,sample,60261,59693,2136,57557,8413,49144,37022,2261,5891,522,42913,3448,2491,1125,9249,6260
CTAGCGACTCCATTGG,sample,52912,52587,2618,49969,5960,44009,28991,2101,8168,840,37159,3909,3069,1635,7803,4101
TCATCGAATCCATTGG,sample,39346,39152,1045,38107,6947,31160,26009,1932,1994,247,28003,978,1519,1363,10838,4988
TGATTCCGTCCATTGG,sample,64571,62805,2724,60081,7155,52926,39578,2393,6946,591,46524,3418,2503,1667,9750,5583
GCAACTAGTCCATTGG,sample,7480,7362,329,7033,1154,5879,4683,331,643,77,5326,145,813,800,1675,840
ATGGCGTTTCCATTGG,sample,15046,14895,564,14331,1868,12463,9635,619,1312,148,10947,749,1133,912,2488,1395
CCATTCTTTCCATTGG,sample,21503,21323,527,20796,3318,17478,15348,1260,687,45,16035,138,761,940,4021,2446
CATTCGGTTCCATTGG,sample,118620,117843,2332,115511,9289,106222,91998,7816,4054,446,96052,1908,1735,1932,13666,6628
GCTCTTCTTCCATTGG,sample,4575,4527,211,4316,474,3842,3022,280,322,41,3344,177,630,553,550,301
CCTAGCGGTCCATTGG,sample,21418,21227,1972,19255,1812,17443,10713,742,3181,399,13894,2408,2647,1445,1880,983
GCGTTACCTCCATTGG,sample,32930,32531,1124,31407,2774,28633,23319,2097,1971,247,25290,999,1328,1116,4036,1909
CGTCGAGGTCCATTGG,sample,55189,54677,2314,52363,5149,47214,34499,2861,6189,700,40688,2965,2206,1119,6490,3635
CGCGGTCGTCCATTGG,sample,38229,37762,2465,35297,2324,32973,22391,1690,4839,424,27230,3629,2421,1051,3435,1355
TCTCCTAGTCCATTGG,sample,69061,68344,5857,62487,5088,57399,29766,2164,14455,1743,44221,9271,4959,1573,5061,3076
ATGAATAGTCCATTGG,sample,91720,90943,4044,86899,5791,81108,53753,3711,16666,1712,70419,5266,3613,2119,8853,4055
GACTAACCTCCATTGG,Neg_Ctrl,613,327,209,118,9,109,86,6,6,1,92,10,44,33,14,5
CGCGAGACTCCATTGG,sample,37335,36983,3156,33827,3225,30602,14622,1422,8305,944,22927,5309,3127,1079,3593,1888
CGTAGAACTCCATTGG,sample,68605,68019,4394,63625,6099,57526,34999,2485,10816,1350,45815,7876,4065,1559,6575,4366
ATATGCAATCCATTGG,sample,89,85,4,81,12,69,41,7,11,0,52,10,28,18,6,5
AGAGTTCTCATAGGCG,sample,62623,61967,3010,58957,6408,52549,32423,2497,12352,1354,44775,3923,3143,1697,8397,4550
GACGTATGCATAGGCG,sample,182708,181255,10183,171072,21196,149876,96985,5799,24182,2880,121167,20030,6798,2159,29119,14283
CATAATGGCATAGGCG,sample,138916,137848,6908,130940,18841,112099,76528,4355,18374,2086,94902,10756,5171,1861,24345,13250
GGAGAAGCCATAGGCG,sample,106557,105801,4003,101798,16849,84949,69193,5513,6095,864,75288,3284,2449,1739,23599,11587
GAGCCTCCCATAGGCG,sample,140338,139463,3689,135774,24607,111167,96708,5904,5121,840,101829,2594,2004,1615,30708,18242
TCGAACGACATAGGCG,sample,44391,44115,1840,42275,9072,33203,24720,1490,4269,423,28989,2301,2533,1488,9084,6195
TCATACCACATAGGCG,sample,95562,94946,5010,89936,11798,78138,52128,3637,13503,1584,65631,7286,3715,1618,14969,8048
TACGCGAGCATAGGCG,sample,55256,54793,3895,50898,6607,44291,22874,1535,11548,1705,34422,6629,3753,1208,7132,4322
TCTCAGGACATAGGCG,sample,67995,67196,4905,62291,8654,53637,34767,2133,8675,949,43442,7113,4220,1545,12831,5771
GGCAGGTTCATAGGCG,sample,16903,16829,458,16371,3578,12793,10469,954,914,126,11383,330,1195,1226,2781,2526
GATGCGTTCATAGGCG,sample,48991,48492,3864,44628,6921,37707,22357,1915,8210,877,30567,4348,3059,1706,6126,4686
ACGCTTAACATAGGCG,sample,26703,26443,1740,24703,2811,21892,12318,949,5582,639,17900,2404,3019,1653,1878,1830
GAGATTCTCATAGGCG,sample,81469,80470,7660,72810,8343,64467,36656,2173,14188,1574,50844,9876,5059,1911,11215,5286
CTAAGCATCATAGGCG,sample,48795,48152,3105,45047,6412,38635,26458,1845,6675,611,33133,3046,2794,1852,6087,4288
AAGGTCTGCATAGGCG,sample,34659,34289,3431,30858,4225,26633,14556,1011,6504,687,21060,3875,2966,1077,4840,2676
CTAACCGGCATAGGCG,sample,74355,73528,3455,70073,7957,62116,48023,3805,6283,771,54306,3234,2434,1603,12416,5596
GCTGCTTCCATAGGCG,sample,109093,107983,9144,98839,9128,89711,53242,3282,19986,2059,73228,11142,5335,2126,9003,5902
GCCTATTCCATAGGCG,sample,121792,120820,4974,115846,10232,105614,70680,5511,19638,1537,90318,8248,3976,1966,13430,6727
AGCAGAGCCATAGGCG,sample,116232,114688,16177,98511,6932,91579,37784,2862,27161,2932,64945,20840,9037,2240,7039,3489
ATACCGCCCATAGGCG,sample,98477,97544,5465,92079,9269,82810,58356,5198,11342,1578,69698,6336,4116,1939,11864,6599
GGCGTACCCATAGGCG,sample,77086,76380,3692,72688,5854,66834,43674,2832,12323,1781,55997,6224,3775,1568,8560,3836
CAGCTTCGCATAGGCG,sample,95203,94129,6183,87946,7528,80418,54861,4487,11582,1267,66443,8221,3861,1527,8886,5307
CGCGGTCGCATAGGCG,sample,66437,65748,3043,62705,6370,56335,40803,3268,7477,1162,48280,3625,3118,1658,8392,4416
ATGAATAGCATAGGCG,sample,110668,109260,11859,97401,6762,90639,44532,2525,24151,2413,68683,17018,6718,1790,9061,3815
ATTCTACCCATAGGCG,sample,69908,68917,4690,64227,7776,56451,41150,2584,7708,847,48858,4162,2837,1416,9928,5131
CGCGAGACCATAGGCG,sample,97055,96193,3189,93004,7622,85382,64539,4398,11585,1339,76124,3521,2647,2218,9183,5191
CGTAGAACCATAGGCG,sample,102524,101111,11787,89324,9227,80097,38645,2466,20921,2543,59566,15522,6717,1586,9616,5879
CTGGTCTTTTGGAGAG,Pos_Ctrl,43749,43149,2776,40373,2039,38334,32103,2963,2320,301,34423,647,5031,5375,2391,943
AGCTGAATTTGGAGAG,sample,164209,163143,4735,158408,22615,135793,105968,7609,15096,2272,121064,4848,3156,2692,20281,16580
CATAATGGTTGGAGAG,sample,149871,148922,5459,143463,13867,129596,96124,6309,17165,2577,113289,7421,4011,2542,13548,10147
TATACGGATTGGAGAG,sample,79845,78996,7026,71970,8662,63308,35816,2547,14053,1401,49869,9491,5054,1533,10943,5317
GAGCCTCCTTGGAGAG,sample,157339,155883,9334,146549,19353,127196,80223,5539,25440,3122,105663,12872,4632,1890,21372,13368
CATACTCCTTGGAGAG,sample,175888,174670,7190,167480,18925,148555,108723,8786,20270,2193,128993,8583,4475,2517,19627,13904
TCGAACGATTGGAGAG,sample,117273,116393,3793,112600,12629,99971,74198,5439,13202,1635,87400,5497,3329,2213,15146,8787
TCATACCATTGGAGAG,sample,84701,84046,3516,80530,8916,71614,54329,3800,7923,1038,62252,4524,3242,1990,11644,6316
TGATTCCGTTGGAGAG,Pos_Ctrl,22643,22322,1656,20666,963,19703,16444,1410,1291,145,17735,413,3847,3622,1271,478
TCTCAGGATTGGAGAG,sample,53593,53108,3049,50059,6751,43308,28499,1854,8411,1097,36910,3447,2611,1279,10736,4941
ACGCTTAATTGGAGAG,sample,45710,45363,1638,43725,5295,38430,28367,1735,5760,704,34127,1864,2196,1552,8511,3666
TAGCGAGTTTGGAGAG,sample,88669,88109,2315,85794,13835,71959,62143,4792,3208,680,65351,1136,1863,2173,16298,10419
CTAACCGGTTGGAGAG,sample,43035,42715,1977,40738,5278,35460,25108,1884,5337,553,30445,2578,2968,2102,5992,3556
GGCGTACCTTGGAGAG,sample,95689,94816,2220,92596,12729,79867,67962,7481,3001,287,70963,1136,968,1208,15877,10774
GTCGCGAATTGGAGAG,sample,170655,169568,5925,163643,19380,144263,109864,9934,14983,1785,124847,7697,3097,1984,19423,14642
TAACGCCATTGGAGAG,sample,127595,126727,3756,122971,14103,108868,85913,6611,10955,976,96868,4413,2867,1806,20148,10124
GACGTATGTTCAAGCC,sample,21566,21416,1199,20217,4613,15604,10275,900,2766,296,13041,1367,2507,1817,2318,3130
GGAGAAGCTTCAAGCC,sample,74173,73566,3823,69743,9957,59786,37950,2466,11177,1773,49127,6420,3273,1227,13520,6719
TCGAACGATTCAAGCC,sample,77452,76915,2773,74142,11400,62742,45695,3720,8785,924,54480,3618,2513,1358,14707,8099
CGTCGCCATTCAAGCC,sample,38631,38248,2814,35434,4176,31258,21020,1398,5172,498,26192,3170,2777,1267,8633,2766
TCATCGAATTCAAGCC,sample,38802,38361,4355,34006,3612,30394,13021,768,9424,1028,22445,6153,3876,1272,1881,2118
ATTCAAGGTTCAAGCC,sample,130251,129035,10716,118319,8185,110134,60185,3944,25051,3413,85236,17541,6097,1606,5834,4196
ATACGTTCTTCAAGCC,sample,97751,96941,6703,90238,11216,79022,47345,2897,16528,2147,63873,10105,5283,1674,13000,8321
CCGTACGCTTCAAGCC,sample,30601,30015,3090,26925,3285,23640,14459,779,4584,430,19043,3388,2698,1107,4610,2158
CGGTTGGTTTCAAGCC,sample,60671,59960,3499,56461,5050,51411,30624,1346,12461,1490,43085,5490,3073,1314,7805,3387
CATTCGGTTTCAAGCC,sample,24858,24584,2168,22416,2560,19856,10183,826,5365,616,15548,2866,2720,1294,2839,1572
GAGATTCTTTCAAGCC,sample,62017,61393,4332,57061,6969,50092,30434,1888,9956,1200,40390,6614,4019,1540,8661,4898
AAGGTCTGTTCAAGCC,sample,75780,75039,4977,70062,9652,60410,43505,2269,8531,753,52036,5352,2575,1319,13470,7013
CCTAGCGGTTCAAGCC,sample,9728,9615,1293,8322,877,7445,3522,238,2031,205,5553,1449,1603,719,1071,487
TGCGCTCCTTCAAGCC,sample,53336,52983,2228,50755,6065,44690,33686,2504,4872,548,38558,3080,2264,1179,10910,4343
CGTCGAGGTTCAAGCC,Pos_Ctrl,23878,23408,1724,21684,1007,20677,17157,1524,1402,197,18559,397,3944,3748,1129,432
CAGCTTCGTTCAAGCC,sample,62443,61846,4149,57697,5626,52071,35467,2047,8046,728,43513,5783,3702,1465,7974,3514
TTATGACGTTCAAGCC,sample,91272,90512,2843,87669,7127,80542,62001,4835,8586,1124,70587,3996,2963,2040,10698,5066
ATTCTACCTTCAAGCC,sample,106804,106077,2667,103410,11215,92195,77748,6108,4660,598,82408,3081,2094,1878,15388,8113
GACTAACCTTCAAGCC,sample,96683,95831,5641,90190,8300,81890,55859,5027,11288,1139,67147,8577,4333,1439,11194,5535
CGCGAGACTTCAAGCC,sample,96046,95170,2016,93154,11044,82110,72088,5814,3198,327,75286,683,939,1223,15038,7570
CTGGTCTTAACTTAAC,sample,85294,84407,2579,81828,16393,65435,52673,5274,4885,561,57558,2042,1904,1684,12979,11019
GTCGTTCTAACTTAAC,Neg_Ctrl,672,363,144,219,13,206,152,18,16,2,168,18,90,60,37,7
GACGTATGAACTTAAC,sample,66955,66569,2405,64164,9062,55102,39156,3580,8074,800,47230,3492,2810,1789,11056,6435
GGAGAAGCAACTTAAC,sample,91986,91456,2286,89170,14193,74977,60429,4528,7010,624,67439,2386,2130,1778,16709,9529
CTAGCGACAACTTAAC,sample,66700,66354,3868,62486,8549,53937,36858,2791,8447,1072,45305,4769,3045,1582,10166,5296
TCGAACGAAACTTAAC,sample,55182,54879,2151,52728,6683,46045,33265,2457,6319,807,39584,3197,2687,1657,9022,4687
GGTAGAGAAACTTAAC,sample,42522,42037,2266,39771,7653,32118,22587,1429,5006,603,27593,2493,2013,1052,8327,5485
TCATCGAAAACTTAAC,sample,74440,74046,3203,70843,7424,63419,40886,2636,13543,1364,54429,4990,3519,1863,9873,5301
TGATTCCGAACTTAAC,sample,59256,58615,2848,55767,5925,49842,37827,2132,6436,677,44263,2770,2340,1632,9775,4361
GCAACTAGAACTTAAC,Neg_Ctrl,585,266,151,115,10,105,75,15,8,3,83,4,42,38,19,4
CCGTACGCAACTTAAC,sample,93656,93063,4123,88940,9338,79602,55388,3811,12914,1247,68302,6242,4277,2411,11516,6447
TGCGCGTTAACTTAAC,sample,93735,93031,4291,88740,12939,75801,53014,3638,12304,1476,65318,5369,3706,1918,13669,9725
AGCGTCTTAACTTAAC,sample,86423,85737,6864,78873,8142,70731,41467,2386,15685,1616,57152,9577,4275,1609,11252,5191
CATTCGGTAACTTAAC,sample,68581,67991,4025,63966,11455,52511,42702,3382,3883,349,46585,2195,1574,1191,14421,8522
TAGCGAGTAACTTAAC,sample,21774,21557,2161,19396,2463,16933,8994,475,4591,413,13585,2460,2573,1061,3066,1556
GAGATTCTAACTTAAC,sample,60339,59781,3277,56504,6072,50432,34871,2060,8872,899,43743,3730,2392,1346,7446,4488
GGCGTACCAACTTAAC,sample,88075,87445,2877,84568,9769,74799,62551,4219,5529,437,68080,2063,2341,1929,12064,7292
TCTCCTAGAACTTAAC,sample,77201,76618,3189,73429,7301,66128,50594,4074,6844,881,57438,3735,2725,1810,8487,5157
AAGTAGAGAACTTAAC,sample,84291,83701,2354,81347,8690,72657,61155,5231,4200,361,65355,1710,1624,1261,13478,6677
ATTCTACCAACTTAAC,sample,65498,64835,3774,61061,5437,55624,37886,2474,8738,991,46624,5535,3070,1221,8196,3821
CGCGAGACAACTTAAC,sample,77463,76790,5121,71669,7346,64323,42678,3380,9629,1296,52307,7340,4024,1474,9671,5255
TTAACTGAAACTTAAC,sample,98662,97999,4582,93417,7407,86010,64115,4865,9615,1292,73730,6123,3656,1823,10534,4386
ATATGCAAAACTTAAC,sample,2791,2725,133,2592,231,2361,1460,159,462,45,1922,235,650,454,218,142
TCTAGGTTATACTTGA,sample,54711,54144,4617,49527,6863,42664,27854,2221,7117,765,34971,4707,3246,1367,8656,4483
AGAGTTCTATACTTGA,sample,96672,96062,3913,92149,11961,80188,55088,4190,13733,1214,68821,5963,3194,1376,19332,8612
AGCTGAATATACTTGA,sample,174874,173901,5049,168852,23309,145543,116441,8389,14423,1670,130864,4620,2631,1834,27637,15995
GACGTATGATACTTGA,sample,118938,117888,4647,113241,15915,97326,73878,6136,11065,1104,84943,5143,3368,1743,20618,12029
TATACGGAATACTTGA,sample,100220,99100,8939,90161,10778,79383,41812,2863,21148,2089,62960,11471,5472,1561,10790,6842
GGAGAAGCATACTTGA,sample,101702,101029,5350,95679,11183,84496,54717,3451,16695,1734,71412,7899,4357,1874,12944,7629
CATACTCCATACTTGA,sample,71132,70651,3140,67511,7356,60155,38629,2720,12138,1053,50767,5615,3702,2088,9216,4908
CTAGCGACATACTTGA,sample,849,837,31,806,167,639,455,60,69,8,524,47,223,174,150,116
TCTCAGGAATACTTGA,sample,29404,29222,568,28654,4026,24628,21352,1836,897,199,22249,344,1326,1580,5873,3012
GATGCGTTATACTTGA,sample,26115,25913,1474,24439,3002,21437,15813,903,2832,350,18645,1539,2242,1547,3967,2006
CTAAGCATATACTTGA,sample,174888,173829,10523,163306,22398,140908,94144,7087,21049,2293,115193,16335,6648,2126,22958,15528
CTAACCGGATACTTGA,sample,79623,78888,3537,75351,7530,67821,47847,3895,10246,941,58093,4892,3090,1616,11586,5174
GCTGCTTCATACTTGA,sample,104718,103935,3756,100179,10084,90095,61197,5315,16255,1870,77452,5458,3135,1679,14237,6937
GCCTATTCATACTTGA,sample,37193,36841,3971,32870,5077,27793,14988,1159,6574,1050,21562,4022,3716,1683,3785,3440
GTCGCGAAATACTTGA,sample,89605,88739,6626,82113,5969,76144,38299,3621,20816,2193,59115,11215,5551,1973,6756,3890
CAGCTTCGATACTTGA,Neg_Ctrl,1335,714,349,365,31,334,223,11,61,5,284,34,143,91,61,14
TCTCCTAGATACTTGA,sample,70367,69628,4784,64844,5911,58933,37688,2682,11193,1124,48881,6246,3724,1587,6758,4089
AAGTAGAGATACTTGA,sample,57424,56780,4585,52195,6534,45661,23266,1964,10557,1486,33823,8388,3466,887,5198,4054
TCAATCAGATACTTGA,sample,41039,40554,3132,37422,3387,34035,17998,1208,8879,810,26877,5140,3195,1087,4013,1939
GACTAACCATACTTGA,sample,37836,37260,5141,32119,2815,29304,12530,951,8235,819,20765,6769,3928,1067,2462,1655
GCGCAATAATACTTGA,sample,125817,124541,10602,113939,9141,104798,54243,3419,25266,2827,79509,19043,6824,1399,14067,5344
AACCGGTTATCCGCGA,sample,59430,59137,2642,56495,6319,50176,29597,2630,11426,1707,41023,4816,3269,1679,7333,4470
CATAATGGATCCGCGA,sample,39458,38971,2149,36822,5862,30960,19801,1698,5453,570,25254,3438,2740,1366,2429,3609
CATACTCCATCCGCGA,sample,125089,124189,8666,115523,16678,98845,62862,4995,16655,2188,79517,12145,5482,2170,16560,11248
TCGAACGAATCCGCGA,sample,97309,96743,2878,93865,16508,77357,65288,4780,4768,618,70056,1903,1673,1633,19034,11851
TCATCGAAATCCGCGA,sample,118449,117702,5046,112656,14029,98627,64309,4110,20434,1776,84743,7998,4060,1649,18843,10198
TGGATCAAATCCGCGA,sample,38824,38523,2554,35969,4422,31547,20660,1274,6014,713,26674,2886,2526,1245,6490,2946
TGCGCGTTATCCGCGA,sample,111916,111205,5217,105988,17679,88309,62185,4867,13205,1664,75390,6388,3490,1416,16304,12319
CCATTCTTATCCGCGA,sample,119397,118343,7240,111103,12570,98533,68019,4606,14920,2400,82939,8588,4485,1953,13759,7271
ACGCTTAAATCCGCGA,sample,112480,111672,3119,108553,17267,91286,80116,5664,4189,216,84305,1101,1113,1343,23383,12360
TAGCGAGTATCCGCGA,sample,85119,84251,6427,77824,9380,68444,35903,2639,16121,1940,52024,11841,4942,1198,10327,6399
GCTCTTCTATCCGCGA,sample,101484,100447,8915,91532,11761,79771,46551,2714,15985,1508,62536,13013,5169,1209,16078,7546
GCTGCTTCATCCGCGA,sample,138215,137008,8646,128362,12490,115872,78995,5367,17843,2151,96838,11516,5619,1985,17239,8365
TGCGCTCCATCCGCGA,sample,65771,65074,5649,59425,5454,53971,26191,1785,15291,2052,41482,8652,4912,1849,3367,3124
ATACCGCCATCCGCGA,sample,16866,16586,1073,15513,2270,13243,7912,665,3033,281,10945,1352,2024,1239,745,1436
GCGTTACCATCCGCGA,sample,115776,114739,7812,106927,8948,97979,52937,3777,26786,2638,79723,11841,5080,1640,11215,6074
TCAATCAGATCCGCGA,sample,44473,44005,3235,40770,3926,36844,22259,1894,7841,812,30100,4038,3234,1271,4737,2288
GCGCAATAATCCGCGA,sample,94041,93232,3681,89551,8080,81471,54799,3652,14651,1937,69450,6432,3031,1295,10236,5776
TTAACTGAATCCGCGA,sample,111750,110735,6269,104466,9015,95451,65306,4378,15058,1356,80364,9353,4430,1463,13779,6242
ATATGCAAATCCGCGA,sample,16085,15942,553,15389,1645,13744,8773,802,2975,355,11748,839,1561,1186,1349,1011
GTCGTTCTAGGACTCA,sample,136553,135714,8359,127355,15802,111553,64856,4531,25530,2602,90386,14034,5939,2067,15044,10987
AGCTGAATAGGACTCA,sample,128083,127141,5135,122006,14796,107210,77338,5652,15414,1480,92752,7326,3421,1966,21449,10002
CATAATGGAGGACTCA,sample,118078,117370,3935,113435,13902,99533,69460,4298,17637,1143,87097,6995,2708,1653,17484,10869
TATACGGAAGGACTCA,sample,103739,103065,4507,98558,16240,82318,56136,3813,14705,1453,70841,6211,3826,1445,18706,11615
CTAGCGACAGGACTCA,sample,116543,115433,7135,108298,16035,92263,68345,5063,9603,1305,77948,7947,3615,1551,22803,11957
GGTAGAGAAGGACTCA,sample,15497,15304,1437,13867,1692,12175,6733,396,3022,285,9755,1739,1806,823,2122,1117
TCATCGAAAGGACTCA,sample,125803,124990,4565,120425,17421,103004,81359,6792,9417,1076,90776,4360,2747,1645,22482,12587
GACTCAAGAGGACTCA,sample,123540,122804,3208,119596,13979,105617,85135,7027,8813,869,93948,3773,2578,2075,18944,10128
TGGATCAAAGGACTCA,sample,92346,91692,2883,88809,8758,80051,60221,4314,8496,998,68717,6022,3319,1329,10000,5747
ATGGCGTTAGGACTCA,sample,62254,61804,2491,59313,7584,51729,40379,2497,5485,728,45864,2640,2589,1890,8395,5560
CCATTCTTAGGACTCA,sample,76427,75849,4077,71772,7400,64372,45165,2915,10441,967,55606,4884,3229,1666,11964,5407
AGCGTCTTAGGACTCA,sample,34544,34224,2446,31778,2621,29157,17768,1099,6527,768,24295,2995,2776,1549,3095,1702
CGGTTGGTAGGACTCA,sample,45222,44885,1358,43527,4625,38902,28695,1885,6383,482,35078,1457,1856,1545,6212,3493
AAGGTCTGAGGACTCA,sample,88227,87444,7602,79842,8126,71716,41159,2560,14178,1564,55337,12255,5270,1499,10553,5106
GCTGCTTCAGGACTCA,sample,97265,96637,3848,92789,9091,83698,56427,3648,15234,1895,71661,6494,3307,1623,14290,5817
TGCGCTCCAGGACTCA,sample,67752,67069,3792,63277,8630,54647,35107,2398,9768,846,44875,6528,3006,1073,9016,5737
ATACCGCCAGGACTCA,sample,134952,133862,6391,127471,11487,115984,88440,6848,13313,1395,101753,5988,3559,2276,15678,8142
CGTCGAGGAGGACTCA,sample,58827,58142,3372,54770,6331,48439,33416,1610,7597,821,41013,4995,2791,1064,8533,4282
CGCGGTCGAGGACTCA,sample,42709,42221,2339,39882,4832,35050,28641,2413,2215,466,30856,1315,1383,1264,6668,3434
TCTCCTAGAGGACTCA,sample,68781,67903,5396,62507,8287,54220,32947,2523,10946,1197,43893,6607,3687,1193,6976,5297
ATGAATAGAGGACTCA,sample,71120,70446,3019,67427,7101,60326,41635,3098,9312,890,50947,5391,2255,1081,9588,4994
ATTCTACCAGGACTCA,sample,146181,144739,10067,134672,8757,125915,69013,4481,29604,3342,98617,19475,6393,2047,8889,4961
GACTAACCAGGACTCA,sample,121190,120199,4663,115536,11716,103820,79752,6128,10215,935,89967,6790,3569,1803,12431,7163
CCTAACTAAGGACTCA,Pos_Ctrl,43524,42851,2248,40603,1593,39010,32519,2776,2583,410,35102,722,4846,5549,1849,475
CTGGTCTTTATTGAAC,sample,62048,61694,2240,59454,11002,48452,33924,2923,7649,800,41573,3156,2439,1358,9650,7267
GACGTATGTATTGAAC,sample,85335,84891,3011,81880,10620,71260,51276,4929,9220,1178,60496,4657,3887,2066,15315,7710
CATAATGGTATTGAAC,sample,75384,75058,1659,73399,11723,61676,49770,5233,4288,359,54058,2026,2320,1797,13851,8616
GAGCCTCCTATTGAAC,sample,61071,60606,2720,57886,6430,51456,35391,3203,7502,740,42893,4620,3187,1453,7741,4265
CGTCGCCATATTGAAC,sample,109001,108339,4696,103643,14323,89320,57188,4158,17097,1799,74285,9078,4754,1755,15869,10075
TCATCGAATATTGAAC,sample,129158,128468,5148,123320,16638,106682,72100,5352,19410,2612,91510,7208,3754,1960,12630,11446
TCATACCATATTGAAC,sample,37189,36853,2683,34170,5143,29027,18416,1211,5486,702,23902,3212,2757,1313,6028,3555
ATTCAAGGTATTGAAC,sample,85811,85236,3148,82088,12409,69679,50262,3820,8849,1156,59111,5592,3509,1749,17120,8633
TACGCGAGTATTGAAC,sample,137390,136549,5854,130695,20856,109839,80391,7016,13064,1526,93455,7842,3974,1752,24125,14542
CCGTACGCTATTGAAC,sample,96324,95635,3476,92159,11665,80494,60174,4583,10987,1028,71161,3722,2832,1517,16389,9264
GATGCGTTTATTGAAC,sample,49661,49343,3166,46177,5994,40183,23834,1604,8602,995,32436,5148,3551,1257,7031,4038
AGCGTCTTTATTGAAC,sample,69033,68384,5596,62788,6011,56777,32285,2691,12060,1309,44345,8432,4188,1121,7959,3497
CATTCGGTTATTGAAC,sample,114319,113453,6214,107239,9157,98082,55857,5045,20689,1925,76546,14566,5591,1468,11489,5708
TAGCGAGTTATTGAAC,sample,54068,53494,2976,50518,5656,44862,27748,2544,8322,1090,36070,5158,2985,880,6532,3674
GCTCTTCTTATTGAAC,sample,74233,73516,5375,68141,5579,62562,34244,2463,14823,1357,49067,9675,4365,1377,5708,3215
GGCGACGATATTGAAC,sample,90361,89662,4629,85033,8160,76873,48958,3103,14415,1281,63373,9116,4283,1680,13309,5488
GCTGCTTCTATTGAAC,sample,48276,47735,3668,44067,4321,39746,21710,1759,9549,981,31259,5747,4184,1574,3769,2345
GCCTATTCTATTGAAC,sample,61880,61367,1863,59504,6335,53169,41778,2266,6355,554,48133,2216,2205,1520,12213,4572
ATACCGCCTATTGAAC,sample,85929,85170,4103,81067,8334,72733,46837,3663,14126,1192,60963,6915,3492,1392,10872,5913
GGCGTACCTATTGAAC,sample,111658,110768,5007,105761,11478,94283,68202,5529,11844,1785,80046,6923,3709,1854,15403,7768
CGTCGAGGTATTGAAC,sample,78134,77445,5699,71746,5956,65790,36865,2651,15953,1459,52818,8862,4703,1459,8139,4210
CAGCTTCGTATTGAAC,sample,95008,93688,11816,81872,4682,77190,28048,1675,26181,3258,54229,18028,6674,1548,2998,1713
CGCGAGACTATTGAAC,sample,104175,103174,4655,98519,8762,89757,66125,8906,8403,733,74528,5590,3222,1510,10459,6399
CGTAGAACTATTGAAC,sample,91483,90458,6573,83885,7597,76288,47858,4237,13966,1289,61824,8938,4597,1598,9997,4737
CATAATGGGTTCAACT,sample,39196,38943,1302,37641,5785,31856,25684,1940,2564,362,28248,1306,1922,1576,6467,4141
GAGCCTCCGTTCAACT,sample,23102,22903,1561,21342,2566,18776,13416,1017,2413,268,15829,1662,1810,1114,3971,1821
CATACTCCGTTCAACT,sample,35433,35168,1373,33795,5545,28250,21946,1710,2864,245,24810,1485,1567,1130,6315,4039
CTAGCGACGTTCAACT,sample,26059,25852,1325,24527,3043,21484,14997,1136,2997,326,17994,2028,2025,1197,4854,2019
TCATCGAAGTTCAACT,sample,45530,45290,1420,43870,6970,36900,28953,2383,3587,447,32540,1530,1734,1580,6611,5029
TGATTCCGGTTCAACT,sample,41041,40730,1685,39045,3547,35498,23206,1737,7064,974,30270,2517,2510,1709,4320,2626
ATACGTTCGTTCAACT,sample,40455,40145,1334,38811,4683,34128,25597,2462,4031,521,29628,1517,1720,1451,7127,3296
TCTCAGGAGTTCAACT,sample,24743,24541,1285,23256,2546,20710,13907,954,3546,426,17453,1877,1986,1268,3341,1778
GATGCGTTGTTCAACT,sample,18434,18250,1174,17076,1428,15648,8638,565,4555,535,13193,1355,1651,983,1751,823
TGCGCGTTGTTCAACT,sample,30924,30708,1052,29656,4483,25173,21129,1406,1648,174,22777,816,1387,1290,6283,3541
CGGTTGGTGTTCAACT,sample,35967,35582,1948,33634,2811,30823,20609,1472,4997,496,25606,3249,2377,1227,4681,1796
TAGCGAGTGTTCAACT,sample,42570,42223,3198,39025,3589,35436,19841,1765,8887,1030,28728,3913,2713,1352,4581,2406
AAGGTCTGGTTCAACT,sample,34410,34168,1005,33163,4089,29074,21803,1887,3387,414,25190,1583,2325,2080,3084,2788
CTAACCGGGTTCAACT,sample,37378,36934,3868,33066,2481,30585,14936,921,7670,882,22606,6176,3828,1020,4066,1471
GGCGACGAGTTCAACT,sample,8318,8176,534,7642,900,6742,3780,303,1697,243,5477,719,1083,505,1162,565
TAACGAAGGTTCAACT,sample,37403,37043,2091,34952,3825,31127,21175,1456,4671,416,25846,3409,2342,1304,5298,2234
GCTGCTTCGTTCAACT,sample,49957,49567,1784,47783,4053,43730,34585,2379,4784,369,39369,1613,2186,1925,5111,3004
AGCAGAGCGTTCAACT,sample,28433,28180,1040,27140,3125,24015,19345,1814,1788,230,21133,838,1648,1528,3675,2250
GCGTTACCGTTCAACT,sample,26668,26413,1495,24918,2167,22751,14415,1075,3899,529,18314,2833,2152,999,3170,1412
CGTCGAGGGTTCAACT,sample,19829,19588,825,18763,1864,16899,13221,1077,1456,186,14677,959,1158,906,2966,1380
GACTAACCGTTCAACT,sample,18293,18032,1555,16477,1239,15238,9025,679,2987,349,12012,2198,1679,698,2246,682
CGCGAGACGTTCAACT,sample,27926,27626,1863,25763,1795,23968,15375,930,3916,404,19291,3343,2308,1134,3158,922
GCGCAATAGTTCAACT,Neg_Ctrl,308,190,64,126,4,122,82,4,21,2,103,13,63,36,16,3
TTAACTGAGTTCAACT,sample,20704,20516,799,19717,2267,17450,13217,948,1987,255,15204,1043,1445,1056,2722,1587
TATACGGACTGAGGTT,sample,102640,101981,3385,98596,13362,85234,54845,4237,17895,2236,72740,6021,3243,1722,14170,9350
TCGAACGACTGAGGTT,sample,11230,11170,285,10885,1646,9239,6741,600,1379,150,8120,369,1318,1086,1410,1162
CGTCGCCACTGAGGTT,sample,100642,100109,3858,96251,14131,82120,59153,4591,10525,1306,69678,6545,3885,2175,16118,10141
TCATACCACTGAGGTT,sample,118696,117725,4132,113593,9496,104097,70411,7887,15358,2209,85769,8232,3744,1537,10022,5381
ATACGTTCCTGAGGTT,sample,73026,72397,3925,68472,5238,63234,43030,2937,11035,1139,54065,5093,3425,1550,6331,3787
CCGTACGCCTGAGGTT,sample,109680,108417,4556,103861,9360,94501,67289,5570,11611,1719,78900,8312,4290,1523,10109,6586
CGGTTGGTCTGAGGTT,sample,140738,139567,4043,135524,15762,119762,98739,6854,9922,1025,108661,3222,2187,1621,25637,11640
ACGCTTAACTGAGGTT,sample,63841,63034,3909,59125,7259,51866,31662,1920,10330,1084,41992,6870,3313,1032,7787,4730
CATTCGGTCTGAGGTT,sample,112474,111565,5573,105992,11311,94681,60638,4643,17455,1928,78093,10017,4969,1744,18288,8066
GAGATTCTCTGAGGTT,sample,132759,131751,4095,127656,10700,116956,80893,5676,20921,2955,101814,6511,3275,2086,14636,6736
CTAAGCATCTGAGGTT,sample,124574,123431,4789,118642,15661,102981,80915,5226,9673,1411,90588,5756,2856,1364,23543,10946
GGCGACGACTGAGGTT,sample,115877,114925,3955,110970,16820,94150,77211,6558,5640,804,82851,3937,2640,2066,17207,12192
ATACCGCCCTGAGGTT,sample,162708,161474,7423,154051,16430,137621,104017,6805,15176,1736,119193,9887,4533,1910,23434,11491
GGCGTACCCTGAGGTT,sample,171294,170028,6011,164017,15516,148501,113192,10581,17870,1612,131062,5246,2938,2118,18960,12028
CGTCGAGGCTGAGGTT,sample,103364,102589,2286,100303,8960,91343,73089,7070,7810,463,80899,2911,2176,1795,13994,6202
CAGCTTCGCTGAGGTT,sample,97885,96931,3852,93079,9143,83936,56369,5800,12733,1688,69102,7346,3377,1347,13390,6496
CGCGGTCGCTGAGGTT,sample,121453,120232,10680,109552,9704,99848,42933,3134,28725,3156,71658,21900,8109,1887,10108,5950
ATGAATAGCTGAGGTT,sample,89448,88683,3875,84808,9116,75692,58494,5541,7030,1326,65524,3301,2897,1926,6805,5858
TCAATCAGCTGAGGTT,sample,92107,91404,2702,88702,9813,78889,59921,4912,8667,1584,68588,3805,2777,1573,12519,6831
GACTAACCCTGAGGTT,sample,110934,109773,4415,105358,10333,95025,68474,6152,11904,925,80378,7570,3699,1264,15888,7041
GCGCAATACTGAGGTT,sample,149205,147793,7961,139832,10991,128841,83591,6657,22608,2186,106199,13799,4390,1544,15784,7575
AACCGGTTAGACCGTT,sample,179678,178754,4317,174437,26875,147562,120859,9162,11212,1032,132071,5297,3433,2491,29640,19168
CTGGTCTTAGACCGTT,sample,133554,132732,3422,129310,13533,115777,76543,6186,24297,2811,100840,5940,3573,2481,15614,8451
AGAGTTCTAGACCGTT,sample,128362,127801,3549,124252,15301,108951,80970,6356,14032,1583,95002,6010,3927,2551,14988,10633
TATACGGAAGACCGTT,sample,144142,143409,3834,139575,22612,116963,95467,6602,10051,1217,105518,3626,1974,1718,26463,16994
CATACTCCAGACCGTT,sample,74064,73633,3342,70291,8512,61779,45788,3210,7479,813,53267,4489,3559,2185,10404,5683
CTAGCGACAGACCGTT,sample,132865,132016,3374,128642,19443,109199,88416,6886,9127,1530,97543,3240,2276,1896,19569,13901
TCGAACGAAGACCGTT,sample,103071,102412,2225,100187,13855,86332,73104,6054,5318,601,78422,1255,1498,1755,16802,10774
TGGATCAAAGACCGTT,sample,146244,144913,6306,138607,10087,128520,75492,5881,30764,3570,106256,12813,4158,1399,13979,5963
GATGCGTTAGACCGTT,sample,210751,209239,8355,200884,17289,183595,137649,9279,20272,2230,157921,14165,5608,2462,22338,10354
CGGTTGGTAGACCGTT,sample,74062,73299,4443,68856,7441,61415,36447,3458,13483,1430,49930,6597,3422,1302,9611,4716
ACGCTTAAAGACCGTT,sample,129515,128603,3765,124838,15977,108861,88817,5100,10343,1046,99160,3555,2078,1511,28201,12257
GCTCTTCTAGACCGTT,sample,139945,138898,6837,132061,14053,118008,79656,6531,19322,1868,98978,10631,3405,1714,18961,10644
CTAAGCATAGACCGTT,sample,120211,119249,5260,113989,7588,106401,59759,4148,29197,3815,88956,9482,4200,1909,9094,4745
GGCGACGAAGACCGTT,sample,52762,52224,4526,47698,3960,43738,21338,1230,12662,1355,34000,7153,4015,1384,4125,2243
TAACGAAGAGACCGTT,sample,122333,121292,6389,114903,9379,105524,60501,4935,24674,3395,85175,12019,4049,1522,9614,5846
GCTGCTTCAGACCGTT,sample,142091,140822,6933,133889,12194,121695,84074,4852,19100,2036,103174,11633,5447,2314,14754,8165
TCTCCTAGAGACCGTT,sample,100481,99743,3039,96704,13400,83304,71108,5121,3855,402,74963,2818,2218,1858,14611,9346
TAACGCCAAGACCGTT,sample,64883,64180,3152,61028,4232,56796,30197,2138,15722,1609,45919,7130,3084,1218,1908,2521
CGCGAGACAGACCGTT,sample,91220,90247,3759,86488,7062,79426,58215,4203,9950,1260,68165,5798,3277,1441,14256,4630
AACCGGTTCTTGAGTT,sample,43755,43382,851,42531,8264,34267,27549,2666,2776,373,30325,903,1611,1540,7484,5609
TCTAGGTTCTTGAGTT,sample,93274,92795,2564,90231,14286,75945,57780,4050,10087,1387,67867,2641,2558,1675,20211,10267
GTCGTTCTCTTGAGTT,sample,101982,101199,2406,98793,15203,83590,67655,5048,7406,1016,75061,2465,2355,1811,22133,10624
AGAGTTCTCTTGAGTT,sample,201369,200160,7734,192426,23913,168513,116932,9405,24996,3015,141928,14165,5283,2194,32486,17761
GGTAGAGACTTGAGTT,sample,56191,55730,2613,53117,9708,43409,31121,2056,6770,617,37891,2845,2570,1448,8498,6689
TCATCGAACTTGAGTT,sample,154146,152855,4275,148580,13067,135513,110023,11028,8739,661,118762,5062,2113,1368,19952,9377
TCTCAGGACTTGAGTT,sample,157209,155995,9430,146565,22081,124484,84389,5914,18722,2054,103111,13405,5238,1895,25482,15510
GATGCGTTCTTGAGTT,sample,145752,144770,5993,138777,18342,120435,88043,6185,16236,1823,104279,8148,4412,2167,24539,14102
ATGGCGTTCTTGAGTT,sample,167392,166247,18715,147532,15188,132344,72800,4824,30321,3429,103121,20970,7573,2759,17859,9144
TGCGCGTTCTTGAGTT,sample,118948,117959,5448,112511,15036,97475,66950,4372,16347,1929,83297,7877,3810,1710,20600,10546
ACGCTTAACTTGAGTT,sample,158614,157238,8344,148894,14695,134199,89656,6911,20687,2626,110343,14319,5502,1802,29675,10856
AAGGTCTGCTTGAGTT,sample,108089,107242,5784,101458,11842,89616,55045,4592,17903,2285,72948,9791,5146,2067,10971,8845
CTAACCGGCTTGAGTT,sample,72813,72109,4617,67492,7617,59875,39707,3512,9535,924,49242,6197,3605,1426,10564,5304
GGCGACGACTTGAGTT,sample,123959,122687,8027,114660,8600,106060,61411,3899,24121,2421,85532,14208,5765,1863,14476,6299
TGCGCTCCCTTGAGTT,sample,106342,105058,3852,101206,10579,90627,68828,5332,10111,1506,78939,4850,3465,1714,11709,8056
ATACCGCCCTTGAGTT,sample,102910,101670,5135,96535,9847,86688,59749,5286,13075,1818,72824,6760,3464,1416,15414,7143
GCGTTACCCTTGAGTT,sample,72049,71065,4351,66714,5759,60955,28582,2189,18355,1847,46937,9982,4125,1302,2751,3602
CGTCGAGGCTTGAGTT,sample,99221,98377,2302,96075,10366,85709,72472,5870,4776,638,77248,1953,2072,1930,11739,7988
TTATGACGCTTGAGTT,sample,108975,107958,3814,104144,8892,95252,70222,5043,12182,1593,82404,6212,3417,1808,12313,5934
TAACGCCACTTGAGTT,sample,78642,77831,2685,75146,8456,66690,52886,3676,5585,763,58471,3780,2406,1411,8321,5575
GACTAACCCTTGAGTT,sample,56300,55535,2892,52643,5294,47349,33631,2807,6707,565,40338,3639,2520,1331,5237,3106
AACCGGTTTCGGAGTT,sample,48928,48378,1958,46420,7073,39347,28207,2053,4916,519,33123,3652,2458,1027,10016,4871
CTGGTCTTTCGGAGTT,sample,68444,67942,1550,66392,9081,57311,46828,3775,4061,438,50889,2209,2085,1504,15198,6464
AGAGTTCTTCGGAGTT,sample,91281,90722,2385,88337,11681,76656,61185,5060,7432,722,68617,2257,2583,2337,14088,8976
AGCTGAATTCGGAGTT,sample,60775,60288,1932,58356,9049,49307,40179,2579,4034,560,44213,1955,2171,1610,9773,6326
CATAATGGTCGGAGTT,sample,65386,64978,1566,63412,10293,53119,45729,3361,2530,354,48259,1145,2487,2693,9123,7341
CATACTCCTCGGAGTT,sample,43899,43535,1807,41728,6124,35604,26195,1916,4418,518,30613,2557,2558,1466,6960,4311
TCGAACGATCGGAGTT,sample,42995,42681,1192,41489,5662,35827,27559,1869,3959,507,31518,1933,2139,1688,7858,4281
TCATCGAATCGGAGTT,sample,10545,10324,488,9836,1836,8000,5995,451,951,181,6946,422,934,684,1665,1262
TCATACCATCGGAGTT,sample,67233,66772,2188,64584,6827,57757,42888,3172,7961,734,50849,3002,2356,1796,9079,5215
TACGCGAGTCGGAGTT,sample,54051,53618,3444,50174,4797,45377,26365,1923,10454,1188,36819,5447,3872,1646,6771,3376
CCGCAGTCTCGGAGTT,sample,24846,24512,1879,22633,1911,20722,9001,654,6638,738,15639,3691,2696,930,1542,957
CCGTACGCTCGGAGTT,sample,66975,66484,1713,64771,8206,56565,47361,3554,3622,585,50983,1443,2258,2394,11527,6120
TGCGCGTTTCGGAGTT,sample,54177,53686,3498,50188,5655,44533,28907,1641,8058,721,36965,5206,2886,1146,10487,3914
TAGCGAGTTCGGAGTT,sample,56682,56251,2272,53979,8223,45756,35502,2674,4077,601,39579,2902,2851,1944,8678,5920
CTAAGCATTCGGAGTT,sample,45775,45281,4189,41092,3905,37187,20406,1226,8025,906,28431,6624,3937,1282,5816,2339
AGCAGAGCTCGGAGTT,sample,60334,59751,2680,57071,4288,52783,36068,2186,9472,1203,45540,3854,2779,1645,7426,2860
GGCGTACCTCGGAGTT,sample,58705,58188,1777,56411,7152,49259,40541,3486,3275,266,43816,1691,1438,1357,10608,5093
CGTCGAGGTCGGAGTT,Pos_Ctrl,19109,18839,996,17843,650,17193,14324,1281,1027,164,15351,397,3485,3403,854,204
AAGTAGAGTCGGAGTT,sample,57132,56539,2416,54123,3706,50417,34040,2606,8417,1014,42457,4340,2557,1184,6158,2339
TAACGCCATCGGAGTT,sample,56069,55517,3089,52428,4055,48373,33018,2513,6998,769,40016,5075,3144,1199,5615,2404
CCTAACTATCGGAGTT,sample,87966,87088,4626,82462,6614,75848,47729,3835,13446,1576,61175,9262,5045,1540,9545,4505
GCGCAATATCGGAGTT,sample,35130,34635,2394,32241,1897,30344,16929,1137,7421,771,24350,4086,2840,1201,2154,958
CTGGTCTTTGAACCTT,Pos_Ctrl,518,514,30,484,52,432,306,24,68,13,374,21,167,112,64,46
GACGTATGTGAACCTT,sample,32859,32663,1875,30788,3353,27435,17147,1577,5440,798,22587,2473,3063,1900,3563,2266
TATACGGATGAACCTT,sample,77097,76727,1716,75011,12505,62506,52161,4927,3883,312,56044,1223,1575,1620,14656,9175
GAGCCTCCTGAACCTT,sample,39704,39373,1403,37970,6727,31243,23907,1163,3902,503,27809,1768,1837,1347,5960,4767
CTAGCGACTGAACCTT,sample,75752,75317,2432,72885,12673,60212,46981,3511,5538,571,52519,3611,2843,1735,13849,9085
GGTAGAGATGAACCTT,Pos_Ctrl,20501,20305,1073,19232,855,18377,15367,1495,1070,107,16437,338,3547,3490,1247,402
CGTCGCCATGAACCTT,sample,83179,82545,3363,79182,11382,67800,49250,4047,9256,1024,58506,4223,2651,1369,15414,7424
TACGCGAGTGAACCTT,sample,110476,109823,3724,106099,10018,96081,68944,5189,15046,1474,83990,5428,3169,2164,15125,7503
ATGGCGTTTGAACCTT,Pos_Ctrl,47158,46644,2558,44086,1791,42295,35403,3151,2583,344,37986,814,5136,5669,2686,803
CCATTCTTTGAACCTT,sample,137482,136281,5851,130430,13138,117292,87151,5553,15380,1646,102531,7562,3932,1860,17113,8937
GCTCTTCTTGAACCTT,sample,62055,61515,1795,59720,7839,51881,41333,3204,5343,434,46676,1567,2482,2297,8667,5867
CCTAGCGGTGAACCTT,Pos_Ctrl,28121,27789,1463,26326,1059,25267,20964,2041,1549,197,22513,516,4195,4303,1366,449
CTAACCGGTGAACCTT,sample,133408,132347,8181,124166,9575,114591,67417,4906,25030,2736,92447,14502,7075,3048,9669,6119
GGCGACGATGAACCTT,sample,86871,86134,7364,78770,7109,71661,39820,2985,16426,1704,56246,10726,4909,1622,10195,4636
TAACGAAGTGAACCTT,sample,37117,36540,1246,35294,3858,31436,21177,2112,5239,678,26416,2230,2152,1415,2262,2511
GCCTATTCTGAACCTT,sample,129421,128251,5602,122649,9954,112695,75520,5328,19437,2120,94957,10290,4222,1836,14752,6829
AGCAGAGCTGAACCTT,sample,149852,148529,9758,138771,11931,126840,79493,5984,23044,2223,102537,16096,6327,2013,19528,7597
GCGTTACCTGAACCTT,sample,85729,84933,2816,82117,9880,72237,56023,4721,7701,694,63724,3098,2477,1565,13471,6783
ATGAATAGTGAACCTT,sample,105936,105101,3784,101317,6933,94384,63201,4625,17504,2993,80705,6061,3333,1559,9535,4020
ATTCTACCTGAACCTT,Pos_Ctrl,40916,40059,2389,37670,1233,36437,30045,2756,2466,382,32511,788,4764,5306,1364,386
CGTAGAACTGAACCTT,sample,111076,110125,4236,105889,8312,97577,70773,4602,14627,1968,85400,5607,2923,1532,13448,5025
TTAACTGATGAACCTT,sample,149106,147899,12847,135052,7697,127355,64739,5583,31439,3146,96178,22448,7870,2129,10050,3629
AGAGTTCTACCGAATT,sample,34996,34664,2390,32274,4542,27732,19217,1123,4035,483,23252,2874,2240,1093,7111,2961
CATACTCCACCGAATT,sample,100891,100107,5568,94539,8529,86010,49839,2633,22274,2610,72113,8654,4664,1933,10312,6132
CGTCGCCAACCGAATT,sample,94329,93595,3363,90232,12934,77298,62910,3811,6188,854,69098,3535,2233,1361,19993,9337
GACTCAAGACCGAATT,sample,115665,114562,5124,109438,6682,102756,56407,4305,27100,2222,83507,12722,4490,1480,4215,3411
ATACGTTCACCGAATT,sample,66473,65720,6099,59621,5341,54280,25194,2262,14853,1543,40047,10428,4821,1053,5993,3137
CCGTACGCACCGAATT,sample,86071,85376,4258,81118,7286,73832,44137,4076,17043,1760,61180,6816,4276,2277,8203,4931
CGGTTGGTACCGAATT,sample,157175,156207,6007,150200,14229,135971,102780,8266,15506,1838,118286,7581,4498,2825,23272,9925
ACGCTTAAACCGAATT,sample,129271,128450,4419,124031,19995,104036,80893,5488,10800,1643,91693,5212,3572,2125,26244,14180
CTAACCGGACCGAATT,sample,111944,111258,4652,106606,10380,96226,68400,5150,13553,1446,81953,7677,4408,2181,12875,7351
GGCGACGAACCGAATT,sample,120171,119177,5704,113473,10639,102834,67138,5946,17720,2043,84858,9987,4450,2106,14092,6972
AGCAGAGCACCGAATT,sample,79138,78281,2900,75381,10808,64573,47523,3810,8390,1224,55913,3626,2669,1168,12407,7412
TGCGCTCCACCGAATT,sample,140485,139466,6632,132834,10936,121898,76970,5449,25438,2841,102408,11200,4619,2003,13598,6070
GCGTTACCACCGAATT,sample,119571,118730,3629,115101,14682,100419,78399,7201,8238,742,86637,5839,3230,1691,19047,10082
CAGCTTCGACCGAATT,Neg_Ctrl,1346,777,350,427,42,385,230,16,62,5,292,72,151,88,57,30
CGCGGTCGACCGAATT,sample,64898,64393,2762,61631,4691,56940,36584,2690,11251,1525,47835,4890,2969,1563,7432,3473
TTATGACGACCGAATT,sample,109351,108573,4871,103702,8558,95144,64165,3650,18166,1983,82331,7180,3247,1602,12807,5546
TCTCCTAGACCGAATT,sample,83281,82444,5541,76903,8450,68453,39962,3672,13861,1334,53823,9624,4627,1310,10222,5797
TTAACTGAACCGAATT,sample,89059,88216,2794,85422,9728,75694,58736,4568,7598,860,66334,3932,2114,1209,13580,6570
GTCGTTCTGGTCTGGT,Neg_Ctrl,624,347,158,189,30,159,98,6,35,0,133,20,78,48,20,14
AGCTGAATGGTCTGGT,sample,114331,113679,3457,110222,16870,93352,75100,6033,7856,1117,82956,3246,2230,1549,21060,12742
GACGTATGGGTCTGGT,sample,89742,89235,1972,87263,11515,75748,59892,4436,7849,822,67741,2749,2046,1869,15862,8036
CGTCGCCAGGTCTGGT,Neg_Ctrl,743,364,229,135,22,113,77,13,16,3,93,4,45,31,26,14
ATTCAAGGGGTCTGGT,sample,106773,106126,4372,101754,8712,93042,68361,5622,10734,1072,79095,7253,3963,1526,13814,6047
TACGCGAGGGTCTGGT,sample,153109,152229,5131,147098,10755,136343,93016,9351,20517,2815,113533,10644,4093,1935,13690,6449
GACTCAAGGGTCTGGT,sample,121736,120936,4285,116651,11522,105129,73437,7650,13010,1322,86447,9710,4047,1347,13408,7569
GATGCGTTGGTCTGGT,sample,114098,113359,5051,108308,14547,93761,65277,5632,13947,1422,79224,7483,3832,1795,16687,9919
TGCGCGTTGGTCTGGT,Neg_Ctrl,1542,795,612,183,21,162,112,7,25,1,137,17,73,46,24,8
ACGCTTAAGGTCTGGT,sample,50391,49890,3159,46731,5303,41428,23574,2023,10169,1395,33743,4267,3002,1284,6372,3728
GAGATTCTGGTCTGGT,sample,64408,63910,3186,60724,7117,53607,36981,2356,8659,1058,45640,4553,2950,1274,13334,5017
CTAACCGGGGTCTGGT,Neg_Ctrl,755,415,207,208,33,175,121,10,29,2,150,13,84,54,17,17
ATACCGCCGGTCTGGT,sample,144372,143251,5361,137890,12222,125668,92264,9499,13164,1486,105428,9255,4635,2133,19060,8055
GCGTTACCGGTCTGGT,sample,117345,116392,4759,111633,10250,101383,65679,4996,19494,2191,85173,9023,3824,1637,15019,6579
GACTAACCGGTCTGGT,Neg_Ctrl,906,540,380,160,11,149,105,6,24,4,129,10,74,49,26,18
CGTAGAACGGTCTGGT,sample,79817,78686,7337,71349,4911,66438,29801,2041,17966,1858,47767,14772,5932,1559,4542,2411
AACCGGTTCGACGTTA,sample,131015,130312,7294,123018,13918,109100,62172,4624,23097,2762,85269,16445,6420,1909,22278,8891
CTGGTCTTCGACGTTA,sample,132585,131699,7122,124577,16170,108407,67185,4598,21955,2265,89140,12404,5500,1854,21888,10678
GTCGTTCTCGACGTTA,sample,144226,143514,3065,140449,21508,118941,95563,7389,11584,1301,107147,3104,2350,2196,23378,16009
CATAATGGCGACGTTA,sample,160620,159780,5146,154634,26815,127819,105788,8301,7306,1190,113094,5234,2743,2071,28709,18981
GGTAGAGACGACGTTA,sample,29774,29544,1476,28068,3799,24269,16980,1432,3765,425,20745,1667,2083,1258,4631,2837
CGTCGCCACGACGTTA,sample,118790,118117,3427,114690,16853,97837,71569,5485,15264,1730,86833,3789,1923,1546,21007,13002
TCATCGAACGACGTTA,sample,153851,152759,6573,146186,15238,130948,94352,10087,14961,1769,109313,9779,3899,1564,17653,10056
TACGCGAGCGACGTTA,sample,166933,166015,4605,161410,21489,139921,112105,9264,12497,1809,124602,4246,2659,2226,28575,15853
GACTCAAGCGACGTTA,sample,81795,81028,3542,77486,11707,65779,44491,2637,11644,1044,56135,5963,3183,1092,14340,8334
ACGCTTAACGACGTTA,sample,130820,129958,5495,124463,15768,108695,77980,6239,14561,2062,92541,7853,3595,1603,23090,11369
GCTCTTCTCGACGTTA,sample,176856,175647,7569,168078,15618,152460,93378,7005,34558,4742,127936,12777,5410,2188,20661,9955
CTAAGCATCGACGTTA,sample,219314,218013,7094,210919,22851,188068,138292,10943,23393,3740,161685,11700,4319,2429,41440,16136
AGCAGAGCCGACGTTA,sample,205498,204232,4543,199689,20956,178733,153585,11467,8509,1419,162094,3753,2544,2160,33301,15585
GTCGCGAACGACGTTA,sample,174165,173144,5012,168132,13998,154134,112232,9080,21058,2741,133290,9023,3753,2143,20893,9479
TTATGACGCGACGTTA,sample,146376,145422,8010,137412,8713,128699,61001,3895,42973,4529,103974,16301,5968,1773,6379,4504
CGTAGAACCGACGTTA,sample,189464,188372,7416,180956,15429,165527,122741,8425,19112,2836,141853,12413,4346,1646,23755,10428
AGATACTACGACGTTA,sample,358797,357348,7224,350124,19623,330501,275666,25322,19201,2834,294867,7478,3790,3452,34479,13220
GCGCAATACGACGTTA,sample,153263,152238,8069,144169,15271,128898,85821,9095,18137,2029,103958,13816,4824,1760,15866,10105
CATACTCCTACTAAGT,sample,34573,34207,1949,32258,4447,27811,18154,1446,4926,552,23080,2733,2243,1118,3856,2833
TCGAACGATACTAAGT,sample,45088,44764,1355,43409,7366,36043,29615,2250,2659,272,32274,1247,1854,1616,8719,4930
GGTAGAGATACTAAGT,sample,51373,50975,1311,49664,5711,43953,33392,2534,5279,621,38671,2127,1817,1320,8824,4114
TCATCGAATACTAAGT,sample,44570,44179,2197,41982,5780,36202,20120,1231,9428,1235,29548,4188,2473,1011,4066,3895
ATTCAAGGTACTAAGT,sample,54044,53623,1641,51982,4374,47608,29427,2176,11438,1670,40865,2897,2231,1592,6032,2985
CCATTCTTTACTAAGT,sample,28419,28091,1215,26876,2388,24488,12621,1128,7538,891,20159,2310,1993,988,2970,1697
ACGCTTAATACTAAGT,sample,49457,49055,1995,47060,5928,41132,30492,1856,5099,521,35591,3164,2423,1224,8907,4211
CATTCGGTTACTAAGT,sample,58779,58388,2167,56221,7013,49208,40883,2575,3355,457,44238,1938,2301,2063,9915,5171
CCTAGCGGTACTAAGT,sample,26904,26627,1238,25389,2408,22981,16099,1253,3450,426,19549,1753,1853,1225,4956,1643
CTAACCGGTACTAAGT,sample,30144,29925,1123,28802,2693,26109,17007,1070,5434,710,22441,1888,1937,1322,3738,1853
GCCTATTCTACTAAGT,sample,87810,87178,2767,84411,5885,78526,60803,4762,8676,1407,69479,2878,2612,2043,9089,4130
TGCGCTCCTACTAAGT,sample,42274,41847,1967,39880,3860,36020,25579,1319,5674,531,31253,2917,2219,1019,6564,2705
TCTCCTAGTACTAAGT,sample,72940,72406,3212,69194,5995,63199,44722,2363,9235,793,53957,6086,2817,1063,10372,3968
AACCGGTTTTGCCGCT,sample,108609,107917,7985,99932,10507,89425,43054,2929,23144,2666,66198,17632,6930,2110,12460,6358
AGAGTTCTTTGCCGCT,sample,148344,147498,5299,142199,18997,123202,99317,7545,10159,1848,109476,4333,3450,2429,23695,13490
AGCTGAATTTGCCGCT,sample,199156,197803,7074,190729,22832,167897,125476,7996,21259,3129,146735,10037,4220,2136,34554,16487
GACGTATGTTGCCGCT,sample,86091,85273,4432,80841,9140,71701,42707,3290,15218,2312,57925,8174,4612,1571,9221,6381
TCGAACGATTGCCGCT,sample,110398,109678,5145,104533,15143,89390,66917,4546,9651,979,76568,7297,3601,1725,19383,10369
CGTCGCCATTGCCGCT,sample,73629,73050,1926,71124,11510,59614,48259,4013,5147,427,53406,1768,2541,2357,13170,8608
GCAACTAGTTGCCGCT,sample,46263,45842,1582,44260,4874,39386,27426,2683,6081,606,33507,2590,3080,2161,4213,3363
TGCGCGTTTTGCCGCT,sample,35879,35358,1321,34037,4700,29337,21336,1226,4434,597,25770,1744,1971,1547,6793,3573
ACGCTTAATTGCCGCT,sample,37290,36356,1568,34788,3631,31157,22835,1690,4135,527,26970,1970,2213,1402,5461,2517
GCTCTTCTTTGCCGCT,sample,164860,163199,4998,158201,13996,144205,100076,7282,24923,3062,124999,8862,3379,1633,25793,9805
GAGATTCTTTGCCGCT,sample,199066,196697,11275,185422,19208,166214,134858,10371,14718,1461,149576,4806,3666,2531,25860,14410
AAGGTCTGTTGCCGCT,sample,205748,204274,5147,199127,17259,181868,130444,8393,32421,3131,162865,7479,3650,1975,28829,12039
CCTAGCGGTTGCCGCT,sample,145084,144082,4747,139335,11209,128126,95736,5436,16992,1975,112728,7987,4464,2474,16282,8353
GGCGACGATTGCCGCT,sample,220945,219233,10197,209036,18735,190301,131246,11547,27420,3280,158666,16808,5959,2321,22595,12007
TAACGAAGTTGCCGCT,sample,266112,264295,12174,252121,23284,228837,147994,10854,42026,4174,190020,23789,8171,2357,36829,15057
GCCTATTCTTGCCGCT,sample,199758,198479,6394,192085,17185,174900,144910,10462,10993,1611,155903,6924,3849,2593,25892,12277
AGCAGAGCTTGCCGCT,sample,172162,170887,6620,164267,21187,143080,112974,10901,10833,1457,123807,6915,3437,1882,23990,14794
ATACCGCCTTGCCGCT,sample,219862,218555,5619,212936,20494,192442,155133,15545,14776,2269,169909,4719,3285,2683,26250,14741
GCGTTACCTTGCCGCT,sample,195922,194488,7455,187033,17721,169312,127987,10426,17576,1491,145563,11832,4633,1991,29159,12884
GGCGTACCTTGCCGCT,sample,169174,168154,4350,163804,17684,146120,116800,9447,13277,1617,130077,4979,3509,2126,22800,13033
CGTCGAGGTTGCCGCT,sample,79611,78942,3132,75810,5482,70328,41450,3114,16649,2073,58099,7042,3725,1797,5461,3375
CAGCTTCGTTGCCGCT,sample,163050,161859,8504,153355,11657,141698,84509,7849,26183,2665,110692,20492,7244,2000,15047,8530
TCTCCTAGTTGCCGCT,sample,187508,186321,6238,180083,15257,164826,121951,8418,22530,2106,144481,9821,3846,1766,24685,10219
TAACGCCATTGCCGCT,sample,190319,189123,10495,178628,14996,163632,112181,7640,24422,2527,136603,16862,5960,2080,30615,11192
CGCGAGACTTGCCGCT,sample,197367,196352,4468,191884,16954,174930,143318,10609,12882,1709,156200,6412,3151,1822,34997,13189
AACCGGTTTTCGACCT,sample,245231,244052,6026,238026,31398,206628,174296,13374,11416,1742,185712,5800,3992,3640,38168,21241
TCTAGGTTTTCGACCT,sample,129513,128514,3837,124677,14383,110294,81810,5780,16177,1168,97987,5359,3721,2255,18636,10466
GACGTATGTTCGACCT,sample,65738,65245,4610,60635,6171,54464,30659,2030,12841,1504,43500,7430,4266,1467,11136,3518
GGAGAAGCTTCGACCT,sample,153342,152339,5380,146959,21206,125753,93029,7222,16878,1653,109907,6971,2882,1812,24244,14889
CTAGCGACTTCGACCT,sample,97500,96757,4225,92532,13437,79095,54462,4632,12276,1425,66738,6300,3722,1652,18861,8929
GGTAGAGATTCGACCT,sample,83163,82620,2422,80198,8879,71319,56503,4089,6748,1063,63251,2916,2768,2003,17028,6261
TCATCGAATTCGACCT,sample,40333,40071,1791,38280,4071,34209,23461,1858,5500,634,28961,2756,2873,1656,7336,2890
ATTCAAGGTTCGACCT,sample,175037,173883,4716,169167,15462,153705,119291,12227,14252,1979,133543,5956,3677,2298,18975,10544
TGATTCCGTTCGACCT,sample,184604,183457,5718,177739,14320,163419,114715,10343,24529,3343,139244,10489,3901,2150,19416,8808
ATACGTTCTTCGACCT,sample,50724,50005,2146,47859,6506,41353,31750,1966,5215,605,36965,1817,2289,1750,9874,4643
CCGCAGTCTTCGACCT,sample,56493,56115,2788,53327,6661,46666,35386,1876,4981,622,40367,3801,3160,1937,11089,4633
TGGATCAATTCGACCT,sample,214167,212802,6226,206576,22769,183807,141119,11954,21121,1935,162240,7678,3226,1871,24734,16726
AGCGTCTTTTCGACCT,sample,102676,101818,4164,97654,8696,88958,58347,5218,17378,2295,75725,5720,3036,1743,12078,5969
TAGCGAGTTTCGACCT,sample,169318,167990,12231,155759,14668,141091,75120,5816,32062,3192,107182,24901,7531,2118,16407,7703
GAGATTCTTTCGACCT,sample,213906,212427,9959,202468,17501,184967,129444,9355,28654,2665,158098,14849,5512,1924,32171,12448
CTAACCGGTTCGACCT,sample,187640,186291,7601,178690,10899,167791,127721,8431,19365,1835,147086,10439,5078,2821,20706,7751
AAGTAGAGTTCGACCT,sample,203110,201642,10675,190967,12967,178000,106355,8238,34184,4121,140539,25102,8750,2658,16653,6924
CGTAGAACTTCGACCT,sample,205690,204340,8318,196022,19502,176520,132907,9545,19543,2229,152450,12296,5143,2022,30173,12974
TCTAGGTTTCCAGACT,sample,46695,46392,1569,44823,5230,39593,26183,2174,7444,996,33627,2796,2321,1416,7269,3555
GTCGTTCTTCCAGACT,sample,58241,57863,1453,56410,7935,48475,39878,3339,3187,433,43065,1638,2214,1854,9234,5278
AGAGTTCTTCCAGACT,sample,116958,116313,4058,112255,14554,97701,73549,5334,11931,1444,85480,5443,2865,1770,20864,10698
CATAATGGTCCAGACT,sample,36547,36105,3234,32871,4316,28555,15730,950,6097,590,21827,5188,3167,908,5935,2641
TATACGGATCCAGACT,sample,57503,57145,1839,55306,9169,46137,34614,2515,5723,570,40337,2715,1917,1254,10925,7192
GAGCCTCCTCCAGACT,sample,30662,30323,1263,29060,4828,24232,18235,1145,3060,358,21295,1434,1854,1225,5363,3218
TCGAACGATCCAGACT,sample,41671,41345,2341,39004,4117,34887,20985,1522,7970,791,28955,3619,2837,1463,5579,2797
CGTCGCCATCCAGACT,sample,25527,25316,1433,23883,2553,21330,12672,912,4501,447,17173,2798,2297,915,4742,1774
TACGCGAGTCCAGACT,sample,32396,32185,1548,30637,2951,27686,19835,1252,4120,548,23955,1931,2405,1725,4701,2159
GACTCAAGTCCAGACT,sample,20310,20145,823,19322,2602,16720,12736,813,2109,240,14845,822,1762,1350,3441,1854
ATACGTTCTCCAGACT,sample,115170,114186,9336,104850,7616,97234,46220,4495,25988,3084,72208,17447,7348,2157,9474,3422
TCTCAGGATCCAGACT,sample,36643,36338,1584,34754,4996,29758,22201,1217,4028,436,26229,1876,1904,1161,7570,3538
TGGATCAATCCAGACT,sample,35668,35378,2252,33126,4581,28545,21335,1386,3019,343,24354,2462,1949,1200,6775,3499
GGCAGGTTTCCAGACT,sample,16605,16388,1115,15273,1763,13510,8576,438,2807,305,11383,1384,1738,1060,2319,1157
ATGGCGTTTCCAGACT,sample,20297,20082,964,19118,2752,16366,12326,737,2157,229,14483,917,1425,1050,4531,2019
CATTCGGTTCCAGACT,sample,104079,103126,5654,97472,7820,89652,55059,4839,16979,1459,72038,11316,4979,1573,13226,5334
TAGCGAGTTCCAGACT,sample,74854,74159,4499,69660,6661,62999,36086,2645,13297,1454,49383,9517,4757,1539,9774,4296
CTAAGCATTCCAGACT,sample,56623,56216,2614,53602,4362,49240,30933,2027,11164,1434,42097,3682,2928,1747,6743,3003
GGCGACGATCCAGACT,sample,110888,109752,13343,96409,9799,86610,34130,2431,26237,2642,60367,21170,8536,1712,7501,5560
TAACGAAGTCCAGACT,sample,149246,148227,4682,143545,13945,129600,103627,8375,11929,960,115556,4709,2955,2074,20767,11404
GCCTATTCTCCAGACT,sample,41053,40593,2528,38065,3490,34575,22105,2119,6077,743,28182,3531,2860,1537,4905,2237
TGCGCTCCTCCAGACT,Pos_Ctrl,32270,31842,1875,29967,1102,28865,24159,2138,1806,203,25965,559,4464,4660,1436,427
ATACCGCCTCCAGACT,sample,63558,62817,3005,59812,4330,55482,29807,1813,15824,1759,45631,6279,2840,1121,4965,2518
CGTCGAGGTCCAGACT,Pos_Ctrl,19042,18662,1159,17503,667,16836,13925,1280,1139,149,15064,343,3470,3346,753,240
CGCGGTCGTCCAGACT,sample,29665,29340,2298,27042,1772,25270,14192,1078,5610,542,19802,3848,3364,1529,2591,1109
TTATGACGTCCAGACT,sample,45746,45256,3377,41879,3371,38508,22838,1406,8186,944,31024,5134,3047,1034,5033,2090
ATTCTACCTCCAGACT,sample,47095,46618,2850,43768,2693,41075,25975,1710,8457,1078,34432,3855,2595,1156,5225,1688
TCTAGGTTACCATTAT,sample,208464,207206,9552,197654,18783,178871,109524,6435,41929,4801,151453,16182,6058,2462,25415,12520
CATAATGGACCATTAT,sample,57522,56769,2887,53882,8247,45635,29671,2216,10686,1056,40357,2006,2649,1658,6407,5978
TATACGGAACCATTAT,sample,152971,152153,5078,147075,23404,123671,97720,8141,11140,1304,108860,5366,3573,1983,26758,17412
CTAGCGACACCATTAT,sample,144293,143141,5072,138069,17662,120407,92927,7120,11932,1353,104859,7075,3634,1862,25606,11559
ATTCAAGGACCATTAT,sample,54795,54375,2767,51608,6540,45068,30541,2026,8104,925,38645,3472,3132,1539,9963,4605
GACTCAAGACCATTAT,sample,116815,115961,6218,109743,14139,95604,65816,4851,14458,1799,80274,8680,4716,2074,17415,9981
GATGCGTTACCATTAT,sample,209410,208123,5303,202820,26118,176702,152299,9934,9238,1039,161537,4192,2462,2631,32153,18942
GCTCTTCTACCATTAT,sample,146226,144911,6354,138557,13839,124718,81541,5836,23327,3028,104868,10986,4191,1647,22764,10476
CCTAGCGGACCATTAT,sample,96630,95840,4382,91458,6718,84740,51695,3712,19962,2383,71657,6988,4114,2253,8923,4025
GCTGCTTCACCATTAT,sample,174773,171922,9067,162855,10820,152035,103117,7058,29536,2877,132653,9447,3905,1849,18705,7692
GCCTATTCACCATTAT,sample,260297,258695,8501,250194,23524,226670,172247,13076,25969,3105,198216,12273,5464,2305,37087,15186
AGCAGAGCACCATTAT,sample,193490,191484,8238,183246,21172,162074,124501,8340,18941,2806,143442,7486,2751,1710,27183,16612
TGCGCTCCACCATTAT,sample,195357,194261,5222,189039,18977,170062,140137,10771,12755,1457,152892,4942,3212,2374,29253,13502
CGCGGTCGACCATTAT,sample,105998,105073,6766,98307,9013,89294,58402,5106,13948,1488,72350,10350,5182,1487,15897,6429
TTATGACGACCATTAT,sample,165014,163879,5037,158842,12756,146086,116057,10711,13073,1553,129130,4692,3082,1997,19084,8808
AGATACTAACCATTAT,sample,156781,155575,6864,148711,13174,135537,93313,6544,21078,2815,114391,11787,3753,1484,21911,10246
AACCGGTTCAATGGAT,sample,103432,102705,6452,96253,12269,83984,53486,4116,14507,1673,67993,10202,5010,1743,17113,8390
TCTAGGTTCAATGGAT,sample,25958,25732,1851,23881,2986,20895,11829,678,5159,585,16988,2644,2284,902,4096,1738
GAGCCTCCCAATGGAT,sample,33516,33227,1992,31235,3151,28084,17892,881,6363,655,24255,2293,2626,1559,4408,2241
CATACTCCCAATGGAT,sample,34055,33778,1704,32074,4268,27806,19514,1603,4066,451,23580,2172,2126,1141,6937,2880
GGTAGAGACAATGGAT,sample,116156,115503,3224,112279,15857,96422,78555,6407,7936,548,86491,2976,2196,1580,26945,12853
TGATTCCGCAATGGAT,sample,105167,104312,8079,96233,10879,85354,49323,3277,17624,1801,66947,13329,6255,1726,19640,7468
GACTCAAGCAATGGAT,sample,64201,63664,2612,61052,8131,52921,41176,2372,5584,627,46760,3162,2668,1512,12712,6059
CCGCAGTCCAATGGAT,sample,116439,115626,5462,110164,11491,98673,70041,4992,15322,1460,85363,6858,4066,2004,19002,8624
TCTCAGGACAATGGAT,sample,164284,163199,4990,158209,16957,141252,104270,7152,21128,2097,125398,6605,2953,1857,26617,13108
TGGATCAACAATGGAT,sample,207065,205718,9994,195724,22897,172827,128666,11000,19712,2081,148378,11368,4675,2165,25798,15744
CCATTCTTCAATGGAT,sample,87944,87156,5078,82078,7258,74820,49213,4664,12252,1480,61465,7211,3833,1474,13376,4885
AGCGTCTTCAATGGAT,sample,158463,157294,5791,151503,16088,135415,101925,7418,16216,1713,118141,8143,3840,1811,25100,10630
GCTCTTCTCAATGGAT,sample,143260,142005,5554,136451,10800,125651,97801,6605,11910,1079,109711,8256,4333,2430,17081,7149
AGCAGAGCCAATGGAT,sample,154486,153414,5287,148127,18206,129921,99300,8410,13523,1495,112823,7193,4347,2124,26180,12615
TGCGCTCCCAATGGAT,sample,143625,142649,5233,137416,10639,126777,88119,6621,20973,2814,109092,8250,3700,1897,15606,6655
ATACCGCCCAATGGAT,Neg_Ctrl,1819,1025,450,575,88,487,309,30,69,12,378,67,177,134,93,39
CGTCGAGGCAATGGAT,sample,105360,104600,3441,101159,8641,92518,71158,6260,9741,1116,80899,4243,3107,2158,13799,5930
CAGCTTCGCAATGGAT,Neg_Ctrl,1415,815,305,510,75,435,303,24,69,3,372,36,185,133,81,21
TCTCCTAGCAATGGAT,sample,167478,166424,4737,161687,13472,148215,124325,7675,10670,931,134995,4614,2768,2063,23709,8626
CGCGAGACCAATGGAT,sample,154802,153746,6167,147579,14333,133246,95466,6888,17992,2080,113458,10820,3949,1532,21621,10100
CGTAGAACCAATGGAT,sample,146622,145868,4718,141150,16121,125029,99411,8457,10636,1352,110047,5173,3969,2729,20131,12452
CCTAACTACAATGGAT,Pos_Ctrl,61078,60178,2871,57307,2282,55025,45962,4452,3075,424,49037,1112,5540,6807,2602,753
ATATGCAACAATGGAT,sample,123182,122394,3270,119124,10655,108469,85561,7349,9441,1793,95002,4325,2676,1858,15801,7137
AGCTGAATAGATTCAT,sample,16680,16506,848,15658,2630,13028,9053,738,1925,220,10978,1092,1629,1033,2717,1646
TCATCGAAAGATTCAT,sample,77313,76891,2206,74685,9917,64768,50769,3792,6725,825,57494,2657,2112,1463,16392,7448
ATACGTTCAGATTCAT,sample,110336,109589,2756,106833,10069,96764,75945,7263,9236,800,85181,3520,2892,1752,11075,6512
CCGTACGCAGATTCAT,sample,107359,106635,3012,103623,15828,87795,74028,5612,5255,468,79283,2432,1971,1918,17698,11676
TGGATCAAAGATTCAT,sample,85998,85360,4960,80400,8915,71485,44879,2521,14750,1684,59629,7651,4012,1278,15652,5883
GATGCGTTAGATTCAT,sample,99145,98481,4053,94428,11790,82638,62701,3894,10023,1341,72724,4679,3312,2141,14009,8057
TGCGCGTTAGATTCAT,sample,152205,151130,6369,144761,12000,132761,88724,5758,24307,2910,113031,11062,4687,1941,20186,7819
ACGCTTAAAGATTCAT,sample,91512,90928,2256,88672,12227,76445,66598,4544,3740,573,70338,990,1616,1889,16922,9341
TAGCGAGTAGATTCAT,sample,224240,222896,10469,212427,24266,188161,141368,11710,17985,2264,159353,14834,5597,2233,30263,15485
GAGATTCTAGATTCAT,sample,117735,116955,3000,113955,12987,100968,84937,5966,6515,730,91452,2820,2720,2745,16462,9894
AAGGTCTGAGATTCAT,sample,96036,95375,4836,90539,10844,79695,56151,3975,11861,993,68012,6715,4030,1860,14986,7841
CCTAGCGGAGATTCAT,sample,73296,72858,4112,68746,7616,61130,40050,3131,10139,1168,50189,6642,3869,1627,10342,4804
CTAACCGGAGATTCAT,sample,118813,117921,2346,115575,10479,105096,89808,6130,6031,1061,95839,2066,2413,2484,13130,7262
ATACCGCCAGATTCAT,sample,91686,90844,2758,88086,6583,81503,47825,3702,20837,3071,68662,6068,2507,1367,5864,3887
GGCGTACCAGATTCAT,sample,44934,44511,1611,42900,4512,38388,27686,2447,4882,528,32568,2845,2784,2048,3958,2902
GACTAACCAGATTCAT,sample,95312,94641,3318,91323,7806,83517,63647,5271,9483,1052,73130,4064,2325,1413,12067,5378
CGTAGAACAGATTCAT,sample,164166,163272,4234,159038,14101,144937,112852,8834,14564,2692,127416,5995,3348,1989,19161,9464
CTGGTCTTCAATCTTG,sample,86786,86358,2513,83845,11789,72056,52514,4140,10230,1236,62744,3936,2962,2073,13611,8315
GTCGTTCTCAATCTTG,sample,77873,77471,2417,75054,10814,64240,49681,4371,6774,495,56455,2919,2730,1971,13796,8036
GACGTATGCAATCTTG,sample,100707,100174,2599,97575,14664,82911,62045,5733,9998,1265,72043,3870,2747,2243,13484,10372
CATAATGGCAATCTTG,sample,109408,108801,3127,105674,10874,94800,76671,4957,7696,1042,84367,4434,3559,2702,15932,7593
GGAGAAGCCAATCTTG,sample,135515,134952,3317,131635,20982,110653,93400,6775,6382,800,99782,3296,2486,1805,24401,14904
TCGAACGACAATCTTG,sample,120552,119737,4576,115161,10643,104518,78757,6259,11746,1480,90503,6276,3500,2280,15774,7243
TCATCGAACAATCTTG,sample,82927,82489,3224,79265,10087,69178,45136,3025,13556,1665,58692,5796,3422,1727,12264,7159
TGATTCCGCAATCTTG,sample,163676,162547,8437,154110,16814,137296,92922,6592,21436,2124,114358,14222,4755,1622,19091,12054
GCAACTAGCAATCTTG,sample,45746,45177,1268,43909,4849,39060,31230,2871,3284,485,34514,1190,1523,1336,5076,3616
TCTCAGGACAATCTTG,sample,114854,114165,2631,111534,15629,95905,79630,6543,7065,467,86695,2200,2254,2000,24608,11403
GATGCGTTCAATCTTG,sample,168894,167757,4564,163193,14757,148436,123823,7393,11520,1064,135343,4636,3102,2313,22843,10197
ATGGCGTTCAATCTTG,sample,152362,151173,5520,145653,15479,130174,89796,7774,20749,2980,110545,8875,3490,1535,26048,10296
TGCGCGTTCAATCTTG,sample,140940,139888,6082,133806,15296,118510,82198,5823,18047,1741,100245,10701,4568,1840,21271,9611
AGCGTCTTCAATCTTG,sample,138841,137861,3024,134837,12507,122330,96286,6404,14887,1446,111173,3307,2234,2060,19758,8881
CGGTTGGTCAATCTTG,sample,181958,180777,6405,174372,18107,156265,115851,10844,16464,1780,132315,11326,5330,2324,25564,13095
ACGCTTAACAATCTTG,sample,377235,374375,24878,349497,15998,333499,129373,8554,142993,20094,272366,32485,9077,3394,8713,6836
CATTCGGTCAATCTTG,sample,139703,138591,4034,134557,15401,119156,98121,7900,8039,1115,106160,3981,2639,1801,22359,10402
CTAAGCATCAATCTTG,sample,96075,95313,3750,91563,8690,82873,52490,3053,18752,2056,71242,6522,3380,1586,10213,5867
CCTAGCGGCAATCTTG,sample,73049,72504,3837,68667,6881,61786,45108,3444,8002,819,53110,4413,3100,1798,11543,4837
GCCTATTCCAATCTTG,sample,160551,159244,5092,154152,11798,142354,96104,8077,25257,2392,121361,10524,3602,1836,22332,8882
GTCGCGAACAATCTTG,sample,45086,44673,2139,42534,4030,38504,28520,2455,4816,545,33336,2168,2197,1381,7400,2922
CAGCTTCGCAATCTTG,sample,101643,100675,5938,94737,7325,87412,50391,3064,21838,2143,72229,9976,4727,1884,9322,5008
ATGAATAGCAATCTTG,sample,27310,26955,2338,24617,2043,22574,12483,1094,5522,624,18005,2851,2440,1082,2663,1230
TAACGCCACAATCTTG,sample,112074,110973,5939,105034,11021,94013,66474,4918,11894,1432,78368,9295,3870,1397,14091,7944
CCTAACTACAATCTTG,sample,99552,98602,6926,91676,7230,84446,53946,3337,15012,1506,68958,10645,4433,1337,13902,3926
GCGCAATACAATCTTG,Neg_Ctrl,1396,891,295,596,55,541,386,26,70,14,456,45,233,164,66,43
AACCGGTTCGTTCCGA,sample,58835,58401,3416,54985,6658,48327,27852,1871,11747,1369,39599,5488,3704,1338,9472,4257
CTGGTCTTCGTTCCGA,sample,93371,92504,4115,88389,13095,75294,55977,3622,9180,933,65157,5582,3439,1391,20308,9118
GTCGTTCTCGTTCCGA,sample,108560,107958,3285,104673,14310,90363,69523,5831,9883,1075,79406,4051,3293,2370,18239,10283
GACGTATGCGTTCCGA,sample,121198,120337,4950,115387,16656,98731,69171,5305,16864,2390,86035,5001,4311,3460,14938,12045
GGAGAAGCCGTTCCGA,sample,147286,146519,4486,142033,23062,118971,99495,7321,6613,709,106108,4833,2395,2092,22817,17191
ATTCAAGGCGTTCCGA,sample,88797,88070,3343,84727,12155,72572,57337,3724,6246,589,63583,4676,2878,1623,15855,8744
CCGTACGCCGTTCCGA,sample,154382,153348,6462,146886,18222,128664,96739,7192,14040,2231,110779,8462,4555,2412,20692,12609
GGCAGGTTCGTTCCGA,sample,87780,87059,4543,82516,10550,71966,44618,3464,15270,2274,59888,6340,3078,1192,15173,7412
CGGTTGGTCGTTCCGA,sample,63536,62992,2995,59997,6378,53619,38746,2644,7742,811,46488,3676,2924,1321,12221,4300
CTAAGCATCGTTCCGA,sample,92167,91541,5466,86075,10540,75535,52144,3543,11600,1354,63744,6894,3939,1473,15467,7583
CTAACCGGCGTTCCGA,sample,96256,95644,3096,92548,12615,79933,64673,4754,6864,841,71537,2801,2222,1499,17741,8656
AGCAGAGCCGTTCCGA,sample,202850,201597,7185,194412,18753,175659,134494,10244,19263,1772,153757,9886,3169,1927,27667,13824
GTCGCGAACGTTCCGA,sample,58658,58056,5321,52735,5587,47148,21196,1265,14514,1552,35710,8621,4610,935,6204,3540
CAGCTTCGCGTTCCGA,sample,96973,96279,3086,93193,9893,83300,66578,6084,6438,642,73016,3558,2274,1297,16898,7705
CGCGGTCGCGTTCCGA,sample,100238,99565,5202,94363,8333,86030,54984,3402,17783,1893,72767,7968,4194,1770,10966,5428
TCAATCAGCGTTCCGA,sample,157959,156939,9527,147412,9766,137646,73339,5758,39031,4035,112370,15483,6277,2058,8852,5505
CGCGAGACCGTTCCGA,sample,106686,106155,2106,104049,12021,92028,81285,7762,2237,303,83522,441,912,1267,15105,8457
CTGGTCTTCAATTCGG,Pos_Ctrl,1239,1226,90,1136,64,1072,867,72,88,10,955,35,423,329,93,39
GTCGTTCTCAATTCGG,sample,8012,7889,256,7633,1028,6605,5026,532,620,97,5646,330,913,875,1105,723
AGCTGAATCAATTCGG,sample,91941,91445,2367,89078,16712,72366,55648,4352,7979,1297,63627,3090,2610,2035,12922,10746
GAGCCTCCCAATTCGG,sample,4298,4215,202,4013,746,3267,2478,194,363,41,2841,191,687,602,558,515
CATACTCCCAATTCGG,Pos_Ctrl,516,503,30,473,30,443,359,35,22,1,381,26,208,177,45,17
CTAGCGACCAATTCGG,sample,48213,47957,1806,46151,6072,40079,28316,2438,5532,726,33848,3067,3061,1986,8394,4428
TACGCGAGCAATTCGG,sample,90196,89552,2674,86878,7876,79002,58451,4876,10007,1536,68458,4132,1973,1186,9984,5245
GACTCAAGCAATTCGG,Pos_Ctrl,27919,27724,1015,26709,1102,25607,21327,2386,1309,209,22636,376,4136,4631,1056,371
CCGTACGCCAATTCGG,sample,96117,95261,3815,91446,8331,83115,52715,4482,16678,1860,69393,7380,3649,1278,11556,4812
ATGGCGTTCAATTCGG,Pos_Ctrl,37011,36692,1743,34949,1530,33419,27747,2849,1965,267,29712,591,4603,5051,1970,611
GCTCTTCTCAATTCGG,sample,134348,133327,4142,129185,16871,112314,91990,7271,7471,885,99461,4697,2516,1642,23380,12230
GAGATTCTCAATTCGG,Pos_Ctrl,46303,45777,2291,43486,1848,41638,35082,3134,2345,356,37427,721,5115,5735,2517,591
CCTAGCGGCAATTCGG,sample,69141,68686,3879,64807,6444,58363,36793,3085,11365,1476,48158,5644,3280,1489,9146,4184
TAACGAAGCAATTCGG,sample,78237,77515,5014,72501,7294,65207,34943,2281,16244,2107,51187,9632,4776,1674,5780,4427
AGCAGAGCCAATTCGG,Pos_Ctrl,32651,32284,1640,30644,1150,29494,24492,2316,1848,216,26340,622,4525,4813,1615,404
ATACCGCCCAATTCGG,sample,47293,46550,2812,43738,3697,40041,24455,1426,8630,1032,33085,4498,2742,1142,6928,2430
GCGTTACCCAATTCGG,sample,75517,74872,4139,70733,8292,62441,41796,3057,9216,957,51012,7415,4103,1386,12012,5963
GTCGCGAACAATTCGG,sample,72629,71807,4416,67391,7080,60311,35482,2586,13335,1322,48817,7586,4088,1218,8713,4806
CGTCGAGGCAATTCGG,Pos_Ctrl,33621,32990,1914,31076,1237,29839,24750,2226,2044,222,26794,597,4560,4841,1581,471
CAGCTTCGCAATTCGG,sample,118550,117428,7348,110080,9036,101044,65975,5467,16537,2152,82512,10913,5296,2030,14410,5830
TCTCCTAGCAATTCGG,sample,101732,100917,3191,97726,7834,89892,76445,4379,5227,700,81672,3141,2635,1994,13591,5699
AAGTAGAGCAATTCGG,sample,83590,82803,3728,79075,6490,72585,53567,5316,8882,621,62449,4199,2264,1352,9627,4826
TCAATCAGCAATTCGG,sample,90632,89917,3570,86347,6402,79945,57939,5601,10207,1381,68146,4817,3081,1439,11484,4468
AGATACTACAATTCGG,sample,95051,94206,3692,90514,8164,82350,71901,5316,2918,675,74819,1540,1555,1486,14594,6192
AGCTGAATAACTCCGG,sample,98625,97615,5317,92298,13463,78835,63058,4391,7638,735,70696,3013,2251,1672,21963,9546
TATACGGAAACTCCGG,sample,93548,92803,3614,89189,8626,80563,62314,4367,8010,1031,70324,4841,3322,1878,13201,5945
CGTCGCCAAACTCCGG,sample,66989,66584,2306,64278,8931,55347,44021,3403,5057,538,49078,2328,2485,1616,13288,6558
TCATACCAAACTCCGG,sample,113466,112667,3609,109058,12826,96232,69787,7286,11104,1073,80891,6982,2509,1163,11477,8930
TGATTCCGAACTCCGG,sample,113041,112234,3889,108345,7515,100830,60596,5128,23463,3016,84059,8627,3638,1309,10951,4335
GCAACTAGAACTCCGG,sample,25148,24803,1058,23745,2073,21672,14655,1515,3235,318,17890,1949,2095,1207,2679,1235
CCGCAGTCAACTCCGG,sample,180050,178941,6251,172690,12023,160667,109200,10624,27212,3064,136412,10567,4909,2266,17028,8370
CCGTACGCAACTCCGG,sample,78528,77557,4784,72773,6433,66340,39493,4737,13889,1331,53382,6890,3265,1255,6278,4066
TGGATCAAAACTCCGG,sample,89095,88301,3071,85230,7030,78200,55538,4316,11178,1490,66716,5678,2810,1404,9875,4332
GGCAGGTTAACTCCGG,sample,97163,96409,7172,89237,7363,81874,34515,3194,23602,2428,58117,18135,6237,1343,8235,3627
TGCGCGTTAACTCCGG,sample,2990,2946,104,2842,617,2225,1861,145,128,25,1989,66,454,445,609,395
CATTCGGTAACTCCGG,sample,63488,62734,1746,60988,6354,54634,41902,3953,5520,787,47422,2472,2748,2242,4460,4119
GCTCTTCTAACTCCGG,sample,89838,88847,5873,82974,7352,75622,43407,3048,16225,1761,59632,11181,5261,1349,14637,4340
GCCTATTCAACTCCGG,sample,103253,102278,4937,97341,7423,89918,56752,3857,17782,2946,74534,8581,3970,1982,12141,4837
TGCGCTCCAACTCCGG,sample,44621,44227,2416,41811,4637,37174,25247,1962,5785,644,31032,3536,2619,1213,5572,3204
TAACGCCAAACTCCGG,sample,99953,99161,5847,93314,9674,83640,56726,3825,12556,1544,69282,8989,4117,1396,14208,6155
CTGGTCTTCCTGAAGG,sample,128507,127526,2331,125195,18764,106431,93795,6637,4258,559,98053,1182,1059,1450,24617,13527
GTCGTTCTCCTGAAGG,Neg_Ctrl,1247,564,359,205,16,189,123,6,42,0,165,18,80,47,37,5
GACGTATGCCTGAAGG,sample,129919,129116,5084,124032,13900,110132,76920,5499,17582,1866,94502,8265,4478,2226,20968,10121
CATACTCCCCTGAAGG,sample,57470,57124,1768,55356,7267,48089,38958,2732,3851,445,42809,2103,2187,1553,10050,5304
CTAGCGACCCTGAAGG,Neg_Ctrl,1376,699,415,284,24,260,146,16,75,4,221,19,107,62,39,11
CGTCGCCACCTGAAGG,sample,39787,39466,2337,37129,3658,33471,20495,1256,6839,762,27334,4119,3253,1702,3639,2105
GACTCAAGCCTGAAGG,sample,51301,50907,1791,49116,6984,42132,33759,2306,4036,517,37795,1514,2255,1776,9640,4958
ATACGTTCCCTGAAGG,Neg_Ctrl,817,554,285,269,35,234,141,5,69,1,210,18,103,59,31,20
CCGCAGTCCCTGAAGG,sample,67411,66960,2041,64919,9725,55194,46380,3952,3002,267,49382,1593,2413,2473,12576,7384
CCGTACGCCCTGAAGG,sample,66984,66479,3447,63032,6180,56852,42274,3178,6211,907,48485,4282,3353,2037,11484,4116
GGCAGGTTCCTGAAGG,sample,116985,116054,5860,110194,7190,103004,56441,4334,29929,2149,86370,10151,4189,1471,11051,4707
GATGCGTTCCTGAAGG,sample,100355,99487,4326,95161,10750,84411,62208,4425,10661,1109,72869,6008,2369,1055,15636,8567
TGCGCGTTCCTGAAGG,Neg_Ctrl,936,597,344,253,26,227,156,4,39,0,195,28,74,40,54,23
CCATTCTTCCTGAAGG,sample,45296,44805,2696,42109,5683,36426,24705,1879,5779,693,30484,3370,2738,1527,8303,3875
CTAAGCATCCTGAAGG,Neg_Ctrl,1644,939,648,291,33,258,166,12,59,3,225,18,108,66,40,21
CCTAGCGGCCTGAAGG,sample,41827,41363,3486,37877,3828,34049,20805,1417,6584,733,27389,4510,3515,1697,4386,2434
AGCAGAGCCCTGAAGG,sample,80009,79101,3732,75369,9163,66206,52921,4168,5181,639,58102,3297,2650,1701,12834,6958
TGCGCTCCCCTGAAGG,Neg_Ctrl,1443,818,534,284,23,261,166,10,36,29,202,20,104,66,38,12
CAGCTTCGCCTGAAGG,Neg_Ctrl,930,550,253,297,26,271,174,13,51,3,225,30,114,65,50,10
AAGTAGAGCCTGAAGG,sample,95241,94300,6436,87864,6084,81780,43657,3567,21763,2298,65420,10495,4971,1625,8946,3164
TCAATCAGCCTGAAGG,sample,104715,103888,5855,98033,7806,90227,56110,4336,18448,2248,74558,9085,4587,1768,9795,4583
CGTAGAACCCTGAAGG,sample,51549,50911,2466,48445,4435,44010,31688,2352,6276,705,37964,2989,2110,1007,8282,3010
AACCGGTTAATATTCG,sample,134313,133482,4413,129069,19225,109844,75524,5586,17027,1908,92551,9799,3740,1623,25157,14477
GTCGTTCTAATATTCG,sample,144592,143629,7016,136613,12842,123771,68069,4250,31891,3965,99960,15596,5552,2080,15261,8020
GACGTATGAATATTCG,sample,191805,190560,9588,180972,16645,164327,91569,6868,44059,5046,135628,16785,5447,2183,21702,12193
TATACGGAAATATTCG,sample,132989,132080,5714,126366,14031,112335,82504,5488,15105,1783,97609,7455,4233,1824,24828,10379
GGAGAAGCAATATTCG,sample,71933,71497,2413,69084,10124,58960,46221,2792,6239,776,52460,2932,2787,1643,13621,7346
TGATTCCGAATATTCG,sample,129499,128465,5825,122640,9552,113088,72321,5881,21075,2585,93396,11226,4626,1680,13093,6253
CCGTACGCAATATTCG,sample,74146,73724,2903,70821,9149,61672,43755,3283,9279,991,53034,4364,3070,1686,15373,6432
CCATTCTTAATATTCG,sample,66116,65342,6668,58674,4667,54007,17038,1222,21436,2478,38474,11833,5532,1262,3814,2597
GCTGCTTCAATATTCG,sample,93749,92865,4150,88715,9171,79544,47170,3105,18956,2630,66126,7683,3566,1342,11199,6061
TGCGCTCCAATATTCG,sample,101154,100309,3419,96890,11156,85734,66502,5831,7992,1329,74494,4080,2494,1457,17666,8076
GCGTTACCAATATTCG,sample,66128,65400,3706,61694,7894,53800,35960,1862,9177,1217,45137,5584,3390,1194,12402,5320
CGTCGAGGAATATTCG,sample,101556,100567,5959,94608,7473,87135,54844,4285,15934,1641,70778,10431,4553,1785,11578,4138
CAGCTTCGAATATTCG,sample,94834,93980,3908,90072,8201,81871,53280,4147,15128,1648,68408,7668,3586,1477,12123,5526
CGCGGTCGAATATTCG,sample,56864,56023,2812,53211,4929,48282,32884,3176,7819,1171,40703,3232,2373,1313,6659,3543
TCTCCTAGAATATTCG,sample,88680,87365,9073,78292,6066,72226,38673,2644,18368,1925,57041,10616,4884,1647,8906,3791
TCAATCAGAATATTCG,sample,66331,65619,4482,61137,5777,55360,29450,2345,12524,1577,41974,9464,4656,1415,4595,3343
TAACGCCAAATATTCG,sample,120393,119315,6142,113173,8453,104720,67817,4644,19831,2579,87648,9849,3910,1673,14925,5131
ATTCTACCAATATTCG,Pos_Ctrl,48979,48139,2585,45554,1547,44007,36451,3153,3018,390,39469,995,5311,6022,2021,532
CCTAACTAAATATTCG,sample,143903,142840,4302,138538,10961,127577,87807,7170,24403,3026,112210,5171,2272,1614,16077,6595
GCGCAATAAATATTCG,sample,105057,104183,4397,99786,8895,90891,65189,6182,12881,1475,78070,5164,2944,1519,14638,5689
ATATGCAAAATATTCG,sample,114374,113619,2480,111139,11837,99302,85179,7388,4916,389,90095,1430,1127,1249,15688,8947
CTGGTCTTAGTCTCCG,sample,147459,146600,4933,141667,16939,124728,100537,7099,9294,1574,109831,6224,3660,2151,27412,11774
GTCGTTCTAGTCTCCG,sample,108118,107512,3114,104398,10772,93626,65663,5702,15191,1656,80854,5414,3788,2394,12393,7181
GACGTATGAGTCTCCG,sample,119877,119169,2645,116524,13333,103191,77294,6938,12994,1805,90288,4160,2924,2097,18820,9153
CATAATGGAGTCTCCG,sample,91221,90740,1594,89146,15660,73486,61337,5752,4501,738,65838,1158,2423,2721,13157,10765
TATACGGAAGTCTCCG,sample,20958,20832,517,20315,3906,16409,12897,1176,1738,184,14635,414,1271,1262,3096,2640
TCATACCAAGTCTCCG,sample,74852,74530,1212,73318,13997,59321,51714,4360,2293,278,54007,676,2025,2567,10341,9390
TACGCGAGAGTCTCCG,sample,92034,91457,5073,86384,9980,76404,43939,4033,18184,2160,62123,8088,4300,1696,13580,6861
GACTCAAGAGTCTCCG,sample,77353,76758,2574,74184,9830,64354,54161,3342,4560,506,58721,1785,1955,1618,14544,7728
TGCGCGTTAGTCTCCG,sample,81570,80880,2818,78062,6565,71497,40660,2598,19784,2630,60444,5825,3147,1683,6301,4368
TAGCGAGTAGTCTCCG,sample,141324,140398,4857,135541,14951,120590,81635,6743,20986,2296,102621,8930,5190,3302,13461,10816
AAGGTCTGAGTCTCCG,sample,104612,103996,3931,100065,12470,87595,66673,3714,11266,1164,77939,4778,2701,1659,17759,9250
TAACGAAGAGTCTCCG,sample,98137,97370,3087,94283,11568,82715,57231,5038,13537,1795,70768,5114,3076,1527,14311,7965
ATACCGCCAGTCTCCG,sample,108762,108031,3221,104810,10121,94689,67452,4504,14806,2455,82258,5472,3655,2129,15455,7044
GCGTTACCAGTCTCCG,sample,92069,91511,2531,88980,10868,78112,61740,4222,7917,1003,69657,3230,2862,2050,14600,7076
CAGCTTCGAGTCTCCG,sample,85359,84808,4369,80439,7218,73221,46160,4014,12338,1428,58498,9281,4739,1774,11213,4393
TCTCCTAGAGTCTCCG,sample,20545,20389,555,19834,2810,17024,11480,919,3224,297,14704,1104,1363,1015,2758,1702
AAGTAGAGAGTCTCCG,sample,35139,34887,1259,33628,3148,30480,20778,1671,5387,643,26165,2001,1922,1354,2173,1828
TCAATCAGAGTCTCCG,sample,91897,91263,3252,88011,10052,77959,59120,5258,8341,833,67461,4407,3462,2092,11398,6930
CCTAACTAAGTCTCCG,sample,124001,123167,5909,117258,11778,105480,62410,4465,20057,3271,82467,15277,5269,1487,16011,7351
GCGCAATAAGTCTCCG,sample,105487,104567,9052,95515,7432,88083,47222,3526,19784,2420,67006,15131,6559,1984,8232,3769
TCTAGGTTTGCCTACG,sample,58463,58054,2497,55557,5898,49659,33326,2634,9015,917,42341,3767,3162,1893,7388,4131
CTGGTCTTTGCCTACG,sample,58858,58513,1667,56846,8211,48635,37938,2522,5596,678,43534,1901,2253,1966,9721,6142
AGCTGAATTGCCTACG,sample,26641,26432,1169,25263,3161,22102,16619,880,2527,364,19146,1712,1698,1001,6289,2159
GACGTATGTGCCTACG,sample,36639,36343,1738,34605,4974,29631,20482,1264,4510,557,24992,2818,2627,1488,5285,3191
CTAGCGACTGCCTACG,sample,37232,37052,1128,35924,5815,30109,25351,1959,1682,219,27033,898,2181,2245,5970,4230
CGTCGCCATGCCTACG,sample,22321,22115,1368,20747,2804,17943,11979,628,3096,488,15075,1752,1798,790,4773,1884
GCAACTAGTGCCTACG,sample,10110,9981,670,9311,1285,8026,4350,315,2120,250,6470,991,1774,1070,914,806
TCTCAGGATGCCTACG,sample,25942,25671,1433,24238,2997,21241,16267,811,2495,256,18762,1412,1818,1097,4511,2054
TGGATCAATGCCTACG,sample,69120,68450,3195,65255,8493,56762,43049,3561,6193,724,49242,3235,2473,1566,11920,5863
GGCAGGTTTGCCTACG,sample,38923,38588,1578,37010,4625,32385,21803,1842,5980,646,27783,2114,2128,1386,6327,3144
ATGGCGTTTGCCTACG,sample,71622,70977,8503,62474,8166,54308,21565,1660,16147,1783,37712,13153,6520,1394,5594,5278
TGCGCGTTTGCCTACG,sample,67474,67060,2262,64798,7405,57393,43984,3478,5655,616,49639,3660,3062,2108,10660,4889
ACGCTTAATGCCTACG,sample,28318,27878,2254,25624,3022,22602,10331,922,6085,765,16416,4499,2501,769,2409,1814
GCTCTTCTTGCCTACG,sample,16527,16318,1051,15267,3020,12247,7174,584,2355,335,9529,1799,1843,1078,1423,1898
GAGATTCTTGCCTACG,sample,55062,54639,2250,52389,6915,45474,37302,2637,2986,317,40288,2232,2233,1728,8149,5088
TAACGAAGTGCCTACG,sample,41779,41422,2455,38967,4315,34652,17521,1022,10200,1095,27721,4814,2967,961,3997,2529
CAGCTTCGTGCCTACG,sample,50406,49577,3685,45892,4915,40977,28662,2527,5626,615,34288,3547,2536,1095,7216,2938
CGCGGTCGTGCCTACG,sample,36271,35897,1629,34268,3016,31252,21201,1614,4995,506,26196,2936,2190,1053,6006,2087
TTATGACGTGCCTACG,sample,70613,69900,4697,65203,5620,59583,40214,2767,8801,961,49015,6840,3795,1519,8911,3747
ATGAATAGTGCCTACG,sample,45596,45270,1634,43636,5494,38142,28593,2139,4842,635,33435,1933,2454,1938,6646,3673
TAACGCCATGCCTACG,sample,40360,40049,1189,38860,4064,34796,27504,2228,2881,550,30385,1633,1630,1283,6461,2501
GACTAACCTGCCTACG,Neg_Ctrl,625,307,186,121,6,115,85,4,13,6,98,7,48,29,27,3
TTAACTGATGCCTACG,sample,9714,9687,148,9539,1186,8353,7264,663,277,36,7541,113,1151,1405,778,807
TCTAGGTTCTTAGTTC,sample,67168,66773,3146,63627,8121,55506,37346,2526,9258,1373,46604,5003,3391,1401,13697,5839
AGAGTTCTCTTAGTTC,sample,71347,70899,2761,68138,6092,62046,41106,2282,12497,1384,53603,4777,3586,1790,11355,4337
GACGTATGCTTAGTTC,sample,122698,122024,3453,118571,17658,100913,80800,6784,8272,836,89072,4221,3150,2433,15958,13330
GGAGAAGCCTTAGTTC,sample,31651,31382,3796,27586,2280,25306,5766,481,10676,1301,16442,7082,4523,889,706,1062
CGTCGCCACTTAGTTC,sample,111639,111069,2456,108613,16131,92482,79075,5489,4475,906,83550,2537,2517,2428,19662,12309
TACGCGAGCTTAGTTC,sample,148442,147463,4863,142600,12540,130060,101812,10152,10685,1412,112497,5999,3316,1988,15726,8310
ATACGTTCCTTAGTTC,sample,194295,192915,5464,187451,14270,173181,123692,9977,22867,2315,146559,14330,3766,1906,15100,10754
CCGTACGCCTTAGTTC,sample,85859,85061,2904,82157,10072,72085,51328,3725,10934,1263,62262,4835,2640,1370,17420,7828
AGCGTCTTCTTAGTTC,sample,152878,151769,9937,141832,11768,130064,63374,5029,37192,5645,100566,18824,6645,1995,14976,8089
ACGCTTAACTTAGTTC,sample,108187,107408,3450,103958,10469,93489,66026,3697,16305,2139,82331,5322,2999,1832,13673,7310
CATTCGGTCTTAGTTC,sample,90104,89353,3039,86314,10560,75754,59207,4215,6977,955,66184,4400,3018,1951,14020,7992
CTAAGCATCTTAGTTC,sample,98989,98094,6525,91569,11688,79881,52279,4224,12504,1345,64783,9529,4529,1541,14675,8371
TAACGAAGCTTAGTTC,sample,90749,90036,3755,86281,9973,76308,59130,3862,7857,1212,66987,4247,3087,1647,16100,7684
GCTGCTTCCTTAGTTC,sample,102155,100719,4700,96019,8124,87895,55334,4307,18338,2370,73672,7546,4694,2463,9447,5229
TCTCCTAGCTTAGTTC,sample,100471,99693,4020,95673,8988,86685,59351,4338,14502,1790,73853,6704,3400,1457,10172,5331
ATGAATAGCTTAGTTC,sample,107304,105734,6752,98982,8910,90072,63773,5038,12658,1331,76431,7272,4226,1658,17475,5935
TAACGCCACTTAGTTC,sample,101241,100550,2997,97553,7487,90066,64309,4678,13493,1622,77802,5964,3319,1903,11495,4863
GACTAACCCTTAGTTC,sample,47907,47308,2401,44907,5822,39085,26340,1554,7496,831,33836,2864,2002,994,5758,3740
AGATACTACTTAGTTC,sample,92476,91761,5024,86737,7734,79003,45457,3564,17848,2328,63305,9806,4406,1394,12225,4684
CCTAACTACTTAGTTC,sample,76734,75985,4120,71865,8283,63582,40021,3505,11294,1092,51315,7670,3547,1183,8938,5188
CTGGTCTTCGAGCTTC,sample,114832,114172,3003,111169,15355,95814,77829,5345,8782,901,86611,2957,2303,1966,21605,11603
AGAGTTCTCGAGCTTC,sample,124584,123593,4642,118951,11884,107067,72761,4961,19866,2049,92627,7430,3365,1869,19651,8372
AGCTGAATCGAGCTTC,sample,137343,136634,3697,132937,19433,113504,95966,6560,7853,897,103819,2228,2402,2127,30836,15084
GAGCCTCCCGAGCTTC,sample,71244,70780,3199,67581,9602,57979,38100,2752,11243,1455,49343,4429,2968,1518,11429,6824
CATACTCCCGAGCTTC,sample,45903,45642,1370,44272,8943,35329,26859,2771,3876,509,30735,1314,2086,1753,7836,5938
CTAGCGACCGAGCTTC,sample,137306,136507,3343,133164,22014,111150,82935,6496,14151,1763,97086,5805,3359,2098,23381,15372
TCGAACGACGAGCTTC,sample,73807,73274,2908,70366,8455,61911,33042,2891,18578,1937,51620,5463,3141,1454,6716,5695
TCATCGAACGAGCTTC,sample,59060,58668,2653,56015,11722,44293,29212,2242,8405,857,37617,3577,3143,1391,9641,7799
TCATACCACGAGCTTC,sample,209605,208066,9983,198083,13195,184888,103797,9982,47782,5371,151579,17956,7038,3064,10790,7617
TACGCGAGCGAGCTTC,sample,127976,127168,5321,121847,10539,111308,76696,7601,16337,1609,93033,9065,4639,1749,11382,6611
GGCAGGTTCGAGCTTC,sample,132143,131251,4765,126486,16805,109681,77800,5625,18306,1910,96106,6040,3464,1731,19069,11735
AGCGTCTTCGAGCTTC,sample,179412,178040,5957,172083,19024,153059,114201,6650,23104,2169,137305,6935,3323,1826,26092,13790
CATTCGGTCGAGCTTC,sample,90435,89594,4974,84620,10142,74478,48593,3350,12633,1558,61226,8344,4485,1622,11802,6822
GCTCTTCTCGAGCTTC,sample,137470,136307,5295,131012,15026,115986,88425,7657,12084,1072,100509,6748,3575,1895,18981,9882
GAGATTCTCGAGCTTC,sample,134801,133670,6248,127422,14450,112972,81052,5977,15084,1604,96136,9255,3607,1788,23042,10596
TAACGAAGCGAGCTTC,sample,59167,58716,2621,56095,7486,48609,33358,2872,7426,819,40784,4134,2890,1304,11701,5249
GCTGCTTCCGAGCTTC,sample,104617,103721,3462,100259,8711,91548,54669,4043,23590,3346,78259,5900,3313,1704,13199,5950
GCCTATTCCGAGCTTC,sample,106356,105742,3608,102134,18339,83795,61899,5780,10119,1348,72018,4649,4025,2885,13915,13206
TGCGCTCCCGAGCTTC,sample,64669,63861,4079,59782,7652,52130,29848,2130,11354,1199,41202,7599,3342,1019,7477,5317
ATACCGCCCGAGCTTC,sample,119514,118419,5340,113079,10990,102089,69517,4833,17112,1883,86629,8744,3719,1649,15984,6860
CAGCTTCGCGAGCTTC,sample,35265,34624,1994,32630,4362,28268,18260,1290,5622,614,23882,2482,2346,1190,3516,3038
TTATGACGCGAGCTTC,sample,70259,69655,3313,66342,3988,62354,32416,2433,17604,1865,50020,8036,3679,1318,3496,2207
ATGAATAGCGAGCTTC,sample,102700,101804,6676,95128,9290,85838,56841,4415,13132,1531,69973,9919,4812,1609,12876,6206
ATTCTACCCGAGCTTC,sample,56487,55899,2714,53185,6320,46865,33758,2381,6014,581,39772,4131,2553,1066,11005,4442
GCGCAATACGAGCTTC,sample,139117,138013,4760,133253,13981,119272,78517,7041,25796,2824,104313,5094,1946,1538,19829,9935
ATATGCAACGAGCTTC,sample,137290,136418,12127,124291,14411,109880,68845,5443,19427,2366,88272,13799,5679,1536,15590,10032
CTGGTCTTGTAGAATG,Pos_Ctrl,48982,48519,2164,46355,1884,44471,37285,3485,2664,343,39949,694,5330,6007,3331,844
AGAGTTCTGTAGAATG,sample,43567,43149,2846,40303,4617,35686,20424,1312,8776,1052,29200,4122,3597,1737,5511,3019
GACGTATGGTAGAATG,sample,115285,114396,3950,110446,11538,98908,71229,5504,15313,1396,86542,5466,3114,1664,21631,8664
CATAATGGGTAGAATG,sample,120258,119592,6079,113513,20685,92828,63219,6525,12436,1398,75655,9250,6006,2945,14651,14184
CTAGCGACGTAGAATG,sample,89740,88942,3464,85478,11539,73939,49517,3563,13576,1582,63093,5701,3274,1511,14453,8244
TCGAACGAGTAGAATG,sample,93260,92592,2928,89664,9253,80411,51481,3065,17910,2639,69391,5316,2754,1644,10133,6690
GCAACTAGGTAGAATG,Pos_Ctrl,9128,9074,366,8708,512,8196,6821,728,442,66,7263,139,2561,2551,596,229
ATACGTTCGTAGAATG,sample,176923,175693,5861,169832,19088,150744,107882,8236,22616,2614,130498,9396,4179,2200,22709,14818
GGCAGGTTGTAGAATG,sample,67422,66847,3817,63030,8428,54602,35435,2962,9358,1180,44793,5667,3699,1354,11078,5760
CGGTTGGTGTAGAATG,sample,92211,91300,6036,85264,5233,80031,29310,1733,32139,3643,61449,13206,5118,1699,1722,3097
GCTCTTCTGTAGAATG,Pos_Ctrl,33215,32834,1592,31242,1417,29825,24958,2242,1788,256,26746,581,4595,4862,1965,599
CCTAGCGGGTAGAATG,sample,68268,67749,2385,65364,7370,57994,39448,3195,10896,949,50344,3506,2456,1610,9121,5399
TAACGAAGGTAGAATG,sample,85905,85283,3489,81794,8655,73139,49221,3123,13927,1193,63148,5675,3122,1565,12365,6026
GCCTATTCGTAGAATG,sample,122947,121914,3131,118783,11447,107336,77075,6299,16922,1944,93997,5096,2316,1681,19946,7416
AGCAGAGCGTAGAATG,sample,201288,199834,7907,191927,13954,177973,124222,10068,27798,3661,152020,12224,6038,3625,19024,8293
TGCGCTCCGTAGAATG,sample,79633,78660,2658,76002,8212,67790,46811,5163,10254,1188,57065,4374,2974,1559,10787,6175
CGTCGAGGGTAGAATG,sample,114895,114026,4196,109830,12994,96836,69331,6218,13860,1026,83191,6401,3529,2038,15335,8918
CAGCTTCGGTAGAATG,sample,116084,114756,7197,107559,12109,95450,72452,5279,10093,1088,82545,6538,3513,1496,18733,8705
TTATGACGGTAGAATG,sample,102088,99813,11508,88305,7798,80507,53064,4099,14785,1773,67849,6786,4105,1711,8146,4878
AAGTAGAGGTAGAATG,sample,109443,108447,5068,103379,8982,94397,68007,5501,11868,1326,79875,7695,3701,1565,14823,6098
TCAATCAGGTAGAATG,sample,116141,115396,6020,109376,12420,96956,63937,5745,15177,1586,79114,10511,4786,1665,14340,8493
CTGGTCTTCAATAGTC,sample,89533,89046,1793,87253,13836,73417,62318,4230,4842,413,67160,1614,1516,1453,19693,10608
AGAGTTCTCAATAGTC,sample,114483,113700,5262,108438,13388,95050,69563,6015,11569,1374,81132,6529,3954,1783,20083,10417
CATACTCCCAATAGTC,sample,69713,69199,3214,65985,7536,58449,38142,3270,11087,1070,49229,4880,3164,1616,11484,5079
CGTCGCCACAATAGTC,sample,68867,68183,6234,61949,6648,55301,22912,972,17905,1925,40817,11587,5414,1269,6619,4241
TCATACCACAATAGTC,sample,114214,113613,3823,109790,15682,94108,76419,6236,7109,694,83528,3650,2791,2361,14979,11951
GCAACTAGCAATAGTC,sample,28314,27933,968,26965,2410,24555,17283,1595,3869,370,21152,1438,1714,1016,3217,1465
ATACGTTCCAATAGTC,sample,96180,95411,5921,89490,7539,81951,50363,4802,14990,1410,65353,10386,5498,1532,8821,4400
CCGCAGTCCAATAGTC,sample,110271,109341,7353,101988,8288,93700,55649,4960,18765,1871,74414,12455,5629,1511,8345,5247
CCGTACGCCAATAGTC,sample,95674,94936,5068,89868,6642,83226,57514,4446,10868,1187,68382,9211,4500,1663,12895,3878
GATGCGTTCAATAGTC,sample,68054,67597,2023,65574,8094,57480,45308,3703,5501,675,50809,2293,1824,1271,13381,6190
ATGGCGTTCAATAGTC,sample,76658,76216,1908,74308,14485,59823,48425,3951,4904,599,53329,1944,1958,1545,12263,10510
AGCGTCTTCAATAGTC,sample,95427,94789,2905,91884,10028,81856,63156,3723,10295,1160,73451,3522,2159,1599,14882,7137
GCTCTTCTCAATAGTC,sample,60412,59940,2835,57105,6870,50235,32956,2898,9172,929,42128,4280,3217,1345,9003,4696
AAGGTCTGCAATAGTC,sample,69321,68883,2857,66026,7331,58695,42969,3400,7748,985,50717,3593,2864,1509,11872,4977
GGCGACGACAATAGTC,sample,55247,54792,2032,52760,5750,47010,36273,3221,4770,576,41043,2170,2510,1848,7651,3817
TAACGAAGCAATAGTC,sample,49928,49674,1058,48616,4898,43718,34661,3135,4246,504,38907,1172,1849,1721,8747,3326
AGCAGAGCCAATAGTC,sample,65005,64579,2617,61962,6597,55365,41166,2639,6976,637,48142,3947,2974,1437,12669,4567
GGCGTACCCAATAGTC,sample,96391,95759,3378,92381,7707,84674,56435,4620,16427,1509,72862,5683,3231,1814,10358,4690
CGTCGAGGCAATAGTC,sample,84590,83979,2912,81067,8562,72505,54109,3872,9031,1150,63140,4343,2664,1501,12703,5756
TTATGACGCAATAGTC,sample,76005,75569,2520,73049,7457,65592,44917,3297,10128,1433,55045,5817,3265,1639,8942,4814
TCTCCTAGCAATAGTC,sample,113758,113039,4946,108093,10042,98051,74702,5382,11076,1114,85778,5777,3544,1700,17279,7236
AAGTAGAGCAATAGTC,sample,82264,81642,3330,78312,8018,70294,53084,4176,7823,1011,60907,4200,2664,1528,12460,6776
CGTAGAACCAATAGTC,sample,71697,70875,6104,64771,5205,59566,33366,2368,12641,1243,46007,9948,4889,1530,8208,3079
CCTAACTACAATAGTC,sample,40133,39714,1713,38001,2967,35034,26277,1890,4273,462,30550,2132,2325,1547,4860,1737
AACCGGTTCGTTACTC,sample,203706,202369,6820,195549,27074,168475,126245,8861,21591,1812,147836,9966,3522,1870,39411,19475
CTGGTCTTCGTTACTC,sample,116223,115396,4126,111270,16493,94777,73375,6334,9173,967,82548,4928,3275,1870,22240,11420
GTCGTTCTCGTTACTC,Neg_Ctrl,1623,960,488,472,67,405,232,15,107,6,339,45,165,104,35,31
GAGCCTCCCGTTACTC,sample,20672,20489,1636,18853,2919,15934,10495,738,2518,265,13013,1918,2366,1365,3090,1974
GGTAGAGACGTTACTC,sample,138472,137317,8187,129130,11749,117381,70751,4907,26260,3305,97011,12158,5645,2481,12322,7841
TCATCGAACGTTACTC,sample,126402,125411,3413,121998,21999,99999,85162,7840,4922,817,90084,1258,1304,1664,22788,16459
GCAACTAGCGTTACTC,sample,53684,52911,2335,50576,5798,44778,34502,2631,4344,566,38846,2735,2113,1071,6899,3810
TACGCGAGCGTTACTC,Neg_Ctrl,1645,820,320,500,52,448,302,15,71,1,373,59,183,140,55,19
ATACGTTCCGTTACTC,sample,58755,57968,3239,54729,6970,47759,27715,2633,9528,930,37243,6953,3739,1161,3810,4083
CCGCAGTCCGTTACTC,sample,123025,121828,5868,115960,13559,102401,69792,5616,13677,2305,83469,11011,4501,1289,13839,8693
TGCGCGTTCGTTACTC,sample,96915,96124,6237,89887,11433,78454,57687,3675,10380,1121,68067,5591,3570,1848,19518,8512
CCATTCTTCGTTACTC,sample,143848,142383,15383,127000,14009,112991,53729,4325,33319,3854,87048,17764,8240,2766,12746,9095
CGGTTGGTCGTTACTC,sample,174740,173464,7624,165840,16176,149664,107022,9301,19889,2703,126911,10749,4529,1919,29569,10820
CATTCGGTCGTTACTC,sample,86284,85554,3325,82229,11156,71073,52490,3529,9805,1535,62295,3714,2833,1653,12321,7981
TAGCGAGTCGTTACTC,sample,231899,230294,13309,216985,15564,201421,86331,5524,75508,9467,161839,24591,7412,2371,11420,9547
GAGATTCTCGTTACTC,Neg_Ctrl,2056,1322,580,742,89,653,458,28,104,15,562,48,264,170,95,58
CTAAGCATCGTTACTC,sample,195028,193789,7954,185835,26539,159296,128467,11220,11122,1431,139589,7056,3118,1737,34005,19800
AAGGTCTGCGTTACTC,sample,151408,150190,8541,141649,16569,125080,74317,6293,25638,3009,99955,15823,6309,1829,18845,10706
CTAACCGGCGTTACTC,sample,124313,123430,7374,116056,9901,106155,47489,3592,36064,5068,83553,13942,5929,2000,6663,6390
GCGTTACCCGTTACTC,sample,151522,149902,10759,139143,15161,123982,69617,5247,28202,3013,97819,17903,6364,1969,17966,9744
CGTCGAGGCGTTACTC,sample,107902,106879,5959,100920,9431,91489,58305,5934,14883,1636,73188,10731,4798,1726,13896,5992
TTATGACGCGTTACTC,Neg_Ctrl,1393,857,372,485,38,447,260,12,119,20,379,36,193,111,49,25
TCAATCAGCGTTACTC,sample,147506,146466,5000,141466,14088,127378,102609,9460,9469,973,112078,4867,2573,1711,17776,9005
CGCGAGACCGTTACTC,sample,126111,125108,4471,120637,10209,110428,72304,4886,21726,2971,94030,8541,3898,1645,15844,6426
CGTAGAACCGTTACTC,sample,101483,100460,7781,92679,8787,83892,38810,3230,23644,2081,62454,16127,6340,1466,9857,5167
AGATACTACGTTACTC,sample,184681,183467,7224,176243,15741,160502,119534,10149,18413,2754,137947,9652,3916,1703,18427,9726
TTAACTGACGTTACTC,sample,6975,6899,178,6721,1039,5682,4486,471,438,39,4924,248,814,804,786,671
CTGGTCTTTGGACTGC,sample,78036,77428,5065,72363,10216,62147,36650,3309,12634,1138,49284,8416,4251,1468,10590,6643
GTCGTTCTTGGACTGC,sample,109077,108387,3230,105157,16323,88834,65200,4407,10793,1441,75993,6993,3396,1983,18363,11770
AGCTGAATTGGACTGC,sample,150467,149514,5199,144315,18332,125983,99383,6992,12547,1401,111930,5660,3681,2358,29246,12938
TATACGGATGGACTGC,sample,70642,70079,2910,67169,9131,58038,35770,2563,13371,1508,49141,4826,3451,1675,8356,6273
TCATCGAATGGACTGC,sample,69865,69376,2996,66380,7364,59016,40301,3094,10460,1371,50761,3790,2674,1496,13317,5181
TGATTCCGTGGACTGC,sample,57304,56886,2250,54636,4899,49737,34785,3346,6784,927,41569,3895,2635,1345,7520,3118
ATACGTTCTGGACTGC,sample,33215,32886,3398,29488,2729,26759,10412,798,8703,1032,19115,5814,3893,1138,1666,1586
CCGTACGCTGGACTGC,sample,52865,52459,2750,49709,5267,44442,29805,1662,8522,806,38327,3647,2667,1450,8762,3484
TCTCAGGATGGACTGC,sample,98306,97501,3663,93838,8826,85012,59842,4959,13093,1700,72935,5418,3215,1428,11599,6044
CATTCGGTTGGACTGC,sample,60713,60226,1791,58435,8111,50324,37040,2611,6872,901,43912,2900,2608,1818,10953,5696
TAGCGAGTTGGACTGC,sample,102151,101485,6538,94947,8682,86265,42314,2575,22818,2480,65132,16078,6364,1731,12766,4822
CTAAGCATTGGACTGC,sample,77003,76377,4050,72327,9894,62433,36212,2890,13959,1697,50171,7675,3909,1369,10862,6424
AAGGTCTGTGGACTGC,sample,88751,88312,1984,86328,14267,72061,59769,4787,4809,714,64578,1982,1988,1976,15666,10254
GCTGCTTCTGGACTGC,sample,88430,87861,2475,85386,13168,72218,61512,6022,3086,240,64598,1358,1731,1821,17423,10045
GCGTTACCTGGACTGC,sample,106019,105280,3056,102224,8026,94198,72000,5697,11375,1358,83375,3768,3608,2772,13844,5293
GGCGTACCTGGACTGC,sample,59356,58856,1910,56946,7120,49826,37611,2864,5728,507,43339,3116,2859,1629,8309,4828
GTCGCGAATGGACTGC,sample,62324,61736,3510,58226,4773,53453,33479,2932,8581,1007,42060,7454,3900,1775,5437,2897
TTATGACGTGGACTGC,sample,53621,53122,2314,50808,4720,46088,26835,2028,11430,1262,38265,4533,2924,1532,3383,2580
TCTCCTAGTGGACTGC,sample,83352,82695,4182,78513,5481,73032,48013,3453,13821,1388,61834,6357,3553,1607,9511,3556
ATGAATAGTGGACTGC,sample,95753,94656,11814,82842,6129,76713,22531,1136,28755,3255,51286,21036,8467,1866,2156,2853
AAGTAGAGTGGACTGC,sample,61300,60703,3350,57353,5783,51570,32444,2196,9227,1331,41671,6372,4004,1654,4192,3728
TCAATCAGTGGACTGC,sample,61386,60775,2915,57860,4169,53691,38805,2621,8264,796,47069,3205,2680,1739,5321,2410
TAACGCCATGGACTGC,sample,73250,72683,2314,70369,8996,61373,47596,4633,4967,884,52563,3293,2393,1431,12365,6333
GCGCAATATGGACTGC,sample,21054,20808,1299,19509,1844,17665,12349,913,2381,328,14730,1694,1782,1014,3171,1044
AACCGGTTCCTTGAGC,sample,172339,171517,5649,165868,27196,138672,106636,6846,16247,1465,122883,7478,4057,1999,32191,18900
TCTAGGTTCCTTGAGC,sample,125795,124809,6691,118118,14382,103736,64881,4010,21083,2654,85964,11108,5062,1554,23800,10145
CTGGTCTTCCTTGAGC,sample,184124,182642,11262,171380,19777,151603,85045,5654,35762,3893,120807,21249,7001,2304,25919,12583
AGCTGAATCCTTGAGC,sample,165502,163516,7357,156159,21048,135111,105290,7483,13863,1599,119153,6876,3798,2130,28318,15024
CATAATGGCCTTGAGC,sample,136202,135494,3017,132477,25296,107181,91091,6193,5696,1775,96787,2426,1442,1717,28315,19217
GAGCCTCCCCTTGAGC,Pos_Ctrl,56358,55979,2649,53330,2660,50670,42697,4211,2599,319,45296,844,5629,6762,3602,1180
CTAGCGACCCTTGAGC,sample,124556,123791,3268,120523,17040,103483,85875,5587,7826,1087,93701,3108,2824,2226,23373,12304
TCGAACGACCTTGAGC,sample,87238,86667,5871,80796,12010,68786,45635,2444,11902,1194,57537,7611,4494,1633,16805,8446
GGTAGAGACCTTGAGC,sample,98721,98129,4800,93329,12685,80644,58342,3719,10110,929,68452,7544,4385,1918,18819,9314
CGTCGCCACCTTGAGC,sample,110887,110262,3944,106318,14064,92254,70453,5062,10710,1205,81163,4824,3479,2418,18255,10664
ATTCAAGGCCTTGAGC,sample,289704,287759,15872,271887,14151,257736,127864,9210,80861,10669,208725,29132,7663,2603,8392,7603
TCTCAGGACCTTGAGC,sample,91648,91042,3312,87730,13311,74419,56475,3137,9559,858,66034,4390,3388,2124,18299,8937
GGCAGGTTCCTTGAGC,Pos_Ctrl,47432,46793,3030,43763,2103,41660,34855,3063,2645,309,37500,788,5366,5828,3313,895
ACGCTTAACCTTGAGC,sample,169839,168451,10818,157633,16777,140856,74883,4241,33113,3461,107996,25158,8337,2190,19986,10958
CATTCGGTCCTTGAGC,sample,213355,212246,5088,207158,29487,177671,157681,13985,3648,305,161329,2052,2015,2828,25487,21551
TAGCGAGTCCTTGAGC,sample,92312,91718,7249,84469,9649,74820,39099,2630,18705,2037,57804,12349,5645,1802,9630,6299
GAGATTCTCCTTGAGC,sample,106685,105938,4959,100979,15401,85578,56822,4654,13751,1661,70573,8690,4100,1802,17715,10808
CTAAGCATCCTTGAGC,sample,166043,164883,7981,156902,14929,141973,88230,6138,31260,3918,119490,12427,4952,2189,18236,9952
AAGGTCTGCCTTGAGC,sample,92842,92199,4124,88075,8818,79257,46424,3060,19670,1988,66094,8115,3607,1647,9267,5912
GGCGACGACCTTGAGC,sample,169349,168143,11750,156393,14656,141737,67812,5211,44153,4918,111965,19643,6920,2277,11375,9723
GCTGCTTCCCTTGAGC,Pos_Ctrl,47367,46418,3102,43316,1709,41607,34581,3088,2621,325,37202,992,5410,5880,2264,757
GTCGCGAACCTTGAGC,sample,127900,126804,7707,119097,9917,109180,73441,6296,18166,1951,91607,9326,4857,2174,15212,7173
CGCGGTCGCCTTGAGC,sample,75313,74585,2814,71771,8355,63416,51241,4224,4140,826,55381,2985,2046,1368,11373,6836
TCTCCTAGCCTTGAGC,sample,112812,111944,3074,108870,9912,98958,78100,5721,9731,1278,87831,4128,2366,1544,19445,6966
ATGAATAGCCTTGAGC,sample,125870,124783,4738,120045,9930,110115,88990,7610,8442,904,97432,4169,3443,2551,14867,6805
GACTAACCCCTTGAGC,sample,33956,33489,2255,31234,2705,28529,18429,1401,5525,740,23954,2434,2257,1135,4958,1523
AGATACTACCTTGAGC,sample,120325,119373,6260,113113,8447,104666,63827,4622,23451,2357,87278,10409,4523,1730,12671,4647
CCTAACTACCTTGAGC,Pos_Ctrl,46550,45607,2705,42902,1658,41244,34261,3193,2687,263,36948,840,5146,5766,2114,713
TCTAGGTTCGATATCC,sample,70623,70239,2009,68230,10538,57692,45400,3521,5720,777,51120,2274,2715,2179,9183,7159
TATACGGACGATATCC,sample,70587,70177,2252,67925,11533,56392,42193,3584,6607,761,48800,3247,2495,1381,14183,8216
GAGCCTCCCGATATCC,sample,19771,19607,424,19183,5036,14147,11660,1117,923,176,12583,271,1309,1393,3283,3337
CATACTCCCGATATCC,sample,21344,21114,559,20555,3459,17096,11501,959,3330,457,14831,849,1637,1209,3459,2314
CGTCGCCACGATATCC,sample,77186,76823,2338,74485,11428,63057,49898,3385,6619,784,56517,2371,2042,1674,13755,8531
TCATCGAACGATATCC,sample,74079,73753,1535,72218,14780,57438,46206,3860,4957,495,51163,1920,2121,1773,13930,9954
TGATTCCGCGATATCC,sample,83784,83284,3381,79903,11091,68812,45439,2814,13346,1343,58785,5870,3485,1660,14837,7665
TACGCGAGCGATATCC,sample,65366,65059,2106,62953,9413,53540,42975,2618,5372,502,48347,2073,2068,1576,16920,6655
CCGCAGTCCGATATCC,sample,94270,93509,3853,89656,15985,73671,54135,4804,8684,852,62819,5196,3139,1431,17793,10925
CCGTACGCCGATATCC,sample,135155,134355,4941,129414,16527,112887,88249,7128,9962,1283,98211,6265,3793,2204,22805,10746
TGGATCAACGATATCC,sample,164717,163985,4981,159004,27608,131396,108424,7173,9393,1885,117817,4521,2658,1854,30454,20537
GGCAGGTTCGATATCC,sample,89368,88637,3192,85445,14113,71332,57239,4860,5660,656,62899,2917,2492,1819,15100,9715
ATGGCGTTCGATATCC,sample,131118,130137,5067,125070,15270,109800,74238,5600,19167,1827,93405,8968,4247,1785,21589,10584
ACGCTTAACGATATCC,sample,76252,75680,3872,71808,8672,63136,45529,3086,8272,984,53801,5265,3274,1346,13406,5972
CTAACCGGCGATATCC,sample,95023,94299,4435,89864,13456,76408,54360,4296,10980,1231,65340,5541,3963,1990,15611,9337
GCCTATTCCGATATCC,sample,116209,115324,6812,108512,12708,95804,61133,4857,16519,1844,77652,11451,6153,2428,14254,8708
GGCGTACCCGATATCC,sample,122657,121570,6502,115068,9980,105088,64155,4881,22791,2187,86946,11074,4719,1865,13159,6095
CGTCGAGGCGATATCC,sample,59337,58764,2912,55852,5981,49871,35683,3297,6091,741,41774,4059,2974,1476,9923,3964
TTATGACGCGATATCC,sample,96618,95847,3789,92058,9776,82282,62368,5279,9091,1193,71459,4351,3134,1761,12363,7405
TAACGCCACGATATCC,sample,79923,79095,7033,72062,6334,65728,39512,2443,12334,1227,51846,10212,5187,1653,8329,3910
CGTAGAACCGATATCC,sample,44222,43757,2903,40854,3920,36934,23614,1603,7530,862,31144,3325,2981,1580,4948,2500
CCTAACTACGATATCC,sample,135643,134418,8254,126164,10093,116071,72272,5776,22387,2416,94659,13220,5358,1758,12235,6058
GCGCAATACGATATCC,sample,117873,116743,4872,111871,7880,103991,77710,5992,13211,1397,90921,5681,3658,2186,12429,5022
TCTAGGTTATCTGACC,sample,349,342,30,312,29,283,199,10,43,3,242,28,128,81,39,25
GGAGAAGCATCTGACC,sample,17357,17243,616,16627,2830,13797,10228,984,1686,219,11914,680,1900,1624,2232,1908
GAGCCTCCATCTGACC,sample,29255,29084,908,28176,4434,23742,17803,1301,3194,289,20997,1155,1741,1420,5523,3219
CATACTCCATCTGACC,Neg_Ctrl,390,276,46,230,26,204,147,16,26,1,173,14,87,62,27,20
GCAACTAGATCTGACC,sample,17693,17501,883,16618,1625,14993,7880,613,4325,531,12205,1644,1993,1205,1976,1232
CCGCAGTCATCTGACC,sample,68064,67539,3524,64015,8142,55873,38237,2481,8809,838,47046,5508,3322,1277,12539,5380
TCTCAGGAATCTGACC,sample,75969,75499,1801,73698,13134,60564,54317,3011,2476,299,56793,461,1067,1341,15774,9345
TGGATCAAATCTGACC,sample,63906,63387,2715,60672,6742,53930,34361,2713,11037,1116,45398,4703,2672,1331,9132,4880
GATGCGTTATCTGACC,Neg_Ctrl,945,565,221,344,35,309,195,16,57,8,252,33,132,94,44,21
CCATTCTTATCTGACC,sample,58612,58007,4679,53328,5968,47360,29732,1969,8636,925,38368,6098,3556,1096,12137,3779
AGCGTCTTATCTGACC,sample,87665,86912,5406,81506,10115,71391,46825,3648,12195,1400,59020,7323,3715,1334,16099,6560
CGGTTGGTATCTGACC,sample,48641,48171,3428,44743,6131,38612,23239,1519,7303,827,30542,5724,3254,1244,6491,3915
TAGCGAGTATCTGACC,sample,81147,80529,4498,76031,6236,69795,32475,2489,22267,2818,54742,9746,3807,1339,4270,3747
GCTCTTCTATCTGACC,sample,71319,70792,2140,68652,11712,56940,46699,2920,4585,775,51284,1961,2297,1816,13310,8148
GAGATTCTATCTGACC,sample,45287,44881,3807,41074,3681,37393,18699,1215,9963,917,28662,6599,4136,1363,3253,2180
CTAACCGGATCTGACC,sample,55031,54528,2589,51939,7578,44361,31569,2558,6431,540,38000,3263,2291,1208,8916,5758
TAACGAAGATCTGACC,sample,102393,101508,7193,94315,6627,87688,43402,2988,27320,3382,70722,10596,5613,1995,8110,3919
GCCTATTCATCTGACC,Neg_Ctrl,1053,668,280,388,43,345,210,26,62,13,272,34,150,102,44,23
AGCAGAGCATCTGACC,sample,30406,30043,1674,28369,2883,25486,18673,1461,3436,458,22109,1458,1629,1057,5682,1939
TGCGCTCCATCTGACC,sample,78408,77774,2995,74779,9957,64822,55013,4449,3265,504,58278,1591,1630,1624,12856,7473
ATACCGCCATCTGACC,sample,90315,89499,5544,83955,9637,74318,48609,4397,11677,1280,60286,8355,4594,1597,13937,6644
GCGTTACCATCTGACC,sample,104516,103869,4568,99301,11494,87807,60517,3281,14137,2521,74654,7351,3133,1567,16739,8253
GGCGTACCATCTGACC,sample,88874,88177,5024,83153,7792,75361,51761,3584,11048,1200,62809,7768,4621,2358,9181,4808
CGTCGAGGATCTGACC,sample,26007,25670,2101,23569,2368,21201,9170,622,6765,666,15935,3978,2717,1044,1455,1358
TCTCCTAGATCTGACC,sample,21310,20966,2369,18597,1987,16610,6693,538,5282,541,11975,3556,2488,697,1528,1177
AAGTAGAGATCTGACC,sample,167022,165727,10795,154932,8485,146447,90507,6083,25881,2395,116388,21581,6969,2397,12475,4495
CGTAGAACATCTGACC,sample,69894,68935,3931,65004,6485,58519,43650,3333,6765,1170,50415,3601,2748,1429,9815,3903
GCGCAATAATCTGACC,Neg_Ctrl,805,470,134,336,42,294,198,7,54,8,252,27,143,80,36,13
AACCGGTTCTTCTTAC,sample,111586,111063,2519,108544,17689,90855,72978,6789,7764,960,80742,2364,2001,1817,19001,13064
CTGGTCTTCTTCTTAC,sample,132317,131570,3247,128323,13820,114503,89320,7294,12088,1323,101408,4478,2652,2247,17887,10064
AGCTGAATCTTCTTAC,sample,49877,49570,3078,46492,5654,40838,24868,2525,7577,868,32445,5000,3656,1735,3781,3487
TACGCGAGCTTCTTAC,sample,86082,85302,2939,82363,9889,72474,57816,4137,6811,639,64627,3071,2411,1335,10178,7167
GACTCAAGCTTCTTAC,sample,126041,125155,5325,119830,11235,108595,79045,6059,14073,1235,93118,8183,4596,1878,13411,6971
CCGTACGCCTTCTTAC,sample,78696,78040,2564,75476,11966,63510,47437,4355,7087,870,54524,3761,2767,1497,15172,8904
GGCAGGTTCTTCTTAC,sample,84776,84080,4345,79735,8859,70876,44980,3241,13444,1884,58424,7327,3998,1343,15408,6251
ATGGCGTTCTTCTTAC,sample,137759,136819,5713,131106,13860,117246,82954,4817,19252,2514,102206,7709,3575,1882,19730,9461
CCATTCTTCTTCTTAC,sample,44769,44072,4593,39479,6646,32833,13001,1018,9935,988,22936,7891,3805,758,3794,3959
TGCGCTCCCTTCTTAC,sample,56965,56099,3386,52713,6485,46228,33953,2996,5606,814,39559,2859,2384,1067,8046,4359
GCGTTACCCTTCTTAC,sample,157269,155846,6939,148907,12071,136836,106867,8387,15094,1619,121961,4869,3471,3144,15117,7539
ATGAATAGCTTCTTAC,sample,60993,60509,1912,58597,6705,51892,40915,4022,4714,529,45629,1712,2052,1572,9510,4789
TCAATCAGCTTCTTAC,sample,83457,82630,4575,78055,7809,70246,47112,3110,11756,1383,58868,6885,3634,1231,13921,5830
CCTAACTACTTCTTAC,sample,84586,83773,3991,79782,6983,72799,49831,3048,12520,1168,62351,6232,3047,1271,12622,4535
GCGCAATACTTCTTAC,sample,81357,80472,4494,75978,6173,69805,45101,3350,12386,1547,57487,7421,4014,1468,7870,3923
AGAGTTCTACTTCTAC,sample,75649,75249,3373,71876,10338,61538,42770,3670,8277,1081,51047,5740,3686,1690,11743,7193
TCGAACGAACTTCTAC,sample,60556,60246,1392,58854,7523,51331,38176,3720,6507,1106,44683,1822,2163,1939,8611,5338
TCATCGAAACTTCTAC,sample,56185,55907,1898,54009,8266,45743,36028,1957,4831,462,40859,2465,2606,1802,10288,6248
GCAACTAGACTTCTAC,sample,14010,13750,565,13185,1429,11756,7539,693,2491,248,10030,785,1225,833,1624,848
CCGTACGCACTTCTAC,sample,100510,99953,2458,97495,14992,82503,67805,6195,5142,363,72947,2998,2612,2396,15732,11121
GGCAGGTTACTTCTAC,sample,87060,86553,3805,82748,10045,72703,54155,4526,8446,1163,62601,4413,3059,1621,14382,7401
CGGTTGGTACTTCTAC,sample,96190,95538,3009,92529,10661,81868,61412,5096,10208,1372,71620,3780,2828,2029,14300,7343
AAGGTCTGACTTCTAC,sample,34575,34144,1603,32541,5882,26659,19022,1708,3854,463,22876,1612,1787,1135,5025,3886
CCTAGCGGACTTCTAC,sample,44039,43686,1759,41927,6333,35594,31218,1881,1620,206,32838,669,1484,1614,7681,4659
GGCGACGAACTTCTAC,sample,64056,63582,1936,61646,7333,54313,42879,3390,4778,638,47657,2628,2188,1453,11966,5393
GCTGCTTCACTTCTAC,sample,46132,45726,2366,43360,5121,38239,25502,1391,6975,858,32477,3513,2815,1244,9990,3342
GCCTATTCACTTCTAC,sample,51452,50948,2302,48646,4875,43771,24125,1665,12475,1713,36600,3793,2437,1060,6181,3230
TGCGCTCCACTTCTAC,sample,101146,100286,5640,94646,8245,86401,50271,2892,22442,2236,72713,8560,3914,1521,12682,5512
TTATGACGACTTCTAC,sample,9501,9362,411,8951,1518,7433,4730,467,1449,175,6179,612,1066,733,1111,956
TCTCCTAGACTTCTAC,sample,1464,1402,71,1331,209,1122,785,87,154,22,939,74,313,267,222,130
TCAATCAGACTTCTAC,sample,21231,21026,681,20345,2518,17827,11171,899,3795,585,14966,1377,1214,842,1626,1538
TAACGCCAACTTCTAC,sample,95542,94996,2546,92450,8948,83502,63460,4404,9737,800,73197,5101,2433,1487,13473,6579
GCGCAATAACTTCTAC,sample,60349,59485,4124,55361,5462,49899,37388,2116,6769,1114,44157,2512,1997,1356,6692,3592
TTAACTGAACTTCTAC,sample,84540,83959,4283,79676,7758,71918,53064,3348,9316,1230,62380,4960,3121,1444,10958,5278
ATATGCAAACTTCTAC,sample,52857,52538,1434,51104,6421,44683,34482,2758,4443,610,38925,2390,2012,1516,6993,3999
AACCGGTTAGAAGTAA,sample,51966,51647,1439,50208,8838,41370,30730,2652,5438,730,36168,1820,1894,1397,7790,6089
AGAGTTCTAGAAGTAA,sample,150032,149095,5189,143906,18782,125124,90811,6437,18070,2309,108881,7497,3845,1627,32207,13188
AGCTGAATAGAAGTAA,sample,134930,134174,3877,130297,26859,103438,90603,7136,4592,388,95195,719,1064,1458,26878,19487
CATACTCCAGAAGTAA,sample,49740,49462,1903,47559,7535,40024,27924,2576,5774,956,33698,2794,2994,1935,7281,5171
CGTCGCCAAGAAGTAA,sample,32418,32085,951,31134,5922,25212,19239,1456,2912,318,22151,1287,1631,1175,5187,3933
TGATTCCGAGAAGTAA,sample,161936,161072,3984,157088,14984,142104,108486,8122,18817,2140,127303,4539,2666,2148,27955,10032
CCGCAGTCAGAAGTAA,sample,21434,21199,1112,20087,1936,18151,8684,734,5841,868,14525,2024,2433,1281,1266,1326
ATGGCGTTAGAAGTAA,sample,51369,50969,1709,49260,8671,40589,28941,1939,6910,523,35851,2276,2064,1080,10108,6323
CCATTCTTAGAAGTAA,sample,125180,124299,3906,120393,11432,108961,69291,4319,24074,3539,93365,7738,3348,1823,16618,7725
ACGCTTAAAGAAGTAA,sample,93265,92372,4600,87772,12352,75420,55333,3741,9292,1515,64625,5539,2844,1348,15756,8167
GAGATTCTAGAAGTAA,sample,94143,93760,2271,91489,15772,75717,60186,5780,5883,669,66069,3199,2507,1842,20746,11266
GGCGACGAAGAAGTAA,sample,106526,105657,4625,101032,7590,93442,58869,3787,20035,2332,78904,8419,4473,2376,6904,4952
GTCGCGAAAGAAGTAA,sample,490,453,21,432,62,370,250,34,58,6,308,22,157,97,63,37
CGCGGTCGAGAAGTAA,sample,163,162,9,153,13,140,104,9,20,0,124,7,60,42,27,6
AAGTAGAGAGAAGTAA,sample,253,249,23,226,20,206,140,4,33,3,173,26,94,57,32,13
TCAATCAGAGAAGTAA,sample,189,187,12,175,13,162,111,7,28,3,139,13,70,50,32,8
ATATGCAAAGAAGTAA,sample,27426,27268,1183,26085,2873,23212,15869,1754,3745,378,19614,1466,2063,1363,2944,1780
Short,Non_sample,0,NA,NA,NA,NA,NA,NA,NA,NA,NA,NA,NA,NA,NA,NA,NA
Unselected,Non_sample,1265404,NA,NA,NA,NA,NA,NA,NA,NA,NA,NA,NA,NA,NA,NA,NA
Undetermined,Non_sample,142585439,NA,NA,NA,NA,NA,NA,NA,NA,NA,NA,NA,NA,NA,NA,NA
