Barcode,Sample,Barcoded_Reads,Trimmed_Reads,Unmapped_Reads,Mapped_Reads,Multimapped_Reads,Uniquely_Mapped_Reads,Exon_Reads,Ambiguous_Exon_Reads,Intron_Reads,Ambiguous_Intron_Reads,Gene_Reads,Intergenic_Reads,No_of_Genes,No_of_Transcripts,Mitochondrial_Reads,Ribosomal_Reads
TCCTCCGTCGTTGGTT,sample,24236,24007,1134,22873,5299,17574,10379,991,4359,674,14738,1171,1777,1217,2420,3476
ACGTTATGCGTTGGTT,sample,35319,35089,3323,31766,10110,21656,11076,852,5646,633,16722,3449,2923,1038,2717,5461
TTCTAATGCGTTGGTT,sample,22447,22285,803,21482,6663,14819,12165,1073,1266,97,13431,218,947,1026,4163,4229
CAAGGCCTCGTTGGTT,sample,276,268,48,220,31,189,122,16,29,4,151,18,88,61,39,19
GACGGAGACGTTGGTT,sample,2309,2278,199,2079,320,1759,1054,78,439,47,1493,141,686,407,335,228
GTTAGCCGCGTTGGTT,sample,28944,28742,1968,26774,6831,19943,12525,1153,3882,449,16407,1934,2844,1561,3656,4257
AATCCGTCCGTTGGTT,sample,61317,60812,5062,55750,6286,49464,22864,2213,16180,1646,39044,6561,4649,1791,4700,3996
CGTACGTCCGTTGGTT,sample,189330,187784,13901,173883,28530,145353,90166,6168,30117,3438,120283,15464,5891,2062,29804,20974
GTCCTGCCCGTTGGTT,sample,62918,62375,5208,57167,7290,49877,25997,2115,13536,1382,39533,6847,4592,1593,6947,4578
GCCTGAACCGTTGGTT,sample,119564,118647,4862,113785,22035,91750,70144,5603,10770,1134,80914,4099,3188,1906,14159,16395
ACGTATTACGTTGGTT,sample,154035,153301,4816,148485,29599,118886,95036,9775,10139,885,105175,3051,2404,1998,24741,21149
AACTCGTACGTTGGTT,sample,39187,38907,3517,35390,5256,30134,15478,1884,8017,921,23495,3834,3450,1576,3604,3426
CGTATGAACGTTGGTT,sample,50873,50547,2639,47908,10801,37107,25004,2640,5844,860,30848,2759,3145,1610,5758,7042
CTTCATGACGTTGGTT,sample,22030,21888,869,21019,3312,17707,11228,1082,3780,436,15008,1181,2461,1860,1604,2247
TTATTCGACGTTGGTT,sample,46268,46033,1594,44439,9215,35224,26740,2516,4243,571,30983,1154,1717,1508,6867,6551
GACCGGAACGTTGGTT,sample,244,237,18,219,46,173,107,4,44,1,151,17,104,55,31,29
GGAGAGTTCTATCGTT,sample,24840,24708,902,23806,5493,18313,15605,1453,815,130,16420,310,1455,1810,3031,3763
AAGTTCGTCTATCGTT,sample,24027,23828,1248,22580,2934,19646,11826,902,4961,568,16787,1389,1969,1326,2267,2082
ACGTTATGCTATCGTT,sample,58950,58434,4675,53759,11322,42437,26781,1546,7424,838,34205,5848,3698,1576,9512,7604
ATGCCTGGCTATCGTT,sample,30903,30650,2541,28109,5694,22415,14557,1038,3851,458,18408,2511,3387,1921,3434,3750
CAAGGCCTCTATCGTT,sample,31721,31438,1954,29484,7178,22306,16612,1103,3018,356,19630,1217,2239,1468,5626,4856
CATAACCTCTATCGTT,sample,14657,14539,907,13632,2250,11382,7674,681,1929,277,9603,821,1943,1376,2284,1544
ACTATACTCTATCGTT,sample,29933,29743,1575,28168,8491,19677,16162,1264,1589,207,17751,455,1097,1113,5186,5405
GACGGAGACTATCGTT,sample,23192,22989,1512,21477,4642,16835,13099,634,1875,283,14974,944,1412,1029,5326,3340
CCAGAGCGCTATCGTT,sample,1726,1699,126,1573,273,1300,951,73,164,31,1115,81,591,451,171,189
CCGCAACGCTATCGTT,sample,38109,37621,2187,35434,7075,28359,24120,1515,2158,237,26278,329,1143,1210,7982,5107
ACCTCGAGCTATCGTT,sample,38462,38078,1881,36197,7106,29091,24406,1501,2490,192,26896,502,985,998,9360,5256
CATTGCAGCTATCGTT,sample,27015,26461,4607,21854,2816,19038,7436,442,5945,688,13381,4527,3619,965,2233,1606
ACGACTTCCTATCGTT,sample,62832,62166,4279,57887,10631,47256,34020,1998,7601,793,41621,2844,2557,1217,13134,7627
AATCCGTCCTATCGTT,sample,52317,51809,3637,48172,7240,40932,29611,2037,6315,548,35926,2421,2387,1384,9554,5403
TTGGTACCCTATCGTT,sample,76368,75578,5561,70017,8636,61381,43885,3188,8806,912,52691,4590,3451,1573,9968,6273
TTGGCCTCCTATCGTT,sample,18585,18398,2448,15950,2095,13855,4378,422,5068,481,9446,3506,3000,681,1107,1328
GAAGGCGCCTATCGTT,sample,36147,35696,4907,30789,3843,26946,10712,1254,7824,1065,18536,6091,3786,1021,1814,2198
GTACCGTACTATCGTT,sample,35473,35161,2084,33077,5750,27327,20889,1251,3150,509,24039,1528,1559,905,6515,4063
TCGCCTGACTATCGTT,sample,54172,53657,6163,47494,5827,41667,19102,1495,11363,1253,30465,8454,5439,1239,4338,3762
TTATTCGACTATCGTT,sample,17091,16938,1588,15350,1339,14011,6652,447,4399,473,11051,2040,2368,1073,804,766
ATTCTCTTGTCTTCTT,Pos_Ctrl,2305,2268,256,2012,152,1860,1516,156,132,11,1648,45,931,714,140,97
TCCAACTTGTCTTCTT,sample,38915,38681,1624,37057,7455,29602,20023,1860,5453,627,25476,1639,3149,2528,3046,4976
TCCTCCGTGTCTTCTT,sample,40678,40475,1828,38647,8229,30418,22702,1724,3954,325,26656,1713,2493,1708,6819,5742
CCTCTAGAGTCTTCTT,Pos_Ctrl,7375,7235,743,6492,509,5983,5043,542,262,33,5305,103,2133,1891,431,299
AGTACCATGTCTTCTT,sample,45396,45050,2518,42532,5705,36827,19468,1267,11185,1416,30653,3491,2910,1568,3073,3944
ACGTTATGGTCTTCTT,sample,53392,53015,3111,49904,10185,39719,28579,2044,6024,853,34603,2219,2201,1146,13718,7419
ATGCCTGGGTCTTCTT,sample,38196,37849,2614,35235,4155,31080,18694,1038,7400,1079,26094,2869,2946,1668,3976,2884
TGAGCGCGGTCTTCTT,sample,40473,40133,2512,37621,4759,32862,21056,1107,7120,1225,28176,2354,2479,1438,7059,3736
AATGGTAAGTCTTCTT,sample,42831,42531,2365,40166,5862,34304,21881,1326,7690,1027,29571,2380,2883,1777,6459,4150
CATAACCTGTCTTCTT,sample,103365,102258,10666,91592,15071,76521,46460,3581,16654,1608,63114,8218,5741,2317,12969,10345
CTTGATAGGTCTTCTT,sample,39715,39109,4830,34279,4123,30156,10790,875,10645,1123,21435,6723,4894,1474,1718,2635
ACCTCGAGGTCTTCTT,sample,31345,30881,3652,27229,3698,23531,11218,690,6477,677,17695,4469,3806,1239,3615,2315
CGAGGCAGGTCTTCTT,sample,39131,38658,4395,34263,6133,28130,12462,660,9170,1058,21632,4780,3969,1301,4456,3929
CCATGAAGGTCTTCTT,sample,52827,52251,2875,49376,8843,40533,33368,2284,3481,313,36849,1087,1118,1153,11675,6647
AATCCGTCGTCTTCTT,sample,49996,49259,7126,42133,5745,36388,15678,1257,10890,1123,26568,7440,4781,1198,4894,3729
CTAGGACCGTCTTCTT,sample,55067,54553,2633,51920,9399,42521,35054,3155,2723,218,37777,1371,2723,2713,6029,6875
AACTCGTAGTCTTCTT,sample,10423,10272,745,9527,3028,6499,4974,398,730,90,5704,307,774,594,1162,1816
CGTATGAAGTCTTCTT,sample,55578,54947,5530,49417,6912,42505,23011,1735,9635,1207,32646,6917,4478,1247,6154,4743
GTCTTAGCGTCTTCTT,sample,50496,49884,4574,45310,6571,38739,24871,1650,6841,1285,31712,4092,2638,1040,7929,4644
CCAATTCCGTCTTCTT,sample,56103,55204,7637,47567,6159,41408,17225,1245,12546,1408,29771,8984,4983,1096,5008,3784
GGCATATAGTCTTCTT,sample,55532,55021,4659,50362,7180,43182,30107,2738,6240,582,36347,3515,2788,1184,8229,4974
TCGCCTGAGTCTTCTT,sample,76271,75453,7565,67888,6108,61780,36242,2610,13802,1316,50044,7810,5194,1993,6906,4015
AGGTCGGAGTCTTCTT,Pos_Ctrl,13243,13066,1274,11792,739,11053,9279,938,579,73,9858,184,3221,3075,545,421
ATTCTCTTTAGGCTCT,sample,289357,287808,10254,277554,56662,220892,182435,14857,16688,1969,199123,4943,2600,2303,62977,40798
CCTCTAGATAGGCTCT,sample,100564,99641,8265,91376,16612,74764,37148,2420,20532,2317,57680,12347,5770,1470,11355,11042
TTCGTAATTAGGCTCT,sample,163815,162806,7105,155701,25334,130367,82943,6549,30598,3280,113541,6997,3683,2449,20500,18264
AATGGTAATAGGCTCT,sample,34351,34146,2171,31975,6379,25596,14830,1336,5734,662,20564,3034,3705,1683,4817,3790
CCAGAGCGTAGGCTCT,sample,149441,147522,10762,136760,24132,112628,78163,5905,19192,2423,97355,6945,3389,1570,32831,17175
GTTAGCCGTAGGCTCT,sample,139205,137833,7489,130344,28440,101904,87850,4120,6479,1752,94329,1703,1384,1369,32344,19871
GGACGTAGTAGGCTCT,sample,180569,177483,22667,154816,21627,133189,62560,4535,36443,4118,99003,25533,8756,2167,18554,13132
TGGACGAGTAGGCTCT,sample,151334,149665,7656,142009,33552,108457,91718,5173,8884,1239,100602,1443,1425,1416,35491,23708
CATTGCAGTAGGCTCT,sample,75684,74833,6323,68510,12490,56020,34663,2231,12269,1551,46932,5306,4264,2094,9114,7265
CCATGAAGTAGGCTCT,sample,211664,209738,11487,198251,37449,160802,131690,10098,14393,929,146083,3692,2134,1863,35751,26435
ACGTATTATAGGCTCT,sample,252174,249336,20154,229182,31792,197390,129691,9692,35677,3429,165368,18901,7448,2261,32575,23074
TGCTTCGCTAGGCTCT,sample,99002,98185,6254,91931,14010,77921,44398,5126,17723,2108,62121,8566,4637,1417,9026,9389
AAGAGCGCTAGGCTCT,sample,174061,172848,6357,166491,31478,135013,115480,7311,9725,1148,125205,1349,1413,1517,33742,24072
GTCTTAGCTAGGCTCT,sample,133641,132367,9884,122483,20700,101783,57073,4190,23650,3157,80723,13713,5602,1365,13934,14422
GGCATATATAGGCTCT,sample,149504,148562,6843,141719,30956,110763,91001,7340,9189,1328,100190,1905,1875,1508,25445,22772
TTATTCGATAGGCTCT,sample,63820,63515,2287,61228,7622,53606,39035,3816,8313,853,47348,1589,2431,2165,5202,5607
TATCAGTTTTGACTAT,sample,55024,54523,3031,51492,10165,41327,34651,2152,3124,978,37775,422,1086,1123,11989,7372
TCCAACTTTTGACTAT,Neg_Ctrl,1131,839,586,253,29,224,118,5,50,8,168,43,121,53,22,27
AGTACCATTTGACTAT,Neg_Ctrl,1488,1018,804,214,17,197,106,11,59,4,165,17,105,53,39,13
TTCGTAATTTGACTAT,sample,611,596,111,485,145,340,135,6,97,9,232,93,156,57,45,79
ACGTTATGTTGACTAT,sample,12801,12609,1892,10717,1311,9406,3691,253,3388,394,7079,1680,2236,803,910,716
ATGCCTGGTTGACTAT,sample,26919,26617,1875,24742,3068,21674,15745,1068,3178,373,18923,1310,2374,1778,3099,2293
TTAGAAGTTTGACTAT,sample,22215,22018,982,21036,5679,15357,13217,908,870,83,14087,279,1071,1098,4179,3823
TTCCGTCTTTGACTAT,Pos_Ctrl,24016,23573,3286,20287,1392,18895,15839,1474,1083,160,16922,339,4257,4111,1263,767
GTTAGCCGTTGACTAT,sample,49073,48376,5842,42534,4839,37695,19332,1236,10379,1213,29711,5535,3529,1174,6036,3008
CCGCAACGTTGACTAT,Pos_Ctrl,20324,19627,3337,16290,1102,15188,12885,1032,913,83,13798,275,3997,3556,877,599
GACGATAATTGACTAT,sample,51098,50222,5135,45087,4938,40149,25476,1400,8383,889,33859,4001,3467,1711,5477,3432
GGCCAGAGTTGACTAT,sample,61734,60709,7496,53213,4504,48709,32119,2114,7647,817,39766,6012,4590,2208,4571,2654
CATTGCAGTTGACTAT,sample,35513,34941,3185,31756,4088,27668,16316,934,7208,854,23524,2356,1968,1047,6078,3018
CGAGGCAGTTGACTAT,sample,67218,66250,6475,59775,7561,52214,31462,1586,11161,1052,42623,6953,3700,1321,11367,5273
AATCCGTCTTGACTAT,Pos_Ctrl,31733,30609,5444,25165,1569,23596,19826,1700,1463,189,21289,418,4937,4815,1171,974
CTAGGACCTTGACTAT,sample,60213,58992,10324,48668,5132,43536,16645,1077,14230,1237,30875,10347,5323,1047,5047,2842
GTTAGGACTTGACTAT,sample,73659,72779,5953,66826,9130,57696,37118,2894,10478,861,47596,6345,3075,1182,11668,6438
TTGGCCTCTTGACTAT,Pos_Ctrl,12557,12337,1662,10675,627,10048,8512,819,495,63,9007,159,3049,2741,482,388
ACCAATGCTTGACTAT,sample,124715,122245,20342,101903,11494,90409,41922,2837,24929,2478,66851,18243,7305,1835,9596,7142
GAAGGCGCTTGACTAT,sample,42427,42077,2763,39314,4390,34924,22320,2126,6893,847,29213,2738,2317,1276,5173,3146
GTCTTAGCTTGACTAT,sample,41317,40727,6316,34411,3551,30860,8954,899,11118,1315,20072,8574,4998,978,1233,1941
TCAATATATTGACTAT,sample,64589,63996,3480,60516,9396,51120,42018,3460,3940,629,45958,1073,2003,1799,8163,7294
TTATTCGATTGACTAT,Neg_Ctrl,696,536,246,290,23,267,176,9,41,6,217,35,149,88,33,6
ATGACCGATTGACTAT,sample,140352,139153,19526,119627,8567,111060,42435,3352,40862,4731,83297,19680,10266,2664,6866,4009
GGAGAGTTTGCAGTTG,sample,30273,30066,1659,28407,4277,24130,15131,1173,5258,837,20389,1731,2162,1243,4534,2992
TCCAACTTTGCAGTTG,sample,52621,52063,3110,48953,5006,43947,26062,1864,11342,1192,37404,3487,2724,1499,6217,3405
ACGTAAGTTGCAGTTG,sample,39656,39031,4673,34358,3588,30770,12753,902,10441,1271,23194,5403,3758,1338,3289,2052
GGACCTCTTGCAGTTG,sample,54666,54216,3928,50288,7766,42522,28084,2172,6945,772,35029,4549,4485,2400,5854,5310
TCGCATCTTGCAGTTG,sample,26357,26113,1118,24995,4853,20142,16462,1098,1771,205,18233,606,2087,1854,4167,3397
GCCTTGCTTGCAGTTG,sample,31200,30945,1524,29421,5387,24034,17685,1211,3141,418,20826,1579,1841,1159,6377,3977
GACGGAGATGCAGTTG,sample,21281,20996,2483,18513,3787,14726,6492,627,4221,489,10713,2897,3315,1326,1339,2457
CCAGAGCGTGCAGTTG,sample,53020,52519,2526,49993,10421,39572,34845,1734,2071,314,36916,608,1156,1307,12797,7815
CCGCAACGTGCAGTTG,sample,40057,39700,2261,37439,5426,32013,23849,1707,4361,554,28210,1542,3154,2442,5908,3918
GGACGTAGTGCAGTTG,sample,15311,15175,675,14500,2481,12019,9035,569,1557,265,10592,593,1520,1111,3048,1721
CCATGAAGTGCAGTTG,sample,39982,39294,5723,33571,2969,30602,10786,839,11240,1191,22026,6546,4397,1308,1998,1545
GCCTGAACTGCAGTTG,sample,50231,49717,2414,47303,6827,40476,33922,2225,2900,323,36822,1106,1425,1498,7808,4986
TCCAACTTTCATGCTG,sample,15585,15335,1968,13367,1482,11885,6351,423,3025,351,9376,1735,2073,892,1581,956
TAGTACGGTCATGCTG,sample,25215,24768,2899,21869,2156,19713,12458,586,3900,404,16358,2365,2341,1259,2956,1417
AATGGTAATCATGCTG,sample,21115,20849,1458,19391,3062,16329,13039,939,1508,209,14547,634,1126,946,5026,2204
TTCCGTCTTCATGCTG,sample,12968,12708,1531,11177,1544,9633,6284,310,1928,197,8212,914,1198,596,2784,1107
GGACCTCTTCATGCTG,Neg_Ctrl,336,238,138,100,9,91,59,1,18,1,77,12,51,24,16,3
GCCTTGCTTCATGCTG,sample,11376,11196,1064,10132,1377,8755,5992,450,1387,123,7379,803,1326,788,2081,976
GGACGTAGTCATGCTG,Neg_Ctrl,349,275,125,150,15,135,92,6,20,5,112,12,78,54,23,12
TGGACGAGTCATGCTG,sample,24461,23920,3541,20379,1479,18900,7350,415,6528,757,13878,3850,3069,972,1386,778
GACGATAATCATGCTG,sample,17115,16784,1881,14903,2102,12801,8813,449,2014,194,10827,1331,1335,724,3735,1529
GGCCAGAGTCATGCTG,sample,17224,16890,1774,15116,1908,13208,8362,443,2518,222,10880,1663,2002,931,2288,1323
CGAGGCAGTCATGCTG,sample,9822,9670,918,8752,1612,7140,4241,287,1537,152,5778,923,1555,791,1003,1060
CATGATTCTCATGCTG,sample,15019,14667,2726,11941,1392,10549,3571,250,3668,384,7239,2676,2427,628,706,803
CGTACGTCTCATGCTG,Neg_Ctrl,473,330,130,200,23,177,104,7,40,3,144,23,108,53,19,10
AGTCCGCATCATGCTG,sample,19964,19728,1279,18449,2950,15499,12498,820,1323,166,13821,692,1547,1244,3371,2233
GTCCTGCCTCATGCTG,sample,16130,15927,1134,14793,1612,13181,8644,635,2485,372,11129,1045,1448,917,1844,1008
GTTAGGACTCATGCTG,sample,14500,14329,718,13611,2357,11254,9255,777,957,74,10212,191,656,680,2967,1749
GCCTGAACTCATGCTG,sample,12358,12211,551,11660,1983,9677,8184,579,641,79,8825,194,742,822,2311,1498
AATATATCTCATGCTG,Neg_Ctrl,334,257,102,155,15,140,80,8,34,4,114,14,86,42,14,9
ACCAATGCTCATGCTG,sample,15339,15214,682,14532,1989,12543,10020,906,1078,151,11098,388,1171,1135,1927,1546
ATGACCGATCATGCTG,sample,1201,1191,54,1137,213,924,655,64,121,14,776,70,405,338,93,153
GACCGGAATCATGCTG,sample,89,87,12,75,11,64,36,4,10,1,46,13,36,20,11,7
ATTCTCTTTTAGGCGG,Pos_Ctrl,50429,48247,8494,39753,2288,37465,31412,2522,2422,293,33834,816,5756,6028,2238,1408
TCCAACTTTTAGGCGG,sample,72847,71803,4748,67055,6270,60785,49743,3642,4808,925,54551,1667,2799,2784,8467,4838
AAGTTCGTTTAGGCGG,sample,45610,44820,4575,40245,4878,35367,23025,1404,6508,546,29533,3884,3160,1333,6028,3317
ACGTAAGTTTAGGCGG,sample,67158,66022,6444,59578,6227,53351,31234,2236,12708,1525,43942,5648,3448,1508,9895,3899
CCTCTAGATTAGGCGG,Pos_Ctrl,40909,38795,6897,31898,1896,30002,25305,1910,1969,242,27274,576,5415,5413,1901,1101
ACGTTATGTTAGGCGG,sample,42786,41661,7095,34566,3617,30949,14333,990,9303,1083,23636,5240,4446,1463,3811,2209
TGAGCGCGTTAGGCGG,sample,27959,27787,1024,26763,3571,23192,18783,1870,1675,185,20458,679,2550,2575,2486,2664
TTAGAAGTTTAGGCGG,sample,49159,48810,3259,45551,11077,34474,22622,1785,6113,758,28735,3196,3169,1409,9404,7222
GCCTTGCTTTAGGCGG,sample,54797,54352,3278,51074,10377,40697,28753,1808,5832,757,34585,3547,3140,1443,9415,7121
CATAACCTTTAGGCGG,sample,92050,91152,5609,85543,12571,72972,52297,3940,11147,1273,63444,4315,3530,1974,16176,8858
GTTAGCCGTTAGGCGG,sample,1684,900,470,430,50,380,192,15,91,11,283,71,205,87,55,13
GGAGGACGTTAGGCGG,sample,50028,49313,5007,44306,6653,37653,22197,897,8170,990,30367,5399,3460,1088,10884,4371
GGACGTAGTTAGGCGG,sample,59213,58531,3759,54772,9912,44860,36774,2328,3650,515,40424,1593,1861,1419,14555,7231
CTTGATAGTTAGGCGG,sample,70452,69734,5230,64504,6375,58129,40778,2760,9951,1180,50729,3460,3504,2283,7991,4272
GACGATAATTAGGCGG,sample,36824,36245,4575,31670,3402,28268,12659,751,9530,1021,22189,4307,3458,1493,2840,1893
CATTGCAGTTAGGCGG,sample,38316,37774,3144,34630,5413,29217,19923,1115,4747,494,24670,2938,2739,1340,6217,4081
CCATGAAGTTAGGCGG,sample,170262,167185,20231,146954,13670,133284,71000,3948,31177,3386,102177,23773,8931,2470,13745,8330
CGTACGTCTTAGGCGG,sample,108956,107265,12046,95219,15269,79950,51726,3899,12983,1355,64709,9987,5380,2073,14600,10105
CGGATTACTTAGGCGG,sample,106358,105221,5880,99341,17370,81971,68786,5316,5809,525,74595,1535,1366,1461,18671,12771
GTTAGGACTTAGGCGG,sample,103266,102244,6258,95986,19200,76786,63981,4163,6198,607,70179,1837,1770,1648,15591,13353
TGCTTCGCTTAGGCGG,sample,92327,91463,4529,86934,15541,71393,59995,4787,4708,390,64703,1513,1810,1704,14892,11444
GAAGGCGCTTAGGCGG,sample,80247,79030,9691,69339,8786,60553,29754,2554,16000,1776,45754,10469,5197,1479,9553,5764
CCAATTCCTTAGGCGG,sample,120181,118744,8950,109794,14339,95455,64121,4826,14329,1374,78450,10805,3947,1613,18208,11158
AGGTCGGATTAGGCGG,sample,124606,123563,7030,116533,22249,94284,66395,4431,14682,1705,81077,7071,3234,1511,21177,16537
GACCGGAATTAGGCGG,sample,43473,43106,3457,39649,7585,32064,20958,1169,6268,649,27226,3020,3044,1328,7552,5171
GGAGAGTTTCAGATAC,sample,1488,1460,98,1362,315,1047,849,47,108,11,957,32,320,270,302,225
TATCAGTTTCAGATAC,sample,13315,13175,1464,11711,1146,10565,4979,319,3235,422,8214,1610,2196,898,1105,695
TGAGCGCGTCAGATAC,sample,19602,19385,2324,17061,1802,15259,8140,426,4015,457,12155,2221,2341,1031,2144,1104
AATGGTAATCAGATAC,sample,6776,6666,663,6003,1250,4753,3111,179,931,103,4042,429,1056,557,1313,810
TTAGAAGTTCAGATAC,sample,19959,19746,1231,18515,2693,15822,12302,877,1723,171,14025,749,1662,1410,3077,2091
CATAACCTTCAGATAC,sample,15378,15172,1153,14019,2312,11707,9193,587,1237,140,10430,550,1269,1011,2694,1715
ACTATACTTCAGATAC,sample,20105,19777,2554,17223,2189,15034,9143,605,3070,422,12213,1794,2570,1197,2454,1471
GGACGTAGTCAGATAC,sample,13093,12788,2900,9888,644,9244,2522,122,3947,437,6469,2216,2591,610,312,294
CTTGATAGTCAGATAC,sample,18405,18151,1935,16216,2171,14045,9893,595,2182,204,12075,1171,1802,1041,3192,1515
TGGACGAGTCAGATAC,sample,17118,16845,1287,15558,2499,13059,10451,487,1404,166,11855,551,1097,834,4341,1845
CATTGCAGTCAGATAC,sample,8874,8757,502,8255,1506,6749,5521,381,612,83,6133,152,631,601,2269,1122
CCATGAAGTCAGATAC,sample,19700,19433,1332,18101,2133,15968,12105,835,2028,251,14133,749,1613,1262,2110,1560
ACGACTTCTCAGATAC,sample,25861,25380,4610,20770,1287,19483,7421,428,6817,841,14238,3976,3412,1116,800,576
AGTCCGCATCAGATAC,sample,16200,15962,1665,14297,1823,12474,8585,494,1971,243,10556,1181,1912,1014,1835,1257
TTGGTACCTCAGATAC,sample,17712,17468,2062,15406,1564,13842,6784,455,4135,505,10919,1963,1869,774,1279,902
CTAGGACCTCAGATAC,sample,26546,26040,4228,21812,2397,19415,10071,616,4605,539,14676,3584,3042,935,2675,1366
AACTCGTATCAGATAC,sample,21156,20915,1362,19553,2196,17357,13558,1296,1657,196,15215,650,1389,1110,3041,1517
AATATATCTCAGATAC,sample,116817,115070,17347,97723,5739,91984,40559,2711,32241,3962,72800,12511,7480,2504,4772,2676
TTGGTTAATCAGATAC,sample,38495,38043,6557,31486,3869,27617,10919,840,8173,882,19092,6803,4748,1103,3157,2347
GTACCGTATCAGATAC,sample,28232,27908,1481,26427,3575,22852,19890,1324,1182,217,21072,239,1316,1531,3106,2904
AGGTCGGATCAGATAC,sample,16179,15988,905,15083,3083,12000,9989,795,925,141,10914,150,730,732,2714,2263
TTATTCGATCAGATAC,sample,13436,13287,1057,12230,1294,10936,7245,538,2054,245,9299,854,1397,911,1805,838
GACCGGAATCAGATAC,sample,5216,5165,341,4824,581,4243,3431,267,315,38,3746,192,1062,1029,410,404
TCCAACTTTCGCTAGG,Neg_Ctrl,705,531,240,291,25,266,159,8,52,8,211,39,141,73,37,13
AGTACCATTCGCTAGG,Neg_Ctrl,593,440,256,184,23,161,97,4,36,10,133,14,86,45,35,8
CAACCGCGTCGCTAGG,sample,8642,8400,1909,6491,724,5767,1702,88,2120,250,3822,1607,1783,449,365,384
GGACCTCTTCGCTAGG,sample,11196,10906,1295,9611,1013,8598,5588,310,1487,266,7075,947,1349,695,2058,706
GCCTTGCTTCGCTAGG,sample,7909,7777,552,7225,1146,6079,5038,283,604,41,5642,113,615,567,2090,902
ACTATACTTCGCTAGG,sample,8418,8151,1829,6322,646,5676,1950,114,1903,204,3853,1505,1682,441,603,333
GGACGTAGTCGCTAGG,sample,6341,6219,797,5422,751,4671,2992,170,830,79,3822,600,954,554,1156,520
CTTGATAGTCGCTAGG,sample,12272,12073,1290,10783,1653,9130,5809,370,1714,216,7523,1021,1487,817,1950,1099
TGGACGAGTCGCTAGG,sample,60430,59761,3633,56128,6708,49420,37392,2623,6540,670,43932,2195,2456,1651,12136,4680
GGCCAGAGTCGCTAGG,sample,67192,66645,3562,63083,9442,53641,42022,2738,6204,1059,48226,1618,1838,1299,15268,6646
CATTGCAGTCGCTAGG,sample,54808,54166,5056,49110,4376,44734,23881,1639,12373,1328,36254,5513,3728,1574,3540,2786
CGAGGCAGTCGCTAGG,sample,82535,81712,4402,77310,9327,67983,55989,4579,4589,742,60578,2084,2868,2590,10445,6968
CCATGAAGTCGCTAGG,sample,122674,121399,6677,114722,14015,100707,81508,5058,9431,1065,90939,3645,2636,1910,16759,11248
CATGATTCTCGCTAGG,sample,96747,94866,14957,79909,7670,72239,34899,2612,18180,2145,53079,14403,6814,1546,8111,4341
TTGGTACCTCGCTAGG,sample,42670,42177,2596,39581,5968,33613,26410,1560,3757,348,30167,1538,2127,1366,6860,4399
CTAGGACCTCGCTAGG,sample,81840,81048,6122,74926,6899,68027,44149,3006,13473,1692,57622,5707,3694,1761,8531,4795
CGGATTACTCGCTAGG,sample,94673,93581,6189,87392,10081,77311,51693,3797,14995,1868,66688,4958,2656,1570,10020,7638
GTTAGGACTCGCTAGG,sample,23089,22699,3427,19272,2728,16544,7743,545,4732,531,12475,2993,2813,783,2520,1613
GCCTGAACTCGCTAGG,sample,61190,60118,7891,52227,4649,47578,24191,1848,12495,1481,36686,7563,4579,1361,4515,2721
ACGTATTATCGCTAGG,sample,66704,65844,6041,59803,5313,54490,32032,1955,12316,1824,44348,6363,3345,1268,5194,3323
CGTATGAATCGCTAGG,sample,79728,78150,9725,68425,6624,61801,34261,2924,14382,1418,48643,8816,5391,1650,6174,4474
AATATATCTCGCTAGG,sample,67676,66465,10195,56270,6563,49707,19914,1261,16001,1647,35915,10884,5855,1249,5616,3832
ACCAATGCTCGCTAGG,sample,68653,67864,3551,64313,8446,55867,45927,3259,4501,832,50428,1348,1476,1321,10939,6273
GTACCGTATCGCTAGG,Pos_Ctrl,25304,24485,3975,20510,1138,19372,16478,1381,1013,136,17491,364,4299,4054,931,612
TCGCCTGATCGCTAGG,sample,73433,72629,4564,68065,4279,63786,51608,2831,5599,567,57207,3181,3595,2643,4007,2730
AGGTCGGATCGCTAGG,sample,58083,57590,2758,54832,6613,48219,38384,3304,4498,771,42882,1262,1783,1359,7939,4961
GACCGGAATCGCTAGG,sample,20068,19875,1058,18817,2772,16045,12111,1294,1601,222,13712,817,1920,1596,1784,1960
TATCAGTTCCGTTGCG,sample,62289,61959,3101,58858,9663,49195,26932,2220,14163,1717,41095,4163,3459,1657,7163,6405
ACGTAAGTCCGTTGCG,sample,63589,62970,3412,59558,13721,45837,35425,2010,5769,716,41194,1917,2439,1345,17151,9419
TTCGTAATCCGTTGCG,sample,50868,50426,2530,47896,16067,31829,26121,1633,2943,359,29064,773,2124,1950,8377,9437
TTCCGTCTCCGTTGCG,sample,152028,150100,14641,135459,19221,116238,73156,4696,23283,2366,96439,12737,5723,1985,26900,13065
GGACCTCTCCGTTGCG,sample,89570,88577,9944,78633,12373,66260,38016,2633,14994,1589,53010,9028,5671,1793,16244,7964
GCCTTGCTCCGTTGCG,sample,100041,98020,19733,78287,9219,69068,21947,1326,24243,2580,46190,18972,8616,1964,7493,4938
GTTAGCCGCCGTTGCG,sample,48895,48242,3669,44573,9098,35475,27391,1775,4061,363,31452,1885,2355,1619,10672,6410
GGACGTAGCCGTTGCG,sample,181846,180377,10247,170130,27879,142251,122484,7709,9389,516,131873,2153,1499,1652,39089,22063
TGGACGAGCCGTTGCG,sample,155992,153670,20373,133297,15433,117864,60798,4240,29460,2952,90258,20414,8121,2013,21155,9004
GTTAGGACCCGTTGCG,sample,240249,237191,22763,214428,22586,191842,115994,7803,41064,5556,157058,21425,6260,1948,26766,15788
TGCTTCGCCCGTTGCG,sample,113436,112108,13131,98977,9473,89504,40282,2418,28495,2978,68777,15331,6208,1854,5054,5567
TTGGTTAACCGTTGCG,sample,227838,226352,10091,216261,37228,179033,144406,13132,17180,998,161586,3317,1285,1141,34339,27141
TCAATATACCGTTGCG,sample,235223,231875,44693,187182,15096,172086,45693,3282,66566,7528,112259,49017,12000,2099,10083,7657
CTTCATGACCGTTGCG,sample,109711,108241,11793,96448,13742,82706,42002,2787,21643,2833,63645,13441,6194,1671,4993,7840
TATCAGTTAGGCCAAG,sample,215839,213611,22874,190737,25450,165287,95003,8073,35707,4362,130710,22142,8127,2333,32850,15884
ATTCTCTTAGGCCAAG,sample,246191,243050,24225,218825,28906,189919,100235,7714,46163,3865,146398,31942,9152,2575,27120,19314
AAGTTCGTAGGCCAAG,sample,137039,135413,9906,125507,18301,107206,76283,5387,15155,1992,91438,8389,4819,2116,23282,12114
ACGTAAGTAGGCCAAG,sample,51747,51108,3057,48051,16953,31098,23372,1603,3906,320,27278,1897,1918,1167,8303,10047
ACGTTATGAGGCCAAG,sample,197151,194947,15628,179319,30172,149147,96878,7267,26450,3478,123328,15074,6300,2137,36502,21775
CAACCGCGAGGCCAAG,sample,177806,176257,12776,163481,19037,144444,94268,7290,26827,3209,121095,12850,6217,2765,18662,13621
TTCCGTCTAGGCCAAG,sample,62273,61616,6868,54748,14417,40331,17082,1294,13812,1315,30894,6828,5165,1683,3850,9062
ACTATACTAGGCCAAG,sample,188520,186769,15578,171191,26695,144496,84734,7218,32821,4494,117555,15229,6054,1946,32007,18654
GTTAGCCGAGGCCAAG,sample,26950,26676,3678,22998,3205,19793,6027,387,7551,781,13578,5047,3875,881,1846,1799
GGCCAGAGAGGCCAAG,sample,115061,114334,5881,108453,16464,91989,69896,4475,11894,1536,81790,4188,3826,2126,16267,11986
AGTCCGCAAGGCCAAG,sample,257089,252963,26875,226088,21611,204477,108850,7557,55614,6690,164464,25766,7349,2125,24896,12043
GCCTGAACAGGCCAAG,sample,138662,136968,9992,126976,12792,114184,73369,5780,22363,3273,95732,9399,4375,2070,10109,8415
CCAATTCCAGGCCAAG,sample,112026,110301,10366,99935,12798,87137,54976,4475,15736,2046,70712,9904,5672,2687,9197,8513
TTGGTTAAAGGCCAAG,sample,188459,186539,15988,170551,15789,154762,91980,5675,36772,4674,128752,15661,6112,2283,19650,10585
GTACCGTAAGGCCAAG,sample,262446,258307,35086,223221,27423,195798,87479,5958,58613,5876,146092,37872,10344,2423,23494,17426
GGCATATAAGGCCAAG,Neg_Ctrl,1575,1065,716,349,41,308,198,12,47,9,245,42,164,95,40,21
TCGCCTGAAGGCCAAG,sample,171858,169817,21462,148355,16199,132156,75156,5102,30049,3294,105205,18555,9022,2446,14820,10691
TTATTCGAAGGCCAAG,sample,198921,197343,12808,184535,24244,160291,117237,6396,20753,2234,137990,13671,5360,1725,33316,16542
GACCGGAAAGGCCAAG,sample,110131,109438,5063,104375,16702,87673,65134,5360,11033,1499,76167,4647,3115,1731,14871,12098
AAGTTCGTAGAACCGC,sample,118648,117083,7246,109837,9980,99857,64657,4278,21515,3233,86172,6174,3857,2544,11534,6530
GGTTGCGTAGAACCGC,sample,272651,268812,17596,251216,34817,216399,178222,11687,17940,1816,196162,6734,4890,4026,29196,26833
AGTACCATAGAACCGC,sample,321931,313939,65222,248717,30976,217741,85653,6232,66219,7546,151872,52091,15184,3669,26774,17680
ATGCCTGGAGAACCGC,sample,121048,119789,13732,106057,12715,93342,50807,3384,21983,2346,72790,14822,7516,2091,17278,7896
TAGTACGGAGAACCGC,sample,139620,138665,7334,131331,22017,109314,84627,6304,11681,1850,96308,4852,4044,2279,25489,15555
CAACCGCGAGAACCGC,sample,121947,121071,8312,112759,12323,100436,58615,3923,26018,2997,84633,8883,4641,1906,18100,8768
AATGGTAAAGAACCGC,sample,157292,156005,7490,148515,11412,137103,69386,4812,46533,6385,115919,9987,3448,2131,13435,8171
TCGCATCTAGAACCGC,sample,129660,128438,12788,115650,23657,91993,46050,3469,26758,3183,72808,12533,6201,1841,12927,14801
GGAGGACGAGAACCGC,sample,333736,330542,25570,304972,33201,271771,155617,10351,69318,6720,224935,29765,7332,2111,29274,22475
TGGACGAGAGAACCGC,sample,112228,111467,5806,105661,20229,85432,60670,4512,14448,1596,75118,4206,3320,1896,19884,14574
GGCCAGAGAGAACCGC,sample,230699,228494,14586,213908,31447,182461,137764,8925,24103,2317,161867,9352,4298,1792,49586,22625
GCCTGAACAGAACCGC,sample,251673,247295,31962,215333,23608,191725,98005,7162,47255,6350,145260,32953,8817,1943,23531,15376
TGCTTCGCAGAACCGC,sample,179602,177842,8409,169433,25386,144047,118734,10290,12320,1382,131054,1321,1367,1349,25472,19691
GTACCGTAAGAACCGC,sample,249496,247323,11928,235395,39854,195541,157956,13633,17668,2443,175624,3841,1765,1507,45053,31169
GGCATATAAGAACCGC,sample,129585,127948,14787,113161,13920,99241,51394,4081,25748,2893,77142,15125,6535,2128,8900,8405
GACCGGAAAGAACCGC,sample,241693,239926,17385,222541,32999,189542,145498,11579,20197,2521,165695,9747,3522,1831,28115,23616
TATCAGTTCATCAAGC,sample,463630,458629,68258,390371,39399,350972,151026,8951,109172,11745,260198,70078,15053,4012,45540,24954
CCTCTAGACATCAAGC,sample,84861,83738,6898,76840,17926,58914,42774,2675,7806,751,50580,4908,4299,2517,12686,11794
TTCTAATGCATCAAGC,sample,42823,42403,3335,39068,9886,29182,20791,1534,4163,578,24954,2116,2611,1425,7915,6274
CAACCGCGCATCAAGC,sample,25075,24736,2405,22331,3720,18611,10878,764,4334,580,15212,2055,2433,992,4435,2445
AATGGTAACATCAAGC,sample,156756,155104,12729,142375,18673,123702,81015,5210,22907,2887,103922,11683,5743,2187,25255,12543
GCCTTGCTCATCAAGC,sample,114275,112275,20631,91644,8611,83033,28920,1817,29074,3106,57994,20116,9082,1844,9298,4940
GGAGGACGCATCAAGC,sample,106193,103848,19680,84168,8696,75472,25180,1567,25073,2512,50253,21140,8217,1449,10990,4422
GGACGTAGCATCAAGC,sample,126522,124740,14341,110399,21068,89331,46716,3331,21215,2829,67931,15240,7609,2109,14596,12899
TGGACGAGCATCAAGC,sample,156678,155242,11028,144214,12706,131508,78925,4883,32371,4521,111296,10808,4826,2005,14502,7956
GACGATAACATCAAGC,sample,125235,122820,22547,100273,16558,83715,25907,1235,31527,3505,57434,21541,8459,1557,6785,9685
CGAGGCAGCATCAAGC,sample,247701,244788,18485,226303,35549,190754,148943,8750,18767,3054,167710,11240,2594,1633,46752,25732
CGTACGTCCATCAAGC,sample,154980,152927,10154,142773,13853,128920,95154,6815,19154,2004,114308,5793,4286,2839,14952,9797
GTCCTGCCCATCAAGC,sample,175151,173448,9336,164112,21894,142218,111196,8104,16433,2086,127629,4399,3164,2006,31175,16340
AACTCGTACATCAAGC,sample,150035,148226,11172,137054,16408,120646,83708,7090,19705,1894,103413,8249,2905,1383,22555,12028
CGTATGAACATCAAGC,sample,121595,119705,16360,103345,11108,92237,51904,4547,20020,2000,71924,13766,6253,1583,12267,6770
TTGGCCTCCATCAAGC,Pos_Ctrl,64396,62842,10011,52831,3066,49765,41858,3805,2828,376,44686,898,6030,7140,2371,1632
AATATATCCATCAAGC,sample,186139,184581,9929,174652,28776,145876,121254,9049,11105,1803,132359,2665,1359,1292,35244,20247
GGCATATACATCAAGC,sample,125100,123668,14506,109162,17128,92034,50535,3123,22843,2471,73378,13062,6210,1528,13686,11789
TATCAGTTAGAGAGCC,sample,117334,116501,6526,109975,12931,97044,53558,4336,27097,3416,80655,8637,4190,1841,13468,9034
ATTCTCTTAGAGAGCC,sample,188185,186954,9819,177135,32225,144910,106317,8234,18329,2294,124646,9736,4175,1680,43230,22490
TTCGTAATAGAGAGCC,sample,98319,97716,6602,91114,10194,80920,42171,2805,24351,3185,66522,8408,4297,1852,9489,6756
TTCTAATGAGAGAGCC,sample,98833,98138,5244,92894,16820,76074,58089,3516,9472,773,67561,4224,3162,1377,24417,11974
TTCCGTCTAGAGAGCC,sample,104705,103624,5349,98275,21926,76349,63320,4719,6103,1060,69423,1147,1427,1476,23665,16094
GGACCTCTAGAGAGCC,sample,89299,88123,8531,79592,8025,71567,39865,2389,18795,2598,58660,7920,4572,1945,11960,5167
GTTAGCCGAGAGAGCC,sample,116235,114555,13729,100826,7242,93584,44419,2436,30686,3551,75105,12492,5533,2017,4573,3967
GGCCAGAGAGAGAGCC,sample,65583,64675,5405,59270,8825,50445,31748,2126,10095,1333,41843,5143,3991,1774,6757,5760
CATTGCAGAGAGAGCC,sample,93219,91764,10625,81139,10803,70336,34722,2512,19210,2121,53932,11771,6006,1522,9305,6456
CGAGGCAGAGAGAGCC,sample,102070,100873,7260,93613,8736,84877,44891,4194,25443,2804,70334,7545,3502,1650,8533,5771
CATGATTCAGAGAGCC,sample,142648,140530,14850,125680,12976,112704,67329,3780,25414,2644,92743,13537,6025,2352,10902,8937
AGTCCGCAAGAGAGCC,sample,43625,42970,4679,38291,6712,31579,18666,1372,6605,664,25271,4272,3576,1813,4388,4092
GTCCTGCCAGAGAGCC,sample,86581,85163,10778,74385,8837,65548,31665,2903,18927,1908,50592,10145,6277,1850,8092,5689
CGGATTACAGAGAGCC,sample,186797,185210,8062,177148,20402,156746,136431,11531,5944,881,142375,1959,1899,2370,18642,15847
AACTCGTAAGAGAGCC,sample,93062,91519,14143,77376,10155,67221,31021,2116,18852,1930,49873,13302,6289,1308,9560,6238
ACCAATGCAGAGAGCC,sample,116819,115494,6618,108876,16746,92130,77673,6902,5521,772,83194,1262,1309,1195,20595,13837
TCGCCTGAAGAGAGCC,sample,34649,33781,7412,26369,2927,23442,8860,648,7322,767,16182,5845,4170,1011,2207,1472
ATTCTCTTAGCATTGA,sample,177786,176542,7700,168842,16554,152288,85084,7065,43855,5653,128939,10631,3577,2106,20211,12045
TCCAACTTAGCATTGA,sample,320791,317169,43137,274032,31959,242073,95627,7535,74977,7830,170604,56104,12104,2770,29462,20285
AAGTTCGTAGCATTGA,sample,248542,246639,9840,236799,44184,192615,162037,10475,13603,1396,175640,5104,2875,2384,49149,31704
ATGCCTGGAGCATTGA,sample,147139,145844,9252,136592,15644,120948,85324,6765,18399,2448,103723,8012,6056,3137,19224,11006
TTAGAAGTAGCATTGA,sample,601621,595844,45178,550666,59559,491107,291384,23195,123781,13769,415165,38978,7676,3128,95088,43757
TCGCATCTAGCATTGA,sample,63195,62547,6555,55992,8557,47435,25055,1729,11256,1252,36311,8143,4908,1311,7403,5616
CAAGGCCTAGCATTGA,sample,621588,614938,70187,544751,53620,491131,241935,16292,137552,18992,379487,76360,16492,5203,47858,32316
CCAGAGCGAGCATTGA,sample,191427,190110,7931,182179,34243,147936,117199,8624,15114,1065,132313,5934,3993,2454,27491,25740
GGAGGACGAGCATTGA,sample,261996,258778,28031,230747,26201,204546,65490,5073,69298,7419,134788,57266,13500,3194,11466,14154
CTTGATAGAGCATTGA,sample,303976,301661,12821,288840,34671,254169,203884,16003,23571,2371,227455,8340,4570,3563,28421,26153
CATGATTCAGCATTGA,sample,228487,226312,11616,214696,36514,178182,144257,12302,14358,1263,158615,6002,4338,3218,26951,25515
CGTACGTCAGCATTGA,sample,215288,211955,31482,180473,22359,158114,48846,3930,56616,5989,105462,42733,10845,2131,9578,13091
GTTAGGACAGCATTGA,sample,230616,228446,11953,216493,27605,188888,130883,9015,33467,4185,164350,11338,3948,1733,32675,20003
GCCTGAACAGCATTGA,sample,209582,207810,11199,196611,25825,170786,130511,9698,17118,2056,147629,11403,5634,2573,26343,18632
ACGTATTAAGCATTGA,sample,343704,340868,15537,325331,41854,283477,238275,15503,21960,2742,260235,4997,1862,1870,35652,31380
CGTATGAAAGCATTGA,sample,257170,254264,23490,230774,32264,198510,120256,11241,37505,4140,157761,25368,7892,2144,31244,20883
AATATATCAGCATTGA,Neg_Ctrl,2356,1674,916,758,94,664,374,22,162,13,536,93,370,187,89,44
GGCATATAAGCATTGA,sample,95239,93991,8335,85656,12508,73148,53313,3411,9575,1095,62888,5754,4222,1571,12277,8441
AGGTCGGAAGCATTGA,sample,240960,239182,10084,229098,44026,185072,150826,12801,16122,3063,166948,2260,1500,1466,43551,32332
ATTCTCTTAATTACCA,sample,185507,183419,23266,160153,19156,140997,65536,5421,37279,4016,102815,28745,8101,2076,12546,11265
TCCAACTTAATTACCA,sample,163562,161977,14357,147620,21305,126315,90815,5788,16985,1902,107800,10825,5546,2017,33440,14374
ACGTTATGAATTACCA,sample,159168,157603,7478,150125,21588,128537,110969,7680,7293,620,118262,1975,2042,2268,27253,15347
TGAGCGCGAATTACCA,sample,61198,60720,4011,56709,9154,47555,31242,3378,7897,973,39139,4065,3563,1541,8245,6229
AATGGTAAAATTACCA,sample,111127,110088,12468,97620,10381,87239,38107,2463,26653,3632,64760,16384,6548,1515,12620,6595
GGACCTCTAATTACCA,sample,39781,39332,4079,35253,4327,30926,18454,1476,6621,691,25075,3684,3351,1334,7039,2866
GCCTTGCTAATTACCA,sample,122196,120822,15821,105001,13901,91100,44278,2570,26659,2452,70937,15141,6891,2057,15403,9219
ACTATACTAATTACCA,sample,99059,98236,7349,90887,9820,81067,46166,3000,20949,3247,67115,7705,3999,1825,11848,6152
GACGGAGAAATTACCA,sample,132192,130472,14278,116194,13321,102873,60715,3966,21874,2549,82589,13769,6844,2642,14614,8692
CCAGAGCGAATTACCA,sample,113634,112471,6616,105855,13486,92369,76240,5674,6982,818,83222,2655,3495,2972,15567,9726
CCGCAACGAATTACCA,sample,6707,6561,1493,5068,911,4157,1387,117,1491,165,2878,997,1561,570,189,459
CGTACGTCAATTACCA,sample,108111,105129,23812,81317,7550,73767,23541,1272,25473,2606,49014,20875,7964,1437,7603,3924
GTTAGGACAATTACCA,sample,135783,134415,7422,126993,14875,112118,87937,6242,11666,1390,99603,4883,3708,2702,17436,10651
GCCTGAACAATTACCA,sample,84809,83413,9636,73777,6436,67341,34813,2170,18618,2279,53431,9461,4598,1640,8327,4094
CGTATGAAAATTACCA,sample,73541,71755,15813,55942,6481,49461,13354,566,18382,2102,31736,15057,6041,1230,2577,3358
TCAATATAAATTACCA,sample,126845,125390,6647,118743,13526,105217,82596,6726,11305,2061,93901,2529,2423,1752,16576,10921
TCGCCTGAAATTACCA,sample,87397,85477,14470,71007,5742,65265,26716,1959,20798,2952,47514,12840,5609,1491,4661,2623
ATGACCGAAATTACCA,sample,137555,136199,10465,125734,21251,104483,77944,4896,12229,1752,90173,7662,3344,1533,19843,14460
TATCAGTTTAGATGAC,sample,27976,27777,2214,25563,5293,20270,10880,979,4959,614,15839,2838,3182,1173,3276,3407
ATTCTCTTTAGATGAC,Pos_Ctrl,6965,6873,884,5989,437,5552,4553,506,321,46,4874,126,2029,1707,411,254
TCCAACTTTAGATGAC,sample,64062,63683,3298,60385,10647,49738,35268,3117,7357,966,42625,3030,3296,2083,9845,7187
AAGTTCGTTAGATGAC,sample,92832,92167,5422,86745,9348,77397,43550,2741,22633,2614,66183,5859,3550,1795,11954,6772
TCCTCCGTTAGATGAC,sample,91937,91177,4836,86341,15381,70960,54510,4031,8286,998,62796,3135,2978,1747,17216,11012
CCTCTAGATAGATGAC,sample,77638,76856,5091,71765,10750,61015,40065,3582,11008,1339,51073,5021,3860,1660,8777,7425
ACGTTATGTAGATGAC,Pos_Ctrl,52720,51525,7158,44367,2692,41675,35228,3440,1990,254,37218,763,5766,6552,2919,1508
TGAGCGCGTAGATGAC,sample,163100,161716,10418,151298,22014,129284,94833,6451,17426,1723,112259,8851,5444,2448,21567,15837
TTAGAAGTTAGATGAC,sample,111071,109790,11627,98163,15588,82575,47086,3382,19081,1775,66167,11251,5740,1887,10329,10313
TTCCGTCTTAGATGAC,Pos_Ctrl,64491,62829,10081,52748,3172,49576,41443,3831,2945,409,44388,948,6138,6846,3293,1745
GGACCTCTTAGATGAC,sample,222247,219860,16197,203663,25877,177786,130760,9291,21745,2747,152505,13243,5297,2648,37464,18774
TCGCATCTTAGATGAC,sample,116933,115773,8171,107602,9126,98476,54594,3284,28398,3587,82992,8613,4373,2040,11001,7031
GCCTTGCTTAGATGAC,sample,58031,57291,5879,51412,6549,44863,27168,2090,9492,1187,36660,4926,4939,2712,4980,4244
CAAGGCCTTAGATGAC,sample,147689,146264,8581,137683,19723,117960,95733,6932,11122,933,106855,3240,2936,1992,27619,15688
GACGGAGATAGATGAC,sample,108494,107351,6794,100557,14545,86012,60636,4949,13946,1883,74582,4598,3822,2055,17217,10183
GTTAGCCGTAGATGAC,sample,121415,119854,14003,105851,17017,88834,46957,2930,23643,2371,70600,12933,6046,1359,12619,11424
ACCTCGAGTAGATGAC,sample,55269,54613,4048,50565,4210,46355,25924,1431,12935,1333,38859,4732,3362,1663,5455,2915
TTGGTACCTAGATGAC,sample,127102,125651,6636,119015,11699,107316,72294,4557,22082,2773,94376,5610,3418,1902,9073,7576
AATATATCTAGATGAC,sample,100803,98924,19117,79807,6371,73436,21404,2063,26977,2871,48381,20121,8054,1684,1288,2915
GAAGGCGCTAGATGAC,sample,124008,122293,17557,104736,14479,90257,44299,2945,23687,2624,67986,16702,7242,1461,14010,9332
AAGAGCGCTAGATGAC,sample,105843,104515,11893,92622,11701,80921,40566,3485,22742,2005,63308,12123,5207,1464,10682,7404
GTCTTAGCTAGATGAC,sample,190535,187532,21737,165795,19695,146100,83846,5511,30026,3617,113872,23100,7028,1870,21974,13353
TTGGTTAATAGATGAC,sample,227470,225747,10035,215712,34768,180944,156516,10372,10223,1324,166739,2509,1545,1687,40842,27503
GTACCGTATAGATGAC,sample,262166,257814,34596,223218,26698,196520,97995,5802,50303,4864,148298,37556,12582,3101,25196,17392
TCGCCTGATAGATGAC,sample,84989,83946,11560,72386,8226,64160,24601,1806,21678,2613,46279,13462,6862,1990,2679,4882
AGGTCGGATAGATGAC,sample,111356,110494,5284,105210,12897,92313,62339,5421,16926,3387,79265,4240,2705,1802,12259,8963
TTATTCGATAGATGAC,sample,223321,220102,24828,195274,9698,185576,93946,6642,61336,6370,155282,17282,7370,3603,6945,5919
ATGACCGATAGATGAC,sample,152751,151438,9671,141767,20568,121199,88982,5439,17453,1946,106435,7379,3228,1553,27764,14810
TATCAGTTGTTCAGAA,sample,140227,138469,13058,125411,15949,109462,75180,3699,17574,2295,92754,10714,3937,1497,30447,10869
ATTCTCTTGTTCAGAA,sample,130701,128678,13389,115289,16349,98940,61086,3432,19798,2363,80884,12261,5879,1898,19674,10833
GGTTGCGTGTTCAGAA,sample,131627,128275,19464,108811,14202,94609,48822,3664,22008,2603,70830,17512,7959,2966,8838,8287
ACGTAAGTGTTCAGAA,sample,117214,115754,7492,108262,11560,96702,69662,6214,13174,1632,82836,6020,4397,3373,12830,7929
AGTACCATGTTCAGAA,sample,108613,107257,7574,99683,13120,86563,60696,4897,15270,1854,75966,3846,2619,1667,23078,9617
ACGTTATGGTTCAGAA,sample,133729,131882,10055,121827,15072,106755,67169,4042,23983,2284,91152,9277,4491,1793,22728,10846
TTCTAATGGTTCAGAA,sample,144302,142373,8672,133701,14677,119024,94316,7303,11376,1589,105692,4440,4503,3731,17038,11247
TAGTACGGGTTCAGAA,sample,153897,151533,22499,129034,13952,115082,58766,3552,28931,3339,87697,20494,8514,2314,15578,8688
TGAGCGCGGTTCAGAA,sample,109724,108502,6028,102474,17641,84833,73803,4445,4709,474,78512,1402,1844,1982,19808,12801
TCGCATCTGTTCAGAA,sample,57754,57025,4746,52279,5658,46621,25031,1728,13653,1732,38684,4477,3428,1609,5173,3673
GCCTTGCTGTTCAGAA,sample,66803,65603,10348,55255,4928,50327,17321,1193,17914,2031,35235,11868,6451,1654,3506,2481
CAAGGCCTGTTCAGAA,sample,110515,109072,7743,101329,12973,88356,66256,4053,12184,1697,78440,4166,3504,2084,18155,9091
ACTATACTGTTCAGAA,sample,80025,79086,6064,73022,11497,61525,43192,3379,9142,1190,52334,4622,3895,2082,10647,7573
GTTAGCCGGTTCAGAA,sample,24644,24250,3383,20867,2526,18341,8614,601,5622,650,14236,2854,3273,1398,2097,1467
GGAGGACGGTTCAGAA,sample,109573,107641,12608,95033,9526,85507,41334,2782,26073,2559,67407,12759,5733,1537,13315,5540
TGGACGAGGTTCAGAA,sample,20834,20512,2126,18386,2364,16022,10127,656,3237,383,13364,1619,2457,1394,3520,1451
GACGATAAGTTCAGAA,sample,93587,92500,5282,87218,14543,72675,61954,3389,5151,1178,67105,1003,1339,1346,26889,10465
CATTGCAGGTTCAGAA,sample,79722,78804,5787,73017,7080,65937,36501,2479,18402,2037,54903,6518,3959,1775,7261,4661
ACGACTTCGTTCAGAA,sample,92256,91014,7894,83120,11140,71980,44489,3396,14931,1967,59420,7197,4657,1682,10166,7349
CGTACGTCGTTCAGAA,sample,128345,127083,6941,120142,16040,104102,83334,7232,9141,1077,92475,3318,2716,2086,16029,11524
TTGGTACCGTTCAGAA,sample,93530,92383,11229,81154,8007,73147,26837,2234,25742,2906,52579,15428,6110,1520,5075,4483
CTAGGACCGTTCAGAA,sample,104814,103913,5689,98224,15586,82638,66331,5583,7360,491,73691,2873,2545,1716,17255,11189
GTTAGGACGTTCAGAA,sample,228482,223646,45958,177688,14391,163297,47835,3075,58623,6456,106458,47308,14974,2752,9306,7201
ACGTATTAGTTCAGAA,sample,98813,98088,6418,91670,11400,80270,56157,4280,11674,1137,67831,7022,4588,2230,10535,7842
TGCTTCGCGTTCAGAA,sample,34054,33742,3456,30286,4867,25419,13544,1210,5916,577,19460,4172,4162,1970,1734,2740
GGCATATAGTTCAGAA,sample,32464,32265,1429,30836,3394,27442,17297,1302,6542,846,23839,1455,1986,1361,2259,2107
AGGTCGGAGTTCAGAA,Pos_Ctrl,438,425,84,341,53,288,185,13,58,6,243,26,171,101,45,30
TTATTCGAGTTCAGAA,sample,6237,6184,636,5548,1063,4485,2038,200,1268,158,3306,821,1282,546,458,636
GACCGGAAGTTCAGAA,sample,7622,7538,389,7149,1050,6099,3900,409,1205,129,5105,456,1063,703,792,744
GGAGAGTTTTCTGGTT,sample,25496,25352,928,24424,5629,18795,15485,1003,1619,199,17104,489,1646,1570,3960,3836
TATCAGTTTTCTGGTT,sample,2850,2819,213,2606,490,2116,1275,110,443,62,1718,226,759,482,320,308
TCCAACTTTTCTGGTT,Neg_Ctrl,1093,808,502,306,31,275,137,11,95,9,232,23,129,55,51,30
AAGTTCGTTTCTGGTT,sample,49199,48763,2386,46377,6111,40266,33343,2169,3441,275,36784,1038,2044,1932,8609,4558
TCCTCCGTTTCTGGTT,sample,108938,107143,12639,94504,12621,81883,44243,2827,20291,2246,64534,12276,6917,2579,12735,8319
ACGTAAGTTTCTGGTT,sample,98863,97161,11693,85468,12483,72985,48689,3854,10913,1285,59602,8244,6248,3231,11036,8225
CCTCTAGATTCTGGTT,sample,54703,53866,4787,49079,6189,42890,32872,1861,5002,557,37874,2598,2738,1807,9623,4293
TTCTAATGTTCTGGTT,Neg_Ctrl,632,449,303,146,20,126,43,8,25,36,68,14,48,25,12,13
TAGTACGGTTCTGGTT,sample,26776,26486,1646,24840,4869,19971,16918,1012,1404,141,18322,496,986,1021,7230,3612
TGAGCGCGTTCTGGTT,sample,17330,17020,2187,14833,1183,13650,6197,372,4698,504,10895,1879,2533,1200,936,705
CAACCGCGTTCTGGTT,sample,31097,30582,4455,26127,2821,23306,11639,703,6654,656,18293,3654,3744,1584,2533,1668
TTAGAAGTTTCTGGTT,sample,23289,22828,2832,19996,1521,18475,8804,557,5901,796,14705,2417,2983,1508,889,890
TTCCGTCTTTCTGGTT,sample,28901,28296,3523,24773,2269,22504,12913,805,5432,578,18345,2776,3269,1767,1822,1440
GGACCTCTTTCTGGTT,Neg_Ctrl,548,410,242,168,18,150,88,7,32,8,120,15,99,54,14,8
TCGCATCTTTCTGGTT,sample,10341,10025,2373,7652,832,6820,2726,158,2016,224,4742,1696,1880,586,982,461
CGAGGCAGTTCTGGTT,sample,117237,116023,6115,109908,15840,94068,76359,5208,8879,477,85238,3145,2080,1493,20285,12416
AATCCGTCTTCTGGTT,sample,63405,62059,9750,52309,6473,45836,20580,1410,12757,1514,33337,9575,5323,1236,4502,4125
AATATATCTTCTGGTT,sample,85077,84213,4716,79497,11447,68050,58621,4283,3921,683,62542,542,1246,1376,14227,9424
GAAGGCGCTTCTGGTT,sample,74229,72908,13256,59652,5325,54327,18512,1583,18556,1979,37068,13697,6777,1363,3360,2781
AGGTCGGATTCTGGTT,sample,257,242,54,188,34,154,90,9,34,7,124,14,87,52,25,19
GGAGAGTTGTTCGGTT,sample,17662,17416,1032,16384,2506,13878,11066,731,1433,152,12499,496,1698,1462,3405,1942
TCCAACTTGTTCGGTT,sample,114605,113021,9275,103746,15118,88628,57689,2880,19432,1951,77121,6676,2749,1506,19977,10688
ATGCCTGGGTTCGGTT,sample,57681,57107,5107,52000,8643,43357,27291,1764,8729,863,36020,4710,3758,1353,11885,5957
TAGTACGGGTTCGGTT,sample,21654,21520,1113,20407,3778,16629,9734,781,4369,548,14103,1197,2106,1393,2168,2565
CAACCGCGGTTCGGTT,sample,32181,31725,3099,28626,2999,25627,11954,729,8290,1211,20244,3443,2782,1121,1672,1924
TTAGAAGTGTTCGGTT,sample,193967,192141,15759,176382,24683,151699,108620,7728,20882,2307,129502,12162,6251,2727,26377,17703
TCGCATCTGTTCGGTT,sample,86569,85063,13754,71309,9023,62286,28360,1735,17559,1969,45919,12663,6713,1574,10107,5468
CATAACCTGTTCGGTT,sample,182374,178952,28243,150709,16934,133775,47175,2717,46222,4951,93397,32710,10975,2323,16477,9872
ACTATACTGTTCGGTT,sample,143391,141569,10098,131471,14871,116600,71856,5016,27648,3181,99504,8899,4771,2813,11472,10703
GGACGTAGGTTCGGTT,sample,160630,159204,8290,150914,27545,123369,101714,6501,11302,1411,113016,2441,2169,1867,27178,19726
CTTGATAGGTTCGGTT,sample,142712,141467,8211,133256,15440,117816,60691,4577,36664,4953,97355,10931,4059,1733,10788,11015
ACCTCGAGGTTCGGTT,sample,76774,75133,11395,63738,7465,56273,22798,1445,17756,1912,40554,12362,6321,1450,5005,4726
CATTGCAGGTTCGGTT,sample,174533,171907,17660,154247,16670,137577,81136,4898,29362,3753,110498,18428,7355,2170,25328,10689
AATCCGTCGTTCGGTT,sample,159526,157457,9314,148143,13345,134798,79137,5640,33694,4744,112831,11583,3625,1879,13536,8721
CGTACGTCGTTCGGTT,sample,123237,121744,8239,113505,10326,103179,66496,3782,24414,2184,90910,6303,3433,1868,14020,7356
GTCCTGCCGTTCGGTT,sample,138905,137342,6931,130411,19784,110627,91722,6503,9313,1039,101035,2050,1309,1406,30597,14558
TTGGTACCGTTCGGTT,sample,114311,112182,13338,98844,12264,86580,47127,3394,20387,2143,67514,13529,4784,1462,17520,8051
GAAGGCGCGTTCGGTT,sample,124897,123661,8089,115572,12000,103572,66694,4138,21798,2594,88492,8348,3766,1984,11455,8306
AAGAGCGCGTTCGGTT,sample,132351,130696,11268,119428,12739,106689,69595,4739,20244,3231,89839,8880,4155,1462,17855,8993
GTCTTAGCGTTCGGTT,sample,124753,123056,11571,111485,13835,97650,65625,5173,14803,2610,80428,9439,4586,1605,18334,9813
TTATTCGAGTTCGGTT,Neg_Ctrl,965,767,403,364,44,320,185,8,62,9,247,56,173,101,36,35
ATGACCGAGTTCGGTT,sample,123706,122675,10510,112165,13111,99054,48971,3814,26631,2722,75602,16916,7180,1817,9851,9132
TATCAGTTTGGCGGTT,sample,395298,392189,16316,375873,53568,322305,267135,19661,26557,3298,293692,5654,1891,1755,90692,40642
ATTCTCTTTGGCGGTT,sample,408169,405185,16092,389093,66000,323093,279217,11997,21974,2161,301191,7744,1716,1508,121245,47559
GGTTGCGTTGGCGGTT,sample,299209,293548,33060,260488,28731,231757,143393,8398,46580,4863,189973,28523,7822,2650,41460,18517
TCCTCCGTTGGCGGTT,sample,561874,548156,82581,465575,29819,435756,163222,10520,163471,20171,326693,78372,16529,5613,19542,14815
CCTCTAGATGGCGGTT,sample,206527,203760,26038,177722,20315,157407,42826,2616,57447,6403,100273,48115,12494,2801,8715,11789
ACGTTATGTGGCGGTT,sample,314510,305055,71228,233827,17237,216590,36626,2281,93846,9896,130472,73941,17424,3822,7565,6107
ATGCCTGGTGGCGGTT,sample,169507,166872,25380,141492,21630,119862,55368,3678,32711,3964,88079,24141,8978,1986,21646,13028
TGAGCGCGTGGCGGTT,sample,200632,198536,15745,182791,20217,162574,113636,8308,21542,2556,135178,16532,8528,4030,15147,13005
CAACCGCGTGGCGGTT,sample,160309,158461,10320,148141,22630,125511,95448,5572,15691,1340,111139,7460,3987,1932,34234,16931
AATGGTAATGGCGGTT,sample,248810,246273,14002,232271,46510,185761,144236,9325,19276,2243,163512,10681,4257,1911,62072,32731
TTCCGTCTTGGCGGTT,sample,53539,52692,5697,46995,5994,41001,21117,1171,12050,1434,33167,5229,4034,1478,6819,3968
CCAGAGCGTGGCGGTT,sample,99134,97423,9080,88343,8905,79438,51788,3610,15272,1720,67060,7048,5387,3018,12974,5775
GGAGGACGTGGCGGTT,sample,60032,59564,3170,56394,7909,48485,27673,2843,12266,1419,39939,4284,3274,1551,3570,4993
GGCCAGAGTGGCGGTT,sample,235710,232629,13367,219262,28203,191059,137827,10880,30265,3335,168092,8752,3765,1744,38506,21035
CGTACGTCTGGCGGTT,sample,104819,102345,12647,89698,12524,77174,45560,3325,15370,1759,60930,11160,6423,2207,7639,7810
ACGTATTATGGCGGTT,sample,212039,207829,25918,181911,20201,161710,94275,6448,33108,3518,127383,24361,8715,2282,14506,12791
AACTCGTATGGCGGTT,sample,132820,131579,8394,123185,12516,110669,63164,4542,28752,4078,91916,10133,4560,1845,13261,8134
GTCTTAGCTGGCGGTT,sample,225165,223516,10299,213217,26007,187210,126932,10102,35986,4684,162918,9506,4130,2214,24050,19001
ATGACCGATGGCGGTT,sample,71635,70748,6821,63927,6774,57153,36861,2711,9702,1107,46563,6772,5423,2526,6962,4469
GGAGAGTTTCCTTATT,sample,38221,37599,3940,33659,4793,28866,18076,1331,5442,643,23518,3374,3285,1499,5183,3267
AGTACCATTCCTTATT,sample,10690,10595,765,9830,1478,8352,5079,366,1962,184,7041,761,1389,708,1798,983
TTCTAATGTCCTTATT,sample,3123,3095,234,2861,262,2599,1343,91,786,92,2129,287,863,431,293,168
GCCTTGCTTCCTTATT,sample,1151,1132,75,1057,157,900,602,60,151,18,753,69,385,280,136,119
CTTGATAGTCCTTATT,sample,38841,38555,1262,37293,5710,31583,26176,2423,2101,467,28277,416,804,994,6272,4118
GACGATAATCCTTATT,sample,29187,28990,1095,27895,5231,22664,19516,1246,1457,182,20973,263,940,1049,5932,3623
CCATGAAGTCCTTATT,sample,4055,4014,252,3762,618,3144,2120,177,577,35,2697,235,758,492,754,398
ACGACTTCTCCTTATT,sample,3150,3115,219,2896,280,2616,1331,92,820,121,2151,252,895,515,151,172
CATGATTCTCCTTATT,sample,29308,29004,2699,26305,3986,22319,13244,947,4759,444,18003,2925,2795,970,4012,2589
CGTACGTCTCCTTATT,sample,29012,28702,2891,25811,2177,23634,12745,815,6212,641,18957,3221,3019,1286,2196,1344
GTCCTGCCTCCTTATT,sample,33292,32893,2774,30119,3642,26477,18288,1082,4155,462,22443,2490,2454,1174,5994,2597
CGGATTACTCCTTATT,sample,37287,36932,1892,35040,4082,30958,24779,2145,2467,360,27246,1207,2031,1621,4685,3095
GCCTGAACTCCTTATT,sample,34159,33742,2642,31100,2003,29097,19075,1614,5293,821,24368,2294,2782,1708,2304,1245
TTGGCCTCTCCTTATT,Pos_Ctrl,20956,20362,3136,17226,962,16264,13729,1231,904,102,14633,298,4034,3753,780,546
TGCTTCGCTCCTTATT,sample,17914,17676,2020,15656,1274,14382,7877,599,3157,454,11034,2295,2148,863,1933,837
GAAGGCGCTCCTTATT,sample,28191,27799,2344,25455,3061,22394,15700,1500,3327,311,19027,1556,1805,941,3117,2185
GTCTTAGCTCCTTATT,sample,20213,19849,3109,16740,1584,15156,5817,503,5105,680,10922,3051,3139,1045,627,826
GGCATATATCCTTATT,sample,34132,33705,3212,30493,3975,26518,18820,1533,3725,386,22545,2054,1958,957,5658,2619
GACCGGAATCCTTATT,sample,22214,21911,3653,18258,1597,16661,4498,322,6331,657,10829,4853,3684,801,695,798
AGTACCATAATAAGGT,sample,221793,219153,17563,201590,24429,177161,122142,8077,28911,3718,151053,14313,5044,1870,50054,19328
ACGTTATGAATAAGGT,sample,209019,206416,18757,187659,20698,166961,98660,5949,41045,4869,139705,16438,5994,2089,28943,15310
TTCTAATGAATAAGGT,sample,101037,100019,7310,92709,18336,74373,51754,3256,12440,1569,64194,5354,3840,1794,20145,13067
TGAGCGCGAATAAGGT,sample,103082,101465,11206,90259,13309,76950,41213,2572,19213,1987,60426,11965,5438,1481,15499,8433
CAAGGCCTAATAAGGT,sample,175521,173373,13315,160058,26492,133566,95790,6654,19182,1711,114972,10229,5917,2687,27517,18619
ACTATACTAATAAGGT,sample,147028,144164,18680,125484,13143,112341,58252,3215,28719,3492,86971,18663,7318,1972,20102,8335
CCGCAACGAATAAGGT,Pos_Ctrl,62200,59357,9661,49696,2924,46772,39134,3427,2940,374,42074,897,6140,6880,2794,1543
GGACGTAGAATAAGGT,sample,218911,216645,19449,197196,20966,176230,103598,6825,40091,4478,143689,21238,7574,2260,37523,13781
GGCCAGAGAATAAGGT,sample,86760,85226,8019,77207,6820,70387,50537,4309,8772,888,59309,5881,5304,3550,3705,4406
CCATGAAGAATAAGGT,sample,145021,143230,15459,127771,19514,108257,57400,4467,26456,3579,83856,16355,6896,2206,15844,12200
ACGACTTCAATAAGGT,sample,214227,211975,16557,195418,24391,171027,117471,8200,26629,3332,144100,15395,6525,2361,33071,15495
CATGATTCAATAAGGT,sample,16433,15689,3954,11735,1002,10733,2670,160,4134,511,6804,3258,2641,732,448,371
AATCCGTCAATAAGGT,Pos_Ctrl,62060,60161,9195,50966,2948,48018,40425,3451,2840,371,43265,931,6214,7050,2695,1752
CGTACGTCAATAAGGT,sample,299303,293348,42238,251110,21185,229925,78430,4637,78248,7225,156678,61385,12985,3018,21728,11749
AGTCCGCAAATAAGGT,sample,167493,165691,8841,156850,14460,142390,92506,5802,31365,4264,123871,8453,3397,1982,20743,10551
ACGTATTAAATAAGGT,sample,287267,284477,16294,268183,30834,237349,182936,16886,23104,3193,206040,11230,3444,1943,39856,22453
ACCAATGCAATAAGGT,sample,115920,114291,11993,102298,12336,89962,53381,4078,17885,2421,71266,12197,6005,1532,11987,7736
AAGAGCGCAATAAGGT,sample,54751,54028,8898,45130,4156,40974,14429,1156,13464,1588,27893,10337,5842,1172,3373,2159
TCGCCTGAAATAAGGT,sample,1114,1081,159,922,162,760,474,37,157,14,631,78,341,205,128,107
ATTCTCTTCAGGACCA,sample,321922,319679,17031,302648,48296,254352,212137,14764,19906,3595,232043,3950,1473,1354,85662,35660
AAGTTCGTCAGGACCA,sample,360892,353758,52364,301394,26411,274983,111981,6189,88521,9624,200502,58668,12862,2888,36586,15371
ACGTAAGTCAGGACCA,sample,152177,150322,12381,137941,18321,119620,72427,5619,26987,2795,99414,11792,6076,2495,18881,12918
CCTCTAGACAGGACCA,sample,119300,117899,9427,108472,8301,100171,50367,3449,31517,4036,81884,10802,5520,2258,3776,5539
ACGTTATGCAGGACCA,sample,101866,100511,14081,86430,10720,75710,34281,1971,21875,2111,56156,15472,6690,1845,11496,5761
TGAGCGCGCAGGACCA,sample,179275,176735,20709,156026,18712,137314,66027,4250,38709,3737,104736,24591,8575,2307,26204,11767
TCGCATCTCAGGACCA,sample,143384,142004,10349,131655,13855,117800,67584,5598,29048,4328,96632,11242,5098,2406,9760,9329
CATAACCTCAGGACCA,sample,469339,466362,19687,446675,46246,400429,257916,22435,77269,8337,335185,34472,7474,2948,27156,30552
GACGATAACAGGACCA,sample,135123,133057,11346,121711,19130,102581,67191,5346,17949,2061,85140,10034,5401,2117,16081,12658
CCATGAAGCAGGACCA,sample,388881,377091,82787,294304,24281,270023,93494,5485,89497,11359,182991,70188,16793,3847,21459,11989
CGTACGTCCAGGACCA,sample,181165,178705,11969,166736,21672,145064,113321,5599,16868,2367,130189,6909,3224,1683,37284,15405
AATATATCCAGGACCA,Neg_Ctrl,3125,2757,2184,573,53,520,239,22,116,12,355,131,272,129,45,86
TGCTTCGCCAGGACCA,sample,52703,52008,4393,47615,5352,42263,26159,2028,8307,1092,34466,4677,3526,1478,3571,3237
CTTCATGACAGGACCA,sample,243264,241088,12837,228251,26306,201945,164008,12282,16803,1709,180811,7143,4139,2870,26281,19790
TATCAGTTCCTCGTTG,sample,158193,156918,7749,149169,14255,134914,73397,3853,39667,6609,113064,11388,3765,1745,11781,9039
AAGTTCGTCCTCGTTG,sample,238702,234947,28367,206580,17751,188829,120165,8691,32771,3145,152936,24057,8975,3561,18019,10857
AGTACCATCCTCGTTG,sample,81611,80525,7512,73013,9446,63567,40482,2684,12909,1475,53391,6017,5511,2884,5348,6127
TAGTACGGCCTCGTTG,sample,156536,154635,11153,143482,17583,125899,93691,6214,16451,2220,110142,7323,4075,2523,31287,12904
AATGGTAACCTCGTTG,sample,128079,126413,10485,115928,11201,104727,65412,3494,23925,2483,89337,9413,4827,2136,15751,7917
GACGGAGACCTCGTTG,sample,152177,150365,10938,139427,21011,118416,89290,5704,14968,1421,104258,7033,3727,1950,31259,15867
GGACGTAGCCTCGTTG,Neg_Ctrl,2121,1530,847,683,72,611,315,37,153,12,468,94,279,149,87,70
TGGACGAGCCTCGTTG,sample,105073,104395,5349,99046,16606,82440,62110,4060,11037,1678,73147,3555,3105,1704,22484,12357
GGCCAGAGCCTCGTTG,sample,68337,67315,4157,63158,9625,53533,46050,3104,2922,332,48972,1125,1577,1639,14507,7243
CGTACGTCCCTCGTTG,Neg_Ctrl,2590,1834,1048,786,70,716,426,30,169,18,595,73,373,198,101,46
AGTCCGCACCTCGTTG,sample,138018,135838,15338,120500,14655,105845,64823,4893,19643,2191,84466,14295,7248,2863,11859,9314
GTCCTGCCCCTCGTTG,sample,635920,622969,96795,526174,24427,501747,174814,10834,214696,25696,389510,75707,16476,4359,17220,8379
CGGATTACCCTCGTTG,sample,281912,278843,20513,258330,33971,224359,158296,11726,31754,3658,190050,18925,3583,1772,40059,22548
GCCTGAACCCTCGTTG,sample,152188,150098,13775,136323,10629,125694,67168,4355,36783,4096,103951,13292,5374,2233,14151,6787
AACTCGTACCTCGTTG,sample,188552,187049,7455,179594,17631,161963,124354,7097,21284,2715,145638,6513,3202,2442,22673,12017
TTGGCCTCCCTCGTTG,sample,118759,117380,10991,106389,14216,92173,58604,4078,16659,2096,75263,10736,5420,1862,16053,9604
TGCTTCGCCCTCGTTG,sample,124849,123608,10456,113152,11120,102032,60842,3866,22777,2377,83619,12170,5021,2081,10354,7070
GTCTTAGCCCTCGTTG,sample,285241,281009,38403,242606,20797,221809,76826,7220,70928,6811,147754,60024,12016,2783,15583,11689
GTACCGTACCTCGTTG,Pos_Ctrl,71038,68787,11323,57464,3317,54147,45667,3868,3289,384,48956,939,6162,7270,2267,1813
GGCATATACCTCGTTG,sample,105684,104319,16224,88095,9298,78797,23653,1785,28585,3140,52238,21634,7541,1378,3362,4578
TCAATATACCTCGTTG,sample,181842,179523,20031,159492,20043,139449,66584,6762,36550,3933,103134,25620,8316,1770,10999,11518
AGGTCGGACCTCGTTG,sample,245731,243714,20813,222901,30081,192820,109548,12684,42106,4732,151654,23750,6731,2134,33095,21364
TTATTCGACCTCGTTG,sample,104278,103130,14402,88728,9783,78945,36715,2437,20999,2206,57714,16588,7078,1686,13633,5786
TATCAGTTTTGCGGAC,sample,15855,15730,1056,14674,2532,12142,9586,736,1075,121,10661,624,1833,1642,2206,1690
GGTTGCGTTTGCGGAC,sample,299685,297672,12682,284990,50563,234427,197412,17250,14505,2511,211917,2749,1568,1672,64030,36594
CCTCTAGATTGCGGAC,sample,170161,169095,6841,162254,20591,141663,107946,7308,20476,1439,128422,4494,3270,2395,22682,14860
ACTATACTTTGCGGAC,sample,225935,223465,16485,206980,24207,182773,104454,7394,49774,5216,154228,15935,5987,2287,28683,16138
CCAGAGCGTTGCGGAC,sample,29110,28630,4456,24174,2816,21358,8434,611,7231,758,15665,4324,4275,1603,1265,1578
GTTAGCCGTTGCGGAC,sample,103809,102274,15435,86839,12799,74040,28236,2151,24218,2739,52454,16696,7116,1492,6799,7626
ACCTCGAGTTGCGGAC,sample,26311,25906,2522,23384,2703,20681,11839,753,5601,621,17440,1867,1899,988,4818,1935
ACGACTTCTTGCGGAC,sample,74562,73412,13997,59415,6305,53110,14736,811,20287,2115,35023,15161,7204,1348,3237,3303
CATGATTCTTGCGGAC,sample,139838,138316,7213,131103,11879,119224,85854,6170,19710,2653,105564,4837,2967,2010,21523,9478
CGTACGTCTTGCGGAC,sample,123898,122767,7071,115696,12655,103041,65460,4314,23067,2983,88527,7217,3746,1787,13147,8686
GTCCTGCCTTGCGGAC,sample,166556,164342,18701,145641,14294,131347,68370,3576,33591,3582,101961,22228,7616,2032,19372,8104
AATATATCTTGCGGAC,sample,93239,91913,11701,80212,7769,72443,34296,2491,18807,2153,53103,14696,6770,1975,4128,4527
ACCAATGCTTGCGGAC,sample,254619,251933,20335,231598,27596,204002,117641,11239,42179,4550,159820,28393,7601,2078,27665,20114
AAGAGCGCTTGCGGAC,sample,235165,232441,21585,210856,30795,180061,124092,6609,28406,3172,152498,17782,5809,2368,25966,20364
CCAATTCCTTGCGGAC,sample,118078,116802,9418,107384,17535,89849,60170,5420,15478,1399,75648,7382,5537,2526,8878,12192
TTGGTTAATTGCGGAC,sample,273889,271406,24228,247178,38141,209037,133854,13670,34669,4456,168523,22388,5482,2099,43278,27133
GTACCGTATTGCGGAC,sample,165893,164237,14400,149837,22046,127791,81385,4597,24615,3111,106000,14083,5237,1787,25401,15552
GGCATATATTGCGGAC,sample,128718,127426,14057,113369,16389,96980,46017,3073,26066,2707,72083,19117,8103,1541,12595,10580
CTTCATGATTGCGGAC,sample,270351,266871,31460,235411,34964,200447,109186,6267,47560,5603,156746,31831,10518,2649,26967,22690
TTATTCGATTGCGGAC,sample,112656,111605,7538,104067,13807,90260,59116,4782,18526,1807,77642,6029,3929,1934,17749,10091
GACCGGAATTGCGGAC,sample,83412,82708,8354,74354,12130,62224,27224,2403,18404,1792,45628,12401,6571,1473,4459,7883
GGAGAGTTTCCATTGG,sample,19416,19190,950,18240,2677,15563,13234,738,1164,111,14398,316,1050,1034,5075,1954
TCCTCCGTTCCATTGG,sample,20075,19643,2493,17150,1444,15706,8443,538,4568,472,13011,1685,2105,964,2275,950
ACGTAAGTTCCATTGG,sample,17172,16725,3798,12927,1334,11593,3406,235,4280,459,7686,3213,3055,759,639,672
TTCGTAATTCCATTGG,sample,22858,22483,2104,20379,1858,18521,11301,530,4147,549,15448,1994,2105,1096,2483,1259
ACGTTATGTCCATTGG,sample,7055,6917,875,6042,804,5238,3111,211,1138,161,4249,617,1155,588,1256,479
CAACCGCGTCCATTGG,sample,15399,15042,1400,13642,2052,11590,8828,451,1476,126,10304,709,1194,805,2989,1490
AATGGTAATCCATTGG,sample,6463,6358,409,5949,1359,4590,3603,181,522,78,4125,206,848,604,1509,901
TTAGAAGTTCCATTGG,sample,23335,22867,3850,19017,1555,17462,8893,540,4480,483,13373,3066,3844,1882,1143,824
TCGCATCTTCCATTGG,sample,9773,9613,1356,8257,977,7280,4121,170,1675,185,5796,1129,1541,641,1499,610
CAAGGCCTTCCATTGG,sample,15108,14850,1945,12905,1357,11548,5612,305,3077,263,8689,2291,2430,885,1808,886
CCAGAGCGTCCATTGG,sample,4058,3986,323,3663,574,3089,2392,171,312,47,2704,167,854,672,722,405
GACGATAATCCATTGG,sample,7132,7007,646,6361,648,5713,3928,229,900,127,4828,529,1453,994,521,454
GGCCAGAGTCCATTGG,sample,20237,19951,3664,16287,1592,14695,3479,205,5691,578,9170,4742,3675,700,670,831
CCATGAAGTCCATTGG,sample,22757,22407,3888,18519,1868,16651,4964,440,5944,604,10908,4699,3557,780,1195,960
AATCCGTCTCCATTGG,sample,41216,40762,3490,37272,4436,32836,23309,1759,4320,578,27629,2870,2836,1471,5230,3152
CGTACGTCTCCATTGG,sample,57129,56482,6625,49857,5494,44363,18308,1359,13209,1354,31517,10133,6313,1558,3883,3265
GTCCTGCCTCCATTGG,sample,63367,62499,5907,56592,5063,51529,31316,2540,10930,1155,42246,5588,3222,1033,4840,3344
CGTATGAATCCATTGG,sample,22401,21608,4993,16615,1314,15301,4934,385,5030,494,9964,4458,3165,739,744,474
AATATATCTCCATTGG,sample,59805,59191,4485,54706,4279,50427,31682,1994,10029,734,41711,5988,2989,1074,6179,2682
AAGAGCGCTCCATTGG,sample,28283,27841,3491,24350,2170,22180,12156,974,5098,606,17254,3346,2788,1067,2023,1273
GTACCGTATCCATTGG,sample,17168,16953,915,16038,2053,13985,11939,774,1064,21,13003,187,785,839,3194,1650
GGCATATATCCATTGG,Neg_Ctrl,438,327,132,195,21,174,107,7,39,6,146,15,94,59,19,9
TCAATATATCCATTGG,sample,37667,37249,3142,34107,3735,30372,20267,1674,4582,485,24849,3364,2669,1146,5044,2463
TCGCCTGATCCATTGG,sample,100419,99465,11065,88400,8132,80268,41062,3601,20145,1804,61207,13656,5130,1503,9763,4599
GACCGGAATCCATTGG,sample,43771,43476,1691,41785,7937,33848,28432,1872,2948,165,31380,431,855,881,8080,5446
ATTCTCTTCATAGGCG,sample,4759,4669,435,4234,546,3688,2618,265,568,65,3186,172,1055,811,605,370
TCCTCCGTCATAGGCG,sample,335972,331346,36167,295179,33103,262076,149594,11089,57501,7465,207095,36427,10315,3182,43384,19970
ATGCCTGGCATAGGCG,sample,93273,92127,7551,84576,8764,75812,41741,3214,21464,2274,63205,7119,4120,1782,8358,5685
TGAGCGCGCATAGGCG,sample,135631,134204,11233,122971,13180,109791,70698,4218,22500,2506,93198,9869,5852,2511,19297,9661
AATGGTAACATAGGCG,sample,96528,94710,11731,82979,9878,73101,39819,2181,18569,1824,58388,10708,5833,1961,6257,5950
CATAACCTCATAGGCG,sample,70301,69102,5721,63381,6978,56403,35187,2683,12939,1349,48126,4245,3367,1877,9477,5053
GACGGAGACATAGGCG,sample,28477,28058,3178,24880,5168,19712,14473,969,2586,258,17059,1426,2275,1549,5220,3167
ACCTCGAGCATAGGCG,sample,153432,151728,7963,143765,20006,123759,100967,8027,10986,1231,111953,2548,1276,1283,34146,14727
GACGATAACATAGGCG,sample,291260,287119,40138,246981,26885,220096,78629,4698,76356,9043,154985,51370,10884,2250,13088,15758
CGAGGCAGCATAGGCG,sample,181447,178933,14064,164869,13631,151238,92100,6804,35841,4706,127941,11787,4746,2386,15801,8741
CCATGAAGCATAGGCG,sample,93428,92045,7324,84721,18694,66027,45001,3456,10394,1002,55395,6174,3810,2154,12032,12122
CGTACGTCCATAGGCG,sample,108195,106137,12988,93149,8954,84195,48478,3642,18807,2340,67285,10928,5426,2249,8201,5388
CGTATGAACATAGGCG,sample,111894,109761,15921,93840,11469,82371,38350,2695,23561,2338,61911,15427,6574,1575,11300,6869
AATATATCCATAGGCG,sample,200860,198118,23374,174744,16288,158456,76389,4605,47836,5810,124225,23816,7099,2312,9709,9063
GAAGGCGCCATAGGCG,sample,48748,48458,3112,45346,6089,39257,20265,2646,10896,1611,31161,3839,2981,1450,4490,4094
TCAATATACATAGGCG,sample,184124,182601,9478,173123,21166,151957,124942,9487,12227,1258,137169,4043,3352,2428,20988,15636
TTATTCGACATAGGCG,sample,154542,152552,19577,132975,13021,119954,55731,4162,36072,4763,91803,19226,7139,1791,10969,7605
GACCGGAACATAGGCG,sample,8991,8883,592,8291,1491,6800,4628,509,1042,117,5670,504,1327,883,796,1000
ATTCTCTTTTGGAGAG,Pos_Ctrl,126513,122413,19831,102582,6212,96370,81140,6795,6008,608,87148,1819,7237,9253,6767,3758
CCTCTAGATTGGAGAG,sample,138385,135977,16690,119287,11189,108098,50273,2990,32827,3898,83100,18110,6988,2314,8416,7242
TTCGTAATTTGGAGAG,sample,136475,135289,6175,129114,21931,107183,91914,6076,6269,998,98183,1926,2570,2786,23641,16141
ATGCCTGGTTGGAGAG,sample,59965,58939,4722,54217,5190,49027,35515,2348,7833,990,43348,2341,2992,2189,7974,3833
TAGTACGGTTGGAGAG,sample,123008,121122,18366,102756,12947,89809,45571,2673,22803,2656,68374,16106,7460,2238,13634,7561
TTAGAAGTTTGGAGAG,sample,204243,200855,24159,176696,19381,157315,97613,6515,30238,3953,127851,18996,7835,2582,30235,12553
TTCCGTCTTTGGAGAG,Pos_Ctrl,79984,77405,13127,64278,3958,60320,50818,4260,3683,467,54501,1092,6423,7443,4065,2467
GACGGAGATTGGAGAG,sample,170103,168884,11672,157212,22885,134327,85323,6198,25206,2838,110529,14762,7012,2155,36054,15487
CCAGAGCGTTGGAGAG,sample,92324,90900,5216,85684,7017,78667,66170,4964,5348,661,71518,1524,3486,3918,8119,5050
GGACGTAGTTGGAGAG,sample,101469,100033,5993,94040,10823,83217,71291,5251,5271,304,76562,1100,1686,1819,19546,8621
TGGACGAGTTGGAGAG,sample,304185,300670,23360,277310,33884,243426,176300,11156,33170,4146,209470,18654,5070,1918,53475,23125
CATTGCAGTTGGAGAG,sample,145032,143298,9233,134065,21521,112544,81698,4754,16093,1743,97791,8256,4447,1980,33022,15486
AATCCGTCTTGGAGAG,sample,363522,356287,55077,301210,23963,277247,111135,7915,91402,8235,202537,58560,12788,3006,26347,14250
AGTCCGCATTGGAGAG,sample,243562,241411,11915,229496,30217,199279,161294,12956,17180,2300,178474,5549,4161,2603,30324,20306
CGGATTACTTGGAGAG,sample,214997,212360,16652,195708,23730,171978,119094,7605,26846,2510,145940,15923,6857,1982,26109,17610
GCCTGAACTTGGAGAG,sample,157055,155136,15508,139628,17095,122533,69037,3823,29157,2581,98194,17935,7119,1831,14898,11750
AACTCGTATTGGAGAG,sample,101850,99860,15027,84833,6495,78338,29642,1763,26034,2882,55676,18017,5899,1330,1630,2898
AATATATCTTGGAGAG,sample,106461,105306,5990,99316,11464,87852,74235,4618,7633,507,81868,859,1258,1184,17000,7414
CCAATTCCTTGGAGAG,sample,81784,80577,6981,73596,9740,63856,44698,2897,9986,1039,54684,5236,3714,1874,9828,6334
GTACCGTATTGGAGAG,sample,188337,185323,17809,167514,22997,144517,94788,7953,23129,2763,117917,15884,6715,1994,25295,16301
TCAATATATTGGAGAG,sample,183810,182484,12809,169675,24051,145624,84022,7457,32039,3957,116061,18149,7472,1921,16043,15465
TCGCCTGATTGGAGAG,sample,118191,117001,7373,109628,13287,96341,62493,3846,19144,3365,81637,7493,3674,1804,11522,7273
AGGTCGGATTGGAGAG,sample,296348,292998,30693,262305,27216,235089,109353,9726,63169,6825,172522,46016,9239,2326,26748,17514
ATGACCGATTGGAGAG,sample,238180,235918,17896,218022,21953,196069,129413,10754,30996,3575,160409,21331,5492,2278,30346,14901
GACCGGAATTGGAGAG,sample,230940,228913,25405,203508,18910,184598,70122,5123,58413,6710,128535,44230,12776,3093,12607,10226
AAGTTCGTTTCAAGCC,sample,183680,181489,14700,166789,13956,152833,82974,4967,44387,5874,127361,14631,5953,2497,16715,8956
ACGTTATGTTCAAGCC,sample,26635,26319,2071,24248,2355,21893,11114,685,7076,946,18190,2072,2483,1326,3181,1486
TGAGCGCGTTCAAGCC,sample,122954,121185,11367,109818,12521,97297,68487,5559,13959,2170,82446,7122,4777,2201,15680,8581
GGACCTCTTTCAAGCC,sample,98213,96864,10637,86227,10336,75891,47257,2813,15193,1557,62450,9071,4972,1851,11628,6883
TCGCATCTTTCAAGCC,sample,15628,15359,1046,14313,2659,11654,7489,796,2162,263,9651,944,1956,1348,1344,1715
CATAACCTTTCAAGCC,sample,144640,142621,13876,128745,15807,112938,67465,4610,25547,2851,93012,12465,4858,1496,31023,11463
ACTATACTTTCAAGCC,sample,202239,198826,35179,163647,16151,147496,61263,3384,44333,4510,105596,34006,10540,2032,30302,9100
GGAGGACGTTCAAGCC,sample,405012,401346,19209,382137,29076,353061,266144,19765,44401,7092,310545,15659,4077,2283,38188,21854
ACCTCGAGTTCAAGCC,sample,101047,99870,6919,92951,10915,82036,60968,3952,10158,1329,71126,5629,4463,2604,13126,7375
TGGACGAGTTCAAGCC,sample,91853,90091,11050,79041,6998,72043,34989,1841,21438,2588,56427,11187,5488,2018,4895,4034
CATGATTCTTCAAGCC,sample,268071,264543,19151,245392,24856,220536,147056,10357,40844,4912,187900,17367,4070,1817,44276,18238
AATCCGTCTTCAAGCC,sample,134904,133271,10818,122453,16544,105909,75823,5046,15482,1919,91305,7639,3735,1504,26639,12232
GTCCTGCCTTCAAGCC,sample,106972,105159,12104,93055,6160,86895,41321,2264,28751,3138,70072,11421,5493,1942,5792,3336
AACTCGTATTCAAGCC,sample,108912,107647,8279,99368,15317,84051,61310,3328,12748,1125,74058,5540,4032,1600,20589,11229
CGTATGAATTCAAGCC,sample,214606,211764,17620,194144,18935,175209,121889,8857,26084,2647,147973,15732,5692,1994,25209,13946
TTGGCCTCTTCAAGCC,Pos_Ctrl,39891,38642,6662,31980,1707,30273,25467,2288,1722,252,27189,544,5206,5348,1590,1032
AAGAGCGCTTCAAGCC,sample,183061,180443,20945,159498,19730,139768,84429,6579,25960,2737,110389,20063,7916,2556,11675,13194
CCAATTCCTTCAAGCC,sample,102658,101593,6051,95542,13331,82211,64616,4628,7931,840,72547,4196,3410,2164,11649,9594
GGCATATATTCAAGCC,sample,107177,105550,10494,95056,6679,88377,60180,3291,15280,2094,75460,7532,5252,2821,7779,4127
CTTCATGATTCAAGCC,sample,84643,83670,7086,76584,6471,70113,34053,1867,20718,2227,54771,11248,5152,1866,3134,3898
AGGTCGGATTCAAGCC,sample,150759,148864,12894,135970,18391,117579,79365,5090,21125,1539,100490,10460,3781,1518,22179,14085
ATGACCGATTCAAGCC,sample,63670,63273,2286,60987,6690,54297,44735,4459,3466,440,48201,1197,2355,2640,4690,4468
ATTCTCTTAACTTAAC,sample,247709,246168,8620,237548,35939,201609,175489,11825,10443,919,185932,2933,2838,3050,39527,27338
AAGTTCGTAACTTAAC,sample,280349,278436,17244,261192,23404,237788,136627,9916,64862,5866,201489,20517,5441,2030,31574,16050
ACGTAAGTAACTTAAC,sample,177901,176617,9300,167317,23609,143708,117382,6823,13008,1419,130390,5076,3578,2185,39846,18092
CCTCTAGAAACTTAAC,sample,199305,198040,7090,190950,24478,166472,146305,7879,8768,764,155073,2756,1794,2140,41779,18212
TTCGTAATAACTTAAC,sample,171992,170980,7861,163119,18137,144982,102642,7364,23811,3600,126453,7565,4058,3168,18119,13077
TTAGAAGTAACTTAAC,sample,154757,153108,17070,136038,18476,117562,58064,3359,33140,4308,91204,18691,7200,2050,13848,11756
TTCCGTCTAACTTAAC,sample,194355,192998,10905,182093,23949,158144,118432,9317,18963,2651,137395,8781,5754,3163,21930,17743
GGACCTCTAACTTAAC,Neg_Ctrl,1426,882,498,384,20,364,217,26,71,6,288,44,188,99,44,20
CAAGGCCTAACTTAAC,sample,77932,77131,4944,72187,9934,62253,47818,3529,7527,912,55345,2467,2290,1545,17630,7333
ACTATACTAACTTAAC,sample,425296,422376,16963,405413,33170,372243,242958,21536,78708,8965,321666,20076,4650,2344,19892,19431
GACGGAGAAACTTAAC,sample,458728,453978,34348,419630,35198,384432,231628,17126,84722,10076,316350,40880,7368,2286,40802,20413
CTTGATAGAACTTAAC,sample,299997,296281,36556,259725,26593,233132,104169,6595,67019,9869,171188,45480,9708,2006,17614,16039
GGCCAGAGAACTTAAC,sample,51796,51077,4298,46779,4643,42136,22387,1853,11931,1399,34318,4566,3313,1462,5671,2705
AATCCGTCAACTTAAC,sample,99060,97905,9626,88279,10400,77879,44691,3346,18423,2028,63114,9391,4309,1955,10045,6643
CTAGGACCAACTTAAC,sample,85388,84483,4618,79865,8520,71345,46351,3918,14669,2238,61020,4169,2833,1322,11471,5957
ACCAATGCAACTTAAC,sample,96991,95506,12450,83056,8777,74279,37239,1770,19809,2219,57048,13242,6127,1441,12785,5348
TTGGTTAAAACTTAAC,sample,186454,183635,30532,153103,14797,138306,45129,3093,48706,4686,93835,36692,10394,1817,9859,9183
AGGTCGGAAACTTAAC,sample,158236,157057,10240,146817,20475,126342,87510,7249,17562,4052,105072,9969,4788,1774,27239,14087
ATTCTCTTATACTTGA,sample,308712,305901,16098,289803,27213,262590,198519,15204,30087,4859,228606,13921,5602,3131,33179,19694
TCCTCCGTATACTTGA,sample,287345,284154,22332,261822,32683,229139,154198,9058,36705,5340,190903,23838,6123,2443,52813,24701
ACGTAAGTATACTTGA,sample,83781,82367,8624,73743,9744,63999,44393,3128,9135,1069,53528,6274,4820,2108,12837,6579
CCTCTAGAATACTTGA,sample,250107,247932,11693,236239,29025,207214,174559,12609,14591,2026,189150,3429,1951,1976,59271,22482
AGTACCATATACTTGA,sample,397436,389987,32698,357289,49284,308005,258788,16968,24781,3072,283569,4396,1794,1520,88915,35081
TTCGTAATATACTTGA,sample,5547,5413,1271,4142,675,3467,1670,117,899,109,2569,672,1201,543,462,320
TTCTAATGATACTTGA,sample,33803,33308,2521,30787,3932,26855,21050,1438,2912,235,23962,1220,2185,1804,5332,2876
TAGTACGGATACTTGA,sample,115292,114208,6497,107711,11623,96088,65296,4504,19246,2484,84542,4558,3172,2154,13478,8186
CAACCGCGATACTTGA,sample,199651,197835,10315,187520,27663,159857,128650,9329,14962,1445,143612,5471,2672,1819,48289,20781
TTAGAAGTATACTTGA,sample,193266,191448,11226,180222,18304,161918,89905,4737,45657,7869,135562,13750,4827,2000,13124,11836
TTCCGTCTATACTTGA,sample,247896,246044,16693,229351,30301,199050,143527,9232,28831,3365,172358,14095,4760,2091,49221,21696
TCGCATCTATACTTGA,sample,212443,210844,14700,196144,29403,166741,118939,9342,25816,2587,144755,10057,6686,2577,33746,20942
CAAGGCCTATACTTGA,sample,10629,10490,526,9964,1768,8196,6755,750,453,97,7208,141,954,992,1321,1203
CATAACCTATACTTGA,sample,151485,149775,10187,139588,11957,127631,81186,4723,29114,3339,110300,9269,4445,2448,14207,8066
GGACGTAGATACTTGA,sample,152017,150270,10226,140044,17173,122871,85632,5195,23299,2364,108931,6381,3098,1568,30041,13220
GACGATAAATACTTGA,sample,144593,142534,13634,128900,12418,116482,77093,5187,20575,2594,97668,11033,5980,2418,15690,7792
GGCCAGAGATACTTGA,sample,476326,469143,63260,405883,34618,371265,164164,11968,106374,10626,270538,78133,13029,3456,40012,20271
ACGACTTCATACTTGA,sample,61444,60543,4523,56020,6766,49254,34722,3311,7544,923,42266,2754,3524,2235,7534,4885
AGTCCGCAATACTTGA,sample,127622,126172,6767,119405,21130,98275,79645,6119,9285,820,88930,2406,2504,2357,17779,15095
GTCCTGCCATACTTGA,sample,228833,224085,40551,183534,11842,171692,45099,3478,70791,8236,115890,44088,10813,2428,6005,5270
TTGGTACCATACTTGA,sample,331165,328536,13378,315158,43964,271194,232784,16132,16339,2635,249123,3304,2424,2409,56283,33194
AATATATCATACTTGA,Neg_Ctrl,2037,1461,607,854,94,760,451,22,152,14,603,121,384,215,134,56
AAGAGCGCATACTTGA,sample,91064,89961,4819,85142,7037,78105,56793,2982,13635,1667,70428,3028,2701,1979,12287,5162
TCAATATAATACTTGA,sample,230126,227673,19243,208430,23528,184902,123810,8556,30526,3866,154336,18144,6854,2037,26790,15716
CTTCATGAATACTTGA,sample,193081,190320,18225,172095,18591,153504,103453,8323,23293,2373,126746,16062,6824,2890,17936,12218
ATGACCGAATACTTGA,sample,292942,289943,26227,263716,19931,243785,153486,8978,44359,5155,197845,31807,10137,3300,17273,10897
GACCGGAAATACTTGA,sample,150617,149569,5989,143580,18289,125291,100135,8307,10956,1455,111091,4438,3276,2647,16733,12416
ACGTAAGTATCCGCGA,sample,241990,239482,19684,219798,31495,188303,133708,9281,25981,2372,159689,16961,6485,2190,45275,23236
TTCGTAATATCCGCGA,sample,174546,172918,19605,153313,18868,134445,60959,3864,40348,4599,101307,24675,7630,1825,17008,11347
ATGCCTGGATCCGCGA,sample,194269,190902,37620,153282,14607,138675,49032,3430,44603,4664,93635,36946,10953,2111,18203,7738
TGAGCGCGATCCGCGA,sample,140822,139000,14939,124061,11658,112403,63089,2715,29820,4210,92909,12569,5086,1974,19546,7373
TTAGAAGTATCCGCGA,sample,273826,270190,37676,232514,25062,207452,101675,7630,52847,5597,154522,39703,10128,2659,32305,14480
TCGCATCTATCCGCGA,sample,198886,196744,21244,175500,19726,155774,79498,4264,41965,4681,121463,25366,9106,2239,27228,14066
GGCCAGAGATCCGCGA,sample,180291,177846,13296,164550,19074,145476,103814,7245,21000,2995,124814,10422,5257,2185,25178,12278
CCATGAAGATCCGCGA,sample,264246,260530,29105,231425,23345,208080,118918,7550,47573,5150,166491,28889,9053,2413,24398,15501
AATCCGTCATCCGCGA,sample,95486,93359,17778,75581,10078,65503,29009,1656,18666,2118,47675,14054,7017,2023,6613,5338
CGGATTACATCCGCGA,sample,157645,155513,17045,138468,18313,120155,62826,4350,28635,2642,91461,21702,8131,2117,17682,11751
ACGTATTAATCCGCGA,sample,244791,242791,11203,231588,39345,192243,166674,10871,11112,628,177786,2958,2196,2364,30725,28432
CCAATTCCATCCGCGA,sample,316772,312654,31547,281107,32281,248826,143232,8916,58446,5502,201678,32730,7875,2195,24454,21622
GGCATATAATCCGCGA,sample,110056,108344,17770,90574,6708,83866,30187,2287,29671,3570,59858,18151,6145,1750,2483,2918
TCGCCTGAATCCGCGA,sample,139827,137952,18338,119614,12877,106737,49237,2874,32995,3789,82232,17842,6405,1730,8464,7471
CAACCGCGAGGACTCA,sample,103316,101981,13023,88958,18088,70870,27096,1489,25509,2621,52605,14155,6275,1314,7400,11502
AATGGTAAAGGACTCA,sample,34146,33676,3208,30468,7461,23007,15801,1175,3382,510,19183,2139,2827,1689,5415,4905
TTAGAAGTAGGACTCA,sample,42229,41558,4778,36780,8041,28739,19179,1113,4855,605,24034,2987,3268,1760,7327,4968
TTCCGTCTAGGACTCA,sample,163648,161135,16710,144425,11352,133073,66859,3615,39159,4392,106018,19048,6551,2086,11601,7026
TCGCATCTAGGACTCA,sample,128525,127467,10930,116537,16091,100446,59187,4699,22523,2577,81710,11460,5606,1918,15440,10426
CAAGGCCTAGGACTCA,sample,219541,217216,12182,205034,29972,175062,140928,8094,21054,1699,161982,3287,2250,1563,50697,22092
ACCTCGAGAGGACTCA,sample,106761,104681,15778,88903,7496,81407,31970,1569,27173,3335,59143,17360,7348,1719,5850,4127
TGGACGAGAGGACTCA,sample,142301,140222,10989,129233,19464,109769,76031,5549,17357,1823,93388,9009,5577,2695,19922,14248
GACGATAAAGGACTCA,sample,199605,197833,9397,188436,25896,162540,133834,9257,12986,1513,146820,4950,3299,2441,33134,19569
GCCTGAACAGGACTCA,sample,102473,101455,5816,95639,8923,86716,68666,6004,7746,764,76412,3536,4277,3249,12512,6356
ACGTATTAAGGACTCA,sample,263927,260971,22989,237982,28848,209134,123359,7062,46910,6592,170269,25211,8102,2231,40662,18884
TTGGCCTCAGGACTCA,sample,71477,70754,4228,66526,7699,58827,41948,2587,9820,1236,51768,3236,3321,2199,7273,5429
AATATATCAGGACTCA,sample,142206,140331,10312,130019,14109,115910,79996,7337,19309,1906,99305,7362,4394,2767,14420,10130
ACCAATGCAGGACTCA,sample,131346,129864,7333,122531,18523,104008,79127,6631,11673,1390,90800,5187,3479,1672,21498,13531
TCAATATAAGGACTCA,sample,232287,229431,19015,210416,23200,187216,110938,8056,39142,7230,150080,21850,6382,1975,24584,16755
AGGTCGGAAGGACTCA,Pos_Ctrl,56076,55073,6860,48213,2845,45368,38216,3827,2236,362,40452,727,5808,6920,2702,1642
TTATTCGAAGGACTCA,sample,336904,329384,72020,257364,22981,234383,72220,4555,83418,8610,155638,65580,16840,3469,16496,11437
GACCGGAAAGGACTCA,sample,108547,107931,3298,104633,20689,83944,70952,6459,4621,765,75573,1147,1808,2128,13966,14975
GGAGAGTTTATTGAAC,sample,2311,2278,137,2141,655,1486,786,87,399,42,1185,172,676,425,118,397
AAGTTCGTTATTGAAC,sample,66932,66251,6128,60123,6441,53682,31620,2335,12390,1546,44010,5791,4623,2124,7599,3650
AGTACCATTATTGAAC,sample,209735,207796,17526,190270,14545,175725,92406,4700,53442,6553,145848,18624,6898,2435,17583,9172
TTCGTAATTATTGAAC,sample,149275,147236,19007,128229,19582,108647,54596,4248,28219,2802,82815,18782,7115,1588,11751,12168
ATGCCTGGTATTGAAC,sample,267686,265323,19760,245563,33400,212163,147459,9308,33142,3773,180601,18481,5195,1894,44339,24801
TGAGCGCGTATTGAAC,sample,27348,26898,3057,23841,4007,19834,14573,788,2750,282,17323,1441,2061,1151,5860,2596
CAACCGCGTATTGAAC,sample,83302,82406,7212,75194,9870,65324,43897,1875,12470,1684,56367,5398,4051,1471,14226,6839
AATGGTAATATTGAAC,sample,25886,25500,2361,23139,2378,20761,11098,614,6230,747,17328,2072,2422,1277,3180,1420
ACTATACTTATTGAAC,sample,151978,149776,12322,137454,11900,125554,74739,4667,31054,4186,105793,10908,4510,1921,17400,8361
GGACGTAGTATTGAAC,sample,146262,142807,26903,115904,11025,104879,39035,2480,35385,3462,74420,24517,9143,2001,10171,6229
CTTGATAGTATTGAAC,sample,12119,11681,3233,8448,912,7536,2667,138,2406,229,5073,2096,2171,682,784,335
GACGATAATATTGAAC,sample,345482,340390,40369,300021,29863,270158,157601,10888,54891,6362,212492,40416,10184,2456,21110,18073
CCATGAAGTATTGAAC,sample,184745,182831,8525,174306,21244,153062,130951,10057,9660,504,140611,1890,1627,1672,36620,16025
CATGATTCTATTGAAC,sample,318099,313811,29577,284234,28937,255297,167239,11870,43799,5179,211038,27210,7859,2452,45789,18891
AATCCGTCTATTGAAC,sample,39822,37988,15169,22819,1989,20830,2567,170,9400,1025,11967,7668,5461,698,407,774
AGTCCGCATATTGAAC,sample,162141,159394,18837,140557,17787,122770,72290,5984,25128,2944,97418,16424,7082,1982,18238,11933
ACGTATTATATTGAAC,sample,290386,288292,11004,277288,36343,240945,203298,14055,17506,2228,220804,3858,1742,1635,35869,27588
CGTATGAATATTGAAC,sample,326412,319411,53775,265636,20755,244881,92811,5827,76509,9202,169320,60532,13663,2977,17329,9232
TTGGCCTCTATTGAAC,sample,166233,164264,14131,150133,17790,132343,93768,7699,17688,2209,111456,10979,4950,1768,14364,12572
GTACCGTATATTGAAC,sample,138163,136685,11978,124707,15459,109248,68260,4893,23348,3069,91608,9678,4672,1701,17571,10400
GGCATATATATTGAAC,sample,161009,159677,8351,151326,14622,136704,94319,6926,24531,3235,118850,7693,3659,2111,18535,10143
TCAATATATATTGAAC,sample,45164,44300,7469,36831,2226,34605,7495,489,13963,1256,21458,11402,5159,671,1416,837
CTTCATGATATTGAAC,sample,132292,128244,34890,93354,8974,84380,22918,1396,31031,3398,53949,25637,10226,1774,7131,4075
GACCGGAATATTGAAC,sample,3684,3628,441,3187,384,2803,1111,105,925,126,2036,536,1111,490,129,230
GGTTGCGTGTTCAACT,sample,93042,91139,13066,78073,7377,70696,37464,2859,16494,1722,53958,12157,6684,2694,7996,3803
TCCTCCGTGTTCAACT,sample,47870,46740,8667,38073,4950,33123,13763,690,9939,1068,23702,7663,4657,1037,2694,2788
TTCGTAATGTTCAACT,sample,80878,80067,3833,76234,8238,67996,46199,2955,13565,2121,59764,3156,2573,1898,10848,5772
ATGCCTGGGTTCAACT,sample,36956,36427,3249,33178,2716,30462,15279,1068,9120,1262,24399,3733,3177,1580,2954,1690
AATGGTAAGTTCAACT,sample,52273,51716,3021,48695,8923,39772,28160,2400,6306,696,34466,2210,3252,2554,3613,6005
TTAGAAGTGTTCAACT,sample,22933,22384,4074,18310,1945,16365,7760,476,4434,506,12194,3189,2915,909,2804,1184
TCGCATCTGTTCAACT,sample,34728,34013,8378,25635,2603,23032,6229,314,8633,933,14862,6923,4330,746,2034,1280
GCCTTGCTGTTCAACT,sample,82636,80648,14673,65975,6836,59139,29867,1700,14942,1680,44809,10950,4766,1199,11416,3382
CCAGAGCGGTTCAACT,sample,16287,16103,852,15251,3290,11961,9192,598,1421,194,10613,556,1364,1140,3260,2253
GGACGTAGGTTCAACT,sample,4112,4045,344,3701,1002,2699,1603,148,671,61,2274,216,930,616,280,634
TGGACGAGGTTCAACT,sample,73127,72460,4046,68414,8698,59716,43670,2800,9188,1113,52858,2945,2464,1533,9966,6108
GTTAGGACGTTCAACT,sample,17609,17313,2594,14719,1186,13533,4245,299,5201,528,9446,3260,2805,672,299,556
CGTATGAAGTTCAACT,sample,52266,51465,7193,44272,2873,41399,18366,966,13285,1309,31651,7473,4110,1228,960,1241
TTGGCCTCGTTCAACT,sample,34076,33715,4743,28972,2731,26241,12721,1161,6654,822,19375,4883,3523,831,3302,1705
TTATTCGAGTTCAACT,Neg_Ctrl,352,268,160,108,11,97,53,6,27,0,80,11,65,33,8,3
TCCAACTTCTGAGGTT,sample,172943,170699,12879,157820,16741,141079,93463,6204,27469,2997,120932,10946,4639,2484,21146,11173
AAGTTCGTCTGAGGTT,sample,165848,163717,14595,149122,17961,131161,82696,5911,26555,2889,109251,13110,6105,2503,17821,11056
CCTCTAGACTGAGGTT,sample,284001,282197,11736,270461,31973,238488,182380,16023,28013,2704,210393,9368,3299,2066,52617,23252
CAACCGCGCTGAGGTT,sample,145448,144066,12979,131087,18283,112804,70646,4976,22116,2452,92762,12614,5562,1785,24932,12092
TCGCATCTCTGAGGTT,sample,63800,63193,4435,58758,8306,50452,32904,2413,9375,1068,42279,4692,3964,1809,9689,5781
GGAGGACGCTGAGGTT,sample,106029,105052,6121,98931,10389,88542,53721,3137,21456,2821,75177,7407,3455,1702,19069,7295
CCGCAACGCTGAGGTT,sample,55151,54496,4735,49761,7752,42009,27189,1770,7482,931,34671,4637,2926,1443,11075,4919
CTTGATAGCTGAGGTT,sample,30021,29410,4543,24867,2453,22414,12229,751,4923,597,17152,3914,3481,1499,3842,1315
ACCTCGAGCTGAGGTT,sample,52269,51734,3927,47807,6173,41634,29799,1862,5568,988,35367,3417,3403,1750,10432,4196
ACGACTTCCTGAGGTT,sample,97142,95748,9831,85917,11132,74785,44834,3210,14934,1766,59768,10041,5616,1957,13615,6715
CATGATTCCTGAGGTT,sample,154296,151658,17398,134260,14107,120153,61890,4988,28418,3080,90308,21777,7898,2398,15166,9395
AATCCGTCCTGAGGTT,sample,160601,157602,20939,136663,12178,124485,50898,3457,41311,5239,92209,23580,8949,2538,12716,7344
GCCTGAACCTGAGGTT,sample,14657,14420,1425,12995,1123,11872,6533,501,3119,383,9652,1336,2762,1719,627,724
ACGTATTACTGAGGTT,sample,50679,50007,3627,46380,9319,37061,31560,1578,2718,156,34278,1049,1286,1270,11941,6726
CGTATGAACTGAGGTT,sample,200128,198336,11208,187128,26072,161056,121204,8172,20665,2432,141869,8583,4279,2049,30382,16830
GAAGGCGCCTGAGGTT,sample,61280,60475,5052,55423,6696,48727,34870,2179,6593,637,41463,4448,4142,2046,7118,4575
CCAATTCCCTGAGGTT,sample,176748,175073,8351,166722,25326,141396,120024,6926,11354,1456,131378,1636,1372,1341,37158,20134
ACGTAAGTAGACCGTT,sample,190935,188581,14959,173622,18817,154805,97288,7475,31937,3586,129225,14519,6202,2203,25768,13019
TTCGTAATAGACCGTT,sample,65758,64622,9827,54795,3007,51788,16602,1304,20520,2179,37122,11183,5946,1638,948,1305
ACGTTATGAGACCGTT,sample,70945,70043,6190,63853,5165,58688,28616,2223,19553,2269,48169,6027,4356,2398,3050,3480
TTCTAATGAGACCGTT,sample,69842,69126,4431,64695,6474,58221,30691,1777,18028,2022,48719,5703,3075,1544,5477,4156
CAACCGCGAGACCGTT,sample,93103,92074,7675,84399,12471,71928,48108,3024,12012,1315,60120,7469,4370,1841,15204,9034
TTAGAAGTAGACCGTT,sample,162826,161248,9617,151631,19232,132399,85616,4681,30623,3658,116239,7821,3352,1888,24916,13200
GGACCTCTAGACCGTT,sample,117458,115229,13187,102042,12157,89885,50737,3219,21223,2634,71960,12072,6174,1915,11467,8440
GCCTTGCTAGACCGTT,sample,132126,130574,10196,120378,12874,107504,76224,4880,15390,1834,91614,9176,4985,2502,18539,8363
GGACGTAGAGACCGTT,sample,89319,87787,13997,73790,7096,66694,27195,2208,20850,2602,48045,13839,7540,2824,4929,3581
TGGACGAGAGACCGTT,sample,144023,142515,10112,132403,18277,114126,82403,6626,15044,1795,97447,8258,5757,2783,18012,11983
ACGACTTCAGACCGTT,sample,350019,347578,16013,331565,40704,290861,226279,17317,27148,2738,253427,17379,5269,2667,48573,31063
TTGGTACCAGACCGTT,sample,100589,99493,7722,91771,13306,78465,49144,2813,17208,1446,66352,7854,4256,1643,15971,8505
CGTATGAAAGACCGTT,sample,192838,190311,18734,171577,18142,153435,77714,5324,38328,3761,116042,28308,9232,2304,22016,10939
AAGAGCGCAGACCGTT,sample,258597,256908,12015,244893,37714,207179,132970,10432,42775,5888,175745,15114,4919,1772,45229,26933
GTCTTAGCAGACCGTT,sample,90247,89386,6846,82540,12345,70195,40640,2780,16052,1671,56692,9052,6229,2543,7644,8023
CTTCATGAAGACCGTT,sample,107412,106057,7852,98205,11815,86390,62303,3345,12552,1134,74855,7056,3712,1523,20174,8379
TCCAACTTCTTGAGTT,sample,217743,215634,18546,197088,17718,179370,103611,7522,40038,4695,143649,23504,8822,3208,17055,10798
AGTACCATCTTGAGTT,sample,137831,136910,6185,130725,23823,106902,92427,5406,6894,362,99321,1813,1953,2247,30376,17970
TTCTAATGCTTGAGTT,sample,95929,95239,6403,88836,12887,75949,48094,3708,16154,2045,64248,5948,4680,2185,11476,8961
AATGGTAACTTGAGTT,sample,234553,232866,11677,221189,32777,188412,139689,8909,26444,3061,166133,10309,4052,1886,53088,24079
GGACCTCTCTTGAGTT,sample,172163,170119,17242,152877,17413,135464,73270,5146,30740,3100,104010,23208,7958,3078,14157,10498
GCCTTGCTCTTGAGTT,sample,99165,98132,5154,92978,16901,76077,51499,3043,14668,1682,66167,5185,3073,1441,17125,12012
CATAACCTCTTGAGTT,sample,235933,233869,14289,219580,34792,184788,155495,12081,11508,919,167003,4785,3423,2492,38916,24817
CCAGAGCGCTTGAGTT,sample,177253,175634,8201,167433,17418,150015,115944,7958,17786,2890,133730,5437,4284,4109,15718,12901
CCGCAACGCTTGAGTT,sample,281616,277631,35752,241879,22758,219121,91892,5544,72751,7196,164643,41738,11644,2837,25615,12950
GGACGTAGCTTGAGTT,sample,127501,126291,7349,118942,13796,105146,72061,4537,20305,1942,92366,6301,3867,2262,20447,10241
CTTGATAGCTTGAGTT,sample,129390,127819,10314,117505,13036,104469,70488,5739,17809,2214,88297,8219,5508,2847,19012,8493
ACCTCGAGCTTGAGTT,sample,118692,117506,5509,111997,16604,95393,80870,5908,6662,550,87532,1403,1841,2220,19842,12477
TGGACGAGCTTGAGTT,sample,20547,20045,3494,16551,1856,14695,7567,568,3486,415,11053,2659,2955,1330,2228,940
CATTGCAGCTTGAGTT,sample,250157,246725,27932,218793,29193,189600,76542,6007,62010,6404,138552,38637,10229,2698,10814,17917
AGTCCGCACTTGAGTT,sample,193383,191201,13608,177593,26070,151523,113559,7829,19466,1981,133025,8688,5194,2209,49194,18500
TTGGTACCCTTGAGTT,sample,129182,127424,11465,115959,10378,105581,57779,5142,28005,3289,85784,11366,5544,2378,11600,6778
GTTAGGACCTTGAGTT,sample,87947,86740,7461,79279,13206,66073,37258,2525,17692,1558,54950,7040,5464,2366,6544,8358
AACTCGTACTTGAGTT,sample,137584,136001,7256,128745,18678,110067,92694,6089,7555,1465,100249,2264,1823,1890,25134,13956
TTGGCCTCCTTGAGTT,sample,158128,156473,8872,147601,20947,126654,95827,5359,16479,2152,112306,6837,2851,1349,36032,15781
ACCAATGCCTTGAGTT,sample,159073,157030,11620,145410,19768,125642,93464,6774,16634,1547,110098,7223,2656,1472,33050,15227
AAGAGCGCCTTGAGTT,sample,42305,41814,2357,39457,3549,35908,20912,1292,9740,1335,30652,2629,2861,1876,2110,2294
ATGACCGACTTGAGTT,sample,131352,126033,31557,94476,6917,87559,23404,1463,33266,3207,56670,26219,9807,1658,7734,2933
ATTCTCTTTCGGAGTT,sample,17295,16822,2973,13849,1055,12794,5045,320,4135,461,9180,2833,2671,847,1325,470
TCCTCCGTTCGGAGTT,sample,48124,47162,5839,41323,3950,37373,17881,1336,9992,959,27873,7205,4616,1377,4105,2425
ACGTAAGTTCGGAGTT,sample,30343,29913,2179,27734,2006,25728,15451,969,6715,729,22166,1864,2305,1502,3153,1278
CCTCTAGATCGGAGTT,sample,34468,33906,2566,31340,3785,27555,19597,1569,3805,364,23402,2220,2598,1689,4245,2576
CAACCGCGTCGGAGTT,sample,22200,21874,1954,19920,2074,17846,12088,695,3002,419,15090,1642,1889,1150,4033,1397
GCCTTGCTTCGGAGTT,sample,43092,42388,3873,38515,3563,34952,21399,1185,7434,669,28833,4265,2704,1064,6959,2478
CATAACCTTCGGAGTT,sample,31239,30813,2365,28448,2727,25721,16799,1173,4592,753,21391,2404,2039,966,6179,1875
TGGACGAGTCGGAGTT,sample,10195,10005,826,9179,1216,7963,5845,380,1011,96,6856,631,1338,930,1740,885
GGCCAGAGTCGGAGTT,sample,15503,15182,2237,12945,1206,11739,4783,345,3410,471,8193,2730,2560,655,1608,674
ACGACTTCTCGGAGTT,sample,31323,30960,1294,29666,3833,25833,21534,1736,1856,257,23390,450,995,1110,7237,2895
TTGGTACCTCGGAGTT,sample,25779,25233,2705,22528,2712,19816,11379,833,4333,501,15712,2770,2727,900,4526,1731
GCCTGAACTCGGAGTT,sample,17762,17449,1329,16120,1867,14253,8821,602,2772,352,11593,1706,2313,1219,885,1164
CGTATGAATCGGAGTT,sample,69375,68685,4757,63928,4991,58937,36857,2531,12897,1584,49754,5068,3900,1885,7879,3247
TTGGCCTCTCGGAGTT,Pos_Ctrl,59627,58132,6741,51391,2106,49285,41445,3772,2891,349,44336,828,6018,7322,2143,1015
GTACCGTATCGGAGTT,sample,6307,6192,657,5535,472,5063,3447,235,773,86,4220,522,1447,1010,463,272
GGAGAGTTTGAACCTT,sample,41225,40660,2224,38436,3733,34703,24499,2092,5387,469,29886,2256,2596,1939,4134,2359
ATTCTCTTTGAACCTT,Pos_Ctrl,57093,55204,7887,47317,2683,44634,37610,3132,2607,359,40217,926,6017,6506,3103,1352
TCCAACTTTGAACCTT,sample,106773,104953,10287,94666,10672,83994,57617,3317,14074,1410,71691,7576,3733,1577,17975,7374
TAGTACGGTGAACCTT,Pos_Ctrl,68632,66023,10201,55822,3014,52808,44552,3698,3247,339,47799,972,6443,7224,3556,1705
TTCCGTCTTGAACCTT,sample,38833,38276,4080,34196,4955,29241,16957,1204,6772,760,23729,3548,3913,1815,4069,3032
GCCTTGCTTGAACCTT,sample,134202,132017,10061,121956,15297,106659,87635,6481,8623,1381,96258,2539,2671,1979,16208,11316
ACTATACTTGAACCTT,sample,95038,94190,4876,89314,12453,76861,58388,4367,9204,799,67592,4103,3379,2131,13233,8708
GACGGAGATGAACCTT,sample,33341,32862,2944,29918,5924,23994,12232,1073,6896,693,19128,3100,3396,1218,3012,3714
CCAGAGCGTGAACCTT,sample,19101,18819,1933,16886,3594,13292,6762,505,3472,413,10234,2140,2458,885,1833,2279
GGAGGACGTGAACCTT,sample,30297,30039,1461,28578,3374,25204,20557,1588,2098,270,22655,691,2023,1862,5480,2464
CCGCAACGTGAACCTT,Pos_Ctrl,14871,14550,1521,13029,828,12201,10277,1010,647,62,10924,205,3385,3257,764,463
CATGATTCTGAACCTT,sample,88461,87453,6750,80703,6944,73759,40876,2822,21414,2583,62290,6064,4952,2425,10245,4971
AATCCGTCTGAACCTT,Pos_Ctrl,73553,71405,9115,62290,3329,58961,49562,4477,3385,491,52947,1046,6499,7882,3688,1645
CTAGGACCTGAACCTT,sample,167286,165382,9240,156142,15712,140430,112221,6999,12766,1334,124987,7110,4873,3033,29414,10925
GTTAGGACTGAACCTT,sample,142786,140922,14080,126842,10835,116007,75360,5391,21047,2197,96407,12012,6945,3229,14746,6473
CGTATGAATGAACCTT,sample,149095,146878,14074,132804,10803,122001,80652,4769,19042,2039,99694,15499,6452,2271,19658,6636
TTGGCCTCTGAACCTT,sample,117996,116660,9602,107058,8742,98316,49720,3290,29398,3381,79118,12527,4445,1671,10004,5377
AATATATCTGAACCTT,sample,101245,99395,11064,88331,11113,77218,38688,3936,19371,1949,58059,13274,5998,1467,6873,6733
ACCAATGCTGAACCTT,sample,146771,144034,7244,136790,13939,122851,105634,7662,6726,919,112360,1910,1538,1842,22592,10675
TGCTTCGCTGAACCTT,sample,120506,119137,9025,110112,13788,96324,64327,4548,15816,1302,80143,10331,3972,1448,20142,10393
GTACCGTATGAACCTT,Pos_Ctrl,34736,33461,4791,28670,1406,27264,22991,1981,1610,203,24601,479,5028,5077,1511,717
ATGACCGATGAACCTT,sample,50356,49554,7031,42523,4548,37975,11638,911,13131,1305,24769,10990,6023,1367,2023,2358
TATCAGTTACCGAATT,sample,290423,287083,21566,265517,24220,241297,143501,9823,58798,6269,202299,22906,6947,2846,33282,16118
TCCTCCGTACCGAATT,sample,151556,149564,13790,135774,11164,124610,58209,4564,40797,4955,99006,16085,6375,2376,11162,7028
TTCTAATGACCGAATT,sample,100284,99350,6181,93169,13724,79445,68130,4261,5399,422,73529,1233,1410,1556,25020,10105
TGAGCGCGACCGAATT,sample,145103,143558,10914,132644,17796,114848,75218,5662,21278,2257,96496,10433,5629,2074,26135,12989
AATGGTAAACCGAATT,sample,240253,238044,10940,227104,21770,205334,149380,10866,33210,4014,182590,7864,3983,3762,23227,15687
GGACCTCTACCGAATT,sample,330453,327273,17058,310215,47716,262499,215481,15327,21813,3452,237294,6426,3879,2403,40586,35148
GGACGTAGACCGAATT,sample,150558,149250,7722,141528,17126,124402,99229,6281,12054,1586,111283,5252,3883,2798,18029,12154
CTTGATAGACCGAATT,sample,239925,236004,40567,195437,18584,176853,49097,3293,67990,6471,117087,50002,12225,2437,6630,10009
CGAGGCAGACCGAATT,sample,133816,131833,13790,118043,13601,104442,51701,2505,30670,3338,82371,16228,6580,1714,20361,8637
CGTACGTCACCGAATT,sample,333655,331258,16051,315207,35442,279765,214957,17199,32582,3598,247539,11429,4742,2097,50462,27500
TTGGTACCACCGAATT,sample,378185,375515,17596,357919,35746,322173,226931,20488,55241,6721,282172,12792,5017,2896,37691,23196
GCCTGAACACCGAATT,sample,284290,282669,9814,272855,40197,232658,187261,15177,23046,1108,210307,6066,3565,2046,55167,29407
AATATATCACCGAATT,Neg_Ctrl,2865,2039,1033,1006,150,856,353,27,211,10,564,255,318,173,83,64
AAGAGCGCACCGAATT,sample,89787,87592,18486,69106,5556,63550,14267,941,25623,2925,39890,19794,7883,1761,1059,1995
CCAATTCCACCGAATT,sample,147445,145578,11348,134230,17892,116338,78830,5386,17958,2028,96788,12136,4620,1564,24601,13262
TCGCCTGAACCGAATT,sample,114988,113420,16168,97252,10078,87174,32949,2028,29278,3573,62227,19346,7402,1549,10583,6285
CTTCATGAACCGAATT,sample,118894,117747,7706,110041,10595,99446,58067,4682,25017,2565,83084,9115,4323,1843,13540,7309
AGGTCGGAACCGAATT,sample,172008,169954,14970,154984,10148,144836,75268,5370,43019,5293,118287,15886,6124,2524,9784,5865
GACCGGAAACCGAATT,sample,101946,101322,5321,96001,11612,84389,58919,6526,10489,1311,69408,7144,5297,2701,8488,6810
ATTCTCTTGGTCTGGT,sample,143980,143297,6003,137294,27952,109342,77785,5829,17454,1694,95239,6580,4085,2047,24701,19451
TCCAACTTGGTCTGGT,Neg_Ctrl,967,782,366,416,50,366,202,17,108,7,310,32,201,102,52,37
TCCTCCGTGGTCTGGT,sample,80231,79739,2898,76841,12227,64614,55687,3651,3854,618,59541,804,1535,1832,18415,8632
AGTACCATGGTCTGGT,sample,109071,108004,8909,99095,10657,88438,50362,3163,20023,2155,70385,12735,5938,2003,15790,7207
ACGTTATGGGTCTGGT,sample,33185,32880,1890,30990,3491,27499,20684,1772,3543,356,24227,1144,2438,1940,5501,2433
TGAGCGCGGGTCTGGT,Neg_Ctrl,1042,857,507,350,32,318,147,12,48,6,195,105,127,70,50,55
TTCCGTCTGGTCTGGT,sample,57032,56149,5371,50778,6437,44341,31763,1397,6583,878,38346,3720,2903,1257,13520,4700
GCCTTGCTGGTCTGGT,sample,158209,156682,8764,147918,12276,135642,78423,5233,37033,5647,115456,9306,3842,1893,16677,6700
CAAGGCCTGGTCTGGT,sample,28839,28280,3581,24699,6223,18476,8196,554,5335,566,13531,3825,2913,705,2818,3802
ACTATACTGGTCTGGT,sample,117727,116492,7234,109258,15286,93972,70566,3452,14067,1418,84633,4469,2756,1976,26117,10459
CCAGAGCGGGTCTGGT,sample,138932,137479,7890,129589,12781,116808,74182,5485,25688,3289,99870,8164,4184,2206,15573,7802
GGAGGACGGGTCTGGT,sample,95097,94130,7349,86781,12682,74099,48156,3779,13892,1620,62048,6652,5740,3241,7948,8884
GGACGTAGGGTCTGGT,Neg_Ctrl,1303,1002,501,501,55,446,235,23,93,3,328,92,179,107,67,36
ACCTCGAGGGTCTGGT,sample,46418,45901,2801,43100,4996,38104,27243,1457,6366,623,33609,2415,2799,1926,6575,3189
CATGATTCGGTCTGGT,sample,265967,262122,18545,243577,13504,230073,111527,6848,74779,10158,186306,26761,5842,2210,5840,6787
CGTACGTCGGTCTGGT,Neg_Ctrl,1777,1320,758,562,74,488,311,11,86,15,397,65,262,140,72,48
GTCCTGCCGGTCTGGT,sample,73370,72203,7539,64664,7787,56877,27115,1596,16067,2128,43182,9971,4846,1109,6268,4811
CTAGGACCGGTCTGGT,sample,151370,150025,6341,143684,16727,126957,104673,10261,8384,911,113057,2728,2283,2450,19097,11997
ACGTATTAGGTCTGGT,sample,29053,28607,2665,25942,2718,23224,14096,1248,4513,495,18609,2872,3418,2052,2192,1569
GTACCGTAGGTCTGGT,sample,59116,57475,8537,48938,4681,44257,22995,1458,11493,1200,34488,7111,4721,1581,5990,2752
GGCATATAGGTCTGGT,Neg_Ctrl,977,773,462,311,16,295,151,15,83,7,234,39,149,82,35,32
TCAATATAGGTCTGGT,sample,56726,55733,5333,50400,4530,45870,22217,1485,14770,1668,36987,5730,4156,1734,3225,2880
ATGACCGAGGTCTGGT,sample,155016,153876,6125,147751,10849,136902,109906,7818,13562,1915,123468,3701,2361,2109,21305,7926
ACGTAAGTCGACGTTA,sample,15630,15401,1312,14089,1967,12122,7082,422,2969,348,10051,1301,2418,1447,850,1224
CCTCTAGACGACGTTA,sample,59752,58803,7164,51639,6558,45081,22673,1727,11307,1029,33980,8345,4840,1267,6989,4179
AATGGTAACGACGTTA,sample,389629,386562,17611,368951,42485,326466,262256,26473,25992,3734,288248,8011,4119,2759,73241,30393
TTAGAAGTCGACGTTA,sample,44623,44156,2570,41586,4827,36759,24552,1546,7777,791,32329,2093,3559,2685,4607,3249
ACTATACTCGACGTTA,sample,304522,301921,17690,284231,43614,240617,168620,12547,41347,4481,209967,13622,3851,1928,63887,31761
GGACGTAGCGACGTTA,sample,280668,278634,12401,266233,31755,234478,198855,14594,15369,1724,214224,3936,1930,1953,43740,23471
CTAGGACCCGACGTTA,sample,541188,537572,21591,515981,56297,459684,388589,30681,32726,3634,421315,4054,2258,2319,97309,44175
GCCTGAACCGACGTTA,sample,294894,292478,17329,275149,22550,252599,149829,9480,60071,9989,209900,23230,5879,2507,30715,14448
ACGTATTACGACGTTA,sample,237165,235119,15706,219413,25077,194336,116160,9106,41853,4677,158013,22540,7720,2013,19402,16246
CGTATGAACGACGTTA,sample,412964,409643,21934,387709,36444,351265,270171,21160,36943,5523,307114,17468,6646,3440,36548,26028
TTGGTTAACGACGTTA,sample,125262,124578,4836,119742,14059,105683,70101,5192,19930,3451,90031,7009,4215,2197,7690,9786
TCGCCTGACGACGTTA,sample,192152,191306,5976,185330,31727,153603,126286,15527,8219,1056,134505,2515,1811,2074,20266,23915
TTATTCGACGACGTTA,sample,60712,60434,2454,57980,8263,49717,35010,3020,7492,1196,42502,2999,2582,1223,9179,5757
ATGACCGACGACGTTA,sample,12342,12208,694,11514,1098,10416,6772,632,1963,215,8735,834,1676,1155,905,662
ACGTAAGTTACTAAGT,sample,72477,71270,8473,62797,5540,57257,37612,2372,10946,1392,48558,4935,4399,2340,6840,3527
CCTCTAGATACTAAGT,sample,22133,21801,2519,19282,1806,17476,9502,693,4162,412,13664,2707,2760,1204,2052,1074
AGTACCATTACTAAGT,sample,25059,24731,1156,23575,3470,20105,17597,1064,953,218,18550,273,847,954,6670,2754
TTCTAATGTACTAAGT,sample,35361,34857,3980,30877,2969,27908,17091,1226,5388,512,22479,3691,3320,1216,5749,1830
ATGCCTGGTACTAAGT,sample,15332,15060,2003,13057,1603,11454,6172,425,2664,262,8836,1931,2152,724,2657,1023
AATGGTAATACTAAGT,sample,37634,37228,2159,35069,4443,30626,25918,1642,2375,365,28293,326,1142,1286,7203,3521
TTAGAAGTTACTAAGT,sample,14483,14259,1160,13099,889,12210,6987,328,3426,553,10413,916,1636,926,1086,501
TCGCATCTTACTAAGT,sample,5211,5058,1029,4029,454,3575,1742,86,851,104,2593,792,1205,545,394,230
GCCTTGCTTACTAAGT,sample,65328,64634,4479,60155,9050,51105,35898,2777,6739,910,42637,4781,3482,1675,9492,6480
GTTAGCCGTACTAAGT,sample,23727,23303,2056,21247,1264,19983,11567,555,5457,710,17024,1694,2163,1240,1706,839
TGGACGAGTACTAAGT,sample,10671,10344,2054,8290,808,7482,2609,216,2373,236,4982,2048,2017,598,699,400
CATGATTCTACTAAGT,sample,55817,54792,8316,46476,3924,42552,19529,1306,11868,1284,31397,8565,5329,1231,6592,2378
AATCCGTCTACTAAGT,sample,23828,23503,1713,21790,3206,18584,14999,888,1785,201,16784,711,1284,827,7251,2285
TTGGTACCTACTAAGT,sample,9553,9459,486,8973,1796,7177,5758,331,742,92,6500,254,974,809,1928,1272
AAGAGCGCTACTAAGT,sample,39248,38418,7433,30985,2288,28697,8220,659,10334,1039,18554,8445,4855,724,2531,1165
CTTCATGATACTAAGT,sample,27367,26996,1817,25179,2747,22432,18039,1647,2194,91,20233,461,925,823,5300,2229
ATGACCGATACTAAGT,sample,34308,33905,2203,31702,3179,28523,21651,1619,3021,451,24672,1781,1691,853,6823,2090
TTCGTAATTTGCCGCT,sample,40295,39936,1968,37968,4660,33308,28213,1888,2173,362,30386,672,2183,2175,9384,3537
ATGCCTGGTTGCCGCT,sample,184860,183356,10466,172890,22164,150726,114231,9113,16668,1199,130899,9515,4247,2184,23848,15343
TGAGCGCGTTGCCGCT,sample,171013,169551,8182,161369,17029,144340,120644,8896,10212,2724,130856,1864,1313,1254,31209,13813
CAACCGCGTTGCCGCT,sample,107681,106673,5242,101431,7930,93501,65155,3586,18271,2157,83426,4332,2477,1467,8786,5731
AATGGTAATTGCCGCT,sample,99416,98507,5959,92548,7284,85264,51096,3776,20863,2707,71959,6822,3823,1840,11172,4467
TCGCATCTTTGCCGCT,sample,102713,101497,8209,93288,13466,79822,56420,4759,11604,1013,68024,6026,3505,1563,21461,10065
CAAGGCCTTTGCCGCT,sample,170145,167430,15136,152294,14493,137801,80743,4881,35289,5707,116032,11181,4374,1956,19034,9618
GACGGAGATTGCCGCT,sample,130743,129268,9294,119974,12045,107929,63327,4432,26006,3608,89333,10556,4863,1696,15509,8450
GGAGGACGTTGCCGCT,sample,148695,147302,10416,136886,17500,119386,83843,6369,16605,1959,100448,10610,5291,2200,17271,12833
CGAGGCAGTTGCCGCT,sample,83832,82942,4771,78171,11866,66305,56115,3325,4783,559,60898,1523,1182,1193,21534,9448
ACGACTTCTTGCCGCT,sample,274371,271673,18001,253672,24965,228707,159921,11595,34514,3219,194435,19458,7471,2557,42605,18342
CATGATTCTTGCCGCT,sample,330287,324624,41432,283192,16707,266485,99669,6141,96436,9947,196105,54292,12377,3406,12356,7941
CGTACGTCTTGCCGCT,sample,207181,203887,18835,185052,17839,167213,91479,5687,39753,4937,131232,25357,7585,2129,21883,12189
GTCCTGCCTTGCCGCT,sample,170338,168738,12255,156483,18728,137755,88502,6912,26094,2187,114596,14060,6038,1940,21116,12012
TTGGTACCTTGCCGCT,sample,176897,175103,11363,163740,25291,138449,96898,6599,22619,2196,119517,10137,5268,2126,22311,18316
ACGTATTATTGCCGCT,sample,250377,247779,14899,232880,18609,214271,140728,13226,39250,5775,179978,15292,4817,1919,21865,11313
TTGGCCTCTTGCCGCT,sample,251586,248737,16123,232614,18084,214530,144789,10242,36638,4744,181427,18117,6600,2578,20314,11627
AATATATCTTGCCGCT,sample,189657,186998,16029,170969,15065,155904,89469,6532,35188,3562,124657,21153,7108,1966,20448,9510
GTACCGTATTGCCGCT,sample,130889,129465,8173,121292,5710,115582,61686,3152,33100,4724,94786,12920,4179,1708,2114,3224
TCGCCTGATTGCCGCT,sample,120486,118602,11960,106642,8980,97662,46323,3254,30169,3249,76492,14667,6600,1583,11181,5889
TCCAACTTTTCGACCT,sample,38033,37534,2414,35120,4422,30698,24851,1789,2776,264,27627,1018,2207,1911,6477,3367
GGTTGCGTTTCGACCT,sample,11970,11729,1019,10710,1086,9624,6703,431,1698,242,8401,550,1619,1075,2025,783
TCCTCCGTTTCGACCT,sample,28364,28111,1639,26472,2575,23897,18493,1301,2917,249,21410,937,2218,1934,3970,1861
ACGTAAGTTTCGACCT,sample,54773,54041,3593,50448,5182,45266,32857,2053,7512,656,40369,2188,2754,2066,6708,3444
ATGCCTGGTTCGACCT,sample,135649,134283,11657,122626,10343,112283,70471,5294,19572,2273,90043,14673,5292,1675,13049,7478
TAGTACGGTTCGACCT,sample,130435,129244,11929,117315,7315,110000,62981,3934,26694,2953,89675,13438,6936,2962,7394,3487
TGAGCGCGTTCGACCT,sample,80151,79571,3956,75615,8411,67204,52876,4510,6099,794,58975,2925,4115,3342,8882,5813
CAACCGCGTTCGACCT,sample,118815,118033,6443,111590,13904,97686,55841,3988,26928,3277,82769,7652,4362,2053,11495,9690
AATGGTAATTCGACCT,sample,346490,343710,20442,323268,37791,285477,178275,11761,66063,8147,244338,21231,5918,3126,46853,27605
TTCCGTCTTTCGACCT,sample,364634,362603,15534,347069,55023,292046,248748,13713,20081,3278,268829,6226,2496,1801,95893,40185
ACTATACTTTCGACCT,sample,189723,186453,17107,169346,14413,154933,108532,5763,25845,2572,134377,12221,6786,3209,30811,9962
CCAGAGCGTTCGACCT,sample,119668,116112,24797,91315,7864,83451,26087,1489,28961,3082,55048,23832,9329,1785,10221,3713
CCGCAACGTTCGACCT,sample,214404,211662,14196,197466,22723,174743,135456,9371,18857,2916,154313,8143,4674,3157,24173,16163
CTTGATAGTTCGACCT,sample,205168,202455,14777,187678,23537,164141,119017,9661,21224,2610,140241,11629,6475,3668,27492,15659
CGAGGCAGTTCGACCT,sample,123366,122139,7285,114854,25477,89377,76592,4689,5756,798,82348,1542,1763,1882,26385,17920
CCATGAAGTTCGACCT,sample,355758,352852,16138,336714,39784,296930,246142,19612,20119,3127,266261,7930,4507,3091,54156,27406
ACGACTTCTTCGACCT,sample,644314,637090,56879,580211,55330,524881,307264,24893,103148,9961,410412,79615,14309,4321,55288,36479
CATGATTCTTCGACCT,sample,488226,483318,39256,444062,43292,400770,262165,20749,71676,7550,333841,38630,9537,2827,52610,26731
TTGGTACCTTCGACCT,sample,14335,14054,1853,12201,1765,10436,5835,411,2565,310,8400,1315,2023,940,2553,1106
CTAGGACCTTCGACCT,sample,71146,69029,14010,55019,5808,49211,20524,1207,14720,1542,35244,11218,6753,1716,5406,3144
GTTAGGACTTCGACCT,sample,30720,30261,2738,27523,3995,23528,18993,1186,2013,224,21006,1112,2556,2182,4504,2672
AATATATCTTCGACCT,sample,63859,62856,9205,53651,6890,46761,20407,1605,14374,1497,34781,8878,5310,1340,5313,4311
GTCTTAGCTTCGACCT,sample,311244,307466,24451,283015,30307,252708,170588,10683,41355,5162,211943,24920,8216,2643,42806,21985
GTACCGTATTCGACCT,sample,358889,355500,18994,336506,35714,300792,233962,13265,32770,2888,266732,17907,2997,2155,58116,27552
GGCATATATTCGACCT,sample,249632,247250,14580,232670,29257,203413,158273,11486,21151,1815,179424,10688,5073,2887,32216,21154
TTATTCGATTCGACCT,sample,223519,218760,27234,191526,16807,174719,93464,5554,40965,4876,134429,29860,9469,2644,18333,9364
GACCGGAATTCGACCT,sample,41924,41645,2451,39194,5487,33707,20631,1664,7347,841,27978,3224,3261,1775,4286,3053
TATCAGTTTCCAGACT,sample,187055,185998,5794,180204,23473,156731,132553,8388,12391,1153,144944,2246,1527,1657,54217,18149
AAGTTCGTTCCAGACT,sample,178613,177427,7407,170020,26200,143820,123485,8044,8476,1348,131961,2467,1548,1496,53447,20106
GGTTGCGTTCCAGACT,sample,203122,201507,9596,191911,16261,175650,114987,6826,39692,5269,154679,8876,3907,2623,23120,11786
TCCTCCGTTCCAGACT,sample,113368,112099,14438,97661,13425,84236,36880,2039,24645,2466,61525,18206,8142,2127,11818,8693
ACGTAAGTTCCAGACT,sample,48168,47384,8880,38504,5680,32824,10831,782,12020,1291,22851,7900,6053,1864,2917,3305
AGTACCATTCCAGACT,sample,85399,83668,13707,69961,6138,63823,28127,1770,18941,2011,47068,12974,6397,1979,7681,3152
ACGTTATGTCCAGACT,sample,122829,121324,10834,110490,11020,99470,52530,3835,28117,2946,80647,12042,4826,1558,18840,7281
ATGCCTGGTCCAGACT,sample,86422,85494,7866,77628,12031,65597,41511,3256,12937,1352,54448,6541,5047,2172,10769,7760
TGAGCGCGTCCAGACT,sample,91416,90419,6003,84416,8086,76330,51461,2632,15552,1423,67013,5262,3130,1617,17490,5808
CAACCGCGTCCAGACT,sample,53031,52444,5237,47207,4480,42727,19847,1304,14380,1401,34227,5795,3637,1458,4545,2499
GGACCTCTTCCAGACT,sample,70799,69612,8571,61041,6545,54496,32296,1914,10910,1120,43206,8256,5567,1717,7980,4376
CTTGATAGTCCAGACT,sample,82260,73453,9840,63613,6615,56998,38881,2886,9899,1282,48780,4050,3547,1566,11595,4286
ACCTCGAGTCCAGACT,sample,71196,70244,4485,65759,5540,60219,39079,2283,12832,2132,51911,3893,2682,1538,8804,3528
TGGACGAGTCCAGACT,sample,124651,122168,17598,104570,9616,94954,39930,2803,29351,3118,69281,19752,7926,1700,12531,5364
GACGATAATCCAGACT,sample,68976,67894,6198,61696,5158,56538,26322,1803,20490,2505,46812,5418,4001,2017,1628,3245
CGTACGTCTCCAGACT,sample,235692,229184,42106,187078,15142,171936,48735,3338,61471,6573,110206,51819,15133,3161,13448,7840
AGTCCGCATCCAGACT,sample,124941,123024,12453,110571,13851,96720,63366,3338,17328,1761,80694,10927,5533,1655,20821,9913
TTGGTACCTCCAGACT,sample,81614,79923,11188,68735,5907,62828,31776,2000,16714,2097,48490,10241,6954,2564,4180,3109
GTTAGGACTCCAGACT,Pos_Ctrl,58643,55917,8771,47146,2151,44995,37581,3260,2938,375,40519,841,5977,6781,2698,868
GCCTGAACTCCAGACT,sample,4528,3731,1023,2708,208,2500,681,84,911,72,1592,752,786,218,119,41
AACTCGTATCCAGACT,sample,43498,42876,4055,38821,3854,34967,25589,1992,4411,533,30000,2442,2903,1661,6554,2615
CGTATGAATCCAGACT,sample,146630,143532,21363,122169,10163,112006,56362,4481,29827,3315,86189,18021,7915,2365,14967,5701
TTGGCCTCTCCAGACT,Pos_Ctrl,59084,57216,8128,49088,2234,46854,39679,3386,2668,372,42347,749,6054,7004,2845,960
GAAGGCGCTCCAGACT,sample,45763,44495,8824,35671,2244,33427,11421,787,11220,1222,22641,8777,6013,1188,2859,1133
TTGGTTAATCCAGACT,sample,100787,99610,8153,91457,10334,81123,61259,3785,8952,892,70211,6235,4516,2313,12447,7203
GTACCGTATCCAGACT,sample,88296,87103,8469,78634,8749,69885,45126,2687,12455,1465,57581,8152,3965,1459,13297,5751
GGCATATATCCAGACT,sample,44489,43768,4845,38923,4632,34291,20294,1323,7210,814,27504,4650,3386,1090,6911,2853
TCGCCTGATCCAGACT,sample,15314,15008,1311,13697,1424,12273,10567,610,696,174,11263,226,839,852,3049,1048
ATTCTCTTACCATTAT,sample,209141,207058,11546,195512,19519,175993,101269,6998,51227,5796,152496,10703,3901,2142,21795,11844
TCCAACTTACCATTAT,sample,202114,200048,11575,188473,14215,174258,97970,6236,52049,7263,150019,10740,4065,2472,13871,10072
AAGTTCGTACCATTAT,sample,257665,255073,18358,236715,35761,200954,136199,10173,33065,4805,169264,16712,5235,2009,53978,26144
GGTTGCGTACCATTAT,sample,300052,296990,17772,279218,23640,255578,151092,11412,65662,8599,216754,18813,4640,2656,32153,15896
TCCTCCGTACCATTAT,sample,380765,375329,44676,330653,28759,301894,146446,8219,81651,7963,228097,57615,12421,3057,47879,17026
ACGTAAGTACCATTAT,sample,187185,184930,13509,171421,20363,151058,106278,5918,24618,3801,130896,10443,4505,1968,48273,14697
TTCGTAATACCATTAT,sample,36030,35612,1936,33676,4547,29129,22445,1756,3234,418,25679,1276,2997,2557,3783,3026
ACGTTATGACCATTAT,sample,186544,184233,12939,171294,17558,153736,122042,8387,13952,1567,135994,7788,4536,2451,32433,13205
TAGTACGGACCATTAT,sample,262813,260297,14500,245797,21897,223900,162394,10074,36957,5035,199351,9440,4579,2938,38685,15628
CATAACCTACCATTAT,sample,201441,199220,13065,186155,26955,159200,118727,8095,22401,2675,141128,7302,4186,2211,38197,18753
GACGGAGAACCATTAT,sample,542756,537880,25409,512471,50776,461695,363030,21953,58301,4962,421331,13449,4627,1919,120848,36704
TGGACGAGACCATTAT,sample,294440,291119,21305,269814,30251,239563,175748,9723,33651,3495,209399,16946,4761,2213,63367,21440
CCATGAAGACCATTAT,sample,501946,498168,23565,474603,56695,417908,320647,29509,44853,7780,365500,15119,3250,1809,115947,42459
CGTACGTCACCATTAT,sample,554399,547843,48134,499709,53209,446500,275534,19282,87877,9291,363411,54516,10888,3644,55884,37104
CGGATTACACCATTAT,sample,402676,399767,17216,382551,56640,325911,273421,20481,26571,2861,299992,2577,1750,1544,105402,43639
GCCTGAACACCATTAT,sample,428941,423328,43272,380056,41298,338758,175646,12095,84099,9228,259745,57690,11399,2952,52468,26931
AATATATCACCATTAT,sample,810258,798267,122180,676087,60824,615263,137014,13322,241777,24047,378791,199103,21629,6737,26899,31009
ACCAATGCACCATTAT,sample,496333,492165,30640,461525,46437,415088,242899,21070,95593,9975,338492,45551,6845,2272,52431,29097
TGCTTCGCACCATTAT,sample,533898,530210,27409,502801,55193,447608,318784,31136,62361,6986,381145,28341,7273,3084,58204,37778
CCAATTCCACCATTAT,sample,342564,339547,15806,323741,45622,278119,228802,17380,26596,2224,255398,3117,1791,1615,67602,34319
GTACCGTAACCATTAT,sample,223123,220974,11616,209358,23311,186047,152846,9598,15861,1864,168707,5878,4272,3369,29550,17655
TTATTCGAACCATTAT,sample,219834,217824,12997,204827,19381,185446,121849,7787,36562,6330,158411,12918,4762,2111,31044,12109
GACCGGAAACCATTAT,sample,210562,209095,11639,197456,26668,170788,126581,9455,21709,3008,148290,10035,5430,2570,28951,19503
TCCAACTTCAATGGAT,sample,108653,106959,12752,94207,12312,81895,43095,2904,21922,1736,65017,12238,5624,1504,10197,8517
AAGTTCGTCAATGGAT,sample,245267,243301,13168,230133,32199,197934,163353,7839,18155,1826,181508,6761,2335,1627,70488,23633
GGTTGCGTCAATGGAT,sample,286316,283661,14128,269533,41983,227550,191140,14804,17230,1521,208370,2855,2079,2009,62745,32084
ATGCCTGGCAATGGAT,sample,76876,75822,6624,69198,8068,61130,46819,2562,7511,751,54330,3487,3613,1708,19647,5428
TAGTACGGCAATGGAT,sample,83157,81315,11525,69790,7266,62524,36668,2521,12762,1381,49430,9192,5404,1846,11387,4476
TTAGAAGTCAATGGAT,sample,169869,167132,18614,148518,11625,136893,65632,5034,44283,4649,109915,17295,6813,2449,17529,6680
GCCTTGCTCAATGGAT,sample,470122,465243,30742,434501,36295,398206,256303,15458,81428,9894,337731,35123,6787,2361,50368,23454
CATAACCTCAATGGAT,sample,365174,359941,25426,334515,30973,303542,220981,14826,42861,4339,263842,20535,7667,3738,48459,20549
GTTAGCCGCAATGGAT,sample,525655,519683,44257,475426,58280,417146,268241,19390,76737,7598,344978,45180,9091,3179,86591,40963
GGACGTAGCAATGGAT,sample,396449,390966,34354,356612,31385,325227,209232,13464,59549,5793,268781,37189,10344,3252,51453,21302
ACCTCGAGCAATGGAT,sample,112775,111401,8911,102490,11612,90878,65312,4131,12434,1421,77746,7580,4409,1786,18194,8360
GGCCAGAGCAATGGAT,sample,427621,422574,26704,395870,47712,348158,268231,15123,39856,6433,308087,18515,5539,2123,102479,38958
ACGACTTCCAATGGAT,sample,335726,332510,18262,314248,41271,272977,211173,17649,27988,2973,239161,13194,3617,1898,76932,29208
CATGATTCCAATGGAT,sample,226468,223701,16932,206769,22048,184721,108166,6184,47270,5953,155436,17148,5984,1947,29100,15202
CGTACGTCCAATGGAT,sample,350769,347995,16558,331437,55321,276116,231705,14292,24164,3170,255869,2785,1944,1732,74252,40423
CGGATTACCAATGGAT,sample,236752,234316,17465,216851,39560,177291,117173,9244,31585,3624,148758,15665,6609,2490,20206,26026
GCCTGAACCAATGGAT,Neg_Ctrl,3246,2170,1035,1135,132,1003,645,42,214,23,859,79,504,317,163,62
AATATATCCAATGGAT,Neg_Ctrl,2993,2163,1040,1123,120,1003,612,59,177,26,789,129,496,298,136,84
ACCAATGCCAATGGAT,sample,275573,273451,14912,258539,30098,228441,175220,13957,26663,2928,201883,9673,5219,3016,35682,20422
AAGAGCGCCAATGGAT,sample,158299,156850,13678,143172,12393,130779,70125,4626,33908,4333,104033,17787,7015,2328,13686,6970
GTCTTAGCCAATGGAT,sample,214678,213296,8510,204786,29460,175326,135021,10888,19189,3409,154210,6819,3723,1843,32390,20425
CCAATTCCCAATGGAT,sample,301365,299485,12044,287441,42542,244899,196624,17078,19353,1837,215977,10007,5188,2627,37881,30073
GTACCGTACAATGGAT,sample,181804,180712,7876,172836,16611,156225,100299,9312,34380,4250,134679,7984,3615,2473,24608,12326
GGCATATACAATGGAT,sample,236883,235550,9585,225965,30183,195782,163815,12678,11623,1741,175438,5925,3250,2559,34496,22965
TCAATATACAATGGAT,sample,216130,214768,12759,202009,21970,180039,105739,9495,42006,5528,147745,17271,6311,2164,20057,14547
CTTCATGACAATGGAT,sample,227933,224438,21621,202817,23633,179184,121237,6085,30566,4118,151803,17178,5114,1785,43407,15141
AGGTCGGACAATGGAT,Pos_Ctrl,98320,94501,13992,80509,3704,76805,64418,5694,4633,540,69051,1520,6964,8635,4841,1712
GACCGGAACAATGGAT,sample,135880,134745,7005,127740,13188,114552,71377,3415,28580,3605,99957,7575,3327,1574,16863,9301
TATCAGTTAGATTCAT,sample,245054,241676,22376,219300,18933,200367,130956,7810,34353,3418,165309,23830,7923,2432,37323,11981
ACGTAAGTAGATTCAT,sample,152469,150532,11083,139449,12228,127221,64955,3745,40364,4181,105319,13976,4630,1992,9293,6539
CCTCTAGAAGATTCAT,sample,189967,188177,9669,178508,22589,155919,133646,7006,11628,1417,145274,2222,1519,1402,56506,18507
TAGTACGGAGATTCAT,sample,262677,260197,18843,241354,34566,206788,148483,8626,31138,4113,179621,14428,6013,2127,55669,25910
CAACCGCGAGATTCAT,sample,149972,148426,7060,141366,15467,125899,101728,7349,12298,1888,114026,2636,2497,2368,28649,11658
AATGGTAAAGATTCAT,sample,188667,185058,25455,159603,17839,141764,57175,4175,44907,5058,102082,30449,8992,2251,14526,10221
CAAGGCCTAGATTCAT,sample,680212,664929,119402,545527,41686,503841,155255,9483,177088,18217,332343,143798,21172,5762,56795,22269
CCAGAGCGAGATTCAT,sample,313075,309070,29971,279099,22163,256936,157489,9307,50758,5143,208247,34239,9335,2007,56368,12923
GGAGGACGAGATTCAT,sample,347063,343321,25409,317912,18560,299352,167208,10071,81662,9063,248870,31348,8260,2450,38194,9878
CGAGGCAGAGATTCAT,sample,262898,261104,12677,248427,18465,229962,133015,10067,64998,7192,198013,14690,4857,1994,29803,11268
CATGATTCAGATTCAT,sample,447249,444467,24268,420199,50631,369568,272257,23425,44780,9254,317037,19852,6165,2291,80863,35035
GTCCTGCCAGATTCAT,sample,277266,275364,15536,259828,28772,231056,152796,10150,45943,6090,198739,16077,5812,2315,35769,20563
AACTCGTAAGATTCAT,sample,358005,355303,23031,332272,37723,294549,188639,17287,50315,5570,238954,32738,9463,2816,39835,22650
ACCAATGCAGATTCAT,sample,396780,393373,21070,372303,43420,328883,219914,19715,64757,5062,284671,19435,5051,1900,67084,30158
GAAGGCGCAGATTCAT,sample,308597,306414,14233,292181,38507,253674,206446,18102,20043,1766,226489,7317,3096,2249,44177,28157
AAGAGCGCAGATTCAT,sample,290893,289022,12818,276204,43318,232886,195486,12835,19639,1251,215125,3675,2160,1608,56723,31649
TTGGTTAAAGATTCAT,sample,346964,344506,20890,323616,47152,276464,205520,15558,33779,5040,239299,16567,5540,1836,64112,32733
TCAATATAAGATTCAT,sample,326562,323728,17220,306508,34983,271525,197278,16660,40071,3643,237349,13873,5520,1919,57340,25278
GGAGAGTTCAATCTTG,sample,24153,24033,1126,22907,3203,19704,12122,1155,4606,604,16728,1217,2848,2086,1134,2135
AAGTTCGTCAATCTTG,sample,173443,172259,6800,165459,21646,143813,126236,8294,6261,1024,132497,1998,1504,1592,41573,17200
TTCGTAATCAATCTTG,sample,180303,178364,19055,159309,16494,142815,68922,5175,38549,3682,107471,26487,8966,2067,18920,10082
ACGTTATGCAATCTTG,sample,78036,77424,3502,73922,10760,63162,50554,4209,5454,1050,56008,1895,3062,2490,8777,7320
TTAGAAGTCAATCTTG,sample,293616,291677,13128,278549,39027,239522,183136,12859,27521,2449,210657,13557,5920,2647,50712,28527
CAAGGCCTCAATCTTG,sample,299262,296145,23514,272631,31698,240933,134312,10117,63517,8613,197829,24374,7429,2188,28782,20961
CATAACCTCAATCTTG,sample,361388,357746,21490,336256,41672,294584,217643,13313,40927,5640,258570,17061,4416,1960,81060,28987
GGACGTAGCAATCTTG,sample,247669,245336,19135,226201,27828,198373,138348,9279,29197,3355,167545,18194,7217,2552,33228,16802
ACCTCGAGCAATCTTG,sample,132561,131245,8848,122397,9505,112892,65919,4189,29032,3238,94951,10514,4343,1829,14809,6547
TGGACGAGCAATCTTG,sample,133407,131513,11128,120385,15668,104717,70753,4221,17669,1956,88422,10118,5611,2508,16706,9686
AATATATCCAATCTTG,sample,247801,245691,11426,234265,43452,190813,149666,12523,19584,2958,169250,6082,2996,2156,37595,31121
GAAGGCGCCAATCTTG,sample,337116,332758,40257,292501,29728,262773,117439,10907,70367,7497,187806,56563,11757,2786,21532,16134
TTGGTTAACAATCTTG,sample,194892,192133,24997,167136,21435,145701,64304,5492,43354,3707,107658,28844,8330,1670,13357,13185
GGCATATACAATCTTG,sample,125628,123290,16208,107082,11748,95334,47206,3503,25033,2607,72239,16985,7701,1668,15111,7016
CTTCATGACAATCTTG,sample,184499,181101,15963,165138,13016,152122,105531,6196,24641,3439,130172,12315,5343,1455,36959,8792
AGGTCGGACAATCTTG,sample,379825,375274,30367,344907,30533,314374,217622,15033,47060,5438,264682,29221,4840,2188,45740,22069
TTATTCGACAATCTTG,Neg_Ctrl,3108,2431,1304,1127,134,993,552,47,240,18,792,136,463,249,148,88
GGTTGCGTCGTTCCGA,sample,265992,259211,42078,217133,22571,194562,80851,6713,55425,6440,136276,45133,9152,2062,29443,12918
TCCTCCGTCGTTCCGA,sample,165396,163845,9014,154831,20509,134322,109893,6472,10998,1173,120891,5786,3574,2382,30956,14197
TTCGTAATCGTTCCGA,sample,66584,65357,10304,55053,6221,48832,23912,1739,12918,1543,36830,8720,5014,1362,8168,3403
ACGTTATGCGTTCCGA,sample,44408,43856,6420,37436,4469,32967,16389,1375,8388,955,24777,5860,5915,2782,3672,2848
TTCCGTCTCGTTCCGA,sample,388737,385452,23230,362222,47559,314663,212087,14953,61179,6790,273266,19654,6109,2820,50638,34487
GCCTTGCTCGTTCCGA,sample,201178,199263,11747,187516,28915,158601,114330,7793,25136,3827,139466,7515,4100,2125,36096,19571
ACTATACTCGTTCCGA,sample,364109,359528,42104,317424,35228,282196,150924,11016,68746,6768,219670,44742,10985,3319,39986,20318
GACGGAGACGTTCCGA,sample,194988,191376,27799,163577,16960,146617,66620,5035,41196,4204,107816,29562,9322,2269,21734,9662
GTTAGCCGCGTTCCGA,sample,346168,342327,30286,312041,39579,272462,189909,13353,41244,5126,231153,22830,8658,3454,41015,25829
GACGATAACGTTCCGA,sample,369335,364175,44252,319923,29795,290128,147838,9326,77744,7642,225582,47578,10686,2611,47493,17030
GGCCAGAGCGTTCCGA,sample,271540,267451,28549,238902,26562,212340,93469,5360,62080,7466,155549,43965,10800,2974,28082,17985
CCATGAAGCGTTCCGA,sample,388976,386038,15247,370791,52313,318478,270621,14021,25604,1536,296225,6696,1758,1480,106635,38344
AATCCGTCCGTTCCGA,sample,341345,338480,17180,321300,27251,294049,190933,12194,64862,7969,255795,18091,4446,2232,40597,18025
TTGGTACCCGTTCCGA,sample,434723,431787,23686,408101,52519,355582,227158,20425,72050,10626,299208,25323,7549,2389,41871,37087
GTACCGTACGTTCCGA,sample,46410,46087,1590,44497,6868,37629,29205,3022,3786,505,32991,1111,1854,1402,6268,4346
GGAGAGTTCAATTCGG,sample,182425,180470,18903,161567,27799,133768,76293,4391,28242,3254,104535,21588,6230,1766,30910,17924
TATCAGTTCAATTCGG,sample,325764,323106,15354,307752,38774,268978,228255,12728,20499,4595,248754,2901,1915,1712,88895,30529
ATTCTCTTCAATTCGG,Pos_Ctrl,197305,191163,24941,166222,8615,157607,132306,11725,9409,1175,141715,2992,8122,11476,11216,4381
GGTTGCGTCAATTCGG,sample,229073,226413,17308,209105,30504,178601,111878,8454,36982,3539,148860,17748,6883,2465,20392,19985
TCCTCCGTCAATTCGG,sample,405481,401873,18827,383046,39243,343803,293026,21388,20780,2306,313806,6303,3878,3471,65629,30014
CCTCTAGACAATTCGG,sample,174159,172195,9379,162816,16067,146749,94305,6011,33951,3814,128256,8668,4288,2467,21538,11050
TTCGTAATCAATTCGG,sample,394674,391440,19770,371670,46592,325078,270365,15974,27298,2756,297663,8685,1895,1745,106111,40407
ACGTTATGCAATTCGG,Pos_Ctrl,162398,156432,21861,134571,6946,127625,107584,9448,7459,828,115043,2306,7712,10677,8837,3165
TCGCATCTCAATTCGG,sample,347701,344301,18115,326186,43387,282799,225708,15870,26648,3207,252356,11366,4715,2954,60132,32097
GCCTTGCTCAATTCGG,Pos_Ctrl,161102,154573,21940,132633,6632,126001,106061,9250,7473,928,113534,2289,7769,10674,8583,3477
CATAACCTCAATTCGG,sample,263772,260071,21274,238797,32936,205861,140703,11350,32093,2712,172796,19003,7807,3433,39930,22212
CCGCAACGCAATTCGG,Pos_Ctrl,127506,122340,16514,105826,4632,101194,85446,7901,5336,741,90782,1770,7128,9713,5065,1801
TGGACGAGCAATTCGG,sample,128786,126225,12965,113260,11709,101551,67144,4530,17268,1598,84412,11011,6003,2319,16875,7007
CCATGAAGCAATTCGG,Pos_Ctrl,123102,117921,16383,101538,4954,96584,81279,7153,5736,637,87015,1779,7334,9618,6264,2404
ACGACTTCCAATTCGG,sample,94553,93530,9378,84152,7879,76273,40533,3545,20418,2358,60951,9419,5719,2185,10601,4622
CATGATTCCAATTCGG,sample,517209,510100,53928,456172,39342,416830,238341,14897,108413,12520,346754,42659,13242,5598,27110,24634
AATCCGTCCAATTCGG,sample,162377,160354,15328,145026,18857,126169,67350,3838,30896,4115,98246,19970,7290,1748,17382,10812
TTGGTACCCAATTCGG,sample,629498,625523,30135,595388,82436,512952,398159,41000,46775,3884,444934,23134,3940,2534,100078,59194
CGGATTACCAATTCGG,Pos_Ctrl,137469,133389,16053,117336,5479,111857,94921,8784,5592,773,100513,1787,7283,10142,6241,2438
GTTAGGACCAATTCGG,sample,145448,144082,14131,129951,12053,117898,48732,3533,36629,4130,85361,24874,8052,2063,8031,6283
TTGGCCTCCAATTCGG,Pos_Ctrl,120667,118651,11683,106968,4819,102149,86241,8532,5020,638,91261,1718,7072,10176,4941,1848
ACCAATGCCAATTCGG,sample,544116,540451,23647,516804,53546,463258,362583,34309,44026,5772,406609,16568,5340,2661,83316,40627
TGCTTCGCCAATTCGG,sample,201539,200377,6762,193615,23414,170201,130504,9636,20470,1942,150974,7649,3326,1853,14312,15743
AAGAGCGCCAATTCGG,sample,457291,454329,22289,432040,41471,390569,264767,24103,69968,14279,334735,17452,4745,2259,52373,26636
CCAATTCCCAATTCGG,sample,153168,151977,12173,139804,16644,123160,60144,4741,33428,2987,93572,21860,8272,1862,14837,11256
TTGGTTAACAATTCGG,sample,299398,298105,12528,285577,37783,247794,195615,16356,23724,2421,219339,9678,5296,2417,27512,25993
TTATTCGACAATTCGG,sample,286791,282597,24020,258577,29549,229028,151800,12225,35331,3359,187131,26313,7996,2392,34742,17726
GACCGGAACAATTCGG,sample,167916,166831,5316,161515,17842,143673,117882,11107,9606,1353,127488,3725,3568,2708,17993,11910
GGAGAGTTAACTCCGG,sample,2270,2241,173,2068,337,1731,1321,124,178,19,1499,89,609,526,291,224
ATTCTCTTAACTCCGG,sample,88712,87594,6046,81548,9702,71846,56956,3575,7146,870,64102,3299,2270,1743,17514,7328
ACGTAAGTAACTCCGG,sample,65322,64347,6217,58130,4675,53455,27895,1760,15466,2046,43361,6288,4005,1648,7784,2758
CCTCTAGAAACTCCGG,sample,80728,77470,18909,58561,3914,54647,17416,1026,18733,2073,36149,15399,8310,1877,4377,1737
AGTACCATAACTCCGG,sample,80884,79824,4903,74921,8425,66496,55973,2855,6072,506,62045,1090,1099,1124,26100,6297
ACGTTATGAACTCCGG,sample,78130,76635,10832,65803,7016,58787,27643,1740,16086,1708,43729,11610,5584,1283,10819,3979
CAACCGCGAACTCCGG,sample,152832,151044,8075,142969,17644,125325,104350,7798,8943,2690,113293,1544,1419,1271,28896,12707
ACTATACTAACTCCGG,sample,316796,314556,14305,300251,39692,260559,201870,15241,26541,5752,228411,11155,3649,2029,65982,29703
GACGGAGAAACTCCGG,sample,227221,224676,13009,211667,15943,195724,123805,8175,47401,5486,171206,10857,4161,2594,23703,11117
CCGCAACGAACTCCGG,sample,294726,291910,22595,269315,26116,243199,167497,9807,39623,3092,207120,23180,6430,2002,37954,15662
GGCCAGAGAACTCCGG,sample,14692,14283,2406,11877,2362,9515,3809,277,2925,311,6734,2193,2324,624,1208,1384
CGAGGCAGAACTCCGG,sample,42519,41536,6184,35352,3604,31748,12921,698,10532,1290,23453,6307,4551,1287,3087,1965
CCATGAAGAACTCCGG,sample,118573,117401,7518,109883,17363,92520,72887,4065,9282,1222,82169,5064,3285,1720,28054,12952
CATGATTCAACTCCGG,sample,35723,35194,2676,32518,7944,24574,19612,1228,2380,255,21992,1099,2049,1578,6577,5575
AATCCGTCAACTCCGG,sample,99642,98545,6939,91606,12356,79250,62190,3968,8035,1233,70225,3824,3478,2254,22276,8820
GTTAGGACAACTCCGG,sample,26811,26395,1728,24667,5210,19457,16314,958,1446,280,17760,459,1058,1003,7955,3619
CGTATGAAAACTCCGG,sample,221206,218448,18707,199741,13959,185782,87679,5982,60831,6746,148510,24544,7454,2583,11388,7375
TTGGTTAAAACTCCGG,sample,309738,306985,18005,288980,33914,255066,192479,14621,29179,4040,221658,14747,5285,2485,44943,26756
GGCATATAAACTCCGG,sample,495014,487310,61123,426187,22834,403353,164526,11199,156844,20052,321370,50732,14487,4575,13395,11374
CTTCATGAAACTCCGG,sample,260792,257741,18604,239137,26325,212812,145788,10290,33847,5329,179635,17558,6656,2395,38559,17940
AGGTCGGAAACTCCGG,sample,38231,38016,1698,36318,5807,30511,23450,2561,2834,298,26284,1368,1901,1361,5256,4073
GGAGAGTTCCTGAAGG,sample,311733,308458,24628,283830,36133,247697,175241,11000,38511,4105,213752,18840,5932,2053,82908,27568
TCCAACTTCCTGAAGG,Neg_Ctrl,7941,3799,3013,786,73,713,377,19,229,14,606,74,326,156,95,24
AAGTTCGTCCTGAAGG,sample,108937,107395,9651,97744,12657,85087,58131,4203,13634,1461,71765,7658,5390,2529,16385,8312
TCCTCCGTCCTGAAGG,sample,181918,179597,14409,165188,14124,151064,87921,5028,37960,4822,125881,15333,5162,2012,23994,9577
ACGTAAGTCCTGAAGG,sample,203233,200099,17552,182547,14205,168342,100148,6703,39806,5397,139954,16288,5804,2477,20984,9612
TTCTAATGCCTGAAGG,Neg_Ctrl,2425,1649,1355,294,28,266,128,9,98,5,226,26,127,61,36,19
ATGCCTGGCCTGAAGG,sample,113413,110972,17791,93181,11152,82029,42933,2581,20595,1952,63528,13968,6560,1543,18097,7120
TAGTACGGCCTGAAGG,sample,280346,277201,15943,261258,35187,226071,189299,15808,15809,1933,205108,3222,2415,2220,51990,25546
TGAGCGCGCCTGAAGG,sample,164976,162112,16813,145299,17762,127537,80004,5119,25097,2695,105101,14622,6337,1763,32718,12422
GGACCTCTCCTGAAGG,sample,54660,53899,2724,51175,5038,46137,33593,2552,6923,1047,40516,2022,3711,3419,4408,3686
TCGCATCTCCTGAAGG,sample,177940,176098,8984,167114,25577,141537,121218,7978,9232,988,130450,2121,1929,1859,40172,18965
CAAGGCCTCCTGAAGG,Neg_Ctrl,3002,2277,1448,829,76,753,322,22,251,21,573,137,304,144,77,106
GACGGAGACCTGAAGG,sample,154205,152401,8684,143717,17700,126017,105990,6785,10495,730,116485,2017,1968,1632,42892,13647
GTTAGCCGCCTGAAGG,sample,100948,97827,17869,79958,5810,74148,30619,2276,21589,2279,52208,17385,7427,2557,1708,2239
CCGCAACGCCTGAAGG,sample,154816,152252,14616,137636,9231,128405,55057,4111,43233,5058,98290,20946,6112,1986,3940,5136
GGACGTAGCCTGAAGG,Neg_Ctrl,2620,1861,1117,744,85,659,394,28,146,14,540,77,337,203,104,33
ACCTCGAGCCTGAAGG,sample,225316,220638,29482,191156,17408,173748,88131,5440,42872,5070,131003,32235,10488,2577,24088,10424
ACGACTTCCCTGAAGG,Neg_Ctrl,3294,2241,1340,901,99,802,492,25,139,23,631,123,391,223,133,47
AGTCCGCACCTGAAGG,sample,474325,463729,65847,397882,23724,374158,159059,9734,141631,19287,300690,44447,11097,3553,31403,13581
CTAGGACCCCTGAAGG,sample,59802,58863,5470,53393,8695,44698,29984,1731,8225,850,38209,3908,2962,1450,12015,6418
CGGATTACCCTGAAGG,sample,79472,78293,9947,68346,9473,58873,27585,1852,17341,2278,44926,9817,5314,1511,10182,5946
GTTAGGACCCTGAAGG,Neg_Ctrl,1734,1349,690,659,57,602,336,18,142,40,478,66,277,140,100,33
TTGGCCTCCCTGAAGG,sample,238750,236797,11548,225249,32675,192574,165934,10125,11487,2594,177421,2434,1650,1621,46101,25323
AATATATCCCTGAAGG,Neg_Ctrl,2577,2024,1220,804,92,712,423,20,159,13,582,97,361,185,102,59
ACCAATGCCCTGAAGG,sample,158547,155742,21120,134622,16505,118117,61667,5380,27582,3200,89249,20288,7928,1853,15325,10287
TGCTTCGCCCTGAAGG,sample,149371,147555,16849,130706,15026,115680,56881,3867,30306,3040,87187,21586,7973,1727,15774,8583
GTCTTAGCCCTGAAGG,sample,190763,187481,20260,167221,16926,150295,80620,6399,35268,3422,115888,24586,8315,2138,19337,9844
GGCATATACCTGAAGG,sample,204943,201504,24876,176628,12871,163757,94910,6495,34602,3887,129512,23863,8670,3017,11533,6157
TCGCCTGACCTGAAGG,sample,225901,223178,17146,206032,19372,186660,123851,9684,35230,4282,159081,13613,5066,2242,25486,13383
ATTCTCTTAATATTCG,sample,481783,476814,30654,446160,38609,407551,285831,19899,66497,8095,352328,27229,6688,3565,59944,25390
AAGTTCGTAATATTCG,sample,367698,362680,33297,329383,34779,294604,181600,14410,58682,5472,240282,34440,10176,3648,40410,22537
ACGTAAGTAATATTCG,sample,351548,347849,19814,328035,33967,294068,240528,17810,24738,3421,265266,7571,4631,3830,37533,24525
AATGGTAAAATATTCG,sample,399623,396620,19797,376823,55168,321655,257978,19014,31455,5107,289433,8101,3754,2168,96891,40303
TTAGAAGTAATATTCG,sample,241955,238047,26951,211096,19865,191231,100540,8492,45750,5107,146290,31342,9185,3086,9114,12334
GGACCTCTAATATTCG,sample,383922,379058,30443,348615,15752,332863,139443,9699,127321,16547,266764,39853,8015,2636,10158,8088
TCGCATCTAATATTCG,sample,298393,294757,21328,273429,28765,244664,168460,15457,36492,4182,204952,20073,7342,2973,43492,18472
ACTATACTAATATTCG,sample,246573,243765,19543,224222,18282,205940,111497,7948,57219,7338,168716,21938,7102,2539,18589,12294
GACGGAGAAATATTCG,sample,166442,164947,7882,157065,31727,125338,96181,6295,15157,1785,111338,5920,4024,2442,26042,21909
GGAGGACGAATATTCG,sample,168922,167656,9018,158638,24414,134224,108405,6093,12254,1390,120659,6082,3655,2185,32474,17798
CTTGATAGAATATTCG,sample,341894,338740,16897,321843,35886,285957,238751,17004,21683,3429,260434,5090,2491,2273,62893,26594
GACGATAAAATATTCG,sample,214248,210975,20590,190385,18524,171861,92952,6289,43856,5522,136808,23242,7302,2459,25261,11858
CGAGGCAGAATATTCG,sample,334849,330681,35463,295218,25457,269761,128885,9976,75272,7880,204157,47748,11161,2920,30079,17426
ACGACTTCAATATTCG,sample,321895,318458,25768,292690,24047,268643,140089,10612,77284,7464,217373,33194,9029,3128,20277,14103
AATCCGTCAATATTCG,sample,319636,315881,28690,287191,33034,254157,163450,11122,42411,5072,205861,32102,8917,3017,34646,21527
CGTACGTCAATATTCG,sample,137643,136170,8800,127370,15160,112210,89160,6234,9894,1559,99054,5363,5423,4295,10603,10671
CGGATTACAATATTCG,sample,251651,249307,11743,237564,40860,196704,169897,10092,12280,716,182177,3719,2204,2419,49465,30076
AACTCGTAAATATTCG,sample,146241,144591,8124,136467,12312,124155,90588,6529,19021,2443,109609,5574,4250,2923,13502,8926
CGTATGAAAATATTCG,sample,310954,308609,14128,294481,43437,251044,207331,15930,18382,2828,225713,6573,3526,2452,53593,33288
TGCTTCGCAATATTCG,sample,108455,107439,7539,99900,8260,91640,47791,4286,24885,3338,72676,11340,5239,2195,7962,5122
AAGAGCGCAATATTCG,sample,185309,183055,15167,167888,20897,146991,90614,8245,26665,4017,117279,17450,7478,2960,18445,14655
CCAATTCCAATATTCG,sample,148800,147343,8695,138648,12643,126005,83738,4575,25151,3704,108889,8837,4350,2069,16466,7988
GTACCGTAAATATTCG,Pos_Ctrl,117356,112507,15686,96821,4244,92577,77767,6624,5616,761,83383,1809,7236,9381,5714,1981
TCAATATAAATATTCG,sample,285305,280563,34206,246357,20993,225364,99466,7965,61704,6530,161170,49699,11756,2714,34360,12642
TTATTCGAAATATTCG,sample,111356,109504,13319,96185,8605,87580,37911,2396,27772,3408,65683,16093,6310,1654,8605,4510
TATCAGTTAGTCTCCG,sample,138960,137800,8438,129362,19351,110011,75553,5417,17433,2064,92986,9544,6438,3112,20588,13861
AAGTTCGTAGTCTCCG,sample,40813,40250,3709,36541,5287,31254,19064,1052,6446,814,25510,3878,3404,1284,5667,3594
GGTTGCGTAGTCTCCG,sample,294270,291209,18234,272975,26757,246218,150152,9273,59854,7922,210006,19017,6382,2814,27554,17579
ACGTAAGTAGTCTCCG,sample,150335,148948,7192,141756,25916,115840,94823,5907,10311,1938,105134,2861,3479,3022,20138,18534
TAGTACGGAGTCTCCG,sample,316543,314215,18299,295916,41449,254467,199143,13883,27907,2622,227050,10912,4369,2634,43864,30408
TGAGCGCGAGTCTCCG,sample,27141,26612,3221,23391,10567,12824,4284,397,4571,371,8855,3201,2771,542,1332,4879
TTAGAAGTAGTCTCCG,sample,298548,295319,22149,273170,31421,241749,152423,10064,50775,5672,203198,22815,7758,2518,50316,22966
TTCCGTCTAGTCTCCG,sample,383895,380939,27052,353887,43522,310365,198661,15141,60771,6308,259432,29484,9902,3031,49764,31005
CAAGGCCTAGTCTCCG,sample,254269,252135,13686,238449,21319,217130,135899,9774,51649,7420,187548,12388,4373,2282,34004,14048
CATAACCTAGTCTCCG,sample,351519,347721,14861,332860,48643,284217,240097,17733,20016,2612,260113,3759,1653,1602,87852,37090
GACGGAGAAGTCTCCG,sample,172532,170033,11830,158203,19430,138773,93129,7736,22856,2221,115985,12831,6159,1876,22864,11518
CCAGAGCGAGTCTCCG,sample,148651,147270,15335,131935,8966,122969,35085,2718,45269,4630,80354,35267,11009,2225,3245,3971
GGAGGACGAGTCTCCG,sample,165862,164687,5524,159163,20959,138204,113989,8219,11591,1921,125580,2484,1242,1128,44681,14663
CATTGCAGAGTCTCCG,sample,58767,58193,3172,55021,11801,43220,33718,2278,4944,828,38662,1452,2434,1738,11576,8185
CCATGAAGAGTCTCCG,sample,302809,300230,14958,285272,30293,254979,198356,12907,27251,2643,225607,13822,4743,2279,52624,23662
ACGACTTCAGTCTCCG,sample,212994,210798,12887,197911,15944,181967,104564,7523,45838,5906,150402,18136,5954,2197,17818,10335
AGTCCGCAAGTCTCCG,sample,224246,222228,13181,209047,22294,186753,126355,8953,36428,4977,162783,10040,3583,1819,41763,15407
GTCCTGCCAGTCTCCG,sample,184903,182889,14192,168697,23388,145309,91911,7868,26595,3834,118506,15101,6977,2864,21805,15562
TTGGTACCAGTCTCCG,sample,583065,574878,82027,492851,41501,451350,184094,12628,138320,15986,322414,100322,17833,4729,53824,26719
ACGTATTAAGTCTCCG,sample,152947,151721,7298,144423,22997,121426,84568,7483,19918,2563,104486,6894,4044,1916,22361,16611
CGTATGAAAGTCTCCG,sample,316125,312933,23846,289087,38823,250264,173804,11709,40531,3343,214335,20877,5991,2380,50526,26653
ACCAATGCAGTCTCCG,sample,359315,355112,26448,328664,35223,293441,204928,17721,40392,4341,245320,26059,8336,2429,43806,23856
TGCTTCGCAGTCTCCG,sample,242531,239933,20867,219066,19680,199386,123518,11435,37450,3614,160968,23369,9049,2635,27037,13079
CCAATTCCAGTCTCCG,sample,251172,247978,19440,228538,22603,205935,125674,12191,43103,5518,168777,19449,6161,2157,32775,16104
TTGGTTAAAGTCTCCG,sample,180127,178654,7949,170705,22466,148239,126079,9237,9630,1410,135709,1883,1479,1517,43473,16854
TCGCCTGAAGTCTCCG,sample,218705,216451,13305,203146,23071,180075,136361,9718,20916,3445,157277,9635,3945,2369,25151,18583
CTTCATGAAGTCTCCG,sample,121134,119505,10282,109223,13237,95986,54359,4468,22195,2865,76554,12099,5841,1620,9522,8350
TTATTCGAAGTCTCCG,sample,198448,196736,10448,186288,26125,160163,137809,9371,8892,1160,146701,2931,2310,2236,34950,19940
GACCGGAAAGTCTCCG,sample,76005,75532,3271,72261,11137,61124,49691,4051,5170,631,54861,1581,1269,1198,16358,8196
GGAGAGTTTGCCTACG,sample,317,309,35,274,38,236,163,15,35,7,198,16,127,78,48,26
ATTCTCTTTGCCTACG,sample,94804,93791,7689,86102,5782,80320,43476,2598,23741,2958,67217,7547,4573,2052,10985,3678
TCCAACTTTGCCTACG,sample,189336,186285,27654,158631,12237,146394,47297,3196,49666,5487,96963,40748,12520,2720,14708,6251
GGTTGCGTTGCCTACG,sample,71698,70856,4760,66096,5705,60391,36331,2069,14889,1913,51220,5189,3080,1751,10160,3641
CCTCTAGATGCCTACG,sample,60477,59798,3057,56741,9799,46942,38264,2736,4001,461,42265,1480,2687,2285,10757,7153
TAGTACGGTGCCTACG,sample,96744,95372,7360,88012,6537,81475,45741,2682,23507,2730,69248,6815,4074,1889,7221,4130
TTAGAAGTTGCCTACG,sample,177151,174888,16008,158880,13987,144893,82162,4671,40625,4814,122787,12621,5401,2422,19925,9287
GACGGAGATGCCTACG,sample,123833,122639,9068,113571,9875,103696,56090,3512,29490,3811,85580,10793,4154,1841,13771,6916
GGCCAGAGTGCCTACG,sample,89687,88464,6213,82251,5024,77227,43982,2630,22333,3184,66315,5098,3422,1939,7893,3212
CCATGAAGTGCCTACG,sample,111803,110771,5562,105209,15780,89429,75050,4757,7824,947,82874,851,1428,1383,21684,11402
CGTACGTCTGCCTACG,sample,123390,121964,7009,114955,7681,107274,68931,4748,25127,3201,94058,5267,3184,1977,15388,5277
AGTCCGCATGCCTACG,sample,59321,58591,5061,53530,4096,49434,23810,2035,15899,2366,39709,5324,3863,1656,5202,2763
GTCCTGCCTGCCTACG,sample,66057,65331,4086,61245,5193,56052,37951,2723,11079,1444,49030,2855,3012,1931,7246,3307
CGGATTACTGCCTACG,sample,112359,110700,11926,98774,9796,88978,50300,3160,20233,2436,70533,12849,6077,1302,18758,6495
CGTATGAATGCCTACG,sample,106717,105167,14956,90211,9034,81177,29596,2018,27070,3212,56666,19281,7635,1366,8065,4862
AATATATCTGCCTACG,sample,119174,117605,12837,104768,12160,92608,55855,3833,18699,2142,74554,12079,6098,1798,14018,7519
GAAGGCGCTGCCTACG,sample,107381,106129,8954,97175,9512,87663,56649,3412,14905,2032,71554,10665,5608,2088,11767,6136
CCAATTCCTGCCTACG,sample,99108,98314,4980,93334,12395,80939,68059,5843,4755,642,72814,1640,1179,1334,14144,8911
GGCATATATGCCTACG,Neg_Ctrl,762,544,301,243,21,222,123,9,62,2,185,26,134,69,32,19
TCGCCTGATGCCTACG,sample,116692,114430,17966,96464,8212,88252,26748,1752,31773,3148,58521,24831,9452,1727,7972,4465
ATGACCGATGCCTACG,sample,20021,19895,1012,18883,2982,15901,11733,1041,2145,173,13878,809,1609,1106,3194,1993
ACGTAAGTCTTAGTTC,sample,190941,188124,22487,165637,19584,146053,66241,4121,43701,5427,109942,26563,8174,2018,21080,11260
ACGTTATGCTTAGTTC,sample,127336,125623,9281,116342,13346,102996,64172,4364,23091,2896,87263,8473,3475,1903,20992,10237
CATAACCTCTTAGTTC,sample,85632,84847,4189,80658,18010,62648,45876,3951,9064,1239,54940,2518,3096,2421,10416,12748
GGAGGACGCTTAGTTC,sample,294388,291949,13949,278000,33604,244396,195292,19503,17539,5907,212831,6155,2300,1547,46425,23755
GGACGTAGCTTAGTTC,sample,255713,253033,15676,237357,26632,210725,160424,11984,23159,2540,183583,12618,4797,2405,39709,21767
CTTGATAGCTTAGTTC,sample,88775,87956,3655,84301,20986,63315,45508,3844,10776,1108,56284,2079,1876,1563,12542,14676
CCATGAAGCTTAGTTC,sample,210518,208659,12170,196489,22305,174184,124772,7548,25750,3650,150522,12464,5779,2209,20017,16216
CATGATTCCTTAGTTC,sample,363438,360236,23742,336494,36128,300366,175940,13175,72378,9395,248318,29478,6547,2061,54770,23548
TTGGTACCCTTAGTTC,sample,236766,233790,20552,213238,23632,189606,116349,8738,39406,3561,155755,21552,7351,1974,28367,15775
CGTATGAACTTAGTTC,sample,409673,406747,18289,388458,50338,338120,290657,20579,20983,1592,311640,4309,1686,1584,81397,39965
TTGGCCTCCTTAGTTC,sample,229124,227442,19561,207881,23172,184709,81132,7554,56398,7027,137530,32598,9095,2139,17850,13686
AATATATCCTTAGTTC,sample,224005,221044,25637,195407,21948,173459,82083,7594,43583,4702,125666,35497,8897,2261,25565,13321
GTACCGTACTTAGTTC,sample,164764,161245,25455,135790,12539,123251,42756,4026,39205,4635,81961,32629,9078,1573,7421,6667
TTATTCGACTTAGTTC,sample,195406,193294,16482,176812,13209,163603,87075,6442,42189,5013,129264,22884,6842,2406,15557,7640
TATCAGTTCGAGCTTC,sample,299421,296847,13092,283755,26600,257155,187090,13079,40706,6563,227796,9717,4624,4314,27196,17023
TCCTCCGTCGAGCTTC,sample,171958,169506,11999,157507,20965,136542,96009,6375,19632,2074,115641,12452,6540,2749,29527,15374
CCTCTAGACGAGCTTC,sample,57524,56744,4301,52443,5108,47335,26758,2136,12709,1861,39467,3871,4040,2339,5385,3114
TGAGCGCGCGAGCTTC,sample,29798,29101,3895,25206,3568,21638,12276,931,4830,540,17106,3061,3773,1958,2637,2142
TTAGAAGTCGAGCTTC,sample,184747,181930,16059,165871,25503,140368,88514,6779,25060,2705,113574,17310,7492,2241,23927,16156
CAAGGCCTCGAGCTTC,sample,315317,312361,18620,293741,47747,245994,207711,12930,17558,2732,225269,5063,1709,1673,85750,35693
CCAGAGCGCGAGCTTC,sample,329314,326709,15835,310874,41738,269136,204726,19753,29136,2238,233862,13283,4522,2043,51815,29954
GGAGGACGCGAGCTTC,sample,296802,294504,13098,281406,31091,250315,208154,16293,17467,1707,225621,6694,2848,2095,43749,23930
CCGCAACGCGAGCTTC,sample,310770,307157,24590,282567,25166,257401,146482,9516,64584,8864,211066,27955,7428,2168,35863,16653
TGGACGAGCGAGCTTC,sample,391331,388276,20781,367495,46851,320644,249759,15792,35040,3339,284799,16714,3949,2098,86427,33731
CATTGCAGCGAGCTTC,sample,161822,159927,9488,150439,21751,128688,98711,7025,15549,1506,114260,5897,3821,2448,25336,15494
CATGATTCCGAGCTTC,sample,397706,394185,18913,375272,41521,333751,269486,22625,30202,2188,299688,9250,4412,2673,60461,30070
CGTACGTCCGAGCTTC,sample,273276,268510,29197,239313,25121,214192,119779,7995,46470,4791,166249,35157,10144,2749,18273,15271
CGGATTACCGAGCTTC,sample,319584,312132,39797,272335,16224,256111,83260,6825,92088,10580,175348,63358,14624,4414,4023,8938
CGTATGAACGAGCTTC,sample,417353,412608,26886,385722,51630,334092,254528,17042,38600,4306,293128,19616,5655,2757,48087,37151
ACCAATGCCGAGCTTC,sample,476285,472047,20612,451435,46708,404727,350770,31474,16894,1131,367664,4458,2465,3196,63594,36465
TGCTTCGCCGAGCTTC,sample,158300,156837,9437,147400,17916,129484,86205,7704,22210,2208,108415,11157,5785,2034,11394,11381
AAGAGCGCCGAGCTTC,sample,337098,334658,23179,311479,38579,272900,174430,11755,53201,5308,227631,28206,10252,3491,47004,23933
GTACCGTACGAGCTTC,sample,259448,255504,28202,227302,23329,203973,114115,9445,44342,4947,158457,31124,9057,2099,40504,16113
TCGCCTGACGAGCTTC,sample,237284,234738,19133,215605,25243,190362,91109,6662,52542,6531,143651,33518,9439,2373,10890,16808
ATTCTCTTGTAGAATG,Pos_Ctrl,51709,49624,7364,42260,2115,40145,33782,2821,2523,314,36305,705,5793,6192,2766,1035
TCCAACTTGTAGAATG,sample,145321,143010,11446,131564,15181,116383,76349,6470,19202,3340,95551,11022,3875,1962,21591,10113
GGTTGCGTGTAGAATG,sample,68528,67387,5345,62042,4892,57150,31115,2016,15834,2248,46949,5937,3815,1808,5872,3291
ACGTTATGGTAGAATG,sample,47422,46866,2620,44246,7238,37008,28306,2154,4418,595,32724,1535,2294,1733,9676,4996
AATGGTAAGTAGAATG,sample,147402,145687,7543,138144,15298,122846,105538,7559,5403,1201,110941,3145,3684,3998,12148,11338
TTAGAAGTGTAGAATG,sample,44564,43825,5011,38814,5417,33397,18688,1398,8723,875,27411,3713,3435,1353,5375,3353
GGACCTCTGTAGAATG,Pos_Ctrl,98578,92905,14938,77967,4058,73909,61853,5092,4842,628,66695,1494,6956,8340,5249,1943
GTTAGCCGGTAGAATG,sample,113911,112724,6824,105900,36914,68986,54378,4440,6731,616,61109,2821,3134,1964,20294,21682
ACCTCGAGGTAGAATG,sample,20858,20445,2796,17649,1251,16398,7466,449,5004,538,12470,2941,3191,1165,1598,593
CGAGGCAGGTAGAATG,Pos_Ctrl,98189,92344,14320,78024,3664,74360,62487,5335,4589,587,67076,1362,6941,8617,4646,1546
CATGATTCGTAGAATG,sample,159481,157858,8027,149831,14123,135708,85966,5439,33444,3793,119410,7066,3404,2166,18553,8753
ACCAATGCGTAGAATG,Pos_Ctrl,110950,106873,13434,93439,3832,89607,75660,6756,5027,557,80687,1607,6981,9461,4129,1362
TGCTTCGCGTAGAATG,sample,228270,226672,8962,217710,27420,190290,155369,15552,13272,2250,168641,3847,1766,1361,51893,20513
AAGAGCGCGTAGAATG,sample,80372,79684,3441,76243,12697,63546,42840,4620,12147,1243,54987,2696,2600,1203,9254,8699
GGCATATAGTAGAATG,sample,204722,203087,10867,192220,16878,175342,119752,6549,34357,4060,154109,10624,4025,1631,30499,12116
TCAATATAGTAGAATG,sample,178527,177011,8079,168932,21660,147272,111802,9377,17525,1846,129327,6722,3549,2060,24266,15861
TCGCCTGAGTAGAATG,sample,235689,233518,11745,221773,23576,198197,135210,9335,36862,4324,172072,12466,5051,1787,32542,16172
CTTCATGAGTAGAATG,sample,141500,140360,10138,130222,15636,114586,72973,4951,21906,2474,94879,12282,6305,1614,23044,10530
TTATTCGAGTAGAATG,sample,83154,82713,2501,80212,7066,73146,59014,6739,4974,645,63988,1774,3233,3500,3969,4930
TCCAACTTCAATAGTC,sample,80199,79155,7806,71349,10765,60584,36908,2364,12565,1409,49473,7338,4943,1817,13005,6997
AAGTTCGTCAATAGTC,sample,32079,31374,4344,27030,3836,23194,10917,754,6918,879,17835,3726,3226,1062,3618,2219
TCCTCCGTCAATAGTC,sample,140217,138577,9879,128698,14045,114653,87455,5703,13292,1348,100747,6855,4190,2021,25377,9321
TTCGTAATCAATAGTC,sample,154753,151387,26940,124447,13235,111212,37338,2042,39078,4545,76416,28209,9172,1695,9235,7351
TAGTACGGCAATAGTC,sample,120596,118998,7773,111225,11362,99863,63786,4342,22534,2128,86320,7073,3601,1848,18511,7929
TGAGCGCGCAATAGTC,sample,93887,92750,9296,83454,10014,73440,43283,3122,15692,1702,58975,9641,5236,1568,14867,6815
CAACCGCGCAATAGTC,sample,130031,128676,6584,122092,17230,104862,88778,5296,8580,738,97358,1470,1583,1647,30397,13202
TTAGAAGTCAATAGTC,sample,177283,175911,7992,167919,29486,138433,107672,6597,18076,2226,125748,3862,3036,2416,30277,21789
TCGCATCTCAATAGTC,sample,100589,98919,12871,86048,9907,76141,34733,2902,21351,2287,56084,14868,7379,1993,8118,5794
CATAACCTCAATAGTC,sample,210099,206268,23768,182500,17819,164681,108747,6569,26477,3109,135224,19779,8748,3498,29597,9156
GACGGAGACAATAGTC,sample,155265,152598,21116,131482,11084,120398,56175,4025,35739,3927,91914,20532,9352,3414,9191,6320
CCAGAGCGCAATAGTC,sample,150631,149178,9748,139430,17760,121670,86903,5914,18018,2357,104921,8478,4666,2037,31115,12714
CCGCAACGCAATAGTC,sample,235379,230593,30314,200279,16824,183455,77366,5639,54186,5507,131552,40757,12013,2645,21725,9576
ACCTCGAGCAATAGTC,sample,31597,31231,4470,26761,2986,23775,12198,774,6470,698,18668,3635,3492,1837,1110,1476
GGCCAGAGCAATAGTC,sample,49025,48371,3812,44559,5288,39271,26114,1921,7176,810,33290,3250,3422,2110,5820,3738
CATGATTCCAATAGTC,sample,199248,197585,10212,187373,32572,154801,127816,8131,12674,1144,140490,5036,2158,1659,48177,24892
AGTCCGCACAATAGTC,sample,392668,385542,48757,336785,23654,313131,138259,11915,84363,8884,222622,69710,16842,4702,22347,11898
CGGATTACCAATAGTC,sample,221628,220096,8557,211539,25626,185913,155238,12856,12786,1175,168024,3858,3746,3388,26742,18832
GTTAGGACCAATAGTC,sample,248139,246227,11272,234955,26279,208676,173584,13013,14459,1131,188043,6489,3431,2488,37066,18509
GCCTGAACCAATAGTC,sample,200186,198580,11162,187418,18835,168583,122699,9707,22126,2816,144825,11235,4335,2013,26005,13115
ACGTATTACAATAGTC,sample,220925,219597,9630,209967,24957,185010,135592,13781,21559,3796,157151,10282,3782,1786,31985,17168
AACTCGTACAATAGTC,sample,11425,11294,871,10423,1217,9206,5681,402,1989,297,7670,837,1823,1128,1533,853
AAGAGCGCCAATAGTC,sample,70355,69993,2709,67284,7880,59404,44177,4212,7718,933,51895,2364,2876,2230,8524,5506
TTGGTTAACAATAGTC,sample,246808,245586,10257,235329,33941,201388,146433,13109,26555,3682,172988,11609,4687,2129,41490,25092
TCAATATACAATAGTC,sample,319865,317168,35372,281796,24532,257264,107900,10842,77742,7383,185642,53397,13911,3337,25039,15924
TCGCCTGACAATAGTC,sample,146840,146129,5594,140535,13067,127468,100680,8977,10902,1223,111582,5686,4962,2760,14332,9521
TTATTCGACAATAGTC,sample,77481,76996,4375,72621,10483,62138,42817,3244,9749,1009,52566,5319,4312,1423,9590,7276
TATCAGTTCGTTACTC,sample,185576,184810,4709,180101,34491,145610,123534,11434,7982,526,131516,2134,1629,1901,38361,23967
TCCAACTTCGTTACTC,Neg_Ctrl,4774,3174,2341,833,109,724,429,31,168,18,597,78,367,204,105,111
CCTCTAGACGTTACTC,sample,255457,250746,11340,239406,40015,199391,160577,12997,20254,1479,180831,4084,3194,1827,62432,29410
TAGTACGGCGTTACTC,sample,532577,528275,35052,493223,55539,437684,274524,24306,84593,7897,359117,46364,8799,2731,74391,37903
TCGCATCTCGTTACTC,Neg_Ctrl,2800,1921,1160,761,103,658,391,28,136,50,527,53,337,185,87,91
GCCTTGCTCGTTACTC,sample,129636,127920,9742,118178,7944,110234,53491,3869,36228,4988,89719,11658,4921,2275,5040,4651
GACGGAGACGTTACTC,sample,490991,486101,32961,453140,53426,399714,262122,16541,72696,9963,334818,38392,7384,3206,82065,36893
GTTAGCCGCGTTACTC,sample,376234,372750,19485,353265,61034,292231,249449,11769,22371,3237,271820,5405,2804,1982,88432,42373
GGACGTAGCGTTACTC,sample,520444,514388,54447,459941,55519,404422,242259,18656,79324,7827,321583,56356,10163,3470,92503,35063
CTTGATAGCGTTACTC,sample,211400,209042,12295,196747,28821,167926,132508,9584,18355,1713,150863,5766,4125,2981,33570,20889
GACGATAACGTTACTC,sample,320938,315537,44670,270867,36550,234317,100825,6530,70960,7724,171785,48278,11783,2613,25948,21557
CCATGAAGCGTTACTC,Neg_Ctrl,4972,2900,1543,1357,176,1181,761,48,225,36,986,111,522,312,233,64
ACGACTTCCGTTACTC,sample,174067,171524,16779,154745,12363,142382,65470,4852,49053,4670,114523,18337,7325,2739,5609,7503
AATCCGTCCGTTACTC,sample,323996,317621,35396,282225,28463,253762,145674,9438,61271,6106,206945,31273,9559,3667,34728,18930
CGTACGTCCGTTACTC,sample,201126,198533,11746,186787,24227,162560,128162,9050,16889,1679,145051,6780,4411,2773,31221,16386
ACGTATTACGTTACTC,sample,98059,97056,5410,91646,17032,74614,59946,4304,7465,990,67411,1909,3364,2764,19822,12341
AACTCGTACGTTACTC,sample,99537,98492,6222,92270,16296,75974,60335,4723,6441,753,66776,3722,4028,2769,15989,11760
TTGGCCTCCGTTACTC,sample,342024,338451,24663,313788,35479,278309,176375,14175,56961,5614,233336,25184,8694,3100,31597,23823
TGCTTCGCCGTTACTC,Neg_Ctrl,1974,1385,696,689,116,573,325,24,151,16,476,57,292,166,76,53
GAAGGCGCCGTTACTC,sample,61236,60692,3260,57432,11273,46159,35203,2535,5655,538,40858,2228,3216,2361,7535,7916
TTGGTTAACGTTACTC,sample,501741,497753,30091,467662,72320,395342,319147,24912,32458,4095,351605,14730,4863,2785,85244,54122
TTATTCGACGTTACTC,sample,338329,334396,39644,294752,27510,267242,111917,8519,83426,8103,195343,55277,12162,3218,22013,16622
GGAGAGTTTGGACTGC,sample,103799,103209,6207,97002,9453,87549,50419,4036,22588,2957,73007,7549,5164,2538,9554,5892
TATCAGTTTGGACTGC,sample,381957,378048,19183,358865,42679,316186,245537,14432,39110,4298,284647,12809,5131,2597,62157,30511
TGAGCGCGTGGACTGC,sample,173101,171088,10025,161063,14051,147012,112125,8463,18709,2112,130834,5603,5005,4035,16849,9952
TTAGAAGTTGGACTGC,sample,276487,274105,11906,262199,32216,229983,203074,17051,6041,1038,209115,2779,4610,6063,27654,22515
TCGCATCTTGGACTGC,sample,29297,28441,6304,22137,1978,20159,6295,480,7635,861,13930,4888,4002,1047,1972,844
CATAACCTTGGACTGC,sample,285635,282077,18644,263433,22463,240970,150520,11109,56272,6218,206792,16851,5972,2847,26622,15687
CCAGAGCGTGGACTGC,sample,149851,148284,9164,139120,13791,125329,90538,5936,20075,2757,110613,6023,4926,3820,12118,9575
GGAGGACGTGGACTGC,sample,241222,238837,13578,225259,15118,210141,109090,5615,69768,8194,178858,17474,4826,2028,12334,8069
TGGACGAGTGGACTGC,sample,255996,252151,15311,236840,33372,203468,169345,13377,14003,1310,183348,5433,4044,2890,34153,24375
GGCCAGAGTGGACTGC,sample,108184,106804,7872,98932,10233,88699,50734,3544,23751,2725,74485,7945,5369,3036,12126,6927
CATTGCAGTGGACTGC,sample,192357,189959,10555,179404,13493,165911,129418,9152,18318,1329,147736,7694,3999,3507,22590,9208
CCATGAAGTGGACTGC,sample,328819,326135,13778,312357,19013,293344,200071,14960,59293,7547,259364,11473,3707,2627,25732,12789
ACGACTTCTGGACTGC,sample,230716,227852,30213,197639,21886,175753,71600,4178,53642,5874,125242,40459,13100,3488,15045,12109
CATGATTCTGGACTGC,sample,338195,335250,15263,319987,47624,272363,216664,18919,23251,3112,239915,10417,4554,2492,49494,33173
CGTACGTCTGGACTGC,sample,112892,111345,7973,103372,10963,92409,62161,4211,18112,2435,80273,5490,3621,2292,17998,7836
GTCCTGCCTGGACTGC,sample,167212,165555,9340,156215,23520,132695,110759,7354,11028,1009,121787,2545,2392,1943,36982,18272
CGGATTACTGGACTGC,sample,57299,56448,4734,51714,7404,44310,30996,2091,7057,882,38053,3284,4743,3283,5292,5015
GTTAGGACTGGACTGC,sample,36081,35579,3251,32328,5066,27262,18050,1236,4898,800,22948,2278,2545,1259,6662,3287
GCCTGAACTGGACTGC,sample,497843,493952,20382,473570,35735,437835,333486,27337,53200,7354,386686,16458,5167,3197,32104,21585
CGTATGAATGGACTGC,sample,320391,317541,16309,301232,29430,271802,200263,15082,40707,4371,240970,11379,5385,3244,42924,20629
TTGGCCTCTGGACTGC,sample,88975,88187,5609,82578,10185,72393,48460,3626,13701,1693,62161,4913,3629,1994,12383,6949
TGCTTCGCTGGACTGC,sample,77043,76369,4232,72137,8338,63799,40328,2741,14308,2176,54636,4246,3242,1693,9454,5799
GAAGGCGCTGGACTGC,sample,163870,162567,8031,154536,14071,140465,93564,7726,27714,2886,121278,8575,3627,2050,21219,9537
GTCTTAGCTGGACTGC,sample,182150,179820,18653,161167,18180,142987,72962,6627,36013,4336,108975,23049,8174,2076,16544,11496
CCAATTCCTGGACTGC,sample,121082,119863,10293,109570,11763,97807,49529,3356,28269,3444,77798,13209,5564,1865,12427,7032
AGGTCGGATGGACTGC,sample,160052,158297,11823,146474,14783,131691,86187,5370,26703,2392,112890,11039,4951,1860,22621,9521
GACCGGAATGGACTGC,sample,5070,4931,253,4678,777,3901,3170,316,300,48,3470,67,752,733,660,535
TCCAACTTCCTTGAGC,sample,331797,328235,22523,305712,27029,278683,131604,10151,96457,11364,228061,29107,6070,2233,23479,18671
GGTTGCGTCCTTGAGC,sample,518324,511656,46356,465300,53782,411518,282195,24258,57594,5698,339789,41773,8697,3879,81773,34814
TCCTCCGTCCTTGAGC,sample,82408,81488,4413,77075,12297,64778,43628,3581,11443,1427,55071,4699,4289,2487,5359,8745
ACGTAAGTCCTTGAGC,sample,468992,463447,34778,428669,70312,358357,252166,15551,57060,7666,309226,25914,5017,2247,102716,49704
CCTCTAGACCTTGAGC,sample,231637,211621,27324,184297,17703,166594,85483,5565,50061,5430,135544,20055,6099,2067,20070,9146
AGTACCATCCTTGAGC,sample,335320,318077,36771,281306,24261,257045,137190,10145,69287,7744,206477,32679,7909,2598,19335,25807
TTCGTAATCCTTGAGC,Pos_Ctrl,317208,306128,43588,262540,11864,250676,211318,18496,14316,1823,225634,4723,8300,13050,14160,5113
TAGTACGGCCTTGAGC,sample,496275,491590,27271,464319,50187,414132,334815,26166,33777,4390,368592,14984,5729,2716,86150,36112
AATGGTAACCTTGAGC,sample,311382,305698,40336,265362,27242,238120,131471,7764,56147,6177,187618,36561,9609,2578,53327,15620
TTAGAAGTCCTTGAGC,sample,339811,328399,21856,306543,27352,279191,194593,13305,52591,7082,247184,11620,4523,3120,29465,16863
CCAGAGCGCCTTGAGC,sample,228428,224884,27127,197757,18507,179250,79831,5838,47528,4850,127359,41203,10960,3268,9779,9482
GTTAGCCGCCTTGAGC,Pos_Ctrl,133558,127575,21321,106254,5234,101020,85294,7345,5855,763,91149,1763,7320,9603,6568,2424
CCATGAAGCCTTGAGC,sample,438131,433940,29267,404673,41401,363272,237373,18009,63975,6377,301348,37538,10729,3898,34145,26954
TTGGTACCCCTTGAGC,Pos_Ctrl,173292,166441,26509,139932,6563,133369,112645,9702,7667,955,120312,2400,7759,10744,8207,2560
GTTAGGACCCTTGAGC,sample,270923,268511,15572,252939,29489,223450,172690,14050,21676,2111,194366,12923,5859,2309,50898,22032
ACGTATTACCTTGAGC,sample,347709,343797,25227,318570,44549,274021,199159,15071,41580,4365,240739,13846,4085,2062,70663,34280
AACTCGTACCTTGAGC,sample,239028,236522,17211,219311,16223,203088,102880,5991,69584,6633,172464,18000,5823,2286,17607,9565
AATATATCCCTTGAGC,sample,346303,343716,15910,327806,50353,277453,232918,15849,19268,2114,252186,7304,3686,2594,78023,36401
ACCAATGCCCTTGAGC,sample,169036,166627,12481,154146,14506,139640,84111,5376,33611,4630,117722,11912,5384,2603,11232,10891
GAAGGCGCCCTTGAGC,sample,285297,281603,37116,244487,16709,227778,115614,8529,62672,7446,178286,33517,12743,4144,18296,9589
CCAATTCCCCTTGAGC,sample,303927,300694,26309,274385,34077,240308,150949,11815,46541,4838,197490,26165,8306,2300,44929,21868
AGGTCGGACCTTGAGC,Pos_Ctrl,77656,76165,8878,67287,3253,64034,54381,5108,3153,383,57534,1009,6510,8264,4103,1376
GGAGAGTTCGATATCC,sample,264779,263440,16026,247414,36443,210971,138518,7474,42336,4107,180854,18536,7609,2404,52807,24472
ATTCTCTTCGATATCC,sample,257544,255661,8838,246823,38118,208705,164406,12655,22496,3654,186902,5494,3372,2253,35995,26526
AAGTTCGTCGATATCC,sample,497167,494015,21671,472344,45547,426797,339191,22457,42289,5507,381480,17353,5820,3467,88321,31412
GGTTGCGTCGATATCC,sample,311162,308392,23420,284972,41236,243736,147269,14145,51179,5678,198448,25465,8623,2362,36448,27980
TCCTCCGTCGATATCC,sample,313875,311586,15149,296437,23422,273015,155622,12817,78640,11181,234262,14755,4449,2847,25324,16107
CCTCTAGACGATATCC,sample,429428,425203,19897,405306,57629,347677,287708,19297,30239,2052,317947,8381,3426,2095,106565,44398
ACGTTATGCGATATCC,sample,242956,239820,18273,221547,17279,204268,116504,8570,51868,7795,168372,19531,5764,2661,27221,10254
CAACCGCGCGATATCC,sample,335833,332458,24221,308237,46958,261279,201786,15623,25532,2683,227318,15655,7219,3048,50091,31797
TCGCATCTCGATATCC,sample,423034,419419,23148,396271,42584,353687,261192,20114,50500,7522,311692,14359,4944,2655,58266,29249
GCCTTGCTCGATATCC,sample,391731,387382,19599,367783,49331,318452,271030,18901,22694,1713,293724,4114,2820,2394,74139,35029
GGCCAGAGCGATATCC,sample,370845,366827,21281,345546,30025,315521,226477,13563,55171,5153,281648,15157,5283,3318,39242,20004
CCATGAAGCGATATCC,sample,489206,486004,22774,463230,74689,388541,317546,22390,36418,4299,353964,7888,1887,1595,104006,52686
ACGACTTCCGATATCC,sample,517124,513015,21601,491414,45489,445925,356282,27811,41627,3808,397909,16397,5688,2564,78730,31482
AATCCGTCCGATATCC,sample,452812,448745,27948,420797,71935,348862,286904,22877,29316,3163,316220,6602,3941,3262,70542,48317
CGTACGTCCGATATCC,sample,328725,324749,19357,305392,43742,261650,195703,14435,36245,5987,231948,9280,4585,2386,59449,31371
CGGATTACCGATATCC,sample,77494,76599,6646,69953,14227,55726,34819,2443,11385,1297,46204,5782,5390,2609,10580,9322
AACTCGTACGATATCC,sample,517915,513737,36880,476857,51016,425841,257945,19910,96279,14731,354224,36976,6560,2770,60698,35472
TGCTTCGCCGATATCC,sample,421236,417369,42131,375238,41142,334096,187634,12921,76493,7958,264127,49090,9602,2890,60996,22852
GTCTTAGCCGATATCC,sample,201562,199158,14404,184754,21862,162892,85617,6156,48436,6720,134053,15963,5483,1890,18213,14546
TTGGTTAACGATATCC,sample,297649,295359,12985,282374,39453,242921,202915,12765,18050,2724,220965,6467,3820,2489,50908,28543
AGGTCGGACGATATCC,sample,190576,188772,12118,176654,18920,157734,89271,5689,42812,5515,132083,14447,5011,2350,14462,12066
ATGACCGACGATATCC,sample,252097,250555,11986,238569,33998,204571,147895,12297,25949,3660,173844,14770,6041,2366,40950,22993
TATCAGTTATCTGACC,sample,280769,278248,13669,264579,40611,223968,168794,13200,26692,3973,195486,11309,5836,2862,48737,29317
ACGTTATGATCTGACC,Neg_Ctrl,1740,1159,564,595,81,514,332,25,91,16,423,50,274,175,90,37
TAGTACGGATCTGACC,sample,284874,281222,22366,258856,31831,227025,166599,10480,28720,3131,195319,18095,5183,1901,64451,21612
AATGGTAAATCTGACC,sample,309984,307222,18362,288860,34476,254384,189947,13772,32124,5215,222071,13326,3818,1844,79632,25412
CCAGAGCGATCTGACC,sample,168947,166182,23015,143167,12045,131122,46924,3540,46739,4423,93663,29496,8963,1890,7598,6857
GGAGGACGATCTGACC,Neg_Ctrl,1936,1142,555,587,58,529,346,28,99,12,445,44,292,189,90,17
CCGCAACGATCTGACC,sample,220254,218066,20089,197977,25383,172594,108168,6559,33975,3930,142143,19962,7405,2268,33458,17155
CATTGCAGATCTGACC,sample,206448,204184,12425,191759,17456,174303,102372,7154,46956,7916,149328,9905,4010,2050,27253,9429
CCATGAAGATCTGACC,sample,345727,341487,24586,316901,38467,278434,184479,12951,50949,4234,235428,25821,6382,2275,66091,30015
ACGACTTCATCTGACC,sample,369048,366280,16182,350098,49285,300813,262111,22051,12380,1423,274491,2848,2060,2557,63793,37782
AGTCCGCAATCTGACC,sample,369053,365420,21392,344028,34986,309042,244971,20055,28990,3646,273961,11380,4944,2871,40047,26392
CTAGGACCATCTGACC,Neg_Ctrl,1681,911,505,406,52,354,255,17,51,7,306,24,200,141,55,17
CGGATTACATCTGACC,sample,325468,322955,13063,309892,29729,280163,222134,15901,31255,4232,253389,6641,3229,2997,38370,21684
GCCTGAACATCTGACC,sample,379237,376578,19799,356779,48501,308278,246888,15244,29216,3302,276104,13628,4493,1986,78416,34496
AACTCGTAATCTGACC,sample,1498,1467,134,1333,190,1143,894,79,111,15,1005,44,426,364,283,128
ACCAATGCATCTGACC,sample,366835,363789,16038,347751,48202,299549,251816,22062,19182,1918,270998,4571,3265,2423,51720,33849
GTCTTAGCATCTGACC,sample,283666,281799,10348,271451,38743,232708,187474,15408,22742,2885,210216,4199,1684,1338,58980,28576
CCAATTCCATCTGACC,sample,26060,25621,3165,22456,2493,19963,10098,864,5220,631,15318,3150,2667,900,2318,1107
TCAATATAATCTGACC,sample,139947,138781,6940,131841,25531,106310,85145,6378,9213,1327,94358,4247,3715,2472,21654,18062
CTTCATGAATCTGACC,sample,107266,105825,8677,97148,10463,86685,55391,4154,18197,1976,73588,6967,4393,1919,13859,6882
TTATTCGAATCTGACC,Neg_Ctrl,1242,859,369,490,57,433,270,29,74,10,344,50,213,144,89,27
ATGACCGAATCTGACC,sample,627,600,83,517,71,446,319,23,64,7,383,33,241,165,88,51
GACCGGAAATCTGACC,sample,1469,1414,106,1308,341,967,715,73,117,12,832,50,415,311,214,210
GGAGAGTTCTTCTTAC,sample,250845,249097,14653,234444,25148,209296,140379,9598,37823,5401,178202,16095,5989,1901,59263,18962
TCCAACTTCTTCTTAC,sample,228061,225739,12984,212755,16918,195837,114480,8959,50593,7314,165073,14491,5714,2487,17054,12024
GGTTGCGTCTTCTTAC,sample,543407,539173,24152,515021,74695,440326,376544,26818,26085,3883,402629,6996,2251,2452,99536,57770
ACGTAAGTCTTCTTAC,sample,252162,249443,18954,230489,19758,210731,125127,7828,53368,6916,178495,17492,6069,2730,29926,10578
CCTCTAGACTTCTTAC,sample,319204,316590,15588,301002,46621,254381,214741,16590,17973,2672,232714,2405,1787,1553,91679,35409
TTCGTAATCTTCTTAC,sample,253764,251026,18376,232650,25696,206954,164418,10692,20923,2073,185341,8848,3910,2309,45199,20157
ACGTTATGCTTCTTAC,sample,214026,211183,23149,188034,20320,167714,103978,7026,31053,3529,135031,22128,8072,2461,34924,12041
TCGCATCTCTTCTTAC,sample,590661,585270,35246,550024,48811,501213,322940,28024,104662,12075,427602,33512,7179,2751,60424,34082
CAAGGCCTCTTCTTAC,sample,330166,326879,18486,308393,29557,278836,175549,10016,64761,8805,240310,19705,4842,2513,35973,21275
GGACGTAGCTTCTTAC,sample,170418,168564,13593,154971,18672,136299,80658,5750,33208,3481,113866,13202,5869,2396,18340,12689
ACCTCGAGCTTCTTAC,sample,226750,223923,18017,205906,21595,184311,125077,6650,33125,3642,158202,15817,6685,2238,38744,15592
TGGACGAGCTTCTTAC,sample,565732,551969,101847,450122,48014,402108,149114,8649,128903,13907,278017,101535,19207,4836,43887,24930
GACGATAACTTCTTAC,sample,419568,415883,24500,391383,64343,327040,260576,14828,32538,2639,293114,16459,3501,1779,98408,46178
AATCCGTCCTTCTTAC,sample,233979,231024,25449,205575,23172,182403,89310,5366,53094,4312,142404,30321,8503,1958,19956,15248
GTCCTGCCCTTCTTAC,sample,168421,164791,27356,137435,10908,126527,53749,3890,35852,3904,89601,29132,10182,2449,13182,5756
TTGGTACCCTTCTTAC,sample,314022,308759,33294,275465,29306,246159,114045,9484,68882,7392,182927,46356,10278,2844,17815,18954
GCCTGAACCTTCTTAC,sample,322608,320264,16183,304081,30306,273775,200953,15722,40638,4744,241591,11718,4968,3200,31610,20286
AACTCGTACTTCTTAC,sample,382122,379564,20832,358732,39804,318928,246505,18925,34233,4815,280738,14450,5758,2205,78741,28416
CGTATGAACTTCTTAC,sample,482928,479542,21443,458099,69366,388733,318386,27418,32537,2897,350923,7495,1935,1675,96410,52673
GAAGGCGCCTTCTTAC,sample,215720,213982,13017,200965,15950,185015,119115,9260,38457,4256,157572,13927,4874,2551,24743,10638
GTCTTAGCCTTCTTAC,sample,112604,111670,9098,102572,14586,87986,51200,3064,20712,2567,71912,10443,5789,1572,11915,9757
GTACCGTACTTCTTAC,sample,565825,560859,47884,512975,46266,466709,230905,15200,134635,15703,365540,70266,15763,5429,45628,26695
TTATTCGACTTCTTAC,sample,97359,96756,5423,91333,15941,75392,51990,4398,12004,1359,63994,5641,3864,1630,10140,10879
ATTCTCTTACTTCTAC,sample,245850,244153,9363,234790,20435,214355,135317,10651,49013,7918,184330,11456,3585,2384,30118,14811
TCCTCCGTACTTCTAC,sample,158164,156780,17763,139017,16758,122259,76284,5070,22831,2384,99115,15690,5698,1877,29859,10709
ACGTAAGTACTTCTAC,sample,39984,39570,3337,36233,5087,31146,18898,1925,6587,567,25485,3169,2948,1280,3439,3332
CCTCTAGAACTTCTAC,sample,192670,191096,9524,181572,16129,165443,123839,8043,25616,1968,149455,5977,2793,2026,38761,11647
TTCGTAATACTTCTAC,sample,157351,156035,7540,148495,19470,129025,110547,6462,8189,1793,118736,2034,1895,1643,40539,14412
ATGCCTGGACTTCTAC,sample,181566,178811,16717,162094,19103,142991,89874,7465,25879,2809,115753,16964,6029,2183,25227,12568
TTAGAAGTACTTCTAC,sample,265630,260084,43196,216888,20669,196219,74416,5779,61593,6817,136009,47614,11763,2579,17703,10615
CAAGGCCTACTTCTAC,sample,237172,234793,15535,219258,38469,180789,123991,10249,30186,2860,154177,13503,5840,2182,46143,27118
CATAACCTACTTCTAC,sample,208619,205990,15398,190592,22618,167974,121972,9692,21809,2049,143781,12452,5561,2342,37497,13857
CCAGAGCGACTTCTAC,sample,61027,60244,5711,54533,5009,49524,33706,2384,8192,852,41898,4390,3290,1294,10504,3075
GGAGGACGACTTCTAC,sample,271305,269217,13137,256080,35347,220733,165609,15890,25775,2479,191384,10980,5149,2490,38100,25803
CCGCAACGACTTCTAC,sample,258390,255451,27962,227489,21290,206199,97724,7073,55846,6616,153570,38940,10321,2416,32348,12763
CCATGAAGACTTCTAC,sample,405369,400932,33492,367440,38633,328807,207190,13805,62145,6448,269335,39219,7572,2478,74364,24298
CATGATTCACTTCTAC,sample,409118,405469,18052,387417,43637,343780,287082,25750,25125,2718,312207,3105,1843,1775,83416,32418
AGTCCGCAACTTCTAC,sample,340582,337759,19002,318757,44849,273908,222137,15165,23318,3686,245455,9602,2705,1688,52082,34430
GTCCTGCCACTTCTAC,sample,576953,569795,57366,512429,41600,470829,287199,19306,99255,10837,386454,54232,11329,3240,65458,29897
GTTAGGACACTTCTAC,sample,405236,400993,32212,368781,37817,330964,210395,15839,62669,4954,273064,37107,7407,2402,39584,26741
AATATATCACTTCTAC,sample,699515,692946,54066,638880,53212,585668,352443,27457,132184,15463,484627,58121,14534,5379,49513,35081
GGCATATAACTTCTAC,sample,64847,64340,3189,61151,9517,51634,35943,3420,8145,1091,44088,3035,3145,1823,9107,6619
CTTCATGAACTTCTAC,sample,177010,175708,10165,165543,15727,149816,94601,8760,33369,2691,127970,10395,5198,1882,22927,11236
GGAGAGTTAGAAGTAA,sample,66094,65640,2740,62900,8230,54670,31916,3560,13680,1830,45596,3684,2754,1858,7860,5439
AAGTTCGTAGAAGTAA,sample,2004,1944,256,1688,170,1518,1009,81,288,27,1297,113,685,427,285,117
TCCTCCGTAGAAGTAA,sample,1929,1853,182,1671,261,1410,1010,95,204,17,1214,84,611,442,247,157
GGACCTCTAGAAGTAA,sample,348318,345942,15173,330769,25196,305573,168066,13713,96843,11762,264909,15189,3716,2297,25009,15798
CCAGAGCGAGAAGTAA,sample,263373,261310,13477,247833,30409,217424,126213,10871,57418,8041,183631,14881,5411,2660,14118,20807
GTTAGCCGAGAAGTAA,sample,205585,203965,15827,188138,22274,165864,87514,7185,49378,6342,136892,15445,6937,3290,13477,14911
GGCCAGAGAGAAGTAA,sample,374303,370329,23149,347180,34992,312188,243699,17859,31318,3606,275017,15706,6106,2871,52331,22134
ACGACTTCAGAAGTAA,sample,548147,544280,23232,521048,83012,438036,372244,22746,33286,4131,405530,5629,2031,1836,121844,60010
AATCCGTCAGAAGTAA,sample,204426,202336,22777,179559,15412,164147,58567,4498,59635,6955,118202,34492,10097,2418,8874,9569
CTAGGACCAGAAGTAA,sample,486550,482986,22395,460591,48113,412478,308509,25250,49850,6466,358359,22403,8209,3878,32139,36133
ACGTATTAAGAAGTAA,sample,608303,604732,27608,577124,77680,499444,378536,33147,60417,5276,438953,22068,5841,2472,122767,53939
AACTCGTAAGAAGTAA,sample,343300,341340,14331,327009,32324,294685,202789,16306,53670,7224,256459,14696,3750,1955,46945,23604
TTGGCCTCAGAAGTAA,sample,211623,210380,8716,201664,22336,179328,115942,10648,36776,5853,152718,10109,3873,1818,20256,15798
ACCAATGCAGAAGTAA,sample,194199,192931,8140,184791,30028,154763,118809,12000,15800,2281,134609,5873,4092,2912,24707,21341
GAAGGCGCAGAAGTAA,sample,300156,298153,23526,274627,34567,240060,99791,6553,72509,7749,172300,53458,12600,3316,27990,20837
AAGAGCGCAGAAGTAA,sample,486621,483644,24258,459386,59801,399585,313512,24612,36379,3554,349891,21528,7352,3408,62559,43634
TTGGTTAAAGAAGTAA,sample,417240,414959,19104,395855,46437,349418,241934,23482,49953,6164,291887,27885,8659,2958,41240,31237
GTACCGTAAGAAGTAA,sample,228415,226757,17093,209664,31938,177726,106673,8509,37634,3014,144307,21896,7721,1841,33008,22286
TCGCCTGAAGAAGTAA,sample,45887,45440,2052,43388,4520,38868,25167,2456,7798,1247,32965,2200,2553,1654,2684,2872
CTTCATGAAGAAGTAA,sample,9815,9585,622,8963,823,8140,5275,399,1823,217,7098,426,1281,831,1480,605
AGGTCGGAAGAAGTAA,sample,2394,2343,250,2093,213,1880,1366,109,286,19,1652,100,726,589,294,133
Short,Non_sample,0,NA,NA,NA,NA,NA,NA,NA,NA,NA,NA,NA,NA,NA,NA,NA
Unselected,Non_sample,0,NA,NA,NA,NA,NA,NA,NA,NA,NA,NA,NA,NA,NA,NA,NA
Undetermined,Non_sample,280900219,NA,NA,NA,NA,NA,NA,NA,NA,NA,NA,NA,NA,NA,NA,NA
