Barcode,Sample,Barcoded_Reads,Trimmed_Reads,Unmapped_Reads,Mapped_Reads,Multimapped_Reads,Uniquely_Mapped_Reads,Exon_Reads,Ambiguous_Exon_Reads,Intron_Reads,Ambiguous_Intron_Reads,Gene_Reads,Intergenic_Reads,No_of_Genes,No_of_Transcripts,Mitochondrial_Reads,Ribosomal_Reads
AAGTTCGTCGTTGGTT,sample,93728,92526,13089,79437,21539,57898,19364,1310,22613,2778,41977,11833,5694,1599,7959,12291
TTAGAAGTCGTTGGTT,sample,318079,314434,31670,282764,114425,168339,70317,1538,50036,6055,120353,40393,7599,1467,53254,58228
TTCCGTCTCGTTGGTT,sample,166456,165068,14821,150247,53052,97195,38781,1612,36873,4407,75654,15522,4898,1218,23364,29955
TCGCATCTCGTTGGTT,sample,145865,144312,21884,122428,34548,87880,25699,1065,36848,4032,62547,20236,7468,1563,12293,19632
GGAGGACGCGTTGGTT,sample,82444,80893,12605,68288,22773,45515,16260,1277,14538,1489,30798,11951,5332,758,12058,12584
GGACGTAGCGTTGGTT,sample,86217,85574,3805,81769,42911,38858,30024,1281,4903,859,34927,1791,1379,754,22610,19689
ACCTCGAGCGTTGGTT,sample,153972,152603,26755,125848,45989,79859,33883,955,24360,3118,58243,17543,4329,1243,23247,23318
CATGATTCCGTTGGTT,sample,35940,35454,4848,30606,10187,20419,8213,370,7319,767,15532,3750,3177,822,4972,5425
CGTACGTCCGTTGGTT,sample,152865,149745,28403,121342,28018,93324,22313,588,36154,3541,58467,30728,9076,1310,14652,16107
AGTCCGCACGTTGGTT,sample,275470,270261,46680,223581,59049,164532,46390,1299,62116,6856,108506,47871,10602,2019,27202,35111
CGTATGAACGTTGGTT,sample,271522,270128,8428,261700,139348,122352,81052,1930,28796,3951,109848,6623,2336,932,57642,62460
AGGTCGGACGTTGGTT,sample,292655,289502,38261,251241,70271,180970,55230,2983,67171,8322,122401,47264,11752,2845,18535,39632
GACCGGAACGTTGGTT,sample,211440,210498,9061,201437,115527,85910,66885,2370,12638,1808,79523,2209,1496,725,47667,46984
TCCAACTTCTATCGTT,sample,40348,40067,3214,36853,10428,26425,9669,709,10759,1264,20428,4024,3510,1099,3221,6643
TCCTCCGTCTATCGTT,sample,166172,164605,23502,141103,39104,101999,27973,482,38115,3799,66088,31630,9447,1333,19147,22500
CCTCTAGACTATCGTT,sample,90588,90060,5046,85014,38280,46734,28219,819,11426,1225,39645,5045,3432,1112,17209,19231
TTAGAAGTCTATCGTT,sample,175400,173949,17524,156425,55580,100845,41062,2088,31667,3414,72729,22614,6188,1336,27325,31201
GACGGAGACTATCGTT,sample,75788,75031,6881,68150,29588,38562,20514,470,10144,1291,30658,6143,3471,825,15416,15309
CTTGATAGCTATCGTT,sample,52857,52333,4362,47971,22303,25668,15202,405,6150,777,21352,3134,2620,766,10773,10867
CCATGAAGCTATCGTT,sample,75155,73812,9517,64295,22015,42280,15553,526,14656,1923,30209,9622,4347,804,10098,12007
TTGGTACCCTATCGTT,sample,174765,173068,17006,156062,56944,99118,48943,1254,29889,3192,78832,15840,4461,1213,32415,31083
CGGATTACCTATCGTT,sample,130010,127240,25414,101826,23873,77953,17889,526,30848,2960,48737,25730,8432,1045,11752,13571
AAGAGCGCCTATCGTT,sample,196676,192745,40040,152705,27398,125307,24194,724,51967,4956,76161,43466,11558,1473,13594,14961
TTGGTTAACTATCGTT,sample,48491,48031,5065,42966,17664,25302,13066,702,6630,703,19696,4201,3254,1050,8227,9068
GTACCGTACTATCGTT,sample,84951,84185,6352,77833,31481,46352,24180,580,12389,1376,36569,7827,4055,786,17474,16904
CTTCATGACTATCGTT,sample,65712,65231,4009,61222,32395,28827,22604,534,4617,385,27221,687,888,499,16458,14938
GACCGGAACTATCGTT,sample,63480,63016,7955,55061,13366,41695,12572,776,16441,1858,29013,10048,5858,1156,5596,8063
ATTCTCTTGTCTTCTT,Pos_Ctrl,179590,177099,17655,159444,9029,150415,127383,11822,7621,1064,135004,2525,7959,11330,10702,4798
ACGTAAGTGTCTTCTT,sample,147308,146311,12617,133694,57330,76364,35854,1027,21972,2786,57826,14725,7378,1303,24711,29667
CCTCTAGAGTCTTCTT,Pos_Ctrl,93460,92102,7822,84280,5203,79077,67418,6673,3337,470,70755,1179,6906,9167,5974,2585
TAGTACGGGTCTTCTT,sample,100125,99745,3894,95851,58072,37779,22307,1445,9063,1514,31370,3450,2986,1273,11623,21715
CAACCGCGGTCTTCTT,sample,94192,93771,2866,90905,57796,33109,28301,1107,2686,331,30987,684,1549,1224,18471,20587
CCAGAGCGGTCTTCTT,sample,155048,152824,22728,130096,37045,93051,30240,1036,32223,3403,62463,26149,9755,1573,19494,21476
GGACGTAGGTCTTCTT,sample,56104,55535,2432,53103,29976,23127,18363,299,3350,563,21713,552,900,500,14366,12759
CTTGATAGGTCTTCTT,sample,54721,54073,4755,49318,22073,27245,14316,887,7334,999,21650,3709,3442,991,9198,10944
ACCTCGAGGTCTTCTT,sample,40328,39950,1711,38239,20618,17621,13862,395,2205,347,16067,812,1230,590,10923,9178
TGGACGAGGTCTTCTT,sample,60085,59632,2332,57300,30637,26663,21065,505,3623,633,24688,837,933,545,17017,13888
GACGATAAGTCTTCTT,sample,42990,42037,8523,33514,7129,26385,8553,573,9096,865,17649,7298,4693,1309,2978,5171
CATGATTCGTCTTCTT,sample,88225,86806,10779,76027,27304,48723,19850,560,16051,1774,35901,10488,4695,893,13837,15045
GTCCTGCCGTCTTCTT,sample,190046,186518,33863,152655,32859,119796,29373,485,46455,4870,75828,38613,11114,1459,19751,19359
TTGGTACCGTCTTCTT,sample,234271,229737,38676,191061,48916,142145,38732,1142,56284,6257,95016,39730,9312,1626,22749,28187
TTGGCCTCGTCTTCTT,sample,90544,90045,3730,86315,49676,36639,28139,790,6082,829,34221,799,1101,650,20588,20422
AATATATCGTCTTCTT,sample,173196,169615,27968,141647,35058,106589,27801,1204,43529,4425,71330,29630,9666,1521,15000,20337
ACCAATGCGTCTTCTT,sample,145771,143217,17723,125494,48238,77256,28990,955,26435,2455,55425,18421,5327,1156,19265,25131
AGGTCGGAGTCTTCTT,Pos_Ctrl,121341,119446,12185,107261,5273,101988,86473,7667,5381,726,91854,1741,7066,9685,5885,2600
GACCGGAAGTCTTCTT,sample,172215,169975,25227,144748,28973,115775,22947,839,47768,4636,70715,39585,11441,1701,11624,18512
TTCTAATGTAGGCTCT,sample,182082,181193,12467,168726,66755,101971,37472,2941,38748,4539,76220,18271,8607,2023,16591,36648
GTTAGCCGTAGGCTCT,sample,168887,165973,20367,145606,36974,108632,41989,2031,41037,5107,83026,18468,6844,1724,21284,22997
GGAGGACGTAGGCTCT,sample,245535,243585,9490,234095,119574,114521,92530,2796,14558,1178,107088,3459,1572,880,67305,57821
CCGCAACGTAGGCTCT,sample,344286,336352,50365,285987,80024,205963,57065,1902,75136,7734,132201,64126,12476,2170,39126,46197
CTTGATAGTAGGCTCT,sample,158404,154409,34884,119525,26459,93066,21128,1106,37603,4224,58731,29005,9682,1926,8779,14025
ACCTCGAGTAGGCTCT,sample,402314,395980,47740,348240,86432,261808,75252,2153,95205,10481,170457,78717,13747,2502,50920,53120
CGAGGCAGTAGGCTCT,sample,477375,462409,100715,361694,69454,292240,58569,1783,122634,13271,181203,95983,18014,3041,29872,38780
CATGATTCTAGGCTCT,sample,66156,65257,5907,59350,21652,37698,18907,1440,11010,1336,29917,5005,4322,1975,6963,12523
AATCCGTCTAGGCTCT,sample,192017,188750,22635,166115,61223,104892,36335,1747,37903,4373,74238,24534,8815,1637,21600,32380
TTGGTACCTAGGCTCT,sample,170183,166737,27188,139549,34115,105434,32683,1165,38839,4202,71522,28545,8678,1340,21417,19336
CTAGGACCTAGGCTCT,sample,174772,172306,17074,155232,59225,96007,45490,1793,29490,3479,74980,15755,6065,1700,26931,31365
GCCTGAACTAGGCTCT,sample,454404,443712,82647,361065,78303,282762,58210,2554,119769,13017,177979,89212,16155,3094,25301,45609
AACTCGTATAGGCTCT,sample,392068,389251,23841,365410,164131,201279,119420,4357,46352,6266,165772,24884,4882,1432,89380,85221
CGTATGAATAGGCTCT,sample,417900,415693,19309,396384,228453,167931,133987,2892,24504,2603,158491,3945,1763,826,103776,93436
TTGGCCTCTAGGCTCT,sample,326113,323647,22352,301295,134180,167115,76247,4116,47091,5118,123338,34543,7125,2064,46707,69168
ACCAATGCTAGGCTCT,sample,317463,314692,17477,297215,148089,149126,89835,3159,34060,4384,123895,17688,4701,1323,67431,70491
TGCTTCGCTAGGCTCT,sample,140794,139965,9085,130880,43009,87871,41172,2460,30318,4471,71490,9450,4910,1877,16275,26537
CCAATTCCTAGGCTCT,sample,203809,201767,16848,184919,82689,102230,55882,2298,26267,2764,82149,15019,5142,1221,38044,41219
GGAGAGTTTTGACTAT,sample,104878,104112,4922,99190,51845,47345,34504,628,8222,658,42726,3333,1609,641,27326,23459
TCCAACTTTTGACTAT,Neg_Ctrl,2861,1391,993,398,99,299,105,3,69,10,174,112,104,34,45,34
ACGTAAGTTTGACTAT,sample,133670,130989,28528,102461,24169,78292,19275,583,31620,3672,50895,23142,8371,1328,10221,13395
AGTACCATTTGACTAT,Neg_Ctrl,4166,2647,2221,426,90,336,149,3,127,7,276,50,109,34,64,24
TAGTACGGTTGACTAT,sample,84635,82789,22669,60120,10446,49674,8425,419,21384,2363,29809,17083,7787,1088,3696,5479
CAACCGCGTTGACTAT,sample,63388,62707,5361,57346,21294,36052,17957,581,10638,1215,28595,5661,2869,732,12434,12257
AATGGTAATTGACTAT,sample,185465,179617,47756,131861,22276,109585,16030,421,47407,4890,63437,40837,12024,1383,7905,11090
TTCCGTCTTTGACTAT,Pos_Ctrl,183822,179076,25950,153126,8326,144800,121979,10009,9053,1159,131032,2600,8005,10962,9453,4894
TCGCATCTTTGACTAT,sample,107589,106151,23654,82497,19690,62807,13219,530,25201,2734,38420,21123,8677,1183,6675,9866
CCGCAACGTTGACTAT,Pos_Ctrl,134083,130131,17541,112590,6318,106272,90049,7859,5739,863,95788,1762,7535,9993,7052,3326
GGACGTAGTTGACTAT,sample,37773,37152,5836,31316,5971,25345,7437,430,10393,1263,17830,5822,3651,1012,2128,3462
GACGATAATTGACTAT,sample,53013,52234,2536,49698,24728,24970,19840,458,3506,402,23346,764,896,477,16150,11893
CATGATTCTTGACTAT,sample,20104,19581,4119,15462,2697,12765,2761,159,5530,615,8291,3700,2874,576,837,1534
AATCCGTCTTGACTAT,Pos_Ctrl,120822,116701,17529,99172,5552,93620,79016,6345,5786,697,84802,1776,7196,9044,5737,3183
GTCCTGCCTTGACTAT,sample,59696,59238,2282,56956,31034,25922,21012,400,3552,482,24564,476,895,482,16926,13767
CTAGGACCTTGACTAT,sample,32230,31439,6578,24861,4461,20400,5120,228,8770,888,13890,5394,3853,690,2371,2611
GTTAGGACTTGACTAT,sample,50919,50116,5864,44252,12379,31873,14179,678,11161,1185,25340,4670,3611,1165,6542,7735
TTGGCCTCTTGACTAT,Pos_Ctrl,120920,117674,15843,101831,4752,97079,82416,7253,5256,601,87672,1553,6990,9357,4200,2698
TGCTTCGCTTGACTAT,sample,121248,119755,18193,101562,28743,72819,25752,735,25835,2938,51587,17559,5990,955,17206,16850
GAAGGCGCTTGACTAT,sample,136737,134372,20096,114276,31055,83221,29720,1553,29811,3041,59531,19096,6392,1349,16966,18766
TCGCCTGATTGACTAT,sample,98165,94790,22612,72178,16262,55916,14956,770,21711,2348,36667,16131,7473,1369,6868,8571
TTATTCGATTGACTAT,Neg_Ctrl,2382,1331,892,439,97,342,188,22,72,7,260,53,192,80,58,38
GGAGAGTTTGCAGTTG,sample,41766,41372,3990,37382,11093,26289,10244,452,10116,1145,20360,4332,3063,839,5034,6858
TCCTCCGTTGCAGTTG,sample,63321,62950,2834,60116,32307,27809,16654,572,6003,642,22657,3938,3089,952,11508,13921
TAGTACGGTGCAGTTG,sample,65792,64946,10415,54531,8967,45564,12832,874,18963,2085,31795,10810,6104,1507,4429,5344
CAACCGCGTGCAGTTG,sample,88364,87637,6629,81008,35578,45430,26588,776,11521,1016,38109,5529,3734,955,19513,18367
CAAGGCCTTGCAGTTG,sample,61777,60704,10161,50543,12793,37750,13898,881,13783,1591,27681,7597,5662,1770,5689,7251
ACTATACTTGCAGTTG,sample,89630,88245,13128,75117,24309,50808,13469,491,19009,1808,32478,16031,6659,828,8812,13631
ACCTCGAGTGCAGTTG,sample,48429,47913,3455,44458,18182,26276,13530,433,6566,703,20096,5044,2748,925,8192,9761
TGGACGAGTGCAGTTG,sample,51911,51212,3800,47412,20161,27251,15216,343,6605,738,21821,4349,2838,750,11005,10641
GACGATAATGCAGTTG,sample,47806,46857,5390,41467,13528,27939,11527,340,9353,843,20880,5876,3731,726,7988,7764
CATTGCAGTGCAGTTG,sample,50950,49121,10872,38249,7944,30305,6395,169,12327,1267,18722,10147,5581,695,3638,4427
AACTCGTATGCAGTTG,sample,134454,132646,20367,112279,33501,78778,20879,586,29031,2858,49910,25424,8334,1144,13840,18111
AATATATCTGCAGTTG,sample,165032,162239,25357,136882,37945,98937,26416,955,37853,3730,64269,29983,9912,1450,14919,21241
GGCATATATGCAGTTG,sample,159410,156721,21525,135196,25519,109677,34870,1677,42808,4254,77678,26068,7556,1828,10868,16023
TCGCCTGATGCAGTTG,sample,55899,55428,4249,51179,22153,29026,15428,898,7790,838,23218,4072,3472,1184,7737,11241
CTTCATGATGCAGTTG,sample,140519,138731,12978,125753,41545,84208,30432,782,28739,2801,59171,21454,8078,1303,20263,24100
TATCAGTTTCATGCTG,sample,42001,41609,2087,39522,22237,17285,14183,570,1759,236,15942,537,972,591,10631,9263
TCCAACTTTCATGCTG,sample,64261,62770,12613,50157,11837,38320,9971,312,14773,1603,24744,11661,5843,806,5923,6782
TCCTCCGTTCATGCTG,sample,50512,49435,8773,40662,12681,27981,8922,364,10192,976,19114,7527,4505,880,4885,6754
AGTACCATTCATGCTG,sample,43902,43365,2686,40679,21200,19479,14925,309,3077,253,18002,915,783,402,12655,9585
TTCTAATGTCATGCTG,sample,38277,37779,3874,33905,14357,19548,11635,175,4961,530,16596,2247,1747,460,9332,7496
CAACCGCGTCATGCTG,sample,45160,44540,4614,39926,16956,22970,11281,407,6318,651,17599,4313,2504,731,7307,8634
AATGGTAATCATGCTG,sample,48085,47379,5838,41541,18183,23358,11454,564,6594,690,18048,4056,3841,1278,5394,8932
TTAGAAGTTCATGCTG,sample,37716,36845,7577,29268,7885,21383,6264,154,8046,735,14310,6184,3973,459,4268,4227
GGACCTCTTCATGCTG,Neg_Ctrl,2353,1145,863,282,65,217,88,1,60,11,148,57,82,14,56,16
TCGCATCTTCATGCTG,sample,93546,92313,9344,82969,28402,54567,26179,864,16404,1968,42583,9152,5047,1044,18251,16288
GCCTTGCTTCATGCTG,sample,126997,124838,15781,109057,28143,80914,25419,1117,29227,3275,54646,21876,7225,1377,13619,16886
ACTATACTTCATGCTG,sample,76619,74427,18330,56097,12873,43224,8906,341,18224,2016,27130,13737,7313,1025,4056,6652
GGAGGACGTCATGCTG,sample,148370,144960,26825,118135,20315,97820,22327,788,39809,3882,62136,31014,9621,1429,11393,12286
GGACGTAGTCATGCTG,Neg_Ctrl,1813,877,669,208,60,148,54,0,52,9,106,33,64,9,30,9
ACCTCGAGTCATGCTG,sample,63032,60757,15671,45086,4596,40490,6863,262,17335,1749,24198,14281,7591,932,2977,2291
CGAGGCAGTCATGCTG,sample,70982,69062,14173,54889,12346,42543,12502,521,15959,1909,28461,11652,5759,1171,6197,7134
CCATGAAGTCATGCTG,sample,74669,72937,12121,60816,14358,46458,14802,538,16872,1887,31674,12359,5271,997,7963,8715
CATGATTCTCATGCTG,sample,31128,30563,4463,26100,6090,20010,7663,307,7398,794,15061,3848,3286,702,4159,3667
AATCCGTCTCATGCTG,sample,8319,8199,824,7375,3546,3829,2140,95,1000,110,3140,484,969,382,1365,1689
AGTCCGCATCATGCTG,sample,50197,49623,4395,45228,17997,27231,15417,384,6877,843,22294,3710,2180,588,11190,10045
GTCCTGCCTCATGCTG,sample,52340,51715,4505,47210,18860,28350,17565,590,6466,599,24031,3130,2067,629,13421,10506
TTGGCCTCTCATGCTG,sample,28214,28029,917,27112,13624,13488,10469,324,2179,230,12648,286,683,394,7743,6565
AATATATCTCATGCTG,Neg_Ctrl,1066,594,359,235,83,152,54,4,55,9,109,30,70,15,31,24
ACCAATGCTCATGCTG,sample,35369,34928,5127,29801,7561,22240,7710,364,7984,827,15694,5355,4220,959,3799,4370
AAGAGCGCTCATGCTG,sample,48507,47964,7091,40873,10054,30819,9002,311,11945,1141,20947,8420,5019,699,5631,5988
CCAATTCCTCATGCTG,sample,24036,23748,2772,20976,6614,14362,5387,177,4813,579,10200,3406,3108,563,3348,3620
TTGGTTAATCATGCTG,sample,26319,25989,1978,24011,11162,12849,7693,240,3016,376,10709,1524,1408,354,5795,5415
ATGACCGATCATGCTG,sample,19308,19182,892,18290,9310,8980,5816,185,1899,236,7715,844,1143,415,4193,4339
ATTCTCTTTTAGGCGG,Pos_Ctrl,252036,241099,35807,205292,10942,194350,163117,13334,12390,1793,175507,3716,8415,11976,12696,5694
CCTCTAGATTAGGCGG,Pos_Ctrl,199570,187665,28298,159367,8467,150900,126453,10430,9638,1239,136091,3140,8171,11220,9922,4300
CAACCGCGTTAGGCGG,sample,97287,96711,5288,91423,44261,47162,23723,835,14222,1398,37945,6984,4568,962,16343,21199
TTAGAAGTTTAGGCGG,sample,99897,98912,11714,87198,30099,57099,23811,818,18016,2130,41827,12324,5926,1272,15192,16798
TTCCGTCTTTAGGCGG,sample,365673,364091,16727,347364,182562,164802,108760,4350,31584,3726,140344,16382,4868,1580,72940,82648
TCGCATCTTTAGGCGG,sample,270882,269369,12740,256629,132045,124584,85983,2569,22852,4279,108835,8901,4199,1347,59655,61693
GCCTTGCTTTAGGCGG,sample,196229,194293,24099,170194,42910,127284,43225,1987,48684,5280,91909,28108,9039,1849,23304,26411
CATAACCTTTAGGCGG,sample,869074,851412,155371,696041,129667,566374,118017,3296,226097,24335,344114,194629,22142,5674,62442,79122
GTTAGCCGTTAGGCGG,sample,266585,262274,36750,225524,64820,160704,49697,1925,62221,6799,111918,40062,9894,1730,24750,37524
CCGCAACGTTAGGCGG,sample,259447,257111,18739,238372,97270,141102,72007,1729,42157,4824,114164,20385,4295,1234,47074,52659
GACGATAATTAGGCGG,sample,115478,113255,17100,96155,24602,71553,23406,1038,26687,2681,50093,17741,6865,1142,13353,14961
GGCCAGAGTTAGGCGG,sample,112960,111981,5904,106077,45466,60611,39187,1808,13499,1529,52686,4588,2201,881,28210,24498
CATGATTCTTAGGCGG,sample,202869,199077,30039,169038,43871,125167,33663,1484,48666,4849,82329,36505,9965,1629,18732,24870
AGTCCGCATTAGGCGG,sample,63457,62395,8557,53838,16842,36996,15945,795,10491,1134,26436,8631,4633,1253,9117,9726
GTTAGGACTTAGGCGG,sample,225611,216776,64473,152303,22250,130053,22245,1274,56600,6109,78845,43825,13170,2630,6216,11236
GCCTGAACTTAGGCGG,sample,115057,114048,6181,107867,58576,49291,37945,1075,7583,758,45528,1930,1484,653,29279,25872
TTGGCCTCTTAGGCGG,sample,125563,124757,5361,119396,62574,56822,42797,995,10270,1404,53067,1356,1173,563,34487,29166
TGCTTCGCTTAGGCGG,sample,209166,203718,42928,160790,32811,127979,27894,641,50185,4760,78079,44499,11387,1360,17091,18595
GAAGGCGCTTAGGCGG,sample,122949,119685,19499,100186,24499,75687,19935,798,29618,3409,49553,21927,8121,1394,10201,14433
CCAATTCCTTAGGCGG,sample,142107,140515,8688,131827,63962,67865,42282,2025,14090,1591,56372,7877,3232,1126,26912,30932
TCAATATATTAGGCGG,sample,282275,276787,41753,235034,58336,176698,55623,2276,63531,5965,119154,49303,8751,1759,31896,35710
ATGACCGATTAGGCGG,sample,150828,149421,10637,138784,66292,72492,44649,1629,15522,1892,60171,8800,3118,1045,28263,32266
TATCAGTTTCAGATAC,sample,18781,18609,3200,15409,3482,11927,3015,144,4877,509,7892,3382,2818,461,1659,1954
ATTCTCTTTCAGATAC,sample,173069,171482,25721,145761,41522,104239,26489,941,39762,3990,66251,33057,10733,1539,17611,23547
AAGTTCGTTCAGATAC,sample,77225,76679,6983,69696,31212,38484,17886,483,10946,1163,28832,8006,4026,899,13040,15743
ACGTAAGTTCAGATAC,sample,60987,60322,9020,51302,21552,29750,10657,485,9894,1016,20551,7698,4883,791,7121,10320
CCTCTAGATCAGATAC,sample,73866,72356,19678,52678,8791,43887,7956,413,18692,2038,26648,14788,7478,1249,2648,4783
TAGTACGGTCAGATAC,sample,75903,74873,14962,59911,15499,44412,11591,293,16771,1598,28362,14159,6340,763,7776,8718
TTCCGTCTTCAGATAC,sample,118534,116858,21042,95816,21411,74405,20633,1016,30731,2841,51364,19184,6627,1308,9763,13258
GGACCTCTTCAGATAC,sample,95326,94095,13876,80219,20311,59908,23140,995,21058,2524,44198,12191,5868,1365,11939,12125
GGAGGACGTCAGATAC,sample,106778,105988,4408,101580,55184,46396,35927,991,7700,564,43627,1214,990,572,29132,24608
CCGCAACGTCAGATAC,sample,107417,105784,10811,94973,33734,61239,27361,1009,18667,1968,46028,12234,5429,983,19120,19082
GGACGTAGTCAGATAC,sample,82196,79817,24855,54962,8567,46395,6508,313,20140,2193,26648,17241,7656,939,2590,3901
GACGATAATCAGATAC,sample,43929,43495,2667,40828,20628,20200,14602,445,3231,423,17833,1499,1476,649,10262,9714
CATGATTCTCAGATAC,sample,47812,47204,4984,42220,16096,26124,14835,207,6829,684,21664,3569,2001,505,11739,9010
CGTACGTCTCAGATAC,sample,35847,35552,2304,33248,17468,15780,11590,275,2312,281,13902,1322,1397,654,8326,7836
GTCCTGCCTCAGATAC,sample,33680,32870,6789,26081,5587,20494,6553,227,7256,711,13809,5747,3764,539,4391,3080
CGGATTACTCAGATAC,sample,88990,86834,20959,65875,10439,55436,12360,529,22968,2548,35328,17031,6822,1090,5382,6103
ACGTATTATCAGATAC,sample,33152,32330,7128,25202,4257,20945,5562,306,8557,1029,14119,5491,3981,973,1677,2264
AACTCGTATCAGATAC,sample,120308,116970,35999,80971,9260,71711,9844,425,31752,3536,41596,26154,10667,1257,3183,4467
GTCTTAGCTCAGATAC,sample,60314,59334,8256,51078,17387,33691,13097,612,10724,1253,23821,8005,4406,951,8284,9564
TTGGTTAATCAGATAC,sample,233882,229434,57788,171646,25934,145712,26476,727,60032,6878,86508,51599,14484,1924,13104,13390
GGCATATATCAGATAC,sample,174279,169317,44600,124717,16532,108185,17320,599,46052,4900,63372,39314,13075,1578,7292,8557
TCAATATATCAGATAC,sample,16812,16478,2734,13744,2997,10747,3499,181,4179,493,7678,2395,2120,547,1469,1692
GACCGGAATCAGATAC,sample,56925,56501,3433,53068,25139,27929,19643,433,4542,463,24185,2848,1372,474,14971,12517
TCCAACTTTCGCTAGG,Neg_Ctrl,3481,1563,1297,266,86,180,72,1,65,4,137,38,96,20,41,16
CCTCTAGATCGCTAGG,sample,110447,108402,14259,94143,32503,61640,24455,714,20339,2421,44794,13711,5345,1019,17151,17931
AGTACCATTCGCTAGG,Neg_Ctrl,3129,1921,1663,258,87,171,69,2,60,7,129,33,65,20,37,12
TTAGAAGTTCGCTAGG,sample,22955,22484,5376,17108,4425,12683,3913,202,4488,521,8401,3559,3308,845,1368,2393
TCGCATCTTCGCTAGG,sample,26084,25702,3086,22616,9534,13082,6360,322,3709,397,10069,2294,2409,781,3420,4789
GTTAGCCGTCGCTAGG,sample,8246,7951,2401,5550,1041,4509,876,22,1845,196,2721,1570,1519,153,452,538
CTTGATAGTCGCTAGG,sample,44347,43407,6782,36625,12983,23642,8381,843,7423,755,15804,6240,3852,646,5087,6853
ACCTCGAGTCGCTAGG,sample,14448,14201,1827,12374,3095,9279,4151,215,3078,365,7229,1470,1979,571,2006,1879
TGGACGAGTCGCTAGG,sample,75499,73524,14370,59154,13166,45988,10814,283,18186,1831,29000,14874,6548,755,7123,7666
GACGATAATCGCTAGG,sample,46380,45479,7202,38277,9612,28665,7822,339,11187,1146,19009,8171,4975,778,4413,5632
GGCCAGAGTCGCTAGG,sample,40378,39295,7682,31613,6618,24995,6675,204,9701,1037,16376,7378,4663,647,3973,3884
CATTGCAGTCGCTAGG,sample,24926,24472,3005,21467,7891,13576,7002,169,3637,350,10639,2418,1928,475,5153,4387
CCATGAAGTCGCTAGG,sample,43156,42392,4829,37563,14325,23238,11666,399,6193,685,17859,4295,3112,755,7782,7733
AATCCGTCTCGCTAGG,sample,80933,78116,19899,58217,7831,50386,9315,314,21734,2248,31049,16775,7567,917,4350,4182
AGTCCGCATCGCTAGG,sample,32715,31765,6683,25082,5668,19414,5671,201,7399,817,13070,5326,3794,601,3377,3148
AAGAGCGCTCGCTAGG,sample,32591,32278,1663,30615,14441,16174,11629,486,2750,334,14379,975,1318,764,7630,7378
CCAATTCCTCGCTAGG,sample,54166,53266,7325,45941,14752,31189,12253,417,10025,1152,22278,7342,3848,638,8234,8187
TTGGTTAATCGCTAGG,sample,83640,82408,12944,69464,19271,50193,18683,637,16362,1860,35045,12651,5233,1023,11377,11454
GTACCGTATCGCTAGG,Pos_Ctrl,91579,88416,12342,76074,3522,72552,61122,5217,4451,579,65573,1183,6619,8113,3836,1886
GGCATATATCGCTAGG,sample,61741,60178,8578,51600,11165,40435,11561,357,14559,1386,26120,12572,4537,742,7225,7193
TCGCCTGATCGCTAGG,sample,57935,56893,9991,46902,10493,36409,10366,509,14648,1695,25014,9191,5502,879,5391,6404
ATGACCGATCGCTAGG,sample,55284,53580,12255,41325,7587,33738,5053,206,14156,1386,19209,12937,5912,500,2780,4197
GGAGAGTTCCGTTGCG,sample,64889,63619,15872,47747,9366,38381,5647,315,16663,1746,22310,14010,5860,769,1960,4667
ACGTTATGCCGTTGCG,sample,214517,212932,8999,203933,112068,91865,74296,1036,11749,1344,86045,3440,1701,767,60939,48596
AATGGTAACCGTTGCG,sample,101020,99562,14043,85519,44725,40794,8470,450,16545,1919,25015,13410,5931,865,4329,17769
TCGCATCTCCGTTGCG,sample,286235,284548,18177,266371,125888,140483,81756,3233,37633,5027,119389,12834,4531,1391,48385,60913
GACGGAGACCGTTGCG,sample,91614,90668,4223,86445,45572,40873,32017,626,6344,534,38361,1352,1289,630,26884,20505
CCAGAGCGCCGTTGCG,sample,87395,86475,4980,81495,40396,41099,28533,859,7474,1123,36007,3110,1674,608,23426,19567
GGAGGACGCCGTTGCG,sample,97243,96730,3009,93721,51104,42617,34466,993,5603,315,40069,1240,1329,816,25378,22535
ACCTCGAGCCGTTGCG,sample,269586,263178,64115,199063,29981,169082,26179,846,72309,7875,98488,61873,15864,2169,11231,15352
TGGACGAGCCGTTGCG,sample,168030,163361,40584,122777,15939,106838,16922,746,45253,4789,62175,39128,12533,2101,5212,8974
GACGATAACCGTTGCG,sample,148726,147346,9485,137861,67544,70317,47301,1403,14774,1017,62075,5822,2119,742,34937,33442
GGCCAGAGCCGTTGCG,sample,99122,98369,4689,93680,48116,45564,36836,1144,5511,643,42347,1430,1131,691,29108,22599
AGTCCGCACCGTTGCG,sample,216281,210469,41007,169462,32619,136843,28474,737,54815,6015,83289,46802,11653,1643,17455,18747
CTAGGACCCCGTTGCG,sample,434750,426087,77042,349045,77046,271999,63595,1894,105063,12851,168658,88596,15061,3070,35932,43220
AATATATCCCGTTGCG,sample,297854,290215,70434,219781,41543,178238,34203,1038,73479,7217,107682,62301,13460,1974,18466,23509
GAAGGCGCCCGTTGCG,sample,564488,550838,135409,415429,53600,361829,54746,1976,157217,16041,211963,131849,20754,3975,22842,30972
CCAATTCCCCGTTGCG,sample,160349,158686,10482,148204,57285,90919,51924,1441,24240,1931,76164,11383,3115,892,39194,33367
TTGGTTAACCGTTGCG,sample,57888,56940,9621,47319,16856,30463,10021,463,10753,1215,20774,8011,4488,1034,5408,8617
GTACCGTACCGTTGCG,sample,168337,166996,9085,157911,72974,84937,58722,1252,16704,2541,75426,5718,2301,736,44328,37423
AAGTTCGTAGGCCAAG,sample,236126,231607,41332,190275,42831,147444,39046,954,57206,6652,96252,43586,10143,1818,22842,25964
GGTTGCGTAGGCCAAG,sample,153308,149513,30220,119293,33712,85581,27377,952,30035,3296,57412,23921,8210,1537,18032,17912
CCTCTAGAAGGCCAAG,sample,84868,83068,11043,72025,14487,57538,21532,1138,22478,2277,44010,10113,5452,1601,8377,9528
AGTACCATAGGCCAAG,sample,227027,221985,42710,179275,40755,138520,28583,982,55005,5822,83588,48128,11667,1624,16623,22287
TAGTACGGAGGCCAAG,sample,143951,142105,17691,124414,62807,61607,29686,1636,17045,1756,46731,11484,5871,1795,16691,26755
AATGGTAAAGGCCAAG,sample,213415,208005,36820,171185,37086,134099,33954,1116,52595,4999,86549,41435,9891,1604,20759,22019
TTCCGTCTAGGCCAAG,sample,175048,171517,32735,138782,39347,99435,31306,555,35701,4078,67007,27795,9155,1339,21349,21756
CCGCAACGAGGCCAAG,sample,16556,16038,4160,11878,2979,8899,2530,102,3209,307,5739,2751,2119,407,1404,1364
CTTGATAGAGGCCAAG,sample,178574,175538,18093,157445,63734,93711,42204,1143,28728,2765,70932,18871,5061,1057,31296,33276
TGGACGAGAGGCCAAG,sample,139262,136224,21300,114924,28560,86364,28637,991,31254,3013,59891,22469,8344,1357,18327,17454
CATTGCAGAGGCCAAG,sample,176866,173374,25074,148300,34309,113991,36863,1263,43488,4649,80351,27728,8305,1552,22338,21133
CGAGGCAGAGGCCAAG,sample,161425,158443,19249,139194,51911,87283,38179,1453,26872,3048,65051,17731,5641,1200,26156,27363
CGTACGTCAGGCCAAG,sample,86475,84686,13209,71477,15282,56195,17903,865,22923,2604,40826,11900,5803,1468,7044,9008
GCCTGAACAGGCCAAG,sample,145664,144560,6503,138057,70910,67147,54095,1409,8971,594,63066,2078,1373,748,42701,33170
TGCTTCGCAGGCCAAG,sample,244781,240586,39254,201332,52807,148525,34710,1215,58541,5817,93251,48242,11403,1660,20462,28591
GAAGGCGCAGGCCAAG,sample,95785,94479,8314,86165,27775,58390,28130,1556,19075,2414,47205,7215,4370,1616,11398,17295
GTCTTAGCAGGCCAAG,sample,203510,198032,46371,151661,20789,130872,28700,1471,54948,6246,83648,39507,11764,2268,10167,11228
CCAATTCCAGGCCAAG,sample,159961,157587,20653,136934,32046,104888,33406,1667,38691,4055,72097,27069,8164,1492,17320,19330
GGCATATAAGGCCAAG,Neg_Ctrl,2019,988,620,368,121,247,82,3,83,5,165,74,108,29,40,22
TCAATATAAGGCCAAG,sample,219618,217753,20664,197089,74485,122604,53047,1590,37449,3808,90496,26710,8130,1626,35529,39637
TCGCCTGAAGGCCAAG,sample,40493,40190,2947,37243,9207,28036,11797,613,10574,1657,22371,3395,3041,1014,5402,5921
TTATTCGAAGGCCAAG,sample,131693,130485,10486,119999,47600,72399,34292,1231,22001,2226,56293,12649,5049,1089,21631,26005
GACCGGAAAGGCCAAG,sample,70652,70027,8629,61398,14032,47366,17042,1069,17990,2200,35032,9065,4997,1188,8046,9397
GGAGAGTTAGAACCGC,sample,104379,100610,25281,75329,21076,54253,11924,481,20745,2037,32669,19066,6410,1034,6353,9863
TTCGTAATAGAACCGC,sample,85135,83572,12998,70574,21874,48700,19295,1174,16490,1789,35785,9952,5238,1614,8081,11926
TAGTACGGAGAACCGC,sample,181889,181013,10131,170882,75765,95117,45169,2437,28801,2906,73970,15804,6569,1490,24939,38446
CAACCGCGAGAACCGC,sample,170263,169158,6432,162726,104699,58027,44617,1319,10313,546,54930,1232,1195,588,32043,36261
GGACCTCTAGAACCGC,sample,684974,675113,101091,574022,169873,404149,125713,3327,141025,16149,266738,117935,15576,3569,84000,96914
CAAGGCCTAGAACCGC,sample,498151,492713,67790,424923,139512,285411,109344,4655,95431,10356,204775,65625,15563,3706,50762,78116
GTTAGCCGAGAACCGC,sample,237118,234462,24051,210411,107058,103353,49939,2001,30218,3764,80157,17431,6829,1499,33074,46911
CTTGATAGAGAACCGC,sample,212587,211276,8759,202517,107513,95004,64701,2451,23236,1734,87937,2882,1709,652,49910,49497
GGCCAGAGAGAACCGC,sample,76557,74629,12509,62120,10939,51181,16374,855,20053,2200,36427,11699,5490,1524,5495,7047
CATGATTCAGAACCGC,sample,178236,176856,8813,168043,89874,78169,60912,1669,11602,1398,72514,2588,1643,795,43786,39092
GTCCTGCCAGAACCGC,sample,212048,208798,24344,184454,63343,121111,47350,1439,40560,4038,87910,27724,5871,1363,27446,35461
CTAGGACCAGAACCGC,sample,290328,283013,46492,236521,49287,187234,39133,1232,73777,7269,112910,65823,12305,1799,24505,28047
ACGTATTAAGAACCGC,sample,324159,316235,62402,253833,55423,198410,55446,2849,76235,8825,131681,55055,12054,2230,28581,31368
AATATATCAGAACCGC,sample,243034,240050,25563,214487,80426,134061,63161,2768,42329,6485,105490,19318,4768,1228,41503,43167
ACCAATGCAGAACCGC,sample,169690,167601,13554,154047,60583,93464,50744,1792,26650,3576,77394,10702,4325,1227,35119,33478
GAAGGCGCAGAACCGC,sample,110210,107805,18315,89490,25389,64101,17279,646,24042,2374,41321,19760,7094,1006,10466,13852
GTACCGTAAGAACCGC,sample,228935,225274,24390,200884,76057,124827,54669,1615,35940,4387,90609,28216,4148,1151,37804,41455
GGAGAGTTCATCAAGC,sample,223604,220708,36645,184063,56515,127548,39177,1239,46799,4735,85976,35598,8346,1485,26021,30190
TATCAGTTCATCAAGC,sample,131643,130061,14183,115878,46790,69088,28360,1617,23246,3100,51606,12765,6159,1336,16313,24457
GGTTGCGTCATCAAGC,sample,147932,145409,28992,116417,22843,93574,24842,970,38963,4213,63805,24586,7869,1614,9296,13250
ACGTAAGTCATCAAGC,sample,215695,211664,33171,178493,60417,118076,43298,1268,40859,4497,84157,28154,7234,1328,29488,32305
TGAGCGCGCATCAAGC,sample,35377,34836,4599,30237,16642,13595,8181,258,2963,342,11144,1851,1718,583,6039,6463
GGACCTCTCATCAAGC,sample,210104,206750,25297,181453,71005,110448,49404,1721,33156,3380,82560,22787,7018,1514,31622,36911
GCCTTGCTCATCAAGC,sample,69589,67885,16185,51700,9811,41889,9890,303,17537,1777,27427,12382,6044,928,5230,5227
CAAGGCCTCATCAAGC,sample,216691,213466,30043,183423,68685,114738,50221,2257,36777,3524,86998,21959,7181,1639,30830,34857
CATAACCTCATCAAGC,sample,251584,246881,39396,207485,61164,146321,48540,1363,52560,5773,101100,38085,10036,1648,31481,34297
ACTATACTCATCAAGC,sample,76340,75185,8152,67033,15537,51496,20490,1168,21235,2065,41725,6538,3971,1478,8561,9979
GACGGAGACATCAAGC,sample,150385,147720,21839,125881,35819,90062,32927,1146,31892,3564,64819,20533,6526,1364,19924,21137
CCAGAGCGCATCAAGC,sample,167203,166005,7728,158277,91736,66541,54389,1987,7263,832,61652,2070,1480,980,40870,37435
GGAGGACGCATCAAGC,sample,141743,138693,24201,114492,29093,85399,26251,612,30915,3266,57166,24355,8872,1129,18048,17532
GGACGTAGCATCAAGC,sample,166556,164619,14552,150067,56867,93200,52027,841,23579,3109,75606,13644,3807,1002,40647,32219
CCATGAAGCATCAAGC,sample,146033,141858,39134,102724,21976,80748,14939,588,33817,3590,48756,27814,10325,1499,6724,9609
AATCCGTCCATCAAGC,sample,129644,127037,20591,106446,34233,72213,27506,867,23802,2861,51308,17177,5939,1111,18978,18342
GCCTGAACCATCAAGC,sample,198168,193098,37922,155176,32370,122806,29599,1687,48695,5300,78294,37525,10347,1678,16515,18568
ACGTATTACATCAAGC,sample,133385,132502,5286,127216,63294,63922,50332,839,9478,1218,59810,2055,1295,638,41041,30605
TTGGCCTCCATCAAGC,Pos_Ctrl,117380,114373,15459,98914,4778,94136,79757,6902,5221,655,84978,1601,6843,8901,4704,2513
AATATATCCATCAAGC,sample,700779,682827,163274,519553,48979,470574,92872,4996,205537,23627,298409,143542,20888,4468,18874,26681
GTACCGTACATCAAGC,sample,133683,132134,11629,120505,41770,78735,38918,1373,24541,2674,63459,11229,5224,1092,26184,24108
AGGTCGGACATCAAGC,sample,174474,172113,25545,146568,40360,106208,35734,1081,38688,4593,74422,26112,7822,1341,20298,23801
ATGACCGACATCAAGC,sample,126156,125305,6680,118625,65641,52984,35636,1845,9786,865,45422,4852,2940,1207,23878,28070
TCCAACTTAGAGAGCC,sample,155487,154384,9711,144673,80225,64448,43935,1099,12935,1214,56870,5265,1813,687,34275,33235
GGTTGCGTAGAGAGCC,sample,54412,54077,3942,50135,24567,25568,12857,738,7582,785,20439,3606,3418,1031,7744,11183
ACGTAAGTAGAGAGCC,sample,119020,117950,14824,103126,41089,62037,24427,1407,20471,2193,44898,13539,6734,1565,13495,21005
AGTACCATAGAGAGCC,sample,151346,150332,6076,144256,78223,66033,53490,1285,8915,579,62405,1764,1370,751,43419,35426
TTCTAATGAGAGAGCC,sample,172789,170672,26616,144056,51673,92383,30810,1669,33764,3618,64574,22522,7639,1650,16478,27225
TGAGCGCGAGAGAGCC,sample,101587,100880,4158,96722,51080,45642,36344,724,6810,694,43154,1070,1001,558,30211,23163
ACTATACTAGAGAGCC,sample,28710,27887,6031,21856,2454,19402,4620,252,8645,948,13265,4937,3873,893,977,1222
CCGCAACGAGAGAGCC,sample,133979,130748,25838,104910,15769,89141,21898,1406,37884,4239,59782,23714,8148,1564,7397,9029
ACCTCGAGAGAGAGCC,sample,85949,84197,12081,72116,21593,50523,16399,416,17520,1968,33919,14220,5800,924,10708,12256
AGTCCGCAAGAGAGCC,sample,99218,98469,4506,93963,44024,49939,39099,813,7693,1290,46792,1044,1225,632,31820,22607
GCCTGAACAGAGAGCC,sample,41216,40313,7368,32945,9634,23311,7243,292,8576,834,15819,6366,3597,629,4608,4918
CGTATGAAAGAGAGCC,sample,147443,144449,22316,122133,39746,82387,27098,804,30791,2978,57889,20716,5265,1048,17055,21552
TTGGCCTCAGAGAGCC,sample,95835,94562,10945,83617,31313,52304,24738,562,15669,1431,40407,9904,3316,760,17202,17155
GTCTTAGCAGAGAGCC,sample,162260,157796,30292,127504,25523,101981,23606,814,42609,4668,66215,30284,10171,1576,12480,16021
TTGGTTAAAGAGAGCC,sample,124345,123509,5985,117524,63451,54073,40023,1380,8431,1419,48454,2820,1587,812,28840,27712
GTACCGTAAGAGAGCC,sample,48835,47459,11389,36070,5369,30701,7145,517,13053,1515,20198,8471,5334,1274,1570,2928
TCAATATAAGAGAGCC,sample,232356,226904,45763,181141,41779,139362,31981,1539,56342,5873,88323,43627,11059,1852,14963,22451
GGTTGCGTAGCATTGA,sample,256071,252858,28928,223930,75108,148822,59294,3059,50958,5763,110252,29748,8742,1838,33998,41848
CCTCTAGAAGCATTGA,sample,268261,265902,16008,249894,119193,130701,80393,2943,30088,3008,110481,14269,3744,1165,61740,59312
ACGTTATGAGCATTGA,sample,284892,283259,10704,272555,156223,116332,95191,2656,13137,1919,108328,3429,1702,1003,73474,64936
TGAGCGCGAGCATTGA,sample,191987,190700,8524,182176,101674,80502,62042,1704,13082,1399,75124,2275,1355,717,47191,43116
CAACCGCGAGCATTGA,sample,111188,109761,20378,89383,15817,73566,18759,844,31549,3331,50308,19083,8784,1608,8811,9651
TCGCATCTAGCATTGA,sample,370435,366445,46782,319663,79694,239969,63533,2056,95073,10205,158606,69102,12936,2301,40721,47729
CAAGGCCTAGCATTGA,sample,191794,189794,18637,171157,38750,132407,45189,3398,56228,5658,101417,21934,7890,2316,9792,25912
ACTATACTAGCATTGA,sample,160158,158957,18037,140920,18704,122216,39630,2321,53217,6148,92847,20900,8263,2375,8140,13028
GACGGAGAAGCATTGA,sample,264261,261721,24342,237379,44841,192538,72665,3666,76965,7892,149630,31350,9216,2457,28303,30902
CCGCAACGAGCATTGA,sample,256600,252005,32683,219322,58018,161304,54254,2286,60053,6503,114307,38208,10969,2195,29341,35228
TGGACGAGAGCATTGA,sample,122009,119966,13623,106343,39274,67069,28055,1412,21347,2660,49402,13595,6841,1858,13717,21079
CATTGCAGAGCATTGA,sample,141224,140118,6019,134099,73129,60970,49906,1972,6417,671,56323,2004,2208,1505,30935,32442
CGAGGCAGAGCATTGA,sample,279972,277544,16065,261479,126971,134508,86339,2600,28784,4146,115123,12639,3217,1091,66004,62102
TTGGTACCAGCATTGA,sample,283406,280672,19226,261446,121100,140346,85214,3512,31733,3185,116947,16702,4205,1351,55981,60938
ACGTATTAAGCATTGA,sample,281624,280039,10330,269709,136326,133383,105056,2129,19418,2420,124474,4360,1706,967,80029,65010
AATATATCAGCATTGA,Neg_Ctrl,3123,1640,1068,572,184,388,120,5,181,13,301,69,145,32,72,49
TGCTTCGCAGCATTGA,sample,154367,153178,9764,143414,68143,75271,47497,1069,18815,1630,66312,6260,2493,815,34412,34489
AAGAGCGCAGCATTGA,sample,181926,180227,10532,169695,62237,107458,66261,3576,26777,2179,93038,8665,4461,1468,41681,36643
CCAATTCCAGCATTGA,sample,96544,94618,12009,82609,17681,64928,24993,1344,23885,3071,48878,11635,5919,1605,10009,10959
GTACCGTAAGCATTGA,sample,57080,55684,11040,44644,9978,34666,7855,289,13794,1549,21649,11179,4797,781,4094,5539
AGGTCGGAAGCATTGA,sample,50672,49830,5988,43842,14461,29381,9622,645,11922,1180,21544,6012,3881,873,4868,8156
TTATTCGAAGCATTGA,sample,178348,177325,6868,170457,92110,78347,59913,1696,12856,1665,72769,2217,1540,949,39222,40466
AAGTTCGTAATTACCA,sample,86288,84651,15473,69178,17340,51838,16871,624,19449,2472,36320,12422,4677,998,10009,10087
CCTCTAGAAATTACCA,sample,41838,40864,7983,32881,7232,25649,5920,246,10169,1110,16089,8204,4748,765,3047,4144
AGTACCATAATTACCA,sample,140257,137132,26614,110518,25388,85130,21048,878,32918,3468,53966,26818,8911,1610,10931,14301
TTCGTAATAATTACCA,sample,227567,220770,48322,172448,29273,143175,23377,766,61043,6114,84420,51875,12125,1563,12261,15992
CAACCGCGAATTACCA,sample,44813,44526,4072,40454,17523,22931,10580,592,6763,695,17343,4301,3634,945,6054,8844
AATGGTAAAATTACCA,sample,246244,243186,38006,205180,56797,148383,46051,1237,52637,5959,98688,42499,11087,1669,31028,33104
TTCCGTCTAATTACCA,sample,137714,136635,14747,121888,51444,70444,27747,943,24349,2294,52096,15111,6523,1002,18798,25845
GCCTTGCTAATTACCA,sample,158732,157316,11082,146234,55798,90436,50078,928,22625,2330,72703,14475,3339,892,39069,32502
CATAACCTAATTACCA,sample,227385,224311,31292,193019,44943,148076,48582,2044,58508,6018,107090,32924,9376,2181,21638,28090
ACTATACTAATTACCA,sample,102939,101268,20713,80555,20837,59718,16165,1020,22408,2455,38573,17670,8478,1913,6115,11017
CGAGGCAGAATTACCA,sample,38720,37103,11258,25845,3791,22054,3641,144,9407,1061,13048,7801,4580,482,1774,1770
CCATGAAGAATTACCA,sample,68408,67530,6046,61484,29070,32414,18419,518,8452,1047,26871,3978,3280,878,12766,13918
AATCCGTCAATTACCA,sample,49162,47338,14198,33140,5316,27824,4360,280,11788,1305,16148,10091,5823,857,1185,2776
AGTCCGCAAATTACCA,sample,77632,75857,16868,58989,9561,49428,12280,579,20164,2110,32444,14295,6406,1050,5182,5535
CTAGGACCAATTACCA,sample,45783,44753,7617,37136,12333,24803,10270,553,7934,795,18204,5251,4065,1346,3944,6230
GCCTGAACAATTACCA,sample,69737,68636,8470,60166,18253,41913,19067,954,13760,1586,32827,6546,4459,1310,9250,10658
ACGTATTAAATTACCA,sample,117771,115977,16584,99393,33725,65668,24162,1302,23005,2537,47167,14662,5884,1211,12584,18222
CGTATGAAAATTACCA,sample,394225,382627,106486,276141,39082,237059,43109,2141,100428,11173,143537,80208,17165,3070,14760,19936
AATATATCAATTACCA,sample,56103,54134,14295,39839,15805,24034,7189,409,8371,939,15560,7126,4152,718,4545,6508
TGCTTCGCAATTACCA,sample,140478,137106,33691,103415,14241,89174,17479,1006,37993,3914,55472,28782,11075,1842,5598,7508
GGCATATAAATTACCA,sample,92997,91823,10765,81058,32331,48727,23883,832,13517,1500,37400,8995,3023,762,16165,16791
CTTCATGAAATTACCA,sample,20677,20112,4053,16059,4459,11600,3903,253,4349,457,8252,2638,2678,683,1645,2397
ATGACCGAAATTACCA,sample,55206,54469,6413,48056,15193,32863,13621,448,10800,1143,24421,6851,3774,722,8557,8478
GACCGGAAAATTACCA,sample,52822,52355,5218,47137,16732,30405,15883,876,8231,1144,24114,4271,3191,1086,8548,9416
ATTCTCTTTAGATGAC,Pos_Ctrl,153121,151917,12110,139807,8386,131421,111841,11186,5498,878,117339,2018,7766,11478,9843,4481
ACGTAAGTTAGATGAC,sample,154054,153052,17878,135174,50214,84960,34591,1841,26648,3075,61239,18805,8506,1975,17835,26770
CCTCTAGATAGATGAC,sample,208791,206857,18932,187925,83490,104435,55859,1531,27220,2660,83079,17165,6906,1599,39468,41439
ACGTTATGTAGATGAC,Pos_Ctrl,154175,151734,17248,134486,7791,126695,108062,9736,6100,955,114162,1842,7851,10852,9769,4370
TTCTAATGTAGATGAC,sample,171623,170633,7598,163035,89621,73414,61220,1096,8456,1323,69676,1319,1133,649,50638,39188
TAGTACGGTAGATGAC,sample,184460,182933,21468,161465,60559,100906,38506,2166,33385,3353,71891,23496,7821,1973,22184,33278
TTAGAAGTTAGATGAC,sample,315813,311204,70514,240690,42586,198104,38049,1077,82215,8618,120264,68145,16369,2429,20160,23613
TTCCGTCTTAGATGAC,Pos_Ctrl,130492,127895,16695,111200,6476,104724,88563,7495,5937,743,94500,1986,7549,9736,7698,3529
GCCTTGCTTAGATGAC,sample,96143,95399,5294,90105,48036,42069,33139,496,6568,687,39707,1179,1385,654,27246,21442
CATAACCTTAGATGAC,sample,243064,237379,62285,175094,25602,149492,26039,867,62217,6482,88256,53887,14645,1944,12554,14455
ACTATACTTAGATGAC,sample,94160,93315,11531,81784,38571,43213,18476,793,12491,1200,30967,10253,3474,1127,11517,17695
GTTAGCCGTAGATGAC,sample,13624,13174,3264,9910,1977,7933,1842,58,3106,307,4948,2620,2164,289,984,1032
GGAGGACGTAGATGAC,sample,12059,11737,1974,9763,2089,7674,2849,86,2839,311,5688,1589,1774,406,1458,1256
CTTGATAGTAGATGAC,sample,188252,186316,19209,167107,65008,102099,59500,1881,22328,2824,81828,15566,3543,1022,43728,35428
CGAGGCAGTAGATGAC,sample,100180,98745,9765,88980,36954,52026,26589,646,13735,1812,40324,9244,3741,854,19887,19681
CCATGAAGTAGATGAC,sample,83956,82811,8633,74178,25701,48477,24896,610,13648,1585,38544,7738,4230,863,18183,14901
CTAGGACCTAGATGAC,sample,147181,145474,7936,137538,71861,65677,51473,1610,9862,973,61335,1759,1465,729,38693,32969
ACGTATTATAGATGAC,sample,76931,75851,8309,67542,16830,50712,21816,1319,17577,2015,39393,7985,4229,1420,8917,10842
AATATATCTAGATGAC,sample,232590,226979,39866,187113,49308,137805,41215,2047,51527,5533,92742,37483,10521,2092,20349,27561
TGCTTCGCTAGATGAC,sample,267497,262777,46369,216408,40035,176373,40963,1667,72084,7529,113047,54130,10856,2101,19612,25027
AAGAGCGCTAGATGAC,sample,193848,188788,46458,142330,17011,125319,26342,1404,55548,5926,81890,36099,11043,2010,7212,10113
CCAATTCCTAGATGAC,sample,32646,31719,6708,25011,4697,20314,6107,445,7719,864,13826,5179,3936,1160,1633,2661
TTGGTTAATAGATGAC,sample,267842,263561,38517,225044,48423,176621,41831,1571,72434,7235,114265,53550,13442,2379,20138,28877
GGAGAGTTGTTCAGAA,sample,138289,134999,27658,107341,21513,85828,18926,789,34228,3643,53154,28242,10434,1930,8264,11861
ATTCTCTTGTTCAGAA,sample,157447,151516,54351,97165,8072,89093,8894,478,40944,4481,49838,34296,11038,1421,1449,2343
TCCAACTTGTTCAGAA,sample,215700,211497,29879,181618,58197,123421,37036,1788,47172,4926,84208,32499,9110,1770,19118,32904
TCCTCCGTGTTCAGAA,sample,188235,183803,27119,156684,50149,106535,36002,1307,37546,3916,73548,27764,10248,1644,22787,27944
ACGTAAGTGTTCAGAA,sample,136910,133756,18790,114966,40669,74297,26661,937,25456,2863,52117,18380,4524,1032,17300,22794
GCCTTGCTGTTCAGAA,sample,44110,43620,3573,40047,16440,23607,10817,503,7308,721,18125,4258,3482,756,7258,8895
CATAACCTGTTCAGAA,sample,1017,981,252,729,166,563,164,10,231,21,395,137,256,55,89,96
GTTAGCCGGTTCAGAA,sample,50888,50528,2506,48022,24282,23740,14969,731,5207,477,20176,2356,2069,893,9592,11198
GGAGGACGGTTCAGAA,sample,45203,44381,8368,36013,6164,29849,6668,275,12635,1294,19303,8977,5826,973,2915,3483
CTTGATAGGTTCAGAA,sample,99108,97626,15828,81798,13870,67928,13684,674,29287,3353,42971,20930,8498,1215,6542,8986
TGGACGAGGTTCAGAA,sample,44478,43199,8580,34619,5703,28916,7357,377,11883,1319,19240,7980,4729,839,3391,3229
GGCCAGAGGTTCAGAA,sample,60588,58444,12971,45473,7544,37929,10470,554,15007,1737,25477,10161,6379,1429,3531,3955
CATTGCAGGTTCAGAA,sample,22353,21799,3982,17817,4893,12924,4324,157,4635,495,8959,3313,2490,468,2953,2627
AATCCGTCGTTCAGAA,sample,84199,83114,6118,76996,34522,42474,24611,842,11032,1273,35643,4716,3345,913,17028,17660
CGTACGTCGTTCAGAA,sample,127747,122585,32871,89714,14759,74955,16286,606,31142,3038,47428,23883,9000,1293,8254,7465
CGGATTACGTTCAGAA,sample,222806,221512,22919,198593,48109,150484,45786,1933,56793,6373,102579,39599,11535,2613,19470,29856
ACGTATTAGTTCAGAA,sample,76097,75556,4069,71487,33722,37765,29112,481,6771,478,35883,923,1119,511,23291,16880
ACCAATGCGTTCAGAA,sample,171331,170293,13117,157176,48961,108215,34024,1166,37944,3892,71968,31189,10682,1878,21752,29640
GAAGGCGCGTTCAGAA,sample,59197,58909,4887,54022,20603,33419,14846,508,11160,1156,26006,5749,3999,867,8574,11275
GTACCGTAGTTCAGAA,sample,78949,78043,7113,70930,19057,51873,23365,1204,17884,2051,41249,7369,4040,1323,9398,11827
GGCATATAGTTCAGAA,sample,103979,102513,13765,88748,25341,63407,19726,659,22533,2450,42259,18039,7125,906,13445,15319
AGGTCGGAGTTCAGAA,Pos_Ctrl,172410,167770,20533,147237,6762,140475,118069,10497,8221,1126,126290,2562,7442,10668,7111,3441
ATGACCGAGTTCAGAA,sample,137614,135094,14553,120541,36417,84124,39632,1823,24852,2784,64484,15033,6644,1654,21061,22166
GGAGAGTTTTCTGGTT,sample,688,666,114,552,200,352,129,6,103,14,232,100,128,34,92,111
TATCAGTTTTCTGGTT,sample,60435,59652,11765,47887,10018,37869,9033,468,14459,1585,23492,12324,5848,732,5956,5729
TCCAACTTTTCTGGTT,Neg_Ctrl,1928,1013,704,309,114,195,68,1,69,7,137,50,86,17,41,24
ACGTAAGTTTCTGGTT,sample,98260,97555,5208,92347,51330,41017,32179,1089,5238,1053,37417,1458,1051,535,26368,22099
CCTCTAGATTCTGGTT,sample,49205,48614,4917,43697,16332,27365,13407,593,7910,1193,21317,4262,3492,1194,7364,9041
TTCTAATGTTCTGGTT,Neg_Ctrl,3298,2031,1668,363,127,236,77,2,65,14,142,78,82,25,48,28
TAGTACGGTTCTGGTT,sample,178015,176519,12207,164312,80070,84242,50158,1087,20029,2314,70187,10654,3551,960,38473,38355
TTCCGTCTTTCTGGTT,sample,146293,141334,39905,101429,13712,87717,11747,509,38080,4190,49827,33191,10617,1194,5231,7201
GGACCTCTTTCTGGTT,Neg_Ctrl,1710,985,621,364,81,283,80,2,119,13,199,69,106,17,47,28
TCGCATCTTTCTGGTT,sample,705988,694568,104277,590291,66502,523789,73515,2484,227705,23370,301220,196715,21735,5631,29879,37450
CAAGGCCTTTCTGGTT,sample,222486,219695,20466,199229,63134,136095,59230,1727,44438,5475,103668,25225,4619,1235,34859,40161
CATAACCTTTCTGGTT,sample,318890,313322,43086,270236,64630,205606,64081,1842,78619,7558,142700,53506,9703,2360,37956,41388
CGAGGCAGTTCTGGTT,sample,41033,38488,14015,24473,2742,21731,2709,121,9677,1003,12386,8221,4760,406,1098,1069
AATCCGTCTTCTGGTT,sample,82421,80524,13753,66771,13695,53076,18391,1015,19746,2288,38137,11636,6021,1356,6694,7982
CGGATTACTTCTGGTT,sample,78648,77904,2918,74986,36599,38387,28480,729,6368,914,34848,1896,926,448,23088,18041
GTTAGGACTTCTGGTT,sample,81671,80927,6024,74903,38103,36800,29269,602,5203,602,34472,1124,899,490,24114,17649
GCCTGAACTTCTGGTT,sample,158678,154231,36143,118088,13603,104485,17025,644,45094,4551,62119,37171,10539,1321,8690,6833
TGCTTCGCTTCTGGTT,sample,45911,45373,3033,42340,16641,25699,16501,417,5808,474,22309,2499,1287,475,12860,9485
AAGAGCGCTTCTGGTT,sample,52351,50651,14306,36345,5796,30549,5150,323,13147,1388,18297,10541,6029,978,1748,2364
GTACCGTATTCTGGTT,sample,23121,22581,4727,17854,3896,13958,4154,232,5357,579,9511,3636,3171,693,1900,2114
GACCGGAATTCTGGTT,sample,54611,54333,2525,51808,27655,24153,19644,498,3244,311,22888,456,870,476,14518,12078
GGAGAGTTGTTCGGTT,sample,194278,191689,22389,169300,59974,109326,39689,1464,38450,4615,78139,25108,8941,1625,24238,33235
TATCAGTTGTTCGGTT,sample,161789,160513,5810,154703,80269,74434,62603,1167,8513,694,71116,1457,1265,711,50757,37939
TCCAACTTGTTCGGTT,sample,127241,125939,7848,118091,50419,67672,39699,1871,18478,1746,58177,5878,3674,1425,24967,27122
ACGTAAGTGTTCGGTT,sample,230568,227568,22416,205152,91417,113735,60548,1475,31153,3336,91701,17223,3944,1059,46413,44697
AGTACCATGTTCGGTT,sample,162353,161056,10497,150559,93842,56717,35642,1334,11174,1301,46816,7266,3852,1223,25547,33100
TTCTAATGGTTCGGTT,sample,118823,115224,15084,100140,25869,74271,27697,1598,29047,3840,56744,12089,5760,1532,9198,15426
ATGCCTGGGTTCGGTT,sample,78316,76771,11112,65659,11131,54528,17035,1136,23943,2813,40978,9601,4918,1562,5026,6837
TTAGAAGTGTTCGGTT,sample,131384,129030,16001,113029,38404,74625,30021,1672,25586,2648,55607,14698,7349,1686,16856,21357
TTCCGTCTGTTCGGTT,sample,164593,160853,26723,134130,41566,92564,27784,1076,33737,3864,61521,26103,8994,1353,17324,22354
CAAGGCCTGTTCGGTT,sample,319076,314732,29236,285496,101652,183844,77759,4645,60902,6535,138661,34003,6868,1662,42504,58260
CATAACCTGTTCGGTT,sample,55922,54911,7327,47584,11609,35975,14657,882,12012,1362,26669,7062,4788,1824,5175,6579
CCAGAGCGGTTCGGTT,sample,263648,258219,37793,220426,62166,158260,43074,1938,62373,7144,105447,43731,10905,1852,22055,35830
CCGCAACGGTTCGGTT,sample,83634,82523,7302,75221,17920,57301,23276,1496,21855,3081,45131,7593,3990,1312,8531,11528
GGACGTAGGTTCGGTT,sample,117174,116286,5543,110743,52202,58541,46709,1158,9221,393,55930,1060,1161,656,37254,26647
CATTGCAGGTTCGGTT,sample,136438,135196,8186,127010,49285,77725,46539,2085,18767,2453,65306,7881,2997,983,32555,27911
CCATGAAGGTTCGGTT,sample,127352,125314,12234,113080,46503,66577,31801,1378,19301,1953,51102,12144,5003,1215,20575,24234
AATCCGTCGTTCGGTT,sample,193303,190244,19562,170682,63016,107666,45687,2568,34422,3489,80109,21500,6776,1615,27061,35056
CGTACGTCGTTCGGTT,sample,126422,124843,11765,113078,44909,68169,35367,1588,19280,2575,54647,9359,5264,1282,21802,24247
AGTCCGCAGTTCGGTT,sample,179931,177592,20041,157551,61702,95849,43725,1214,27536,2928,71261,20446,5042,1116,31324,32109
GTTAGGACGTTCGGTT,sample,99296,98659,6764,91895,51543,40352,24065,1315,8086,866,32151,6020,4066,1688,13349,20644
ACGTATTAGTTCGGTT,sample,279260,274271,39480,234791,54789,180002,47283,1785,71873,7079,119156,51982,11211,1966,24275,31230
AATATATCGTTCGGTT,sample,256295,253592,23322,230270,72336,157934,66886,2883,52867,5543,119753,29755,8741,1593,41650,42421
CCAATTCCGTTCGGTT,sample,78715,78314,4065,74249,31182,43067,18586,948,15051,1691,33637,6791,4452,987,10697,16468
CTTCATGAGTTCGGTT,sample,144827,142725,17828,124897,45818,79079,37737,1015,23380,2379,61117,14568,4501,898,27840,25684
TTATTCGAGTTCGGTT,Neg_Ctrl,2300,1394,931,463,135,328,117,8,116,5,233,82,143,28,73,44
TATCAGTTTGGCGGTT,sample,259568,255429,32273,223156,76581,146575,51860,1828,52917,6120,104777,33850,8914,1678,31955,41290
AAGTTCGTTGGCGGTT,sample,206896,202666,33187,169479,41609,127870,37180,1992,47381,5248,84561,36069,10317,2545,16409,24538
GGTTGCGTTGGCGGTT,sample,134587,130115,30250,99865,19536,80329,14340,644,33610,3562,47950,28173,10093,1292,7713,10330
ACGTAAGTTGGCGGTT,sample,274674,272686,13829,258857,159858,98999,70975,3679,15406,1907,86381,7032,4607,2209,41797,58478
CCTCTAGATGGCGGTT,sample,123175,121629,8619,113010,59238,53772,31458,1985,13313,1563,44771,5453,4094,1669,17420,26385
AGTACCATTGGCGGTT,sample,388757,380520,58197,322323,114379,207944,61169,2627,72994,8198,134163,62956,13323,2768,30447,58931
CAACCGCGTGGCGGTT,sample,368353,366048,17471,348577,160863,187714,125449,2685,36356,5650,161805,17574,4553,1465,89292,81805
AATGGTAATGGCGGTT,sample,121260,120756,4888,115868,67488,48380,25234,1353,15030,1734,40264,5029,4560,1844,13048,25922
TTCCGTCTTGGCGGTT,sample,376229,373896,13114,360782,180239,180543,136650,3949,27370,4523,164020,8051,2326,927,105950,86823
CAAGGCCTTGGCGGTT,sample,632476,623267,68024,555243,133275,421968,165851,12368,142488,14194,308339,87067,14044,3359,63962,86587
CATAACCTTGGCGGTT,sample,381555,378488,20236,358252,169307,188945,134776,3351,33880,3891,168656,13047,3444,1181,97762,84137
GGACGTAGTGGCGGTT,sample,217989,215195,17316,197879,75606,122273,56504,2784,37414,4123,93918,21448,8154,1870,33464,41157
CTTGATAGTGGCGGTT,sample,117496,114756,20120,94636,14712,79924,19985,1345,33849,3896,53834,20849,7458,1641,7480,8719
GTCCTGCCTGGCGGTT,sample,210954,208458,14892,193566,74002,119564,61019,2546,35745,4251,96764,16003,6621,1450,37662,41309
TTGGTACCTGGCGGTT,sample,341597,334735,52027,282708,78246,204462,76643,1798,69336,7646,145979,49039,7654,1890,55123,41812
GTTAGGACTGGCGGTT,sample,196088,194163,12409,181754,90339,91415,61621,2541,16365,1683,77986,9205,4764,2219,35222,42078
AACTCGTATGGCGGTT,sample,272355,269765,12958,256807,120126,136681,111838,1900,17363,1958,129201,3622,1408,728,92842,62039
TGCTTCGCTGGCGGTT,sample,251528,244172,35674,208498,61119,147379,49501,2015,53267,6006,102768,36590,9969,1974,27744,34059
CCAATTCCTGGCGGTT,sample,134466,133199,5682,127517,62220,65297,51178,1166,9856,1230,61034,1867,1209,662,36565,30454
ATGACCGATGGCGGTT,sample,164370,163128,15203,147925,52010,95915,27387,1956,38842,4326,66229,23404,7925,1458,10341,28784
AAGTTCGTTCCTTATT,sample,63290,62706,7968,54738,14135,40603,12530,405,15186,1865,27716,10617,5655,958,6649,8770
GGTTGCGTTCCTTATT,sample,59892,59279,9094,50185,13712,36473,10160,336,13409,1384,23569,11184,5761,857,6273,8056
TCCTCCGTTCCTTATT,sample,117810,116608,14017,102591,25950,76641,22299,980,30764,3819,53063,18779,7071,1294,10767,16362
ACGTTATGTCCTTATT,sample,53545,53159,10475,42684,6756,35928,6497,423,15124,1599,21621,12285,7205,1285,2094,3876
TTCTAATGTCCTTATT,sample,1176,1148,159,989,391,598,212,10,179,21,391,176,202,47,137,192
TAGTACGGTCCTTATT,sample,75669,75257,3693,71564,35748,35816,24966,547,6865,827,31831,2611,1615,642,18395,16797
GTTAGCCGTCCTTATT,sample,133415,131718,24329,107389,16238,91151,17848,802,37813,4388,55661,30300,10380,1528,8882,9124
GGAGGACGTCCTTATT,sample,54994,54352,3332,51020,24011,27009,22471,524,2926,240,25397,848,791,417,18445,12064
GGCCAGAGTCCTTATT,sample,17183,16866,2468,14398,2487,11911,3773,194,4742,565,8515,2637,2378,662,1083,1445
CCATGAAGTCCTTATT,sample,39366,38774,6240,32534,7641,24893,8843,451,8307,820,17150,6472,4025,918,4119,4127
CGTACGTCTCCTTATT,sample,45023,44284,7006,37278,6677,30601,10167,579,12387,1609,22554,5859,3157,744,4338,4366
TTGGCCTCTCCTTATT,Pos_Ctrl,49899,48398,6896,41502,1987,39515,33474,2746,2347,304,35821,644,5544,6136,1682,1086
GAAGGCGCTCCTTATT,sample,123841,122510,15583,106927,24184,82743,25947,686,33641,3350,59588,19119,5411,1076,15337,15299
AAGAGCGCTCCTTATT,sample,128224,125649,26539,99110,13635,85475,13042,688,36049,3474,49091,32222,9438,1268,5406,7137
TATCAGTTAATAAGGT,sample,391888,385870,62904,322966,95789,227177,76592,1383,78324,8127,154916,62751,10526,2278,50967,53386
TCCAACTTAATAAGGT,sample,65433,64502,5386,59116,15574,43542,20545,1177,15125,1979,35670,4716,3725,1554,8825,9796
GGTTGCGTAATAAGGT,sample,69167,67974,11435,56539,17592,38947,12585,776,14523,1676,27108,9387,5182,1517,5347,9191
ACGTAAGTAATAAGGT,sample,363804,358115,38601,319514,107722,211792,74144,2513,72683,7061,146827,55391,9711,2019,50845,61059
CCTCTAGAAATAAGGT,sample,89797,88444,12967,75477,22314,53163,16843,838,19172,1970,36015,14340,7207,1712,8664,12365
TTCGTAATAATAAGGT,sample,347718,340653,51629,289024,95151,193873,74365,3280,60280,6512,134645,49436,12106,2153,49949,51919
TCGCATCTAATAAGGT,sample,95920,95127,7020,88107,42279,45828,28349,1422,9949,1007,38298,5101,4133,1702,16573,20036
GTTAGCCGAATAAGGT,sample,369015,363837,49481,314356,89640,224716,76327,3627,79834,8520,156161,56408,11721,2315,37927,53257
CCGCAACGAATAAGGT,Pos_Ctrl,261253,252657,30388,222269,10410,211859,177989,14915,13353,1824,191342,3778,8234,12480,11747,5084
GGACGTAGAATAAGGT,sample,279233,275218,35181,240037,48101,191936,60091,2399,74645,7450,134736,47351,10515,1891,34737,30863
ACCTCGAGAATAAGGT,sample,489193,480869,79408,401461,32301,369160,114491,8115,158006,18584,272497,69964,16359,3554,27764,18088
GACGATAAAATAAGGT,sample,256460,253108,28154,224954,61480,163474,61030,2781,57190,5467,118220,37006,9463,2073,31107,38400
CATTGCAGAATAAGGT,sample,180929,178126,18729,159397,47126,112271,44153,1396,36691,3843,80844,26188,6915,1386,27958,27652
CCATGAAGAATAAGGT,sample,183725,181792,13841,167951,62951,105000,52084,965,29082,3419,81166,19450,4629,1206,36336,35773
AATCCGTCAATAAGGT,Pos_Ctrl,4579,4505,479,4026,295,3731,2992,322,260,32,3252,125,1619,1385,208,181
ACGTATTAAATAAGGT,sample,335229,330219,31939,298280,98143,200137,75866,2348,66991,7482,142857,47450,8032,1969,53721,59040
GAAGGCGCAATAAGGT,sample,147856,145738,20110,125628,36515,89113,33967,1884,28425,2987,62392,21850,8125,2042,15657,21271
AGGTCGGAAATAAGGT,sample,495467,486796,72672,414124,99143,314981,84980,2505,119420,12438,204400,95638,13182,3496,51608,58617
TCCAACTTCAGGACCA,sample,223509,218015,30856,187159,46173,140986,54024,2466,53938,6915,107962,23643,6778,1693,26053,27788
ACGTAAGTCAGGACCA,sample,227613,225296,9882,215414,113228,102186,82361,1349,13668,1897,96029,2911,1635,801,64398,52268
CCTCTAGACAGGACCA,sample,183693,179446,26343,153103,47688,105415,32098,1221,40188,4527,72286,27381,8946,1680,19474,26343
TTCTAATGCAGGACCA,sample,162753,156964,41632,115332,21160,94172,19104,930,40149,4009,59253,29980,9860,1991,5763,10641
CAACCGCGCAGGACCA,sample,389969,377176,91204,285972,54615,231357,51279,1923,98219,10428,149498,69508,13202,2462,27172,29243
CAAGGCCTCAGGACCA,sample,461592,458159,33400,424759,141868,282891,126245,4404,94258,10680,220503,47304,9650,1961,71940,83000
ACTATACTCAGGACCA,sample,393949,387638,50702,336936,110144,226792,52030,1211,90259,8628,142289,74664,11789,1862,31798,58965
GACGGAGACAGGACCA,sample,280276,278006,14076,263930,119404,144526,90694,2496,33837,4110,124531,13389,4572,1137,64284,62464
GGAGGACGCAGGACCA,sample,200508,197587,20901,176686,47022,129664,52920,3127,46550,5649,99470,21418,7220,2259,20611,29304
GGACGTAGCAGGACCA,sample,349476,346149,27195,318954,109465,209489,115935,3727,50784,5100,166719,33943,5259,1486,77861,63475
GACGATAACAGGACCA,sample,358350,352913,41439,311474,101798,209676,91396,4700,67010,8483,158406,38087,9567,2226,52348,57744
GGCCAGAGCAGGACCA,sample,246373,237026,43930,193096,35197,157899,37685,1529,64923,6988,102608,46774,11577,1968,20640,21616
ACGACTTCCAGGACCA,sample,269920,260122,47671,212451,53903,158548,51339,1678,58667,6356,110006,40508,9743,1799,29859,29807
CGTACGTCCAGGACCA,sample,176473,174915,7013,167902,87777,80125,62479,1391,12792,1228,75271,2235,1317,720,49719,40527
CGTATGAACAGGACCA,sample,424289,408890,95698,313192,61763,251429,45967,1961,108025,11595,153992,83881,15265,2756,17701,33616
AATATATCCAGGACCA,Neg_Ctrl,4397,2916,2206,710,191,519,187,4,187,22,374,119,221,43,108,90
TGCTTCGCCAGGACCA,sample,179885,178296,12240,166056,67342,98714,67751,2789,18696,2548,86447,6930,2306,822,38546,38537
CCAATTCCCAGGACCA,sample,86182,84750,6748,78002,20987,57015,27664,1583,19643,2686,47307,5439,3908,1342,11739,13381
TTGGTTAACAGGACCA,sample,235832,232335,27821,204514,74693,129821,62840,1667,39241,3941,102081,22132,4948,1273,42639,40828
GGCATATACAGGACCA,sample,220301,214750,35132,179618,43670,135948,44014,2109,50849,5705,94863,33271,9424,2120,15319,26482
GACCGGAACAGGACCA,sample,200036,198449,10035,188414,87721,100693,73803,1596,17827,2530,91630,4937,1852,804,49820,45039
TCCAACTTCCTCGTTG,sample,237118,234751,17465,217286,108784,108502,72452,1838,20277,3068,92729,10867,2708,1124,54936,50811
AAGTTCGTCCTCGTTG,sample,92689,90902,15507,75395,22001,53394,17169,825,18890,2364,36059,14146,6715,1453,9137,12195
CCTCTAGACCTCGTTG,sample,466021,456568,102861,353707,52896,300811,56428,2646,125229,13359,181657,103149,18509,3873,25364,29780
AATGGTAACCTCGTTG,sample,200511,199310,6770,192540,101754,90786,73427,1405,12379,1113,85806,2462,1210,621,61039,46854
TTAGAAGTCCTCGTTG,sample,127101,125467,11996,113471,45270,68201,37192,1628,18116,1857,55308,9408,3222,1046,25728,24606
TTCCGTCTCCTCGTTG,sample,84779,82812,18349,64463,17950,46513,13515,768,17771,2026,31286,12433,6073,1397,6274,9232
GCCTTGCTCCTCGTTG,sample,128612,126328,18604,107724,32479,75245,23846,821,28055,3590,51901,18933,5699,1127,14973,18969
CAAGGCCTCCTCGTTG,sample,178436,175792,20443,155349,55099,100250,50432,1310,24278,2282,74710,21948,3570,934,38239,32190
ACTATACTCCTCGTTG,sample,51235,50127,9076,41051,7370,33681,9198,547,14222,1550,23420,8164,4426,1167,2791,4213
GTTAGCCGCCTCGTTG,sample,52525,51818,3240,48578,26123,22455,17954,146,2550,189,20504,1616,795,430,15058,11712
GGAGGACGCCTCGTTG,sample,79533,77353,19392,57961,8885,49076,11035,597,20825,2520,31860,14099,7858,1370,3041,4745
GGACGTAGCCTCGTTG,Neg_Ctrl,2775,1358,957,401,142,259,93,3,76,9,169,78,97,25,50,21
CTTGATAGCCTCGTTG,sample,39573,38802,4867,33935,11254,22681,5901,281,8097,1009,13998,7393,2238,478,3007,6457
TGGACGAGCCTCGTTG,sample,171715,169542,19154,150388,56857,93531,52962,1933,22099,2464,75061,14073,4720,1326,32853,30781
GGCCAGAGCCTCGTTG,sample,158696,154103,33130,120973,18688,102285,17352,759,42772,4246,60124,37156,10647,1510,7720,10341
AATCCGTCCCTCGTTG,sample,35646,34800,7083,27717,5951,21766,5781,259,8329,912,14110,6485,3285,694,2792,3199
CGTACGTCCCTCGTTG,Neg_Ctrl,3161,1557,1241,316,100,216,90,3,70,6,160,47,97,23,56,15
TTGGTACCCCTCGTTG,sample,81840,78176,32966,45210,2589,42621,3070,123,20074,2114,23144,17240,7837,423,241,886
GCCTGAACCCTCGTTG,sample,123887,122496,6800,115696,57113,58583,44576,1115,9336,1220,53912,2336,1413,631,35610,27487
TGCTTCGCCCTCGTTG,sample,102086,99750,20172,79578,25154,54424,13487,634,20564,2082,34051,17657,7140,1206,6335,12283
GTACCGTACCTCGTTG,Pos_Ctrl,143722,137539,20998,116541,5846,110695,92684,7741,7118,938,99802,2214,7209,9361,5473,2800
TTATTCGACCTCGTTG,sample,173332,172154,6091,166063,85551,80512,64013,2201,10409,2118,74422,1771,1086,525,51383,39821
ACGTAAGTTTGCGGAC,sample,230466,229616,7999,221617,134175,87442,68601,2738,10463,1544,79064,4096,2359,1350,44915,51363
ACGTTATGTTGCGGAC,sample,301258,298884,27460,271424,110656,160768,84303,1389,40513,4885,124816,29678,6252,1537,66483,59757
TTAGAAGTTTGCGGAC,sample,194974,193348,18739,174609,67937,106672,46527,1088,32351,3409,78878,23297,8890,1601,30662,35831
TTCCGTCTTTGCGGAC,sample,197898,195463,30527,164936,57286,107650,41013,1193,33804,3503,74817,28137,7779,1210,29435,30970
ACTATACTTTGCGGAC,sample,173446,170384,20106,150278,53810,96468,38971,1136,31212,3576,70183,21573,5263,1234,26324,30686
GACGGAGATTGCGGAC,sample,131518,130113,8971,121142,52718,68424,39958,1129,16588,1719,56546,9030,3864,1091,27694,26979
GTTAGCCGTTGCGGAC,sample,43550,42758,8804,33954,9263,24691,9839,409,9228,1103,19067,4112,3062,905,3786,6434
GGAGGACGTTGCGGAC,sample,38742,38012,5560,32452,9978,22474,8602,443,7860,911,16462,4658,3640,743,5268,5791
CGGATTACTTGCGGAC,sample,270259,267166,28387,238779,82249,156530,65229,1799,48632,5603,113861,35267,6259,1356,44873,46035
GTTAGGACTTGCGGAC,sample,172556,169274,26401,142873,38151,104722,30581,1663,43725,4427,74306,24326,8698,1532,14882,22075
GTCTTAGCTTGCGGAC,sample,99040,96823,17732,79091,17207,61884,16408,613,25212,2436,41620,17215,7488,1260,8409,9759
GTACCGTATTGCGGAC,sample,166677,164197,20109,144088,45499,98589,39093,1324,34775,4441,73868,18956,7376,1340,21493,26668
GACCGGAATTGCGGAC,sample,161611,160715,4881,155834,80729,75105,58011,1631,12297,1439,70308,1727,1181,543,45833,37702
TCCAACTTTCCATTGG,sample,29207,28859,5201,23658,5902,17756,5217,266,6982,791,12199,4500,4032,937,2251,3375
GGTTGCGTTCCATTGG,sample,101538,100662,8883,91779,31019,60760,30595,1399,15553,1636,46148,11577,6224,1834,13699,18070
TGAGCGCGTCCATTGG,sample,97629,96409,13637,82772,21775,60997,17284,399,22999,2373,40283,17942,6948,985,11288,12888
TTCCGTCTTCCATTGG,sample,200455,198360,37341,161019,22619,138400,25646,605,57068,6135,82714,48946,14327,2078,13254,12926
GGACCTCTTCCATTGG,sample,69557,68688,7614,61074,21326,39748,18059,307,12236,1248,30295,7898,3024,685,13337,11940
ACTATACTTCCATTGG,sample,26063,25421,6873,18548,4220,14328,3014,152,5609,674,8623,4879,3606,476,1513,2124
CCGCAACGTCCATTGG,sample,37718,36909,8213,28696,4579,24117,4337,132,9637,1004,13974,9007,4861,423,2720,2556
CCATGAAGTCCATTGG,sample,42547,41745,8477,33268,7606,25662,7240,252,9689,1001,16929,7480,4549,697,4255,4223
ACGACTTCTCCATTGG,sample,30380,29386,9363,20023,1876,18147,1831,55,7845,809,9676,7607,3998,317,740,711
CGTACGTCTCCATTGG,sample,26322,26016,1598,24418,11165,13253,10509,242,1715,333,12224,454,772,414,8229,5876
TTGGTACCTCCATTGG,sample,55710,54774,7233,47541,15926,31615,13671,413,10075,1306,23746,6150,3209,666,8519,8627
AACTCGTATCCATTGG,sample,243061,236833,60304,176529,16349,160180,21584,718,69841,7335,91425,60702,15716,2097,8249,7800
GGCATATATCCATTGG,Neg_Ctrl,1220,607,392,215,48,167,72,1,56,6,128,32,70,21,37,11
GACCGGAATCCATTGG,sample,44162,43734,3469,40265,14813,25452,13471,337,7398,913,20869,3333,1811,468,9165,8488
TATCAGTTCATAGGCG,sample,210530,206174,43212,162962,22905,140057,33744,1652,62031,7045,95775,35585,9539,2077,10027,12913
ATTCTCTTCATAGGCG,sample,276260,271301,49245,222056,50201,171855,35113,1568,72774,7697,107887,54703,11444,2001,17219,28012
TCCTCCGTCATAGGCG,sample,218990,211523,68976,142547,10678,131869,14192,681,60869,6471,75061,49656,13137,1936,2953,4773
TTCTAATGCATAGGCG,sample,337669,333760,30063,303697,104942,198755,89081,2414,59364,6603,148445,41293,5800,1626,62577,62071
AATGGTAACATAGGCG,sample,123956,120943,23937,97006,27440,69566,12097,716,30173,3159,42270,23421,7593,1097,4085,14476
TTAGAAGTCATAGGCG,sample,391636,381716,88134,293582,37109,256473,45306,2224,106637,11437,151943,90869,15900,3139,14883,21082
TTCCGTCTCATAGGCG,sample,183917,179885,39791,140094,38316,101778,20879,1220,41368,4278,62247,34033,10032,1647,9070,19622
CAAGGCCTCATAGGCG,sample,636113,627303,75100,552203,133875,418328,113818,4754,159516,15403,273334,124837,16603,3631,56975,85966
GTTAGCCGCATAGGCG,sample,71666,70046,16668,53378,6304,47074,11191,524,21489,2400,32680,11470,5407,1172,3316,3601
CTTGATAGCATAGGCG,sample,68467,67158,9505,57653,10944,46709,16419,880,19037,1955,35456,8418,4388,1252,4673,6702
CCATGAAGCATAGGCG,sample,17446,17283,1969,15314,3200,12114,3703,275,4654,465,8357,3017,3317,936,1189,1938
GTTAGGACCATAGGCG,sample,73008,70895,15775,55120,13787,41333,11092,495,15812,1799,26904,12135,5591,971,6270,7216
TGCTTCGCCATAGGCG,sample,401860,389938,93741,296197,37020,259177,37832,1772,112549,11732,150381,95292,18542,3305,14221,18816
AAGAGCGCCATAGGCG,sample,402841,392868,88584,304284,69961,234323,51271,1635,92426,8637,143697,80354,11836,2503,27013,39975
GTCTTAGCCATAGGCG,sample,128721,126282,20579,105703,28854,76849,28574,2293,23736,2502,52310,19744,7434,1488,12866,16445
CTTCATGACATAGGCG,sample,164838,162262,14066,148196,53350,94846,40972,1113,31254,3782,72226,17725,5680,1150,27233,29904
AGGTCGGACATAGGCG,sample,242732,237386,37668,199718,49999,149719,44252,1116,60952,6361,105204,37038,7973,1725,25347,29764
TTATTCGACATAGGCG,sample,147390,145289,16356,128933,39482,89451,38350,2491,26766,3294,65116,18550,6642,1646,16924,23105
ATGACCGACATAGGCG,sample,165190,162616,24417,138199,35088,103111,33134,1475,38337,4074,71471,26091,8527,1455,19324,20962
TATCAGTTTTGGAGAG,sample,200263,197052,32160,164892,55816,109076,29501,1425,38687,4081,68188,35382,10329,1961,15488,28883
ATTCTCTTTTGGAGAG,Pos_Ctrl,230846,223926,31575,192351,10564,181787,153462,12256,11410,1314,164872,3345,8176,11555,12363,6108
ACGTAAGTTTGGAGAG,sample,53073,51368,13818,37550,5032,32518,5540,370,15110,1522,20650,9976,5602,842,2000,2581
AGTACCATTTGGAGAG,sample,80821,79204,13897,65307,26754,38553,11780,497,13514,1327,25294,11435,5289,826,7789,12541
TGAGCGCGTTGGAGAG,sample,65750,64654,8197,56457,21548,34909,17839,890,9808,944,27647,5428,4288,1616,8642,11443
TTCCGTCTTTGGAGAG,Pos_Ctrl,129531,124445,20208,104237,5867,98370,82283,6532,6635,961,88918,1959,7296,8950,6131,3019
GGACCTCTTTGGAGAG,sample,143823,142142,13192,128950,50929,78021,36295,2003,23667,2676,59962,13380,5292,1432,21358,27689
GACGATAATTGGAGAG,sample,399192,385758,94315,291443,37078,254365,39037,1130,108724,11339,147761,94135,18671,3158,16931,20781
AATCCGTCTTGGAGAG,sample,155356,149206,38752,110454,15059,95395,16553,865,41967,4736,58520,31274,10844,1840,5344,7889
CGTACGTCTTGGAGAG,sample,116192,112423,21965,90458,21532,68926,20419,732,25879,2976,46298,18920,6912,1162,11574,12606
CGGATTACTTGGAGAG,sample,361246,354659,59519,295140,70569,224571,63233,1544,82207,8877,145440,68710,10408,2246,42406,41815
GCCTGAACTTGGAGAG,sample,225878,220704,40879,179825,38121,141704,32685,816,56956,6094,89641,45153,11444,1630,19497,23650
AATATATCTTGGAGAG,sample,238730,233407,43210,190197,50431,139766,42571,1794,50220,5639,92791,39542,10360,1797,23589,28861
GTCTTAGCTTGGAGAG,sample,132278,127985,30647,97338,13112,84226,17972,1437,34369,3504,52341,26944,9403,1927,5208,7277
CTTCATGATTGGAGAG,sample,161832,156591,35054,121537,19324,102213,20382,584,42821,4665,63203,33761,9561,1305,10103,10773
TATCAGTTTTCAAGCC,sample,49282,48340,6687,41653,8679,32974,12351,684,12220,1406,24571,6313,3939,1312,3901,5434
TCCAACTTTTCAAGCC,sample,136225,134651,14650,120001,39681,80320,36737,1270,24363,3048,61100,14902,6119,1241,22813,23774
AAGTTCGTTTCAAGCC,sample,76022,74809,9355,65454,21776,43678,19468,975,13802,1334,33270,8099,4659,1368,9304,12277
ACGTAAGTTTCAAGCC,sample,83778,82136,15622,66514,12208,54306,13135,516,22681,2494,35816,15480,6648,1227,4706,7190
ACGTTATGTTCAAGCC,sample,415405,405665,100900,304765,33509,271256,52362,2413,117084,13086,169446,86311,18064,3479,16369,17197
TAGTACGGTTCAAGCC,sample,202220,197789,40918,156871,23294,133577,31195,1670,57297,6124,88492,37291,10938,2321,8584,13731
TTCCGTCTTTCAAGCC,sample,183289,180905,18340,162565,48431,114134,55667,1835,34276,3855,89943,18501,4693,1209,32889,29309
TCGCATCTTTCAAGCC,sample,186387,183028,30214,152814,36147,116667,38003,2570,42158,4244,80161,29692,9229,1803,18515,21163
CAAGGCCTTTCAAGCC,sample,127903,125410,18829,106581,17917,88664,26649,2438,36913,4422,63562,18242,7404,1775,7683,11020
GACGGAGATTCAAGCC,sample,50607,49863,4144,45719,23376,22343,14681,689,4339,445,19020,2189,2032,948,9543,10610
CCAGAGCGTTCAAGCC,sample,33736,33052,4192,28860,7035,21825,9687,620,7412,844,17099,3262,3046,1243,2973,3902
CTTGATAGTTCAAGCC,sample,160254,158850,10551,148299,47924,100375,53478,1130,30361,3013,83839,12393,2796,875,38843,30323
CGAGGCAGTTCAAGCC,sample,76502,74635,14637,59998,11725,48273,12381,718,19909,2350,32290,12915,6295,1311,5293,6753
GTTAGGACTTCAAGCC,sample,74537,72721,13363,59358,18472,40886,10866,594,15182,1717,26048,12527,5591,870,6220,9387
ACGTATTATTCAAGCC,sample,120891,119525,8695,110830,44664,66166,43292,1015,13157,1903,56449,6799,2494,726,34598,24825
AACTCGTATTCAAGCC,sample,96891,95160,15607,79553,22608,56945,20326,1209,19727,1909,40053,13774,6703,1537,8872,12083
TTGGCCTCTTCAAGCC,Pos_Ctrl,116611,111549,18380,93169,4804,88365,74347,5835,5703,760,80050,1720,7033,8760,5136,2580
ACCAATGCTTCAAGCC,sample,182297,178361,36437,141924,28410,113514,25354,961,46734,5162,72088,35303,10264,1644,12925,14915
TCGCCTGATTCAAGCC,sample,59085,57381,13369,44012,4097,39915,8430,419,17865,1849,26295,11352,6005,1050,1802,2107
CTTCATGATTCAAGCC,sample,97182,94743,15582,79161,15236,63925,20138,665,23498,2441,43636,17183,6690,936,11656,9665
ATGACCGATTCAAGCC,sample,84354,83693,3189,80504,42087,38417,30259,806,5355,1225,35614,772,1080,588,22605,19181
TCCAACTTAACTTAAC,Neg_Ctrl,2273,1285,941,344,102,242,90,1,105,6,195,40,84,21,64,34
CCTCTAGAAACTTAAC,sample,275452,271784,45996,225788,70643,155145,62311,1475,51073,5366,113384,34920,9340,1813,43874,38057
TTCGTAATAACTTAAC,sample,119587,118657,4994,113663,55595,58068,47922,1011,6812,431,54734,1892,1001,537,40374,27826
ACGTTATGAACTTAAC,sample,105145,103284,21432,81852,15899,65953,12975,376,26933,2963,39908,22706,8530,1105,7236,8870
TTCTAATGAACTTAAC,sample,212104,208822,45032,163790,24918,138872,28046,1193,56446,6094,84492,47093,12843,2175,11674,13901
TTAGAAGTAACTTAAC,sample,178553,176715,19472,157243,63688,93555,48998,1370,22111,2093,71109,18983,4308,1406,31314,32669
GGACCTCTAACTTAAC,Neg_Ctrl,1833,972,674,298,92,206,80,1,60,7,140,58,82,19,49,21
GCCTTGCTAACTTAAC,sample,56612,56009,5474,50535,8612,41923,17466,900,16256,1801,33722,5500,4044,1391,4767,5600
CAAGGCCTAACTTAAC,sample,145867,144613,11867,132746,62704,70042,37308,1218,18198,2011,55506,11307,3308,1006,25866,30916
ACGACTTCAACTTAAC,sample,90674,89625,8327,81298,31900,49398,26611,684,12882,1787,39493,7434,2677,804,19380,17768
CATGATTCAACTTAAC,sample,97754,96736,6791,89945,35584,54361,35860,1319,11650,1826,47510,3706,1753,789,22821,20608
CGTACGTCAACTTAAC,sample,90963,90228,4300,85928,42584,43344,33230,991,6045,784,39275,2294,1282,670,25252,20558
CTAGGACCAACTTAAC,sample,64974,64259,3155,61104,29180,31924,25933,252,3728,651,29661,1360,873,443,21122,14487
GTTAGGACAACTTAAC,sample,204921,201867,37380,164487,46421,118066,42442,1094,39274,3701,81716,31555,7214,1409,30721,25077
ACCAATGCAACTTAAC,sample,110633,108386,13698,94688,23079,71609,25794,1063,25000,2712,50794,17040,6553,1297,12879,14522
TTGGTTAAAACTTAAC,sample,96270,95581,4347,91234,47023,44211,33507,1089,6311,1949,39818,1355,1037,554,24937,21742
AGGTCGGAAACTTAAC,sample,81804,79684,16891,62793,11715,51078,12166,339,20283,2362,32449,15928,6272,862,6927,6818
ATTCTCTTATACTTGA,sample,142781,140551,21074,119477,34155,85322,25446,1097,33108,3321,58554,22350,7458,1361,13438,19641
AAGTTCGTATACTTGA,sample,215382,211437,47388,164049,22927,141122,24355,872,59780,6415,84135,49700,12171,1676,12222,12940
ACGTAAGTATACTTGA,sample,166639,165389,7133,158256,80929,77327,63017,1050,9116,1681,72133,2463,1187,582,50553,38122
CAACCGCGATACTTGA,sample,149873,148384,13469,134915,55416,79499,43164,1384,20378,2784,63542,11789,4417,1291,25886,29207
CAAGGCCTATACTTGA,sample,209164,204730,40747,163983,29479,134504,31440,1085,54137,6048,85577,41794,10198,1515,17907,18036
CATAACCTATACTTGA,sample,277372,271686,50780,220906,35754,185152,41089,1133,76433,8577,117522,57920,14105,2286,21782,20644
GGAGGACGATACTTGA,sample,156069,154269,16270,137999,33961,104038,45350,2031,33054,3898,78404,19705,5976,1543,20802,20901
CATTGCAGATACTTGA,sample,52969,52548,7186,45362,13849,31513,8498,427,12645,1371,21143,8572,5523,954,4291,7616
CGAGGCAGATACTTGA,sample,59366,58429,6317,52112,15265,36847,15867,943,12818,1701,28685,5518,3748,1261,6337,9318
AACTCGTAATACTTGA,sample,111237,110356,5339,105017,48279,56738,41939,1060,10519,1814,52458,1406,1217,621,30315,24471
AATATATCATACTTGA,Neg_Ctrl,2380,1254,868,386,103,283,82,2,128,12,210,59,115,25,42,27
ACCAATGCATACTTGA,sample,113109,112048,5505,106543,51358,55185,40481,1391,9076,1313,49557,2924,1608,747,29197,25506
TGCTTCGCATACTTGA,sample,96570,95124,13530,81594,24774,56820,20296,685,19933,2281,40229,13625,6556,1006,13099,14568
AAGAGCGCATACTTGA,sample,206503,202363,36600,165763,38515,127248,32104,780,48766,4792,80870,40806,10057,1344,21762,23260
CCAATTCCATACTTGA,sample,71249,69496,12529,56967,9201,47766,11225,587,21033,2355,32258,12566,6033,1214,3105,5454
TCGCCTGAATACTTGA,sample,88269,87692,7722,79970,24641,55329,23086,864,18976,2592,42062,9811,5201,1147,12354,14673
ATGACCGAATACTTGA,sample,162023,160218,12451,147767,57201,90566,42789,1169,25895,2209,68684,18504,4935,1080,28877,31598
GGAGAGTTATCCGCGA,sample,193191,191850,8718,183132,100382,82750,64491,1339,12696,1384,77187,2840,1431,672,51789,44345
TCCAACTTATCCGCGA,sample,324676,320371,46490,273881,81534,192347,75811,3207,62479,6148,138290,44702,8626,2000,46104,47528
ACGTAAGTATCCGCGA,sample,226809,224077,20174,203903,83089,120814,54288,1502,38333,4078,92621,22613,4335,1218,39357,44435
CCTCTAGAATCCGCGA,sample,86922,84949,15306,69643,15887,53756,15836,1046,20719,2672,36555,13483,5900,1527,5570,9461
CCAGAGCGATCCGCGA,sample,473659,461980,110975,351005,51531,299474,56473,1930,128663,13560,185136,98848,15241,2851,24381,26802
GGACGTAGATCCGCGA,sample,331855,327723,50456,277267,74846,202421,79278,2523,74169,7840,153447,38611,4658,1396,45792,43520
GGCCAGAGATCCGCGA,sample,168360,165270,22361,142909,42451,100458,40728,1568,33747,3210,74475,21205,5883,1216,25611,25466
GTCCTGCCATCCGCGA,sample,166854,165346,8779,156567,80622,75945,61444,851,10597,1216,72041,1837,1209,634,48952,37099
AATATATCATCCGCGA,sample,251410,247831,30603,217228,64141,153087,58644,2253,52274,6897,110918,33019,8610,1702,31013,37184
CCAATTCCATCCGCGA,sample,112742,111077,12530,98547,35953,62594,27130,1651,20538,2083,47668,11192,5513,1337,12407,18953
GTACCGTAATCCGCGA,sample,220407,216547,32052,184495,50596,133899,43525,2078,45883,4736,89408,37677,9578,1487,25824,30073
TCGCCTGAATCCGCGA,sample,175507,174251,16598,157653,55653,102000,49169,1270,30303,2395,79472,18863,5284,1156,32978,31028
GGAGAGTTAGGACTCA,sample,213441,209851,33727,176124,54570,121554,36996,1313,47482,5243,84478,30520,8248,1663,19803,29489
TATCAGTTAGGACTCA,sample,107645,105757,14539,91218,27897,63321,23619,1139,22468,2245,46087,13850,6126,1336,12795,15551
TCCTCCGTAGGACTCA,sample,123386,120920,19710,101210,36287,64923,24994,1231,21245,2330,46239,15123,6382,1436,13238,19048
TAGTACGGAGGACTCA,sample,155587,154270,16894,137376,48109,89267,35983,1505,27578,2860,63561,21341,7024,1491,22277,26985
TTAGAAGTAGGACTCA,sample,71535,70249,10737,59512,10650,48862,15536,849,19192,2124,34728,11161,5015,1247,5322,6557
CAAGGCCTAGGACTCA,sample,226373,224642,13836,210806,101688,109118,85831,1828,16920,1224,102751,3315,1515,686,67888,50270
ACTATACTAGGACTCA,sample,400744,391903,73553,318350,54531,263819,62157,2384,103028,10686,165185,85564,13889,2427,35968,31025
GGACGTAGAGGACTCA,sample,195842,193536,15246,178290,78131,100159,58583,2949,21915,2060,80498,14652,3905,1499,35038,39793
GACGATAAAGGACTCA,sample,90905,88201,21218,66983,7329,59654,15216,1174,25960,2995,41176,14309,7390,1896,2795,4265
CCATGAAGAGGACTCA,sample,91950,90804,5756,85048,41347,43701,34303,956,5836,1137,40139,1469,1041,617,27631,20023
CATGATTCAGGACTCA,sample,137076,134230,17982,116248,27725,88523,32265,1147,33345,3780,65610,17986,7033,1382,17489,17819
AATCCGTCAGGACTCA,sample,103772,101037,16112,84925,29581,55344,18387,624,19064,2287,37451,14982,6210,1053,11667,15180
CTAGGACCAGGACTCA,sample,69869,68221,10111,58110,11432,46678,15402,853,17792,1837,33194,10794,5330,1357,5492,7043
AACTCGTAAGGACTCA,sample,110494,107881,19231,88650,17093,71557,17549,585,28855,2855,46404,21713,7974,1226,9615,9960
AAGAGCGCAGGACTCA,sample,89300,88556,4756,83800,39670,44130,32820,1326,7542,763,40362,1679,1842,1123,20704,19681
GTCTTAGCAGGACTCA,sample,192835,189149,27748,161401,36212,125189,46550,1643,44426,4429,90976,28141,9228,1757,23925,21307
TTGGTTAAAGGACTCA,sample,211673,208558,21295,187263,64258,123005,48869,1544,38212,3607,87081,30773,9619,1609,33478,36778
TCAATATAAGGACTCA,sample,415297,408207,61785,346422,72336,274086,93273,4568,93584,10763,186857,71898,16229,3871,42862,42510
TCGCCTGAAGGACTCA,sample,239918,236086,33542,202544,44359,158185,48102,1325,58070,6456,106172,44232,11143,1829,28901,27745
AGGTCGGAAGGACTCA,Pos_Ctrl,210191,204100,21813,182287,7503,174784,146620,12790,10581,1538,157201,3255,7928,11505,10436,2848
TCCAACTTTATTGAAC,sample,280260,276859,34384,242475,70711,171764,65418,1142,54843,6475,120261,43886,10235,1591,49240,41876
CCTCTAGATATTGAAC,sample,322748,318674,37685,280989,70664,210325,67494,1478,73213,7372,140707,60768,12570,2190,49001,42590
TGAGCGCGTATTGAAC,sample,125546,124315,13249,111066,34806,76260,28691,1575,29527,3455,58218,13012,6093,1274,14091,20407
TTCCGTCTTATTGAAC,sample,153425,151224,14427,136797,52308,84489,45338,3049,22702,2917,68040,10483,5483,1419,29264,28684
CATAACCTTATTGAAC,sample,315782,311559,41943,269616,62653,206963,68170,3078,74279,7991,142449,53445,11860,2577,37952,36756
ACTATACTTATTGAAC,sample,281118,276776,34858,241918,54045,187873,71065,3396,65596,6936,136661,40880,10016,2146,38183,35263
CCAGAGCGTATTGAAC,sample,120584,118757,13455,105302,29983,75319,31949,1073,26013,3339,57962,12945,6718,1504,16959,18234
CTTGATAGTATTGAAC,sample,282260,274760,51654,223106,47527,175579,46906,1102,65818,6350,112724,55403,12104,1951,28529,27671
ACGACTTCTATTGAAC,sample,183379,171494,33035,138459,28506,109953,32725,1286,41462,4246,74187,30234,9804,1644,18313,16174
GTCCTGCCTATTGAAC,sample,221289,218959,10623,208336,73840,134496,93093,2937,24101,2416,117194,11949,2050,998,59422,45513
AACTCGTATATTGAAC,sample,131089,128226,18476,109750,30121,79629,29142,632,26057,2474,55199,21324,6234,1241,20071,18378
ACCAATGCTATTGAAC,sample,23294,22851,2630,20221,8268,11953,6351,207,3332,387,9683,1676,2017,565,4319,4301
GAAGGCGCTATTGAAC,sample,116734,115652,6004,109648,45300,64348,51392,1785,9264,643,60656,1264,1057,530,39084,26279
GGCATATATATTGAAC,sample,185599,182405,27048,155357,31774,123583,46303,1710,42827,3852,89130,28891,8543,1498,26850,20786
TCAATATATATTGAAC,sample,93989,92437,12487,79950,19925,60025,21662,711,21997,2591,43659,13064,5603,1009,13287,12005
AGGTCGGATATTGAAC,sample,168367,165562,27893,137669,27006,110663,31646,1706,42114,4495,73760,30702,9269,1961,13878,16057
TTATTCGATATTGAAC,sample,124241,122936,10734,112202,43398,68804,39660,1863,17110,1829,56770,8342,4976,1442,24995,24411
GACCGGAATATTGAAC,sample,140830,139389,14577,124812,32365,92447,28769,1646,36139,4188,64908,21705,6152,1124,13102,18766
AAGTTCGTGTTCAACT,sample,44752,31973,7116,24857,11037,13820,11093,436,1752,262,12845,277,710,366,9111,3499
CCTCTAGAGTTCAACT,sample,57008,56326,3389,52937,27563,25374,19683,447,3920,611,23603,713,939,504,16601,12775
AGTACCATGTTCAACT,sample,91537,90163,9281,80882,33065,47817,23516,598,12920,1563,36436,9220,4783,911,17050,17209
TTCTAATGGTTCAACT,sample,183852,179815,26107,153708,35775,117933,38325,2112,45706,5352,84031,26438,8241,1671,20004,20897
ATGCCTGGGTTCAACT,sample,67470,66821,3431,63390,32071,31319,24965,586,4269,582,29234,917,914,578,19569,15302
TCGCATCTGTTCAACT,sample,104393,101784,19534,82250,22578,59672,16510,571,21966,2259,38476,18366,7552,1091,10428,12155
CATAACCTGTTCAACT,sample,76704,75143,8337,66806,18278,48528,19026,306,14788,1596,33814,12812,3917,672,14504,11273
CCGCAACGGTTCAACT,sample,214029,206609,47787,158822,19322,139500,21010,751,60890,6689,81900,50160,14289,1892,8970,10671
CGAGGCAGGTTCAACT,sample,44550,43840,2970,40870,19806,21064,16986,666,2454,267,19440,691,1091,730,10297,9491
CGTACGTCGTTCAACT,sample,43526,42763,3591,39172,18492,20680,12671,465,4570,603,17241,2371,2023,783,8491,9057
AGTCCGCAGTTCAACT,sample,40147,38085,3456,34629,15937,18692,14977,253,2312,346,17289,804,825,486,12327,7480
CGGATTACGTTCAACT,sample,46263,44921,3803,41118,17780,23338,13233,755,6113,588,19346,2649,2527,828,8615,9087
GTTAGGACGTTCAACT,sample,62523,61141,8510,52631,12456,40175,14211,648,15910,1810,30121,7596,4322,1059,6065,7673
GAAGGCGCGTTCAACT,sample,55991,55041,5939,49102,16567,32535,15951,719,9749,1015,25700,5101,3320,755,10289,9470
AAGAGCGCGTTCAACT,sample,45720,45139,3985,41154,14690,26464,14540,551,7522,1029,22062,2822,2642,767,9880,8558
TCAATATAGTTCAACT,sample,127460,124075,18712,105363,17002,88361,22681,708,36856,4019,59537,24097,8803,1309,13508,10965
TTATTCGAGTTCAACT,Neg_Ctrl,848,526,232,294,73,221,99,6,65,6,164,45,121,50,26,27
ATGACCGAGTTCAACT,sample,63901,63019,7097,55922,13319,42603,17538,479,14600,1517,32138,8469,4592,806,10630,8264
GGTTGCGTCTGAGGTT,sample,416277,410766,43953,366813,118148,248665,96137,2165,78935,7769,175072,63659,12495,2173,73110,67736
AGTACCATCTGAGGTT,sample,279053,273759,29129,244630,83877,160753,76563,2476,48511,5498,125074,27705,6726,1464,56610,48434
ACGTTATGCTGAGGTT,sample,170854,168328,13417,154911,74074,80837,62755,1282,12416,1107,75171,3277,1695,756,50827,35236
TTCTAATGCTGAGGTT,sample,152804,146173,16534,129639,51184,78455,44950,1375,20165,2422,65115,9543,4935,1351,30208,25874
ATGCCTGGCTGAGGTT,sample,166900,153609,35016,118593,20774,97819,22059,952,39385,3918,61444,31505,9201,1605,9480,10906
TGAGCGCGCTGAGGTT,sample,111648,108632,22332,86300,12723,73577,18115,1197,31588,3861,49703,18816,7973,1605,6649,7144
TTCCGTCTCTGAGGTT,sample,331581,324791,57777,267014,60232,206782,56525,2550,82265,9153,138790,56289,13660,2712,26819,34904
GGACCTCTCTGAGGTT,sample,210797,207596,13488,194108,98829,95279,75557,1415,14536,1340,90093,2431,1556,751,61578,46810
GCCTTGCTCTGAGGTT,sample,213860,210217,22194,188023,70949,117074,53668,2195,33834,3814,87502,23563,7585,1875,34526,38716
CATAACCTCTGAGGTT,sample,174170,167454,45402,122052,14762,107290,15896,806,47558,5034,63454,37996,12258,1935,5721,7649
CTTGATAGCTGAGGTT,sample,387093,383500,25710,357790,135341,222449,107302,4662,66020,5944,173322,38521,7223,1949,68761,76833
GGCCAGAGCTGAGGTT,sample,197715,191623,23733,167890,62055,105835,56079,2879,29140,4160,85219,13577,4431,1406,34871,34639
CCATGAAGCTGAGGTT,sample,143036,141419,7555,133864,67366,66498,50354,1170,10265,1186,60619,3523,1739,855,38350,31686
CTAGGACCCTGAGGTT,sample,101938,99571,11372,88199,27883,60316,29237,1616,19845,2267,49082,7351,3710,1258,14329,16387
GCCTGAACCTGAGGTT,sample,137504,135500,8628,126872,63122,63750,49256,1430,9411,1365,58667,2288,1459,707,38949,30281
AATATATCCTGAGGTT,sample,148380,147043,7882,139161,67577,71584,54970,1090,10848,1005,65818,3671,1580,756,46023,33723
CCAATTCCCTGAGGTT,sample,146410,144904,9630,135274,53258,82016,53016,2409,18304,2263,71320,6024,3419,1183,34236,29287
GTACCGTACTGAGGTT,sample,227301,225449,17932,207517,81396,126121,64697,1840,33222,4932,97919,21430,3623,1138,42163,45479
TCAATATACTGAGGTT,sample,239995,237374,23725,213649,66999,146650,69089,2942,44794,4189,113883,25636,8390,1881,39185,40739
CTTCATGACTGAGGTT,sample,228725,227216,13310,213906,97712,116194,93507,2992,14931,2622,108438,2142,1380,829,71797,50869
GACCGGAACTGAGGTT,sample,363349,359882,32761,327121,79330,247791,123203,7822,77350,8702,200553,30714,7140,2464,43267,52556
ATTCTCTTAGACCGTT,sample,275244,273428,11464,261964,130314,131650,102465,2288,20904,2726,123369,3267,1564,904,79523,63297
ACGTAAGTAGACCGTT,sample,327278,323094,21737,301357,142427,158930,114808,2334,26505,2295,141313,12988,3129,1246,92191,68482
TTCCGTCTAGACCGTT,sample,200514,197355,29200,168155,41277,126878,34993,1476,48077,5362,83070,36970,10894,2216,17764,24614
CCGCAACGAGACCGTT,sample,147504,146127,8191,137936,65018,72918,51911,1511,12612,2046,64523,4838,2306,701,41722,32215
TGGACGAGAGACCGTT,sample,187038,184363,14904,169459,67580,101879,58719,2527,23212,2336,81931,15085,3788,1308,41593,36095
TTGGCCTCAGACCGTT,sample,56117,55253,6475,48778,17204,31574,14765,803,9456,1145,24221,5405,4049,1226,8184,9664
ACCAATGCAGACCGTT,sample,240463,233470,52914,180556,25726,154830,28125,971,64883,6626,93008,54225,12537,2014,13764,14074
TGCTTCGCAGACCGTT,sample,191521,189903,11188,178715,70086,108629,70405,2637,20922,3900,91327,10765,2868,1092,49627,40312
GTACCGTAAGACCGTT,sample,219098,217586,11421,206165,91330,114835,92831,1628,15860,1892,108691,2624,1315,659,73581,48299
GGCATATAAGACCGTT,sample,317611,314148,24961,289187,76876,212311,91288,3919,78818,6020,170106,32266,4545,1560,51114,50657
AGGTCGGAAGACCGTT,sample,278696,276435,16986,259449,107382,152067,86347,2831,36793,3601,123140,22495,4343,1370,62536,59868
TCCAACTTCTTGAGTT,sample,150245,149407,6408,142999,68739,74260,44855,1069,16811,2615,61666,8910,3086,913,34256,33572
AAGTTCGTCTTGAGTT,sample,145138,143386,19500,123886,22010,101876,27059,1603,44277,4739,71336,24198,8345,1878,11512,13763
GGACCTCTCTTGAGTT,sample,146560,143027,21523,121504,43703,77801,32478,1408,25531,2683,58009,15701,6374,1314,20060,23597
GCCTTGCTCTTGAGTT,sample,131796,129289,13334,115955,46682,69273,34143,1297,21139,2591,55282,10103,5132,1401,21725,24120
CCAGAGCGCTTGAGTT,sample,337956,333577,27091,306486,115879,190607,93634,2766,51443,5063,145077,37701,5711,1629,68753,65988
GTTAGCCGCTTGAGTT,sample,194751,191145,26516,164629,50774,113855,40405,1518,40282,4436,80687,27214,8671,1680,22976,28839
CCGCAACGCTTGAGTT,sample,167567,164831,19417,145414,53940,91474,43184,1563,28894,3170,72078,14663,6640,1468,26787,30287
GGACGTAGCTTGAGTT,sample,42397,41666,4364,37302,10568,26734,11691,673,9542,1235,21233,3593,3191,1396,4366,6458
CTTGATAGCTTGAGTT,sample,264460,259868,33610,226258,81504,144754,63907,2953,43835,4894,107742,29165,9178,2278,35974,43281
AGTCCGCACTTGAGTT,sample,208516,205174,19637,185537,54887,130650,60919,3411,42046,4165,102965,20109,7290,1807,32158,33537
TTGGTACCCTTGAGTT,sample,140541,138686,12206,126480,46396,80084,49754,2538,18750,1902,68504,7140,4685,1852,25650,26531
GTTAGGACCTTGAGTT,sample,317577,313732,24810,288922,100550,188372,100804,2712,51595,5723,152399,27538,5178,1422,72840,61258
GCCTGAACCTTGAGTT,sample,295878,289209,53067,236142,36987,199155,51349,2652,83736,8834,135085,52584,12779,2707,21302,22604
ACCAATGCCTTGAGTT,sample,410176,397978,77874,320104,42914,277190,49108,2150,118541,12263,167649,95128,15981,3306,21551,25113
GAAGGCGCCTTGAGTT,sample,524951,513447,74590,438857,82061,356796,81694,2556,142589,14429,224283,115528,16712,3518,47021,53947
TTGGTTAACTTGAGTT,sample,191872,190222,11453,178769,77130,101639,71068,3996,16765,2452,87833,7358,3679,1753,41158,41082
CTTCATGACTTGAGTT,sample,167830,165005,18473,146532,25492,121040,46522,3084,45978,6048,92500,19408,6161,1657,13666,16425
AGGTCGGACTTGAGTT,sample,264937,259557,49233,210324,35387,174937,31517,1475,71841,8194,103358,61910,11795,1948,15047,19260
TTATTCGACTTGAGTT,sample,777301,756531,144785,611746,63366,548380,93996,4309,232592,24345,326588,193138,22957,5997,37159,34218
TATCAGTTTCGGAGTT,sample,83187,81652,11933,69719,19620,50099,16975,581,17598,2097,34573,12848,6180,1033,10830,11392
ATTCTCTTTCGGAGTT,sample,37981,37184,4833,32351,5795,26556,10734,653,9655,1153,20389,4361,3379,1221,4125,3667
AAGTTCGTTCGGAGTT,sample,42494,41555,5310,36245,11952,24293,11651,393,7066,741,18717,4442,3470,910,7519,6901
TTCTAATGTCGGAGTT,sample,76610,74986,8783,66203,23651,42552,17491,480,13193,1396,30684,9992,5407,886,12932,13088
TAGTACGGTCGGAGTT,sample,571470,563256,81534,481722,31441,450281,110555,5962,217744,31522,328299,84498,16016,3456,24176,18821
TGAGCGCGTCGGAGTT,sample,59646,59050,3985,55065,29785,25280,18251,923,3685,386,21936,2035,1784,1051,11773,12887
AATGGTAATCGGAGTT,sample,109868,107752,12042,95710,20757,74953,25903,517,24080,2704,49983,21749,4788,949,19660,13259
TTAGAAGTTCGGAGTT,sample,91228,88595,17594,71001,14712,56289,12462,512,22598,2274,35060,18443,7489,1179,6208,8651
CATAACCTTCGGAGTT,sample,110085,108206,12435,95771,25929,69842,31636,1239,22601,3073,54237,11293,5246,1264,18730,16273
ACTATACTTCGGAGTT,sample,118446,113924,23299,90625,26233,64392,31344,922,18790,1861,50134,11475,4823,998,22849,14378
CCGCAACGTCGGAGTT,sample,251598,246256,40966,205290,43363,161927,46710,1254,59235,6365,105945,48363,12232,2097,29455,26232
CTTGATAGTCGGAGTT,sample,119920,117152,18273,98879,21332,77547,22997,563,28030,2634,51027,23323,7303,1225,14529,12756
TGGACGAGTCGGAGTT,sample,53524,52760,4184,48576,19341,29235,17593,631,6535,730,24128,3746,2334,885,11716,10887
CATTGCAGTCGGAGTT,sample,12184,11829,2161,9668,1977,7691,2465,50,2704,292,5169,2180,1803,231,1858,1206
CGAGGCAGTCGGAGTT,sample,12651,12178,3308,8870,1281,7589,1134,49,3212,404,4346,2790,2353,183,532,625
ACGACTTCTCGGAGTT,sample,24252,23889,2778,21111,6796,14315,8094,314,3510,337,11604,2060,2323,803,4956,4033
GTCCTGCCTCGGAGTT,sample,37706,36969,4034,32935,7198,25737,10997,353,8468,1107,19465,4812,3667,657,7714,4884
TTGGTACCTCGGAGTT,sample,97973,96500,10623,85877,16976,68901,24012,514,22677,2456,46689,19242,7563,880,17761,11237
TTGGCCTCTCGGAGTT,Pos_Ctrl,122082,118009,13024,104985,4369,100616,84680,6899,6393,836,91073,1808,7291,9594,6065,1559
ACCAATGCTCGGAGTT,sample,70391,68812,9750,59062,13198,45864,16068,630,16231,1711,32299,11224,5835,1062,8828,7984
AAGAGCGCTCGGAGTT,sample,196560,191423,37147,154276,19549,134727,27520,932,55071,5852,82591,45352,11780,1776,15401,12300
AGGTCGGATCGGAGTT,sample,148214,143906,29117,114789,15207,99582,16038,481,42269,4646,58307,36148,10753,1335,7997,8922
GACCGGAATCGGAGTT,sample,143052,141449,13964,127485,16255,111230,26320,1062,45637,5217,71957,32994,7114,1479,13845,11946
ATTCTCTTTGAACCTT,Pos_Ctrl,289325,285086,25078,260008,12031,247977,211066,18374,12798,1843,223864,3896,8583,13697,18005,5604
TCCAACTTTGAACCTT,sample,30274,29724,5611,24113,4347,19766,5880,518,7727,862,13607,4779,3927,1315,1097,2626
AAGTTCGTTGAACCTT,sample,116168,114800,12159,102641,26971,75670,33201,1927,26246,3203,59447,11093,6035,2004,13761,16806
ACGTAAGTTGAACCTT,sample,140754,138305,22231,116074,29483,86591,35510,2155,25851,2868,61361,20207,7949,2515,16162,17274
TTCGTAATTGAACCTT,sample,219709,210093,12786,197307,105480,91827,75101,1878,11085,1297,86186,2466,1576,934,57489,44738
ATGCCTGGTGAACCTT,sample,370788,363360,72332,291028,44818,246210,51099,2089,101347,10507,152446,81168,14733,3210,20688,24670
TAGTACGGTGAACCTT,Pos_Ctrl,234283,227628,27832,199796,9416,190380,160905,12765,12020,1576,172925,3114,8355,12182,13001,4740
AATGGTAATGAACCTT,sample,222160,218584,23011,195573,53826,141747,55389,1942,47433,5345,102822,31638,6968,1471,38275,34487
TTAGAAGTTGAACCTT,sample,59384,58508,7313,51195,17780,33415,14048,398,10537,1029,24585,7403,4017,703,10114,10455
GGACCTCTTGAACCTT,sample,164643,162473,16477,145996,41977,104019,51627,1917,31680,3770,83307,15025,6248,1496,31644,25734
TCGCATCTTGAACCTT,sample,281071,273976,51759,222217,48709,173508,40562,1376,67847,7528,108409,56195,12589,2169,22294,27501
CCGCAACGTGAACCTT,Pos_Ctrl,259371,247346,31548,215798,9963,205835,172179,14620,13576,1627,185755,3833,8359,12634,12238,5207
AATCCGTCTGAACCTT,Pos_Ctrl,186466,178607,22280,156327,6266,150061,125277,10867,9541,1358,134818,3018,7550,10826,7371,2716
CTAGGACCTGAACCTT,sample,230691,224615,38934,185681,27483,158198,31516,990,62155,6851,93671,56686,11722,1848,18816,16515
GTACCGTATGAACCTT,Pos_Ctrl,208788,201136,23541,177595,7088,170507,143383,12100,10440,1389,153823,3195,7687,11337,8915,2915
TCGCCTGATGAACCTT,sample,156504,154538,15048,139490,33749,105741,54878,3283,28731,2697,83609,16152,6293,2036,19951,22121
ATTCTCTTACCGAATT,sample,132067,130192,13262,116930,26446,90484,37593,2241,35087,3831,72680,11732,5297,1814,14773,17318
ACGTAAGTACCGAATT,sample,188984,186428,15767,170661,68128,102533,51984,2501,30825,3877,82809,13346,5894,1625,28934,36809
TTCGTAATACCGAATT,sample,342286,336595,35542,301053,102895,198158,87166,3033,65842,6685,153008,35432,7076,1808,52870,58793
CAACCGCGACCGAATT,sample,247862,245711,13886,231825,111132,120693,92163,2430,17904,1911,110067,6285,1801,796,71397,54661
AATGGTAAACCGAATT,sample,294952,289012,45657,243355,57578,185777,59912,1293,64537,6570,124449,53465,11018,1854,41074,35204
CAAGGCCTACCGAATT,sample,880228,858144,164948,693196,114388,578808,100933,3161,244276,27297,345209,203141,22342,5412,49021,69920
ACTATACTACCGAATT,sample,409414,402344,53215,349129,82405,266724,83971,3564,93521,9980,177492,75688,11845,2409,45088,49797
GACGGAGAACCGAATT,sample,250525,247462,22971,224491,70993,153498,72640,2821,47075,6806,119715,24156,6390,1589,49005,43716
GGAGGACGACCGAATT,sample,126391,124527,18000,106527,17774,88753,22808,1194,37739,3992,60547,23020,7563,1579,10556,11076
GGACGTAGACCGAATT,sample,116530,115727,8594,107133,18283,88850,36792,2969,34805,4190,71597,10094,4768,1754,11326,12661
CTTGATAGACCGAATT,sample,484263,478711,59844,418867,111628,307239,111777,4789,107406,12041,219183,71226,12098,2587,72081,66609
GGCCAGAGACCGAATT,sample,443531,428561,89532,339029,44570,294459,61403,2022,120610,13525,182013,96899,15076,2877,32410,26412
CTAGGACCACCGAATT,sample,213348,211600,12718,198882,98090,100792,80889,2614,13287,1630,94176,2372,1560,866,64620,47987
CGGATTACACCGAATT,sample,197798,195760,11169,184591,85346,99245,78591,3088,12674,2470,91265,2422,1449,787,59189,43905
CGTATGAAACCGAATT,sample,208414,199905,43139,156766,21212,135554,26946,1593,55052,5579,81998,46384,11026,1720,14736,11264
AATATATCACCGAATT,Neg_Ctrl,4408,2729,1372,1357,156,1201,191,6,277,29,468,698,232,55,97,71
TGCTTCGCACCGAATT,sample,130298,128796,10585,118211,47556,70655,42357,1443,16612,1920,58969,8323,3751,915,29780,25958
GAAGGCGCACCGAATT,sample,368561,360945,59254,301691,53771,247920,67673,1992,99318,11458,166991,67479,12556,2245,36090,33022
GTACCGTAACCGAATT,sample,388366,379123,64246,314877,53199,261678,64492,1767,102626,9505,167118,83288,13491,2317,40013,33520
GGCATATAACCGAATT,sample,184577,182231,13302,168929,55989,112940,62017,1529,30091,3188,92108,16115,4511,1238,40783,35316
TCCAACTTGGTCTGGT,Neg_Ctrl,3870,2152,1585,567,195,372,158,5,119,14,277,76,143,36,98,59
ACGTAAGTGGTCTGGT,sample,378744,376135,26852,349283,138845,210438,116845,3088,56393,6289,173238,27823,6843,1759,87789,77504
ACGTTATGGGTCTGGT,sample,241625,238807,18677,220130,86273,133857,72251,3741,36274,3896,108525,17695,7320,1963,43780,47786
TGAGCGCGGGTCTGGT,Neg_Ctrl,2816,1584,1162,422,71,351,98,1,176,2,274,74,96,21,33,40
CAACCGCGGGTCTGGT,sample,293406,289810,26525,263285,106405,156880,84862,2733,41760,3759,126622,23766,5162,1380,60426,55692
TTCCGTCTGGTCTGGT,sample,222315,219946,14251,205695,92411,113284,87851,1765,16905,2966,104756,3797,1487,681,74691,47601
TCGCATCTGGTCTGGT,sample,259302,255538,22668,232870,87154,145716,63008,3484,45644,4223,108652,29357,7167,1887,37611,48873
CATAACCTGGTCTGGT,sample,364968,355052,58277,296775,46424,250351,47690,1889,104256,11008,151946,85508,15925,2934,25158,29441
ACTATACTGGTCTGGT,sample,382780,371819,60315,311504,59817,251687,57608,2261,109010,11587,166618,71221,13468,2711,25797,36142
GTTAGCCGGGTCTGGT,sample,269430,265500,21718,243782,97213,146569,76975,2614,35717,3069,112692,28194,6906,1399,55995,52852
CCGCAACGGGTCTGGT,sample,194068,191832,18379,173453,65247,108206,49842,2017,32308,3524,82150,20515,7296,1654,32176,36000
GGACGTAGGGTCTGGT,Neg_Ctrl,2510,1362,847,515,167,348,133,2,162,9,295,42,118,32,75,38
ACGACTTCGGTCTGGT,sample,85126,83989,10701,73288,23325,49963,20132,1145,17403,2120,37535,9163,5525,1506,11026,13385
CATGATTCGGTCTGGT,sample,223191,216834,36854,179980,40738,139242,36219,1236,54723,5701,90942,41363,11592,1882,20800,23963
CGTACGTCGGTCTGGT,Neg_Ctrl,3317,1565,1122,443,134,309,140,7,93,12,233,57,137,40,82,18
TTGGTACCGGTCTGGT,sample,124287,118606,26788,91818,14585,77233,12347,431,33221,3301,45568,27933,9909,1109,6302,7931
CTAGGACCGGTCTGGT,sample,145737,138856,37580,101276,12855,88421,12673,386,38389,4047,51062,32926,11809,1277,5657,6790
AAGAGCGCGGTCTGGT,sample,189417,182587,34465,148122,30346,117776,28728,813,46303,4816,75031,37116,10122,1424,17532,18019
GGCATATAGGTCTGGT,Neg_Ctrl,2110,1213,884,329,101,228,103,2,76,11,179,36,97,20,65,37
CTTCATGAGGTCTGGT,sample,166273,163919,13400,150519,62546,87973,52291,1792,21383,1883,73674,10624,2862,945,38410,33931
TTATTCGAGGTCTGGT,sample,168412,165820,14478,151342,47657,103685,51810,2765,30078,4382,81888,14650,5881,1618,28400,29529
GGAGAGTTCGACGTTA,sample,504110,496943,57764,439179,131894,307285,105674,6196,118550,12323,224224,64542,11791,2236,65211,76636
TTCGTAATCGACGTTA,sample,764465,753168,112362,640806,209488,431318,140728,7102,147505,16044,288233,119939,15971,4164,81652,113479
TTCTAATGCGACGTTA,sample,420451,416237,37624,378613,173997,204616,124422,5564,46395,4622,170817,23613,4105,1619,77115,84322
TAGTACGGCGACGTTA,sample,114521,112700,12703,99997,32197,67800,30772,1614,24022,2716,54794,8676,5423,1767,13984,18895
TGAGCGCGCGACGTTA,sample,210811,208166,20210,187956,56673,131283,55136,3753,45637,5688,100773,21069,7270,1617,28899,34015
TTCCGTCTCGACGTTA,sample,372226,367224,34838,332386,121070,211316,106692,3947,58466,6290,165158,35921,7984,2068,59139,66839
TCGCATCTCGACGTTA,sample,294169,288446,41597,246849,58726,188123,67059,3755,72476,9637,139535,35196,8263,2065,29118,35705
GCCTTGCTCGACGTTA,sample,339838,335208,32122,303086,79402,223684,97782,4039,72992,7737,170774,41134,10395,2505,48632,49769
ACGACTTCCGACGTTA,sample,108272,105461,22396,83065,16677,66388,16434,574,26322,2848,42756,20210,7744,1294,8780,8955
AGTCCGCACGACGTTA,sample,54960,53783,8487,45296,8641,36655,11043,558,14443,1439,25486,9172,4946,1101,5148,5281
CGGATTACCGACGTTA,sample,197072,194977,10439,184538,91019,93519,73374,1728,12191,2073,85565,4153,1707,840,57805,44776
ACGTATTACGACGTTA,sample,209701,206724,22577,184147,58382,125765,61204,2403,39606,4136,100810,18416,6926,1688,37630,35402
TGCTTCGCCGACGTTA,sample,131718,129225,11252,117973,49099,68874,34362,1039,19727,2369,54089,11377,3875,1014,25449,26158
GGCATATACGACGTTA,sample,218529,216796,16339,200457,84449,116008,69915,3031,28849,3633,98764,10580,4177,1230,46525,45393
TCGCCTGACGACGTTA,sample,359414,356412,35133,321279,72260,249019,93490,7121,90842,10836,184332,46730,9700,2148,44122,46118
TTATTCGACGACGTTA,sample,386595,383412,34545,348867,83672,265195,103124,3970,84501,10236,187625,63364,10531,2442,69197,55637
GACCGGAACGACGTTA,sample,79801,79248,6876,72372,17812,54560,21613,1120,20505,2280,42118,9042,4734,1163,10917,11152
TTCGTAATTACTAAGT,sample,236531,232069,44803,187266,19245,168021,23491,1204,71372,7105,94863,64849,13125,2325,8599,9913
TTAGAAGTTACTAAGT,sample,140245,136187,27277,108910,19568,89342,25056,960,34849,3832,59905,24645,8387,1384,13333,12043
TCGCATCTTACTAAGT,sample,50694,49140,6656,42484,10095,32389,14046,587,10723,1278,24769,5755,3711,1162,6193,6205
GCCTTGCTTACTAAGT,sample,58234,57251,7376,49875,11696,38179,15587,408,13155,1490,28742,7539,4416,924,10176,7429
CAAGGCCTTACTAAGT,sample,108792,106507,16757,89750,18746,71004,23686,874,26170,2324,49856,17950,6370,1226,12606,11268
ACTATACTTACTAAGT,sample,87301,85824,8754,77070,28385,48685,24177,1105,14614,1412,38791,7377,4426,1097,14392,15540
GACGGAGATACTAAGT,sample,34763,34280,2934,31346,5729,25617,11442,878,9135,1153,20577,3009,2689,1070,4323,3904
CCGCAACGTACTAAGT,sample,130819,126763,25312,101451,23456,77995,17626,966,30276,3255,47902,25872,9676,1419,8640,13282
TGGACGAGTACTAAGT,sample,309330,302165,42700,259465,36264,223201,52659,1931,85130,9527,137789,73954,10323,2261,33021,24328
CATTGCAGTACTAAGT,sample,69400,67653,11535,56118,8916,47202,10471,423,19274,1920,29745,15114,7467,980,5595,5442
ACGACTTCTACTAAGT,sample,15019,14703,1442,13261,5187,8074,5507,117,1433,103,6940,914,773,287,4386,2887
CATGATTCTACTAAGT,sample,17749,17369,1411,15958,7317,8641,6855,78,1124,170,7979,414,507,231,5544,3836
AGTCCGCATACTAAGT,sample,17354,16788,3432,13356,3322,10034,2989,123,3771,392,6760,2759,2493,402,1966,1886
TTGGTACCTACTAAGT,sample,176003,173029,24001,149028,35095,113933,49278,1233,35935,3887,85213,23600,5812,1148,34225,24028
GCCTGAACTACTAAGT,sample,17952,17257,2813,14444,4174,10270,3920,122,3878,351,7798,1999,1693,363,2576,2440
CCAATTCCTACTAAGT,sample,68798,66578,15325,51253,6439,44814,8531,604,18935,2090,27466,14654,7738,1380,3254,3491
TTGGTTAATACTAAGT,sample,83353,81775,12962,68813,15614,53199,16316,731,20133,2049,36449,13970,6390,1002,9445,9511
GTACCGTATACTAAGT,sample,67954,66457,12014,54443,11907,42536,12238,475,15644,1681,27882,12498,5987,866,7670,7026
TCGCCTGATACTAAGT,sample,71233,70736,4103,66633,27278,39355,31943,748,5078,481,37021,1105,856,480,26609,15435
GGAGAGTTTTGCCGCT,sample,509627,500184,65067,435117,113440,321677,97138,3323,125032,13383,222170,82801,13940,3217,57262,67359
GGTTGCGTTTGCCGCT,sample,910837,887280,168542,718738,133367,585371,116867,4035,240203,23291,357070,200975,22405,5545,62890,80195
AGTACCATTTGCCGCT,sample,336086,332216,25318,306898,135253,171645,105730,2581,39057,5571,144787,18706,3633,1298,77976,70614
TTCGTAATTTGCCGCT,sample,411431,405388,46978,358410,100462,257948,97732,4826,92580,10238,190312,52572,11395,2416,55623,61623
ACGTTATGTTGCCGCT,sample,230141,227872,11195,216677,104134,112543,92021,2967,13333,1358,105354,2864,1808,961,73975,52343
TAGTACGGTTGCCGCT,sample,203245,199907,23342,176565,35177,141388,55434,3180,55823,5908,111257,21043,6679,2041,22684,22664
TGAGCGCGTTGCCGCT,sample,149625,146180,26168,120012,27950,92062,28133,680,32449,3595,60582,27205,8279,1189,19975,16810
TTCCGTCTTTGCCGCT,sample,532137,519381,77480,441901,69913,371988,94119,4004,149765,16481,243884,107619,14146,2804,50288,44303
GCCTTGCTTTGCCGCT,sample,213878,209872,28269,181603,53167,128436,40851,1267,45454,4618,86305,36246,8538,1801,25263,31518
GACGGAGATTGCCGCT,sample,243502,236828,39236,197592,39717,157875,39846,2153,64454,7045,104300,44377,10872,2279,15246,22134
CCAGAGCGTTGCCGCT,sample,127565,123047,26530,96517,12065,84452,15859,864,36192,3898,52051,27639,9812,1659,6109,6435
CTTGATAGTTGCCGCT,sample,379541,376309,17142,359167,165969,193198,149893,5905,24944,3850,174837,8606,2554,1079,98270,86803
CATGATTCTTGCCGCT,sample,233369,227794,37585,190209,24917,165292,45063,2528,71881,8206,116944,37614,10358,1930,14363,16264
CGTACGTCTTGCCGCT,sample,58638,57455,6717,50738,10867,39871,16344,995,14336,1845,30680,6351,4380,1544,5772,6973
AGTCCGCATTGCCGCT,sample,41238,40624,4032,36592,8470,28122,12489,713,10114,995,22603,3811,3700,1435,4524,6001
TTGGTACCTTGCCGCT,sample,164371,162149,12835,149314,70618,78696,60228,1790,10643,1566,70871,4469,1595,662,48668,34303
TGCTTCGCTTGCCGCT,sample,185337,182719,18439,164280,44133,120147,53924,2866,38183,4430,92107,20744,8006,2212,26187,27213
TCGCCTGATTGCCGCT,sample,159279,156561,20839,135722,26055,109667,33113,1221,44013,4783,77126,26537,8375,1623,17674,16899
AGGTCGGATTGCCGCT,sample,575014,567772,66459,501313,112777,388536,117736,4983,150510,15440,268246,99867,14565,3132,65982,68149
GACCGGAATTGCCGCT,sample,551166,547366,60217,487149,114633,372516,111125,2750,132873,14658,243998,111110,17293,4742,70188,71225
AAGTTCGTTTCGACCT,sample,193909,191626,9628,181998,90101,91897,73358,3991,10513,1418,83871,2617,1470,822,57730,43467
GGTTGCGTTTCGACCT,sample,256639,251877,33273,218604,82135,136469,66941,1783,34758,3723,101699,29264,7504,1696,49624,42660
CCTCTAGATTCGACCT,sample,234467,228738,37586,191152,48283,142869,46902,2222,53915,6105,100817,33725,10971,2128,26577,28159
ACGTTATGTTCGACCT,sample,109842,108721,5686,103035,54909,48126,35065,1932,8058,1027,43123,2044,1848,1150,24258,24746
GACGGAGATTCGACCT,sample,241372,234863,38964,195899,35912,159987,43539,2091,63960,7065,107499,43332,10599,1931,24162,22862
GGCCAGAGTTCGACCT,sample,117802,116081,13357,102724,23165,79559,27347,1575,30106,3080,57453,17451,7275,1791,12122,14066
AGTCCGCATTCGACCT,sample,116232,114859,10566,104293,29099,75194,35266,1408,20100,1998,55366,16422,5956,1270,25221,17497
GTCCTGCCTTCGACCT,sample,127569,125672,15260,110412,15226,95186,37017,2372,35434,4603,72451,15760,6778,2208,10258,10603
CGGATTACTTCGACCT,sample,132929,130798,11991,118807,47933,70874,38779,954,16879,1629,55658,12633,4274,1095,28605,26102
GCCTGAACTTCGACCT,sample,56998,55853,7071,48782,17550,31232,13571,592,9647,1179,23218,6243,4301,972,8739,9594
AACTCGTATTCGACCT,sample,76481,75243,6534,68709,26864,41845,25157,930,9736,963,34893,5059,2255,865,16137,15101
TGCTTCGCTTCGACCT,sample,381960,374595,54641,319954,58468,261486,61826,1474,102294,10517,164120,85375,14467,2616,39722,36320
TTGGTTAATTCGACCT,sample,402666,392570,78633,313937,56553,257384,52982,1708,104617,10408,157599,87669,13692,2309,29713,33434
GTACCGTATTCGACCT,sample,276420,271547,30375,241172,64151,177021,64666,2627,60957,6767,125623,42004,9910,1968,40798,39511
TCGCCTGATTCGACCT,sample,138953,136836,13754,123082,27152,95930,42277,2197,32306,4332,74583,14818,5934,1651,15555,18265
TTATTCGATTCGACCT,sample,287575,282179,37641,244538,59652,184886,55106,2224,66372,6868,121478,54316,11055,2191,34255,36367
GGAGAGTTTCCAGACT,sample,119413,118592,10815,107777,32303,75474,30610,1103,24441,2498,55051,16822,5790,1101,21319,19932
AAGTTCGTTCCAGACT,sample,123662,121657,14687,106970,23761,83209,31081,1250,28513,2894,59594,19471,7221,1434,17622,14927
AGTACCATTCCAGACT,sample,125788,123989,18128,105861,31186,74675,34069,905,21181,2966,55250,15554,3347,871,24514,19139
TTCTAATGTCCAGACT,sample,79957,79315,4503,74812,29704,45108,30708,1636,9656,1379,40364,1729,2226,1325,17091,16992
ATGCCTGGTCCAGACT,sample,102120,99692,17856,81836,10025,71811,14802,624,32580,3349,47382,20456,8487,1353,5108,6563
TTCCGTCTTCCAGACT,sample,104301,101531,19679,81852,17168,64684,16864,476,25185,2519,42049,19640,7184,1059,10175,10038
CAAGGCCTTCCAGACT,sample,162577,157757,29005,128752,25803,102949,28500,632,39140,4270,67640,30407,7338,1305,17498,15864
ACTATACTTCCAGACT,sample,48846,47683,6624,41059,11875,29184,12644,276,8775,894,21419,6595,3781,598,9691,6939
CCAGAGCGTCCAGACT,sample,115882,113103,29224,83879,20751,63128,16822,620,23769,2381,40591,19536,7408,1185,9786,12972
CCGCAACGTCCAGACT,sample,111348,107642,22639,85003,14744,70259,14645,344,28140,2949,42785,24181,9113,1004,9310,8318
CCATGAAGTCCAGACT,sample,19193,18485,4177,14308,2175,12133,2859,108,4786,423,7645,3957,2920,364,1575,1330
GTTAGGACTCCAGACT,Pos_Ctrl,78461,73789,11537,62252,2840,59412,49779,4001,3790,577,53569,1265,6395,7366,3383,1348
ACGTATTATCCAGACT,sample,37140,35417,9641,25776,2742,23034,3369,153,9871,1004,13240,8637,4765,472,1391,1393
TTGGCCTCTCCAGACT,Pos_Ctrl,89402,84984,12283,72701,3030,69671,58265,4593,4741,622,63006,1450,6734,7986,4037,1504
TGCTTCGCTCCAGACT,sample,72404,70709,13753,56956,11381,45575,14104,396,16269,1641,30373,13165,6230,812,9627,6562
AAGAGCGCTCCAGACT,sample,98105,94847,19399,75448,9548,65900,12452,525,27632,3071,40084,22220,8315,1040,5917,5403
CCAATTCCTCCAGACT,sample,64742,62985,11066,51919,7812,44107,12506,413,17686,1579,30192,11923,6022,874,6594,5028
GGCATATATCCAGACT,sample,21418,20729,4361,16368,3783,12585,4092,141,4317,441,8409,3594,2567,446,2457,2086
CTTCATGATCCAGACT,sample,103349,99702,19117,80585,12090,68495,15624,297,27294,2627,42918,22653,7793,879,10180,7082
TCCAACTTACCATTAT,sample,431731,423665,50349,373316,115945,257371,108092,4841,86605,10713,194697,47120,9908,2434,59968,71111
ACGTAAGTACCATTAT,sample,329451,323734,35112,288622,87784,200838,85314,4223,71705,7737,157019,31859,8888,1987,47751,54166
CCTCTAGAACCATTAT,sample,211731,206713,25257,181456,65249,116207,48186,2322,35579,3841,83765,26279,7772,1827,30806,36570
ACGTTATGACCATTAT,sample,529368,522582,53264,469318,126205,343113,138292,3546,117271,11897,255563,72107,11014,2893,89144,80219
TTCTAATGACCATTAT,sample,244747,242135,18584,223551,106847,116704,65344,3740,29033,2990,94377,15597,6811,2270,38974,52318
AATGGTAAACCATTAT,sample,1034199,1013483,174747,838736,142680,696056,142478,4287,280990,30955,423468,237346,22110,5921,81286,82413
TTAGAAGTACCATTAT,sample,726794,715314,94462,620852,138943,481909,144410,5948,185087,19329,329497,127135,14877,3760,83373,88623
GGACCTCTACCATTAT,sample,395615,386307,59723,326584,61322,265262,77680,4023,102504,10510,180184,70545,11780,2246,48258,38144
TCGCATCTACCATTAT,sample,267725,257251,85945,171306,19996,151310,19747,1216,68781,7394,88528,54172,14430,2698,4758,9245
CATAACCTACCATTAT,sample,312323,308047,28154,279893,74153,205740,93734,4964,69528,10317,163262,27197,7407,1748,49150,45653
CCGCAACGACCATTAT,sample,125688,124063,9000,115063,51104,63959,38788,2086,15420,1677,54208,5988,4258,1762,20443,26479
ACCTCGAGACCATTAT,sample,96774,95043,12176,82867,14159,68708,23608,1168,27948,3103,51556,12881,6066,1655,8568,9021
GACGATAAACCATTAT,sample,232778,229806,20587,209219,80935,128284,72963,3029,34878,4140,107841,13274,5590,1398,49211,45078
CGAGGCAGACCATTAT,sample,58395,56871,10127,46744,5936,40808,10981,782,18036,2077,29017,8932,5398,1419,2625,3762
CCATGAAGACCATTAT,sample,50185,49148,7817,41331,11616,29715,8588,388,10998,1112,19586,8629,4916,921,4721,6786
ACGACTTCACCATTAT,sample,144899,142870,10268,132602,57929,74673,55203,1727,14040,1407,69243,2296,1385,647,41376,30720
AATCCGTCACCATTAT,sample,115719,110995,28584,82411,9790,72621,12467,636,31074,3442,43541,25002,9190,1483,4841,5649
AACTCGTAACCATTAT,sample,70004,67969,14181,53788,10936,42852,11936,459,15935,1728,27871,12794,5383,791,7548,6084
ACCAATGCACCATTAT,sample,105698,102452,19116,83336,17582,65754,18435,899,25310,2539,43745,18571,6381,1122,11007,9849
TGCTTCGCACCATTAT,sample,309601,305383,32219,273164,91616,181548,79154,2420,54943,6229,134097,38802,6473,1537,53087,52285
GTCTTAGCACCATTAT,sample,313164,303648,41529,262119,50591,211528,65336,1982,76132,7912,141468,60166,12661,2356,38535,32046
CCAATTCCACCATTAT,sample,842682,821238,152649,668589,76569,592020,111797,3251,246816,25104,358613,205052,23458,6419,50387,43395
TTGGTTAAACCATTAT,sample,400612,383794,97275,286519,27944,258575,31244,1722,116942,13032,148186,95635,15952,3117,6207,11997
TCAATATAACCATTAT,sample,477360,464439,77564,386875,51632,335243,70604,2649,138819,15680,209423,107491,16763,3800,23766,32652
TCGCCTGAACCATTAT,sample,222043,219020,20320,198700,62533,136167,69942,4027,37292,3919,107234,20987,7484,2202,32604,38902
CTTCATGAACCATTAT,sample,364988,361516,26006,335510,133555,201955,116211,3153,46054,5834,162265,30703,4621,1404,79601,74763
GGAGAGTTCAATGGAT,sample,481931,479124,48174,430950,123554,307396,109087,5087,108211,13957,217298,71054,14334,3271,62060,73498
ATTCTCTTCAATGGAT,sample,449113,444286,27063,417223,186944,230279,153523,5632,40378,4756,193901,25990,5834,2368,90710,98697
GGTTGCGTCAATGGAT,sample,124186,121967,13405,108562,35796,72766,35751,1515,22497,2719,58248,10284,4874,1205,23726,20963
TAGTACGGCAATGGAT,sample,243768,241491,12535,228956,109393,119563,94068,2444,17430,2504,111498,3117,2007,1000,69029,57246
CATAACCTCAATGGAT,sample,309510,304562,34839,269723,82705,187018,95721,2298,52369,5862,148090,30768,6167,1559,71262,50326
ACTATACTCAATGGAT,sample,142660,140743,14377,126366,33404,92962,45900,3261,29663,3162,75563,10976,5761,2596,15045,21929
GGACGTAGCAATGGAT,sample,165836,161401,35184,126217,17387,108830,23571,1377,47810,5243,71381,30829,10142,2284,7685,9957
GACGATAACAATGGAT,sample,564513,553851,85016,468835,122014,346821,101570,3728,129718,12199,231288,99606,14732,3417,56663,75884
CATTGCAGCAATGGAT,sample,141692,140057,9171,130886,50227,80659,62361,1151,12776,1002,75137,3369,1378,604,51899,29214
CGAGGCAGCAATGGAT,sample,224370,219723,32506,187217,39493,147724,47124,1523,53801,6219,100925,39057,9587,1677,32037,23384
ACGACTTCCAATGGAT,sample,221873,217621,34495,183126,35144,147982,35979,1245,57377,6157,93356,47224,10886,1694,22095,21013
AATCCGTCCAATGGAT,sample,316719,311814,37733,274081,59797,214284,75586,2190,77619,8356,153205,50533,8655,1899,52232,38335
CTAGGACCCAATGGAT,sample,323081,318856,30675,288181,92880,195301,94452,2771,53621,4405,148073,40052,4842,1301,69702,57379
CGGATTACCAATGGAT,sample,78543,76143,15485,60658,11724,48934,13091,412,19428,1903,32519,14100,5544,955,7403,6625
GCCTGAACCAATGGAT,Neg_Ctrl,4439,2401,1811,590,158,432,137,8,186,12,323,89,168,33,90,56
AACTCGTACAATGGAT,sample,46593,45225,9559,35666,5698,29968,6930,428,12024,1440,18954,9146,4774,859,3084,3068
CGTATGAACAATGGAT,sample,85208,82467,18059,64408,11085,53323,14409,602,21073,2069,35482,15170,6111,1043,8446,6249
AATATATCCAATGGAT,Neg_Ctrl,4436,2701,1955,746,220,526,206,8,186,21,392,105,241,48,112,55
AAGAGCGCCAATGGAT,sample,278335,269540,54863,214677,37027,177650,40934,1272,71089,7100,112023,57255,11624,1782,23314,20483
GTACCGTACAATGGAT,sample,214373,211896,18530,193366,63784,129582,69786,2077,33785,4022,103571,19912,4485,1251,50090,39250
GGCATATACAATGGAT,sample,268013,264088,25892,238196,71551,166645,79969,2761,51786,6288,131755,25841,6049,1596,45450,45094
AGGTCGGACAATGGAT,Pos_Ctrl,202316,189878,27505,162373,6509,155864,130521,11009,9880,1376,140401,3078,7780,10912,7820,2680
ATGACCGACAATGGAT,sample,196350,194621,10001,184620,73338,111282,87617,2478,17062,1913,104679,2212,1495,717,68233,43010
GGAGAGTTAGATTCAT,sample,286529,283607,32042,251565,70800,180765,62104,2878,66355,7582,128459,41846,10465,2081,39044,41684
AAGTTCGTAGATTCAT,sample,159703,156299,20979,135320,39615,95705,36025,928,31271,3015,67296,24466,7572,1144,25779,23935
ACGTAAGTAGATTCAT,sample,266963,264410,16592,247818,107645,140173,106027,2335,21425,3218,127452,7168,1496,718,86787,58227
ATGCCTGGAGATTCAT,sample,223057,217648,39660,177988,38325,139663,39034,1623,55095,5816,94129,38095,11803,2304,16736,23253
CAACCGCGAGATTCAT,sample,255663,249768,42002,207766,47300,160466,54531,2002,59540,6692,114071,37701,9648,1861,31170,29605
AATGGTAAAGATTCAT,sample,250338,245045,39903,205142,39373,165769,52189,3012,65573,7818,117762,37177,10840,2285,24728,25147
TTCCGTCTAGATTCAT,sample,396470,387288,58668,328620,79103,249517,62920,2848,102428,11900,165348,69421,12769,2435,27981,47483
GCCTTGCTAGATTCAT,sample,160547,158731,13974,144757,58654,86103,49205,1567,22459,2463,71664,10409,3907,1141,33012,32538
CCAGAGCGAGATTCAT,sample,49646,48086,11641,36445,5046,31399,6201,340,13185,1420,19386,10253,5097,864,2641,2609
CCGCAACGAGATTCAT,sample,163616,160885,17864,143021,39520,103501,40632,1522,38891,4080,79523,18376,6275,1278,20632,24364
GGACGTAGAGATTCAT,sample,246027,243893,15445,228448,93181,135267,87956,4301,26154,2396,114110,14460,4102,1363,55423,52510
GACGATAAAGATTCAT,sample,121878,118398,21266,97132,15122,82010,22285,908,34425,3189,56710,21203,7065,1495,9197,8750
ACGACTTCAGATTCAT,sample,449418,441221,61730,379491,40698,338793,54748,2100,145981,15349,200729,120615,17674,3896,16529,23410
CATGATTCAGATTCAT,sample,258146,255116,22463,232653,56494,176159,82337,4324,55800,6722,138137,26976,7831,1504,51705,36975
AGTCCGCAAGATTCAT,sample,25323,24473,2454,22019,10206,11813,9608,219,1311,189,10919,486,721,372,8136,5256
GTCCTGCCAGATTCAT,sample,24799,24094,2445,21649,9420,12229,7769,110,2643,329,10412,1378,1235,359,6262,4908
GTTAGGACAGATTCAT,sample,77195,75250,12253,62997,17482,45515,14470,592,16885,1762,31355,11806,5710,1092,8465,10268
ACGTATTAAGATTCAT,sample,152246,149204,27001,122203,35949,86254,27792,1266,31603,3336,59395,22257,7527,1861,13150,19760
TTGGCCTCAGATTCAT,sample,73762,72359,11855,60504,10523,49981,16338,993,19779,2338,36117,10533,5884,1603,5922,6782
TTGGTTAAAGATTCAT,sample,383819,379449,33444,346005,89128,256877,112280,5953,92088,8999,204368,37557,5915,1781,51781,60006
ATGACCGAAGATTCAT,sample,265972,262286,31160,231126,48016,183110,56502,3201,68406,8153,124908,46848,11459,2445,28683,29846
ATTCTCTTCAATCTTG,sample,672451,665300,71725,593575,135402,458173,159476,8012,178046,19043,337522,93596,12408,3265,69577,83937
TCCTCCGTCAATCTTG,sample,282261,277054,38328,238726,31269,207457,60388,3875,86661,10191,147049,46342,10064,2485,17016,20330
TTCGTAATCAATCTTG,sample,408874,399829,52567,347262,93373,253889,92326,4484,88360,8807,180686,59912,12500,2737,54127,55855
ACGTTATGCAATCTTG,sample,328353,324457,30336,294121,97779,196342,88294,2741,67748,6701,156042,30858,4315,1391,57459,60276
TGAGCGCGCAATCTTG,sample,312967,304331,60511,243820,34439,209381,39437,989,86119,9594,125556,73242,14948,2563,19204,19430
AATGGTAACAATCTTG,sample,508454,499661,69320,430341,99428,330913,114143,3909,109157,12529,223300,91175,11236,3004,63238,61053
ACTATACTCAATCTTG,sample,443657,437216,54400,382816,101759,281057,109736,4115,94687,9751,204423,62768,8927,2394,72950,63771
CCAGAGCGCAATCTTG,sample,218214,214714,25346,189368,43345,146023,60093,2793,46348,5292,106441,31497,8776,1850,32886,27685
CTTGATAGCAATCTTG,sample,329034,326662,17318,309344,148360,160984,123796,3210,26916,2464,150712,4598,1809,838,99609,73279
CGAGGCAGCAATCTTG,sample,144760,143206,10589,132617,64650,67967,44296,1422,14459,1551,58755,6239,3145,1048,32691,31312
ACGACTTCCAATCTTG,sample,170743,169267,8137,161130,90367,70763,59176,2369,5991,1253,65167,1974,1656,1241,40971,37879
CGTACGTCCAATCTTG,sample,581599,573893,59845,514048,109290,404758,154641,8125,141555,15292,296196,85145,12595,3023,74941,74030
GTTAGGACCAATCTTG,sample,24383,23482,5707,17775,3155,14620,3051,138,5782,577,8833,5072,3148,424,1804,1625
CGTATGAACAATCTTG,sample,159244,155360,23299,132061,39315,92746,32172,1217,33174,3613,65346,22570,7769,1426,19670,22036
TGCTTCGCCAATCTTG,sample,73381,72363,6302,66061,32499,33562,25731,694,5141,405,30872,1591,1113,512,21000,15562
CCAATTCCCAATCTTG,sample,335473,329665,37139,292526,71648,220878,73374,4751,78847,7553,152221,56353,10628,2565,37033,47024
AGGTCGGACAATCTTG,sample,179047,177392,9075,168317,76034,92283,68870,1419,17221,1708,86091,3065,1502,736,50642,40844
TATCAGTTCGTTCCGA,sample,625213,614497,89425,525072,135493,389579,102834,6223,154120,15911,256954,110491,16202,4172,51974,82279
ACGTAAGTCGTTCCGA,sample,303265,299070,33687,265383,87936,177447,71823,2464,62899,6480,134722,33781,9701,2220,40005,51867
CCTCTAGACGTTCCGA,sample,208194,200938,59003,141935,14720,127215,16730,653,57799,5686,74529,46347,11522,1740,6006,6411
ATGCCTGGCGTTCCGA,sample,187272,183405,29659,153746,41893,111853,28400,1595,44214,4735,72614,32909,10095,2228,12906,24383
GACGGAGACGTTCCGA,sample,916845,891743,161055,730688,112490,618198,128162,4001,259213,25528,387375,201294,21431,6101,58398,70350
CCGCAACGCGTTCCGA,sample,317473,312794,35879,276915,90716,186199,89165,3289,53474,6755,142639,33516,7852,1944,52470,52191
GGACGTAGCGTTCCGA,sample,355120,348837,52007,296830,68077,228753,64626,3045,87932,9261,152558,63889,11269,2331,23485,39917
TGGACGAGCGTTCCGA,sample,1039610,1027472,198943,828529,104554,723975,138453,5804,295254,27645,433707,256819,15812,6978,59844,64795
CGAGGCAGCGTTCCGA,sample,325731,318239,55506,262733,61259,201474,57589,3392,80044,9360,137633,51089,11142,2459,26546,35963
CCATGAAGCGTTCCGA,sample,309170,303677,52982,250695,50998,199697,56458,3358,75846,8620,132304,55415,11549,2664,25322,30413
ACGACTTCCGTTCCGA,sample,356754,350465,55462,295003,108740,186263,69583,3145,57741,5742,127324,50052,11525,2640,38575,56158
GTCCTGCCCGTTCCGA,sample,368110,362677,40519,322158,74923,247235,101685,3479,91671,10658,193356,39742,9372,2128,45170,45763
CGGATTACCGTTCCGA,sample,271571,269324,13505,255819,131237,124582,98855,3622,17013,1690,115868,3402,1585,898,77770,61830
GCCTGAACCGTTCCGA,sample,161871,158243,25360,132883,20182,112701,36535,2276,45820,5409,82355,22661,6817,1812,10818,11788
AACTCGTACGTTCCGA,sample,252036,249129,26232,222897,95677,127220,74704,2671,29916,2882,104620,17047,4326,1374,50355,48458
CCAATTCCCGTTCCGA,sample,386913,380225,43244,336981,92982,243999,107241,4116,74340,9336,181581,48966,10169,1996,77419,57949
TTGGTTAACGTTCCGA,sample,511738,504353,57442,446911,123566,323345,138866,7282,96716,12914,235582,67567,9008,2698,72289,76794
GTACCGTACGTTCCGA,sample,742275,730762,106617,624145,120116,504029,138294,4461,193756,21142,332050,146376,16505,3679,80040,76814
TCAATATACGTTCCGA,sample,290886,287724,25865,261859,92801,169058,96073,4259,43588,4686,139661,20452,6381,1630,60132,57259
TCGCCTGACGTTCCGA,sample,129623,128755,6140,122615,39743,82872,49652,4099,22115,3504,71767,3502,3156,1831,21077,25043
GGAGAGTTCAATTCGG,sample,345652,342150,33673,308477,86641,221836,91002,5500,85023,9156,176025,31155,8404,2369,40892,54815
TATCAGTTCAATTCGG,sample,270043,266453,25049,241404,77591,163813,76444,4232,54487,4661,130931,23989,7213,1961,40465,46768
ATTCTCTTCAATTCGG,Pos_Ctrl,416784,398097,54414,343683,16000,327683,272311,21791,23500,3189,295811,6892,8940,14070,21139,7602
ACGTTATGCAATTCGG,Pos_Ctrl,316852,300478,40654,259824,12390,247434,207659,16689,16361,2084,224020,4641,8618,13107,16626,6581
TCGCATCTCAATTCGG,sample,485167,473893,75188,398705,70097,328608,89356,3927,134543,13714,223899,87068,14703,3366,38051,44723
GCCTTGCTCAATTCGG,Pos_Ctrl,405213,389816,43592,346224,15348,330876,277273,22991,21721,2600,298994,6291,8952,14442,23005,6981
CATAACCTCAATTCGG,sample,352070,347712,25741,321971,113649,208322,108373,3049,58949,5841,167322,32110,6190,2000,64419,67371
CCGCAACGCAATTCGG,Pos_Ctrl,405026,388885,43863,345022,14136,330886,278115,24098,19479,2758,297594,6436,8793,14434,19300,6386
CTTGATAGCAATTCGG,sample,424919,420828,34996,385832,68836,316996,129105,11239,121389,15893,250494,39370,8144,2395,37689,47264
ACCTCGAGCAATTCGG,sample,183812,182127,10073,172054,70476,101578,64534,2994,24144,3424,88678,6482,4133,1546,37303,38081
GGCCAGAGCAATTCGG,sample,44129,43442,2899,40543,13291,27252,15708,1034,7932,816,23640,1762,2868,1761,6067,8093
CCATGAAGCAATTCGG,Pos_Ctrl,227510,218553,27009,191544,8785,182759,153873,12547,11589,1316,165462,3434,8242,11905,13122,3783
ACGACTTCCAATTCGG,sample,66701,64332,18575,45757,5836,39921,6182,421,17540,1837,23722,13941,7037,1143,2033,2503
CATGATTCCAATTCGG,sample,132981,130546,15782,114764,36572,78192,33444,1108,24040,2150,57484,17450,5236,1147,22923,21932
CGGATTACCAATTCGG,Pos_Ctrl,186260,177022,24227,152795,7046,145749,122563,9690,9421,1164,131984,2911,7827,10608,10321,3221
GTTAGGACCAATTCGG,sample,109319,106983,14328,92655,13117,79538,25452,1513,33771,4019,59223,14783,6227,1892,6490,8900
TTGGCCTCCAATTCGG,Pos_Ctrl,182293,175688,23017,152671,7187,145484,121769,10145,9642,1149,131411,2779,7958,10861,10103,2982
ACCAATGCCAATTCGG,sample,114745,111480,18716,92764,25022,67742,23498,761,23334,2375,46832,17774,7271,1343,15246,14523
AGGTCGGACAATTCGG,sample,540973,522382,100052,422330,69348,352982,85886,3627,141794,15218,227680,106457,17496,3899,40857,42569
TTATTCGACAATTCGG,sample,289823,287752,13202,274550,138702,135848,104215,3755,17868,1562,122083,8448,2825,1533,66844,65600
GGAGAGTTAACTCCGG,sample,202476,201214,7575,193639,102098,91541,71808,2522,12373,1753,84181,3085,1402,736,58284,46310
TCCAACTTAACTCCGG,sample,158567,152136,26843,125293,34480,90813,31508,1524,32805,3763,64313,21213,8432,1789,17155,19561
TAGTACGGAACTCCGG,sample,216049,212827,17365,195462,87486,107976,65453,2575,24772,2369,90225,12807,3174,998,50922,44529
TTCCGTCTAACTCCGG,sample,175164,171290,23291,147999,46806,101193,38300,1323,32780,4117,71080,24673,5640,1137,26336,26937
ACTATACTAACTCCGG,sample,203202,198056,29107,168949,27368,141581,47039,3186,56041,7074,103080,28241,8118,2194,16696,17131
GACGATAAAACTCCGG,sample,179316,173860,32653,141207,38045,103162,28981,1107,40591,4179,69572,28304,8358,1532,15701,21210
CATTGCAGAACTCCGG,sample,83421,81807,10280,71527,21905,49622,22047,989,15220,1740,37267,9626,5092,1340,12278,13035
CCATGAAGAACTCCGG,sample,81328,79064,10349,68715,19169,49546,16847,721,17835,1727,34682,12416,5682,939,10875,11450
AGTCCGCAAACTCCGG,sample,69752,67340,10551,56789,16085,40704,15886,579,13020,1324,28906,9895,4968,745,11908,9309
CGGATTACAACTCCGG,sample,122386,118359,23147,95212,17204,78008,16634,570,31993,3768,48627,25043,9072,1304,8491,9704
ACGTATTAAACTCCGG,sample,247765,242219,41282,200937,46448,154489,37829,900,57736,6900,95565,51124,11593,1989,23177,27885
AACTCGTAAACTCCGG,sample,76314,74678,7656,67022,28907,38115,20403,1256,10313,1080,30716,5063,3695,1274,11803,14376
TTGGCCTCAACTCCGG,sample,85256,83456,12352,71104,19063,52041,19931,621,17971,1928,37902,11590,6006,1210,12087,11027
AATATATCAACTCCGG,sample,135289,133209,12734,120475,52128,68347,35162,1126,18060,2151,53222,11848,5715,1111,24779,26491
AAGAGCGCAACTCCGG,sample,196995,195205,9179,186026,91644,94382,70748,2830,14444,3709,85192,2651,1146,597,53951,44906
GTACCGTAAACTCCGG,sample,134848,133030,9244,123786,65202,58584,44792,1157,9138,1467,53930,2030,1044,613,33612,28506
GGCATATAAACTCCGG,sample,175995,169588,23689,145899,35830,110069,44666,1720,37839,4994,82505,20850,4213,1184,21302,20880
ATGACCGAAACTCCGG,sample,207105,200934,28640,172294,28129,144165,49462,2664,57716,5645,107178,28678,5948,1497,21621,19462
TCCAACTTCCTGAAGG,Neg_Ctrl,4552,2561,1980,581,189,392,133,8,142,16,275,93,161,37,75,38
TCCTCCGTCCTGAAGG,sample,333055,327362,29161,298201,106649,191552,100040,1747,48785,6128,148825,34852,5515,1413,75589,62924
AGTACCATCCTGAAGG,sample,541193,529428,84353,445075,70713,374362,85162,4254,160968,17185,246130,106793,15384,3499,39308,43538
TTCTAATGCCTGAAGG,Neg_Ctrl,5441,3250,2519,731,181,550,162,11,283,12,445,82,184,35,97,29
AATGGTAACCTGAAGG,sample,229505,224533,35358,189175,31501,157674,48977,2142,64808,7409,113785,34338,8511,1865,18040,17706
CAAGGCCTCCTGAAGG,Neg_Ctrl,5735,3904,3062,842,208,634,202,6,238,17,440,171,281,48,95,59
CATAACCTCCTGAAGG,sample,198216,194958,20202,174756,58078,116678,66603,1715,29163,2967,95766,16230,3678,1086,50471,34700
CCAGAGCGCCTGAAGG,sample,424864,410201,86126,324075,43778,280297,49697,3095,120079,12199,169776,95227,17006,3895,12120,24245
GTTAGCCGCCTGAAGG,sample,426078,413331,72870,340461,43554,296907,69719,3475,118928,12560,188647,92225,13661,2905,26605,27404
GGAGGACGCCTGAAGG,sample,326466,317630,63294,254336,34161,220175,39369,1551,89045,9262,128414,80948,13315,2205,23575,19573
GGACGTAGCCTGAAGG,Neg_Ctrl,3566,1953,1545,408,125,283,100,2,94,6,194,81,126,25,53,32
CGAGGCAGCCTGAAGG,sample,62826,61298,7901,53397,8828,44569,15772,974,18295,1994,34067,7534,4324,1358,5329,5941
ACGACTTCCCTGAAGG,Neg_Ctrl,2174,1488,1071,417,90,327,95,7,95,8,190,122,126,27,55,51
CATGATTCCCTGAAGG,sample,45160,42427,13397,29030,3115,25915,3362,214,11854,1245,15216,9240,5388,663,895,1376
GTTAGGACCCTGAAGG,Neg_Ctrl,14590,5449,4869,580,109,471,95,8,247,16,342,105,139,31,46,14
CGTATGAACCTGAAGG,sample,202300,194227,39645,154582,27478,127104,31496,1202,48298,4985,79794,41123,9678,1695,13441,15799
AATATATCCCTGAAGG,Neg_Ctrl,4419,3138,2632,506,92,414,112,1,182,24,294,95,185,33,67,57
TGCTTCGCCCTGAAGG,sample,78783,75043,24399,50644,4597,46047,5909,253,20804,2299,26713,16782,7874,915,1734,1897
GTCTTAGCCCTGAAGG,sample,144957,140827,22044,118783,32106,86677,35321,1644,28333,3072,63654,18307,7678,1877,14795,19129
GGTTGCGTAATATTCG,sample,262024,256597,32511,224086,71695,152391,58868,1904,51599,5824,110467,34196,9984,2262,29225,41160
TCCTCCGTAATATTCG,sample,182861,180922,10239,170683,80045,90638,67082,1349,15258,1373,82340,5576,2439,909,52976,40089
AGTACCATAATATTCG,sample,241132,238823,14972,223851,109841,114010,79094,3016,21140,2402,100234,8358,3791,1610,54692,53664
ATGCCTGGAATATTCG,sample,175655,170781,14293,156488,50594,105894,51782,2679,30864,4359,82646,16210,6029,1545,28177,30126
GGACCTCTAATATTCG,sample,225167,221589,48056,173533,22920,150613,24526,774,64071,6206,88597,55036,12160,1835,10742,12696
GCCTTGCTAATATTCG,sample,33829,33099,3915,29184,5242,23942,10187,643,9141,1042,19328,2929,3350,1507,2967,3301
GACGGAGAAATATTCG,sample,130473,125760,28310,97450,13533,83917,14984,488,36008,3861,50992,28576,9690,1312,7875,7267
CCATGAAGAATATTCG,sample,116895,113549,19115,94434,14655,79779,23818,1394,32128,3487,55946,18952,7272,1785,6661,8416
CTAGGACCAATATTCG,sample,257429,249019,53919,195100,24317,170783,29958,1844,72019,7526,101977,59436,14429,2831,9171,13406
CGTATGAAAATATTCG,sample,255978,252765,24706,228059,80571,147488,70966,2185,43620,4273,114586,26444,5550,1223,50151,46266
ACCAATGCAATATTCG,sample,207091,201653,31555,170098,40388,129710,39007,1873,49824,6282,88831,32724,9479,1847,19587,24216
TTGGTTAAAATATTCG,sample,217315,214805,14656,200149,93353,106796,86174,1504,14355,2240,100529,2523,1280,665,69194,47502
GTACCGTAAATATTCG,Pos_Ctrl,283107,269558,32126,237432,8919,228513,191218,15945,14709,2058,205927,4583,8071,12323,12788,3564
TCAATATAAATATTCG,sample,171790,167208,24730,142478,64370,78108,59829,2058,13266,1310,73095,1645,1203,603,42406,29024
TCCAACTTAGTCTCCG,sample,188610,186733,10321,176412,85836,90576,70211,1511,13426,1772,83637,3656,1724,811,55559,41837
TCCTCCGTAGTCTCCG,sample,262975,256508,33511,222997,48216,174781,44649,2247,68729,6864,113378,52292,11720,2592,21170,29852
AGTACCATAGTCTCCG,sample,249558,244058,16466,227592,97388,130204,90981,2268,23853,1946,114834,11156,2308,918,73215,52198
CAACCGCGAGTCTCCG,sample,279216,273132,33424,239708,53500,186208,58219,4952,70324,7110,128543,45603,9928,2201,24415,34318
AATGGTAAAGTCTCCG,sample,162291,160590,8493,152097,66952,85145,66296,1995,13175,1315,79471,2364,1330,701,52672,36459
GCCTTGCTAGTCTCCG,sample,262763,258373,32760,225613,54312,171301,60809,1188,59407,5883,120216,44014,9245,2087,42824,35219
CATAACCTAGTCTCCG,sample,65160,63659,9637,54022,9313,44709,14437,790,18495,2242,32932,8745,4421,1234,6033,5043
GGAGGACGAGTCTCCG,sample,198052,194660,19375,175285,50742,124543,52769,2203,41061,4217,93830,24293,7593,1850,29344,30874
CTTGATAGAGTCTCCG,sample,186089,179938,33031,146907,31953,114954,26157,767,46480,5245,72637,36305,10311,1551,14854,18059
ACGTATTAAGTCTCCG,sample,234226,230785,25379,205406,54057,151349,62982,1899,49939,5066,112921,31463,8365,1620,35238,33750
CGTATGAAAGTCTCCG,sample,185442,182988,16025,166963,51532,115431,53662,2440,36324,3598,89986,19407,6778,1469,32302,31547
AAGAGCGCAGTCTCCG,sample,187313,185235,12024,173211,63179,110032,73611,3245,23199,2099,96810,7878,3726,1304,44417,37961
TCGCCTGAAGTCTCCG,sample,348311,340898,48161,292737,50123,242614,51566,1182,94755,9339,146321,85772,13611,2396,31775,30448
CTTCATGAAGTCTCCG,sample,169790,167851,9045,158806,76435,82371,65129,1903,12122,984,77251,2233,965,476,51116,37973
AGGTCGGAAGTCTCCG,sample,233946,231139,18164,212975,51703,161272,66075,3807,58404,6774,124479,26212,8205,2026,26649,33625
TTATTCGAAGTCTCCG,sample,181844,176533,33638,142895,21042,121853,20887,1166,51708,5343,72595,42749,13240,2569,6348,11563
GGTTGCGTTGCCTACG,sample,225150,218354,39226,179128,25385,153743,33218,960,63193,6785,96411,49587,11984,2103,13747,15020
CCTCTAGATGCCTACG,sample,80889,79126,8914,70212,19729,50483,23289,1120,15854,1591,39143,8629,4624,1197,14120,12267
TTCTAATGTGCCTACG,sample,107551,104607,18601,86006,28353,57653,13478,482,22315,2297,35793,19081,6989,895,8147,14580
ACTATACTTGCCTACG,sample,140453,137284,18974,118310,41079,77231,24719,1119,27006,2694,51725,21693,8019,1376,14900,22396
CCAGAGCGTGCCTACG,sample,75054,73614,8618,64996,12561,52435,20552,1154,18819,2379,39371,9531,4848,1126,9461,8326
TGGACGAGTGCCTACG,sample,35265,33805,12165,21640,3621,18019,1584,113,7990,868,9574,7464,4547,375,405,969
AATCCGTCTGCCTACG,sample,101539,99029,15356,83673,14438,69235,22829,644,24558,2560,47387,18644,6094,947,15315,8488
AGTCCGCATGCCTACG,sample,140901,137165,22785,114380,18695,95685,28218,1225,35347,3518,63565,27377,7956,1336,12945,11826
CGGATTACTGCCTACG,sample,54060,52855,7282,45573,14294,31279,13188,546,9710,1009,22898,6826,4278,895,7375,8160
GCCTGAACTGCCTACG,sample,98322,95712,15352,80360,14420,65940,18025,931,25592,2819,43617,18573,7435,1192,9280,9238
ACGTATTATGCCTACG,sample,90215,88487,10048,78439,25069,53370,20989,1595,18560,1909,39549,10317,4581,955,11062,14132
TTGGCCTCTGCCTACG,sample,41003,40274,4102,36172,13317,22855,10760,405,7029,857,17789,3804,2914,719,6364,7219
GGCATATATGCCTACG,Neg_Ctrl,1541,753,548,205,48,157,47,3,54,6,101,47,63,7,34,10
AGGTCGGATGCCTACG,sample,92388,89614,16723,72891,11715,61176,13328,680,25227,2684,38555,19257,6629,1086,5325,6698
TTATTCGATGCCTACG,sample,158633,155988,20563,135425,28382,107043,34101,736,37040,4139,71141,31027,6800,1251,24326,18935
TATCAGTTCTTAGTTC,sample,388031,385483,14278,371205,191493,179712,146024,3278,21869,4040,167893,4501,1876,925,119141,89460
ATTCTCTTCTTAGTTC,sample,471938,465938,38748,427190,136144,291046,125490,6350,102520,12073,228010,44613,6226,2204,70008,85945
GGTTGCGTCTTAGTTC,sample,335572,330212,36970,293242,73206,220036,94292,5792,72725,10257,167017,36970,7475,1975,44351,46251
CCTCTAGACTTAGTTC,sample,170214,166265,21600,144665,38747,105918,31787,1490,41411,4381,73198,26849,8454,1518,17899,23333
TTCTAATGCTTAGTTC,sample,188715,184304,19627,164677,68493,96184,58633,3025,25166,2712,83799,6648,3737,2076,21533,35886
TGAGCGCGCTTAGTTC,sample,121018,116685,24059,92626,14254,78372,16369,866,32759,3550,49128,24828,8479,1467,6830,8424
GGACCTCTCTTAGTTC,sample,455323,445976,65818,380158,78839,301319,69385,2064,116696,11995,186081,101179,14877,2930,44322,47307
ACTATACTCTTAGTTC,sample,523267,512386,71957,440429,100080,340349,89244,3608,134103,14547,223347,98847,14271,3192,49782,59697
CATGATTCCTTAGTTC,sample,231847,226750,31196,195554,72182,123372,69905,2434,29028,3342,98933,18663,4127,1000,49483,39380
AATCCGTCCTTAGTTC,sample,332554,321715,58416,263299,49292,214007,57228,1837,78813,7709,136041,68420,12047,1857,38060,29682
AGTCCGCACTTAGTTC,sample,310099,304304,38444,265860,53864,211996,70642,5598,76514,8613,147156,50629,9886,2067,32271,34979
AACTCGTACTTAGTTC,sample,123656,121878,9757,112121,16390,95731,42382,3277,35472,3981,77854,10619,4767,1904,10966,11736
CGTATGAACTTAGTTC,sample,454193,446014,60033,385981,93422,292559,94434,2808,109120,11125,203554,75072,12191,2542,56340,57692
GAAGGCGCCTTAGTTC,sample,302113,294868,45527,249341,58606,190735,63169,2104,64766,6972,127935,53724,10085,1763,43887,35247
GTCTTAGCCTTAGTTC,sample,220614,215901,27658,188243,51495,136748,48975,1925,45233,4920,94208,35695,9245,1500,33246,31246
TATCAGTTCGAGCTTC,sample,327492,321629,47318,274311,50520,223791,53370,2582,94164,10590,147534,63085,13709,3153,22976,32404
GGTTGCGTCGAGCTTC,sample,308891,306500,14336,292164,148073,144091,115681,2727,18597,1801,134278,5285,1730,865,89094,68889
TCCTCCGTCGAGCTTC,sample,223378,219972,21700,198272,41614,156658,56817,3137,64161,6973,120978,25570,7097,1765,25478,28590
ACGTAAGTCGAGCTTC,sample,204072,201254,18628,182626,32883,149743,58562,3052,62497,7361,121059,18271,6685,2359,17167,22027
GGACCTCTCGAGCTTC,sample,276165,272527,22560,249967,102152,147815,88522,3132,32596,4749,121118,18816,4237,1295,64848,56287
CAAGGCCTCGAGCTTC,sample,478574,468851,50083,418768,121055,297713,107968,4722,103302,10789,211270,70932,11000,2695,65642,75083
GACGGAGACGAGCTTC,sample,289608,283390,33305,250085,57934,192151,63413,2286,70680,8279,134093,47493,11074,2182,38576,35855
CCAGAGCGCGAGCTTC,sample,154114,151583,14914,136669,22238,114431,40655,2690,47024,5480,87679,18582,6734,1725,10029,14933
ACCTCGAGCGAGCTTC,sample,99396,97930,4866,93064,33834,59230,45519,1658,8906,1516,54425,1631,1060,610,34578,20665
CGAGGCAGCGAGCTTC,sample,168780,164807,21959,142848,26116,116732,36298,2034,49536,6103,85834,22761,8241,1961,14133,16657
ACGTATTACGAGCTTC,sample,168621,165371,13902,151469,68883,82586,46577,1354,21429,2865,68006,10361,3491,948,34275,34867
TTGGCCTCCGAGCTTC,sample,27440,26872,2789,24083,7169,16914,7958,606,6045,705,14003,1600,2803,1402,2402,4632
ACCAATGCCGAGCTTC,sample,155816,152015,16741,135274,50902,84372,29571,1406,31097,3609,60668,18689,7428,1598,16613,27454
AAGAGCGCCGAGCTTC,sample,277400,271551,38880,232671,42722,189949,64452,2543,72261,8791,136713,41902,8987,2158,26589,27504
TTGGTTAACGAGCTTC,sample,225165,221814,17030,204784,64964,139820,63084,3085,48608,5015,111692,20028,6561,1734,28055,38688
GGAGAGTTGTAGAATG,sample,2152,2079,205,1874,859,1015,535,22,292,49,827,117,388,155,305,410
ATTCTCTTGTAGAATG,Pos_Ctrl,404641,386402,51100,335302,15187,320115,266787,22095,22162,2656,288949,6415,9006,14182,20907,6914
GGTTGCGTGTAGAATG,sample,268399,265163,16825,248338,128513,119825,95353,2170,16876,2144,112229,3282,1446,763,74496,58390
ACGTAAGTGTAGAATG,sample,343513,338295,32598,305697,113551,192146,93482,3252,56940,5992,150422,32480,5981,1387,70038,63888
TTAGAAGTGTAGAATG,sample,200968,198656,17097,181559,71834,109725,56110,2358,30638,3598,86748,17021,5101,1310,34444,40839
GGACCTCTGTAGAATG,Pos_Ctrl,220794,208116,28866,179250,7714,171536,143294,11520,11839,1343,155133,3540,8079,11317,11517,3808
ACTATACTGTAGAATG,sample,347639,342698,33378,309320,91597,217723,99276,2439,60901,5938,160177,49169,6618,1774,73017,58458
CGAGGCAGGTAGAATG,Pos_Ctrl,245991,232413,30379,202034,8979,193055,162154,12981,12567,1522,174721,3831,8260,11964,13865,3861
AATCCGTCGTAGAATG,sample,55505,53344,12722,40622,9824,30798,8766,650,12359,1402,21125,7621,5896,1481,3295,5358
CGTACGTCGTAGAATG,sample,149184,145184,22597,122587,29640,92947,30117,1234,35009,4090,65126,22497,7417,1392,15615,17715
AACTCGTAGTAGAATG,sample,78125,76139,12726,63413,13354,50059,15407,884,20350,2312,35757,11106,6465,1650,5399,7669
ACCAATGCGTAGAATG,Pos_Ctrl,142480,134137,18666,115471,5560,109911,92071,7181,7442,932,99513,2285,7657,9787,8088,2736
GTCTTAGCGTAGAATG,sample,459593,448343,75361,372982,56741,316241,82940,2768,129304,14163,212244,87066,16737,3858,35817,36209
GTACCGTAGTAGAATG,sample,226083,224075,11929,212146,88296,123850,92664,1646,23223,2429,115887,3888,1396,686,72899,50283
CCTCTAGACAATAGTC,sample,323095,315705,63267,252438,44102,208336,41693,1347,85696,9197,127389,70403,16230,2760,22872,25021
TTCTAATGCAATAGTC,sample,364104,359756,36582,323174,121590,201584,90627,3646,63809,6293,154436,37209,7523,1841,62066,68820
CATAACCTCAATAGTC,sample,279458,275821,29514,246307,57994,188313,72396,2837,67054,7443,139450,38583,10020,2291,39336,37380
ACTATACTCAATAGTC,sample,102139,100292,11229,89063,21018,68045,28393,1623,25315,2825,53708,9889,5981,2408,6315,14030
ACCTCGAGCAATAGTC,sample,169390,166711,20143,146568,26796,119772,37315,1535,44787,4884,82102,31251,9691,1826,20656,17342
TGGACGAGCAATAGTC,sample,220642,218036,17911,200125,60441,139684,67641,4821,39231,3061,106872,24930,6040,1321,43708,37728
CATTGCAGCAATAGTC,sample,81181,79598,10297,69301,33000,36301,13435,927,11760,1249,25195,8930,5261,1181,7699,14698
CGAGGCAGCAATAGTC,sample,344505,334050,69208,264842,37415,227427,45233,2240,94462,9588,139695,75904,15818,3101,17237,20331
ACGACTTCCAATAGTC,sample,88905,86738,12324,74414,21802,52612,18559,631,18646,1838,37205,12938,5243,921,12098,12647
CATGATTCCAATAGTC,sample,64225,63221,4043,59178,28505,30673,24464,575,4119,533,28583,982,1009,478,19703,14170
CGTACGTCCAATAGTC,sample,118713,116077,15947,100130,22328,77802,34944,1769,22690,2439,57634,15960,6679,1840,11375,14105
AGTCCGCACAATAGTC,sample,60105,59134,5740,53394,22181,31213,18415,944,7567,1089,25982,3198,2946,1238,8759,11845
CGGATTACCAATAGTC,sample,32343,31151,4971,26180,3722,22458,7727,284,9324,1130,17051,3993,3602,1077,2756,2490
TTGGCCTCCAATAGTC,sample,103303,101106,15139,85967,27100,58867,22602,472,19001,2303,41603,14489,4680,925,15775,14805
AATATATCCAATAGTC,sample,89432,85887,21106,64781,9528,55253,10496,356,24021,2321,34517,18059,7881,1120,4386,4773
GAAGGCGCCAATAGTC,sample,155420,151815,20044,131771,33137,98634,32495,951,33809,3405,66304,27974,7205,1222,20527,20742
AAGAGCGCCAATAGTC,sample,138826,136723,13428,123295,43645,79650,40972,1896,23156,2887,64128,10739,5641,1231,26165,24643
GTCTTAGCCAATAGTC,sample,89353,88480,6263,82217,46684,35533,24704,830,6603,643,31307,2753,2430,863,18783,18811
GGCATATACAATAGTC,sample,85143,82738,14991,67747,10021,57726,15804,698,24712,2852,40516,13660,6119,1316,5840,5922
ATGACCGACAATAGTC,sample,83190,81998,8090,73908,21715,52193,23558,1025,16673,1974,40231,8963,4960,1169,14068,13424
GGAGAGTTCGTTACTC,sample,733,713,159,554,208,346,162,6,110,8,272,60,135,34,123,107
TATCAGTTCGTTACTC,sample,424536,419676,47867,371809,93356,278453,91065,4584,101978,10729,193043,70097,13016,3127,51289,59394
TCCAACTTCGTTACTC,Neg_Ctrl,6525,3562,2503,1059,263,796,247,11,359,14,606,165,218,50,133,72
AAGTTCGTCGTTACTC,sample,357456,352118,31766,320352,93046,227306,90950,2282,75125,8336,166075,50613,8281,1913,62064,57735
TCCTCCGTCGTTACTC,sample,222845,217611,41474,176137,19504,156633,41011,3076,69005,7702,110016,35839,9793,2459,8967,10917
ACGTAAGTCGTTACTC,sample,627030,621126,38845,582281,259761,322520,196467,5231,67503,7855,263970,45464,8173,2272,141142,132587
CCTCTAGACGTTACTC,sample,375230,371750,21162,350588,174219,176369,137713,4414,24179,2390,161892,7673,2507,1428,89809,87073
AGTACCATCGTTACTC,sample,485675,477765,41232,436533,170324,266209,130325,4520,68446,8076,198771,54842,7664,2317,94131,95089
TCGCATCTCGTTACTC,Neg_Ctrl,8221,4940,3679,1261,273,988,223,7,603,23,826,132,285,58,121,201
CCAGAGCGCGTTACTC,sample,403645,399422,32137,367285,156247,211038,116750,5873,49897,5394,166647,33124,6279,1905,71986,83486
CCGCAACGCGTTACTC,sample,395275,388368,44920,343448,126641,216807,102731,5692,56183,5502,158914,46699,6529,2283,58069,72218
CCATGAAGCGTTACTC,Neg_Ctrl,5077,2942,2041,901,182,719,169,8,134,12,303,396,148,49,113,119
CATGATTCCGTTACTC,sample,192928,189992,12644,177348,80132,97216,75921,1498,16148,738,92069,2911,1422,685,60178,42279
GTCCTGCCCGTTACTC,sample,151051,146512,32382,114130,11158,102972,22916,1552,46346,5271,69262,26887,9181,2299,3843,5838
TTGGTACCCGTTACTC,sample,133976,130490,13508,116982,30343,86639,42857,2775,28426,3129,71283,9452,5285,2076,14711,19493
TGCTTCGCCGTTACTC,Neg_Ctrl,4389,2495,1810,685,223,462,174,8,147,24,321,109,179,27,121,32
GGCATATACGTTACTC,sample,298544,296117,14106,282011,132250,149761,116802,3194,22677,3182,139479,3906,1540,731,91684,67003
CTTCATGACGTTACTC,sample,382765,378090,26589,351501,144153,207348,110524,3510,51009,5256,161533,37049,6015,1834,69705,79310
ATGACCGACGTTACTC,sample,389715,387641,21300,366341,148161,218180,145031,5182,44515,3650,189546,19802,5375,1389,112788,84675
GGAGAGTTTGGACTGC,sample,5489,5420,579,4841,2235,2606,1035,62,858,97,1893,554,975,303,441,1035
TATCAGTTTGGACTGC,sample,181561,180328,7383,172945,91311,81634,64945,2302,10057,1246,75002,3084,1697,888,49729,42278
ATGCCTGGTGGACTGC,sample,138987,135885,13567,122318,35334,86984,32883,1837,29862,2809,62745,19593,6114,1340,16608,21458
TAGTACGGTGGACTGC,sample,153447,148201,28506,119695,33986,85709,20082,782,34966,3759,55048,26120,9605,1478,11124,17904
CAACCGCGTGGACTGC,sample,168863,162038,32965,129073,28760,100313,22646,1266,41631,4478,64277,30292,9913,1787,10052,15729
GCCTTGCTTGGACTGC,sample,147966,146672,6931,139741,62687,77054,59263,1412,12701,1483,71964,2195,1199,598,47745,33911
CAAGGCCTTGGACTGC,sample,651146,628492,133342,495150,51750,443400,100623,4682,185199,22924,285822,129972,19893,4383,31428,28865
CCAGAGCGTGGACTGC,sample,99626,97933,9537,88396,36789,51607,28001,1383,12249,1235,40250,8739,4683,1469,16570,19667
GACGATAATGGACTGC,sample,180365,175589,26471,149118,33516,115602,46136,1723,39048,3974,85184,24721,8675,1778,25973,21790
CATGATTCTGGACTGC,sample,242893,232857,50180,182677,24236,158441,26765,752,66316,6884,93081,57724,15403,2000,13492,13340
TTGGTACCTGGACTGC,sample,181076,176500,24108,152392,30652,121740,42619,1529,44055,4673,86674,28864,8273,1455,23147,19527
GTCTTAGCTGGACTGC,sample,151977,149005,20939,128066,31031,97035,33802,1357,33744,3188,67546,24944,8435,1867,15807,20784
CCTCTAGACCTTGAGC,sample,267007,263595,13735,249860,122287,127573,103044,2252,17065,1458,120109,3754,1629,791,80744,59602
TTCGTAATCCTTGAGC,Pos_Ctrl,259452,246510,38367,208143,9997,198146,165887,13180,13516,1740,179403,3823,8302,11869,12521,5211
ATGCCTGGCCTTGAGC,sample,138526,134192,27558,106634,16942,89692,23386,1602,36037,4283,59423,24384,8209,2148,5077,9094
TCGCATCTCCTTGAGC,sample,385985,375085,69872,305213,88539,216674,57892,2649,78727,7645,136619,69761,11670,2291,32829,47711
CAAGGCCTCCTTGAGC,sample,603291,579196,160372,418824,62064,356760,63686,3588,149871,15729,213557,123886,19136,3776,24874,31073
CATAACCTCCTTGAGC,sample,471019,457625,94281,363344,67209,296135,70224,2661,118765,13488,188989,90997,14882,2800,36754,37283
GACGGAGACCTTGAGC,sample,236862,233504,13613,219891,104000,115891,90088,2232,17969,2120,108057,3482,1479,705,75395,52185
GTTAGCCGCCTTGAGC,Pos_Ctrl,240290,227035,35591,191444,9036,182408,152651,12216,12257,1454,164908,3830,8223,11519,12187,4396
GGAGGACGCCTTGAGC,sample,284510,279012,31960,247052,76812,170240,64876,3591,57542,6059,122418,38172,8657,2057,40265,44875
ACCTCGAGCCTTGAGC,sample,188809,184163,28940,155223,32712,122511,37552,1711,44021,4851,81573,34376,8417,1534,23669,19957
GACGATAACCTTGAGC,sample,465824,457870,48031,409839,73878,335961,145624,6656,116173,15444,261797,52064,10426,2561,57477,54190
CCATGAAGCCTTGAGC,sample,160903,158399,9898,148501,75826,72675,55409,1336,11891,1173,67300,2866,1208,600,43498,35080
GTTAGGACCCTTGAGC,sample,227684,222772,28073,194699,62588,132111,55656,3071,46097,5333,101753,21954,7713,1781,26550,36436
ACGTATTACCTTGAGC,sample,315428,307415,45916,261499,58849,202650,71614,3710,73320,7395,144934,46611,10197,1987,37387,35180
TCAATATACCTTGAGC,sample,511113,500976,83201,417775,86480,331295,98676,3776,120292,11606,218968,96945,10357,2786,60020,51019
AGGTCGGACCTTGAGC,Pos_Ctrl,379209,362399,46422,315977,12679,303298,255469,21581,18236,2307,273705,5705,8554,13878,16423,5216
GGAGAGTTCGATATCC,sample,664,648,148,500,180,320,158,7,93,9,251,53,124,39,107,96
TATCAGTTCGATATCC,sample,141327,140189,15328,124861,36315,88546,23710,1268,34390,3902,58100,25276,9740,1601,13137,21375
TCCAACTTCGATATCC,sample,248594,246631,11399,235232,128597,106635,77904,3419,18249,2725,96153,4338,2490,1394,52528,55642
AAGTTCGTCGATATCC,sample,308308,304319,31184,273135,72275,200860,76074,3456,76189,9391,152263,35750,9072,1851,41029,46157
TTCTAATGCGATATCC,sample,444925,441719,26245,415474,206637,208837,146577,3547,39710,3890,186287,15113,4057,1333,109769,100826
ATGCCTGGCGATATCC,sample,396574,394576,19967,374609,161957,212652,135443,6913,47233,5986,182676,17077,5865,1833,93736,86230
AATGGTAACGATATCC,sample,379415,376511,16514,359997,170588,189409,150341,3233,28281,2994,178622,4560,2022,909,113606,86237
CATAACCTCGATATCC,sample,470603,464548,47886,416662,116516,300146,113841,6366,106647,10851,220488,62441,11663,2699,67371,72215
GGCCAGAGCGATATCC,sample,119212,117156,11930,105226,34725,70501,32480,1118,22235,1991,54715,12677,4568,1035,22244,20818
CATTGCAGCGATATCC,sample,124135,122660,6461,116199,55767,60432,45614,1315,10033,1751,55647,1719,1073,561,37176,27575
CGTACGTCCGATATCC,sample,145217,143367,11569,131798,57158,74640,47526,2429,16666,1680,64192,6339,4122,1459,29495,30154
GTCCTGCCCGATATCC,sample,165996,163180,18128,145052,25817,119235,49242,2492,44653,4979,93895,17869,6764,2002,18262,16692
CGGATTACCGATATCC,sample,319091,310486,48730,261756,34544,227212,52858,4056,101980,12030,154838,56288,11596,2433,17899,20699
GTACCGTACGATATCC,sample,315100,309262,37921,271341,69843,201498,69147,2165,68951,7910,138098,53325,10681,2062,43635,40863
TCAATATACGATATCC,sample,155524,154024,11723,142301,30759,111542,51459,2194,40756,5047,92215,12086,4714,1603,23326,21215
TATCAGTTATCTGACC,sample,532,513,127,386,142,244,103,2,57,14,160,68,85,20,72,74
AAGTTCGTATCTGACC,sample,230650,226966,26477,200489,51693,148796,53764,2421,50174,5119,103938,37318,8845,1610,37294,32660
GGTTGCGTATCTGACC,sample,281498,277405,29278,248127,80203,167924,71644,3225,52589,5752,124233,34714,7717,1857,41587,47337
ACGTAAGTATCTGACC,sample,77460,75991,9723,66268,12523,53745,19316,1277,20992,2992,40308,9168,4537,1452,6419,7438
ACGTTATGATCTGACC,Neg_Ctrl,3190,1931,1315,616,157,459,148,7,103,28,251,173,143,37,93,75
TCGCATCTATCTGACC,sample,175605,174475,7211,167264,79462,87802,74052,2041,8593,622,82645,2494,1221,658,60770,40757
GCCTTGCTATCTGACC,sample,256704,252637,30699,221938,67317,154621,56802,1758,46836,4904,103638,44321,7634,1673,38320,39443
CAAGGCCTATCTGACC,sample,164638,163244,8784,154460,70363,84097,67005,1177,11538,1287,78543,3090,1296,601,56309,37154
GACGGAGAATCTGACC,sample,335368,327943,53172,274771,61151,213620,63965,2189,73984,8654,137949,64828,10230,2182,41034,36486
GGAGGACGATCTGACC,Neg_Ctrl,4097,2175,1687,488,109,379,108,5,182,13,290,71,125,25,67,21
ACGACTTCATCTGACC,sample,70005,69167,5162,64005,28151,35854,28880,852,4204,753,33084,1165,1028,498,23297,15212
CTAGGACCATCTGACC,Neg_Ctrl,3371,1738,1406,332,88,244,75,6,89,7,164,67,97,16,36,21
ACGTATTAATCTGACC,sample,156774,155040,10657,144383,60571,83812,58812,1391,14087,1793,72899,7729,1436,736,46843,33650
CGTATGAAATCTGACC,sample,45726,43672,9072,34600,8385,26215,9867,682,8221,898,18088,6547,4642,1293,4852,5072
AATATATCATCTGACC,sample,161145,159105,14393,144712,51676,93036,47245,1750,25860,3230,73105,14951,5414,1287,31735,28999
ACCAATGCATCTGACC,sample,78687,76964,10299,66665,25246,41419,20870,730,11598,1255,32468,6966,3913,1108,13690,13316
GAAGGCGCATCTGACC,sample,258073,250211,43079,207132,36558,170574,35788,1593,69713,7513,105501,55967,12093,2070,17200,20554
TTGGTTAAATCTGACC,sample,178881,174876,25199,149677,38000,111677,43757,1629,38603,5010,82360,22678,8714,1704,23148,22938
TTATTCGAATCTGACC,Neg_Ctrl,2964,2011,1048,963,214,749,187,6,293,26,480,237,326,62,83,71
GGAGAGTTCTTCTTAC,sample,550,533,149,384,113,271,86,2,105,11,191,67,133,31,42,61
TTCGTAATCTTCTTAC,sample,274288,271811,21672,250139,109406,140733,92869,2752,29622,2546,122491,12944,2387,928,72721,56448
ACGTTATGCTTCTTAC,sample,196365,194040,23868,170172,59061,111111,39833,2443,40332,4594,80165,23909,9031,2301,16583,32266
CAACCGCGCTTCTTAC,sample,313496,301613,64499,237114,39703,197411,45901,2257,81313,9347,127214,58593,14117,2977,13561,23195
TTCCGTCTCTTCTTAC,sample,391786,385540,39738,345802,117285,228517,90149,2653,71752,9469,161901,54494,6641,1891,63660,66567
GCCTTGCTCTTCTTAC,sample,116521,114470,14519,99951,14732,85219,30610,1747,34760,3627,65370,14475,5979,1866,9441,9638
GACGGAGACTTCTTAC,sample,230110,220593,66649,153944,12243,141701,14755,772,64876,6625,79631,54673,14355,1989,3295,4236
CATGATTCCTTCTTAC,sample,211357,207877,19741,188136,60780,127356,59369,2556,39271,3931,98640,22229,6897,1660,33020,36130
AAGAGCGCCTTCTTAC,sample,220854,211173,50840,160333,21220,139113,23916,1008,59386,6296,83302,48507,12194,1935,9443,11045
CCAATTCCCTTCTTAC,sample,335897,328498,40262,288236,74660,213576,63759,2308,76914,7660,140673,62935,12605,2286,38678,43889
TCAATATACTTCTTAC,sample,128945,126212,17887,108325,15865,92460,31892,2512,36906,4249,68798,16901,6950,1971,8730,10161
GACCGGAACTTCTTAC,sample,293027,285390,73842,211548,22766,188782,27672,1141,82813,8773,110485,68383,16232,2423,9898,12270
ATTCTCTTACTTCTAC,sample,24289,23818,2041,21777,5674,16103,4709,607,7518,715,12227,2554,2816,837,920,3597
TTCTAATGACTTCTAC,sample,49587,49200,6660,42540,8213,34327,9500,624,14341,1700,23841,8162,6044,1548,2821,5162
TTCCGTCTACTTCTAC,sample,164131,161169,22374,138795,42761,96034,30775,1199,34982,3904,65757,25174,9051,1547,17250,24238
CATTGCAGACTTCTAC,sample,55756,54268,7403,46865,14483,32382,15468,625,8936,971,24404,6382,3850,765,10923,8199
AATCCGTCACTTCTAC,sample,100476,99621,6719,92902,39805,53097,41582,740,9063,420,50645,1292,964,502,31045,21812
GCCTGAACACTTCTAC,sample,131649,127780,19139,108641,32037,76604,25060,1009,27978,3031,53038,19526,5793,1424,13618,18990
TTGGTTAAACTTCTAC,sample,216587,214285,25923,188362,63566,124796,61608,1576,32509,3440,94117,25663,4459,1082,45530,36365
CTTCATGAACTTCTAC,sample,220917,215690,33044,182646,36340,146306,33934,1192,58793,6750,92727,45637,11237,1748,21316,21828
ATGACCGAACTTCTAC,sample,181076,177481,22056,155425,39512,115913,40497,965,39863,4098,80360,30490,8934,1448,24951,24388
ATTCTCTTAGAAGTAA,sample,936,908,345,563,167,396,192,5,125,12,317,62,243,82,47,86
TAGTACGGAGAAGTAA,sample,152680,151903,9888,142015,61281,80734,35808,2336,25995,3126,61803,13469,6963,1560,19420,31050
GGACCTCTAGAAGTAA,sample,304642,303055,20830,282225,76665,205560,83156,5606,78184,7715,161340,30899,9355,2346,38068,49642
CAAGGCCTAGAAGTAA,sample,809,774,256,518,143,375,151,4,120,16,271,84,174,50,77,72
CCAGAGCGAGAAGTAA,sample,1790,1578,230,1348,537,811,344,26,294,32,638,115,335,134,167,231
GGACGTAGAGAAGTAA,sample,331,316,77,239,62,177,66,3,53,11,119,44,81,31,36,43
TGGACGAGAGAAGTAA,sample,19212,18944,1602,17342,4654,12688,4310,289,5265,553,9575,2271,2925,766,1500,2886
GGCCAGAGAGAAGTAA,sample,3050,2993,223,2770,487,2283,786,70,1028,142,1814,257,871,320,195,337
CATTGCAGAGAAGTAA,sample,2951,2879,244,2635,844,1791,715,46,627,71,1342,332,607,154,463,474
TTGGTACCAGAAGTAA,sample,45405,45128,1207,43921,19141,24780,15263,1101,6520,868,21783,1028,1910,1214,5745,10018
GTTAGGACAGAAGTAA,sample,112267,110791,19107,91684,14120,77564,23656,1228,31358,3905,55014,17417,6889,1478,11585,8555
GCCTGAACAGAAGTAA,sample,272890,270476,22261,248215,85405,162810,82252,3888,44314,5046,126566,27310,8305,2288,45644,50015
ACGTATTAAGAAGTAA,sample,194634,193551,8869,184682,81912,102770,76538,4394,15816,2011,92354,4011,2395,1449,46076,43142
GTCTTAGCAGAAGTAA,sample,339072,335058,42427,292631,56357,236274,74448,2342,89786,9572,164234,60126,10839,2150,41421,35488
CCAATTCCAGAAGTAA,sample,97747,96913,6261,90652,21212,69440,28017,1689,27153,3313,55170,9268,4789,1390,13149,14006
TTGGTTAAAGAAGTAA,sample,90428,89875,3045,86830,44671,42159,28757,1728,9040,927,37797,1707,1600,1093,15644,20156
GTACCGTAAGAAGTAA,sample,194663,193286,16676,176610,49800,126810,60888,3241,37844,4391,98732,20446,7400,2006,31770,30751
TTATTCGAAGAAGTAA,sample,236781,235604,9729,225875,98257,127618,97149,2394,18782,2302,115931,6991,2868,1006,71240,52042
Short,Non_sample,0,NA,NA,NA,NA,NA,NA,NA,NA,NA,NA,NA,NA,NA,NA,NA
Unselected,Non_sample,0,NA,NA,NA,NA,NA,NA,NA,NA,NA,NA,NA,NA,NA,NA,NA
Undetermined,Non_sample,260474766,NA,NA,NA,NA,NA,NA,NA,NA,NA,NA,NA,NA,NA,NA,NA
