Barcode,Sample,Barcoded_Reads,Trimmed_Reads,Unmapped_Reads,Mapped_Reads,Multimapped_Reads,Uniquely_Mapped_Reads,Exon_Reads,Ambiguous_Exon_Reads,Intron_Reads,Ambiguous_Intron_Reads,Gene_Reads,Intergenic_Reads,No_of_Genes,No_of_Transcripts,Mitochondrial_Reads,Ribosomal_Reads
AACCGGTTCGTTGGTT,sample,123731,123324,3134,120190,33851,86339,64435,5959,10386,1188,74821,4371,3064,2218,10136,22137
AGCTGAATCGTTGGTT,sample,119684,119044,4150,114894,23116,91778,58121,4182,20281,2589,78402,6605,3647,1957,11025,16336
TATACGGACGTTGGTT,sample,108755,108113,4456,103657,18373,85284,46524,3175,23851,2309,70375,9425,3990,1633,8560,12698
GAGCCTCCCGTTGGTT,sample,54343,54034,3459,50575,9230,41345,19502,1537,11378,1403,30880,7525,4749,1766,3381,5978
CATACTCCCGTTGGTT,sample,74993,74560,3115,71445,15482,55963,36067,2171,11232,1043,47299,5450,3480,1498,8269,11030
TCATACCACGTTGGTT,sample,47757,47574,1141,46433,12963,33470,22922,2188,5742,810,28664,1808,1744,1504,3713,8491
ATTCAAGGCGTTGGTT,sample,1127,1104,56,1048,313,735,462,43,154,3,616,73,273,182,95,192
ATACGTTCCGTTGGTT,sample,583,569,25,544,115,429,242,7,112,20,354,48,190,120,36,78
CCGTACGCCGTTGGTT,sample,2780,2749,79,2670,755,1915,1081,100,473,48,1554,213,583,340,209,484
TGGATCAACGTTGGTT,sample,35000,34830,1242,33588,8665,24923,15739,1349,4853,504,20592,2478,2433,1210,2943,5739
GGCAGGTTCGTTGGTT,sample,2074,2055,65,1990,633,1357,856,93,275,25,1131,108,455,318,104,397
GCTCTTCTCGTTGGTT,sample,319,319,15,304,63,241,127,14,56,2,183,42,104,65,13,43
GAGATTCTCGTTGGTT,sample,543,533,29,504,93,411,238,20,105,12,343,36,173,90,43,76
GGCGACGACGTTGGTT,sample,4396,4331,131,4200,1330,2870,1648,199,636,73,2284,314,797,538,198,806
TGCGCTCCCGTTGGTT,sample,233,227,18,209,30,179,105,12,35,2,140,25,68,48,14,25
ATACCGCCCGTTGGTT,sample,340,340,33,307,61,246,148,16,44,7,192,31,105,66,30,39
TCTCCTAGCGTTGGTT,sample,130961,130350,4813,125537,21524,104013,74692,6603,14828,1810,89520,6080,4081,2265,10971,15643
ATGAATAGCGTTGGTT,sample,132880,132110,6345,125765,20019,105746,59423,4775,24432,2866,83855,14250,6023,1977,10780,14318
TAACGCCACGTTGGTT,sample,31494,31353,1538,29815,6378,23437,12349,1246,6387,840,18736,2615,2518,1240,1961,4453
GACTAACCCGTTGGTT,sample,414,412,22,390,58,332,177,26,67,10,244,52,131,81,16,39
CGCGAGACCGTTGGTT,sample,366,364,26,338,43,295,196,19,47,9,243,24,133,93,15,30
CGTAGAACCGTTGGTT,sample,294,290,11,279,33,246,130,7,62,17,192,30,113,57,24,25
AGATACTACGTTGGTT,sample,448,442,16,426,96,330,194,19,74,8,268,35,139,83,20,64
GCGCAATACGTTGGTT,sample,1253,1235,52,1183,307,876,622,64,108,7,730,75,306,229,80,211
GTCGTTCTCTATCGTT,sample,66643,66308,2543,63765,8694,55071,26459,2042,20642,2101,47101,3827,3295,1859,4241,6498
AGAGTTCTCTATCGTT,sample,66850,66516,2499,64017,14027,49990,35184,2603,7302,944,42486,3957,3409,2108,6522,10097
AGCTGAATCTATCGTT,sample,91085,90663,3942,86721,16795,69926,41701,3012,17010,1876,58711,6327,3391,1586,8885,11859
GACGTATGCTATCGTT,sample,1954,1937,354,1583,192,1391,381,36,522,67,903,385,439,138,67,123
GAGCCTCCCTATCGTT,sample,100348,99843,6506,93337,17538,75799,42004,3021,16452,1953,58456,12369,6646,1904,8420,12241
CATACTCCCTATCGTT,sample,45675,45408,3126,42282,8497,33785,16436,1441,9194,993,25630,5721,3851,1422,3689,5581
TCGAACGACTATCGTT,sample,30052,29920,1111,28809,5514,23295,14508,1226,4843,597,19351,2121,2148,1227,3189,3964
GGTAGAGACTATCGTT,sample,86641,86189,3994,82195,17528,64667,41396,3760,10912,1677,52308,6922,4516,1764,7222,12170
CGTCGCCACTATCGTT,sample,45653,45432,1121,44311,12855,31456,23088,2436,3895,387,26983,1650,1900,1377,4491,8430
TCATCGAACTATCGTT,sample,81113,80751,2637,78114,17462,60652,47162,2804,7026,650,54188,3010,2207,1433,10120,12403
TCATACCACTATCGTT,sample,84750,84462,3409,81053,11896,69157,35588,3304,22372,2404,57960,5489,3101,1652,6324,8762
ATTCAAGGCTATCGTT,sample,58486,58264,1180,57084,11152,45932,34857,2939,5983,766,40840,1387,1940,1819,5259,8051
GGCAGGTTCTATCGTT,sample,65952,65658,1398,64260,17778,46482,38523,2667,3520,389,42043,1383,1468,1627,7514,12057
TAGCGAGTCTATCGTT,sample,108104,107304,8169,99135,12563,86572,34045,2918,26698,3090,60743,19821,7363,1665,7803,8570
CTAAGCATCTATCGTT,sample,90596,90147,2638,87509,18852,68657,49861,4008,10522,1204,60383,3062,1814,1246,11465,13285
TAACGAAGCTATCGTT,sample,87176,86707,2798,83909,12789,71120,49816,4175,10741,1208,60557,5180,2760,1572,7246,9323
GCTGCTTCCTATCGTT,sample,75784,75426,1880,73546,12235,61311,45556,3502,7748,970,53304,3535,2302,1239,5444,9208
TGCGCTCCCTATCGTT,sample,86367,85928,3431,82497,11090,71407,48628,4403,12147,2017,60775,4212,2601,1373,6680,8204
GCGTTACCCTATCGTT,sample,81589,81103,4670,76433,9452,66981,35458,2919,16602,1657,52060,10345,4841,1273,6947,6597
GGCGTACCCTATCGTT,sample,72546,72180,3024,69156,9757,59399,37137,3005,12921,1014,50058,5322,2895,1170,6102,7222
GTCGCGAACTATCGTT,sample,73292,72949,2001,70948,13411,57537,45287,4946,4592,672,49879,2040,1223,1151,7870,9545
TCAATCAGCTATCGTT,sample,94824,94174,5585,88589,11082,77507,47590,3536,15203,1819,62793,9359,4973,2063,4903,8269
GCGCAATACTATCGTT,sample,70509,70102,3857,66245,10571,55674,29582,2021,14955,1363,44537,7753,4541,1542,5646,7644
AACCGGTTGTCTTCTT,sample,60760,60494,1735,58759,14913,43846,29531,3037,7176,741,36707,3361,2946,1630,6056,10224
CTGGTCTTGTCTTCTT,Pos_Ctrl,11402,11299,667,10632,670,9962,8325,910,463,52,8788,212,2222,2063,658,334
TATACGGAGTCTTCTT,Pos_Ctrl,16577,16388,1496,14892,839,14053,11702,1047,944,97,12646,263,3137,2566,1040,505
GGAGAAGCGTCTTCTT,sample,47434,47166,1603,45563,9045,36518,27379,1938,4564,479,31943,2158,2945,2274,2901,6328
GAGCCTCCGTCTTCTT,sample,71238,70878,2713,68165,13093,55072,35910,3413,10038,1193,45948,4518,3407,1882,5385,9709
CATACTCCGTCTTCTT,sample,63708,63427,1560,61867,14411,47456,36995,2720,5444,609,42439,1688,1589,1284,9029,10478
CTAGCGACGTCTTCTT,sample,72224,71755,3044,68711,13698,55013,36328,2373,9630,1177,45958,5505,3845,1709,6217,9616
GGTAGAGAGTCTTCTT,sample,62083,61775,2286,59489,13811,45678,30169,2522,7633,953,37802,4401,3064,1401,7155,9418
CGTCGCCAGTCTTCTT,sample,66192,65867,2817,63050,11378,51672,33868,2655,9342,890,43210,4917,3196,1580,5108,8334
TACGCGAGGTCTTCTT,sample,67866,67385,5989,61396,8176,53220,22301,1726,16013,1699,38314,11481,5582,1591,3771,5582
GATGCGTTGTCTTCTT,sample,67979,67536,2734,64802,7088,57714,36392,3371,11068,1259,47460,5624,3099,1223,4755,4980
ATGGCGTTGTCTTCTT,sample,62844,62522,1548,60974,9885,51089,36711,3529,7225,970,43936,2654,1812,1058,5279,7443
AGCGTCTTGTCTTCTT,sample,72598,72174,2676,69498,13700,55798,40128,2756,8597,935,48725,3382,2718,1686,7166,9859
GCTCTTCTGTCTTCTT,sample,56018,55755,2311,53444,11674,41770,28679,1922,7046,657,35725,3466,2277,1227,6564,7944
AAGGTCTGGTCTTCTT,sample,61585,61270,2800,58470,11403,47067,29249,2215,9336,1019,38585,5248,3226,1365,5749,8076
CCTAGCGGGTCTTCTT,sample,43161,42909,1630,41279,6640,34639,23143,1475,7560,688,30703,1773,2122,1431,3757,4762
CTAACCGGGTCTTCTT,sample,45256,44996,1847,43149,7974,35175,24171,1462,6094,604,30265,2844,2495,1385,4504,5708
AGCAGAGCGTCTTCTT,sample,81771,81150,8153,72997,7654,65343,28020,1940,21320,3020,49340,11043,6098,1950,3216,5135
ATACCGCCGTCTTCTT,sample,72171,71551,8633,62918,6237,56681,18854,1368,20200,2213,39054,14046,6804,1434,2664,3684
GTCGCGAAGTCTTCTT,sample,62769,62291,4163,58128,7549,50579,27159,2135,12703,1249,39862,7333,4619,1816,2972,5336
CGTCGAGGGTCTTCTT,sample,48227,47873,2883,44990,7132,37858,25049,2047,6300,681,31349,3781,3089,1590,4269,5368
CGCGGTCGGTCTTCTT,sample,29575,29391,1500,27891,5148,22743,13783,875,5194,513,18977,2378,2148,1085,2849,3784
TTATGACGGTCTTCTT,sample,51394,51140,1722,49418,10664,38754,30281,2382,4219,484,34500,1388,1824,1379,6948,7653
ATTCTACCGTCTTCTT,sample,13639,13553,988,12565,1715,10850,5125,337,3528,425,8653,1435,1816,810,1013,1154
AGATACTAGTCTTCTT,sample,69801,69478,1591,67887,11070,56817,44467,4700,5429,338,49896,1883,1768,1430,6177,7778
CCTAACTAGTCTTCTT,Pos_Ctrl,16401,16247,902,15345,677,14668,12074,1309,899,89,12973,297,3030,2837,655,322
AGAGTTCTTAGGCTCT,sample,166308,165520,7910,157610,32728,124882,75119,5195,27855,3242,102974,13471,5667,2069,15236,22528
GACGTATGTAGGCTCT,sample,112809,112353,3545,108808,32063,76745,55772,3194,10749,1377,66521,5653,3953,2156,10624,21243
CATAATGGTAGGCTCT,sample,39449,39247,2380,36867,8543,28324,16715,1129,6088,687,22803,3705,3496,1692,3670,5610
CTAGCGACTAGGCTCT,sample,132944,132329,3022,129307,32728,96579,74304,5809,11621,1459,85925,3386,2052,1500,18304,22377
TCGAACGATAGGCTCT,sample,139068,138404,5381,133023,25051,107972,68708,5441,21647,3051,90355,9125,4887,2427,8622,17513
GGTAGAGATAGGCTCT,sample,105488,105003,3052,101951,30942,71009,49364,3578,11863,1404,61227,4800,3452,1683,10044,20251
TACGCGAGTAGGCTCT,sample,130010,129177,4021,125156,24069,101087,68852,5483,19180,2829,88032,4743,2471,1634,12934,17831
ATACGTTCTAGGCTCT,sample,114876,114247,4067,110180,24050,86130,63389,4428,11726,1592,75115,4995,2826,1455,18599,17200
TCTCAGGATAGGCTCT,sample,125031,124255,4407,119848,23420,96428,69168,6723,13912,1126,83080,5499,3100,1540,11973,17405
TGGATCAATAGGCTCT,sample,106237,105635,3112,102523,18656,83867,64058,4549,10276,1479,74334,3505,2756,1765,12599,13829
GGCAGGTTTAGGCTCT,sample,133487,132494,8252,124242,18083,106159,57392,3352,25854,2728,83246,16833,5903,1627,11813,12441
ATGGCGTTTAGGCTCT,sample,137690,136904,5892,131012,20838,110174,65748,4952,27701,3411,93449,8362,3631,1675,12833,15369
CCATTCTTTAGGCTCT,sample,94825,94163,3791,90372,14098,76274,50716,3795,14273,1673,64989,5817,3192,1757,8956,10533
CGGTTGGTTAGGCTCT,sample,65390,64969,2517,62452,10651,51801,31440,3261,11983,1375,43423,3742,2920,1714,5967,7816
GCTCTTCTTAGGCTCT,sample,118178,117367,5970,111397,14019,97378,48613,3197,30529,3690,79142,11349,4847,1993,6270,10010
GAGATTCTTAGGCTCT,sample,139032,138272,4406,133866,29913,103953,75692,6490,12717,1675,88409,7379,3409,1765,18436,21196
GCTGCTTCTAGGCTCT,sample,133972,133034,7825,125209,16261,108948,55735,4188,29150,3011,84885,16864,6992,2369,9153,11515
ATACCGCCTAGGCTCT,sample,120694,119916,6691,113225,11927,101298,53130,4289,27758,3154,80888,12967,5395,1893,6511,7951
GCGTTACCTAGGCTCT,sample,114901,114158,6230,107928,12606,95322,50720,3886,24061,3207,74781,13448,6238,1888,6494,8607
CGTCGAGGTAGGCTCT,sample,75657,75120,3923,71197,11264,59933,35090,2330,13885,2170,48975,6458,3722,1597,6096,7845
CGCGGTCGTAGGCTCT,sample,85891,85372,3213,82159,16443,65716,43516,3841,10957,1356,54473,6046,3474,1574,8881,11605
TCTCCTAGTAGGCTCT,sample,135247,134513,4187,130326,25993,104333,78559,5630,13454,937,92013,5753,3596,2042,13291,18686
ATGAATAGTAGGCTCT,sample,143334,142582,3669,138913,20335,118578,91333,7511,13685,2235,105018,3814,3064,2787,13220,15023
TAACGCCATAGGCTCT,sample,138165,137448,5600,131848,26816,105032,68986,6093,18776,2686,87762,8491,4454,1678,12275,18937
AGATACTATAGGCTCT,sample,147491,146713,4362,142351,20985,121366,85382,9237,16474,2012,101856,8261,3911,1924,13265,15462
TTAACTGATAGGCTCT,sample,142091,141394,9070,132324,23228,109096,52078,4034,28994,2982,81072,21008,8531,2248,7790,16255
ATATGCAATAGGCTCT,sample,495,488,22,466,85,381,193,34,85,7,278,62,137,83,51,62
GTCGTTCTTTGACTAT,Neg_Ctrl,873,671,131,540,95,445,275,13,95,11,370,51,187,82,63,45
AGAGTTCTTTGACTAT,sample,67098,66679,4747,61932,10087,51845,29853,1702,12777,1414,42630,6099,3688,1787,4207,6910
GACGTATGTTGACTAT,sample,83678,83106,4882,78224,15666,62558,39379,3131,11563,1776,50942,6709,3806,1578,8615,11304
TATACGGATTGACTAT,sample,95973,95381,4257,91124,17240,73884,46878,4142,14276,2185,61154,6403,4027,1814,9262,12382
GGAGAAGCTTGACTAT,Neg_Ctrl,784,656,140,516,65,451,262,38,99,6,361,46,187,114,31,49
GAGCCTCCTTGACTAT,sample,94157,93597,5174,88423,16000,72423,39327,2973,17442,2683,56769,9998,4885,1661,6781,11124
TGATTCCGTTGACTAT,Pos_Ctrl,4250,4198,481,3717,288,3429,2802,251,243,25,3045,108,1222,861,234,195
GCAACTAGTTGACTAT,sample,31654,31439,2882,28557,4508,24049,11081,732,6722,725,17803,4789,4002,1352,2235,3013
ATACGTTCTTGACTAT,sample,23724,23545,2441,21104,3654,17450,8948,732,4296,513,13244,2961,2877,1377,1272,2479
TGGATCAATTGACTAT,sample,89137,88608,4147,84461,14204,70257,47435,3760,11711,1515,59146,5836,3140,1443,7395,10917
ATGGCGTTTTGACTAT,Pos_Ctrl,17683,17458,1716,15742,788,14954,12438,1126,989,98,13427,303,3159,2623,787,460
TGCGCGTTTTGACTAT,sample,86172,85510,5642,79868,8930,70938,35871,2484,20884,2091,56755,9608,4344,1557,5696,6214
CGGTTGGTTTGACTAT,sample,62042,61716,2439,59277,8787,50490,32740,2655,10626,1095,43366,3374,2576,1699,4481,6720
ACGCTTAATTGACTAT,sample,112345,111638,5881,105757,14312,91445,60563,4021,15479,1753,76042,9629,4392,1896,9294,10058
CCTAGCGGTTGACTAT,Pos_Ctrl,8354,8290,516,7774,391,7383,6165,671,392,45,6557,110,1915,1709,320,188
GCCTATTCTTGACTAT,sample,96724,95806,13177,82629,6525,76104,23440,1599,28005,3032,51445,20028,8041,1659,2412,3477
AGCAGAGCTTGACTAT,sample,114089,113322,7275,106047,9948,96099,55944,3588,19509,2251,75453,14807,6382,1932,6215,6909
CGTCGAGGTTGACTAT,Pos_Ctrl,15673,15494,1216,14278,670,13608,11314,1066,791,108,12105,329,2908,2699,610,310
TCTCCTAGTTGACTAT,sample,95624,95101,3241,91860,18663,73197,53505,4391,10571,791,64076,3939,2294,1450,10523,13058
GACTAACCTTGACTAT,sample,98744,97965,6642,91323,11007,80316,44039,2749,19051,2378,63090,12099,5834,1992,4807,7565
CGCGAGACTTGACTAT,sample,95145,94517,4991,89526,12507,77019,50768,3566,12819,1612,63587,8254,4620,2061,7014,8903
AGATACTATTGACTAT,sample,105307,104719,5497,99222,13753,85469,49752,4246,20080,2444,69832,8947,4362,1598,5524,9999
GCGCAATATTGACTAT,Neg_Ctrl,630,485,73,412,89,323,181,14,67,21,248,40,141,80,25,37
AGCTGAATTGCAGTTG,sample,73711,73311,4272,69039,11824,57215,28299,2243,15731,2045,44030,8897,5101,1970,3985,7712
CATAATGGTGCAGTTG,sample,40676,40420,1687,38733,8250,30483,18327,1588,6536,819,24863,3213,2709,1210,3764,5816
TATACGGATGCAGTTG,sample,34156,34006,746,33260,11467,21793,16702,1459,2581,282,19283,769,1747,1502,3855,7052
GAGCCTCCTGCAGTTG,sample,53732,53486,1499,51987,13158,38829,29830,2255,4621,632,34451,1491,1786,1317,6259,9132
CATACTCCTGCAGTTG,sample,52954,52661,3208,49453,8552,40901,23272,1514,9374,997,32646,5744,3978,1355,4692,5996
TGATTCCGTGCAGTTG,sample,39388,39154,1077,38077,7471,30606,23969,2211,2904,237,26873,1285,1788,1483,2966,5181
ATACGTTCTGCAGTTG,sample,52034,51705,1475,50230,9116,41114,32113,2706,3853,732,35966,1710,1806,1364,3385,6952
TGGATCAATGCAGTTG,sample,58227,57759,3420,54339,6158,48181,23266,1854,14893,1657,38159,6511,3808,1596,3950,4191
GATGCGTTTGCAGTTG,sample,62510,62125,2521,59604,8355,51249,33666,2521,9728,911,43394,4423,2715,1604,5454,6339
CCATTCTTTGCAGTTG,sample,74646,74233,2993,71240,10629,60611,41125,3328,9709,1291,50834,5158,3452,1794,5747,7667
CGGTTGGTTGCAGTTG,sample,67840,67437,3325,64112,10882,53230,30957,2577,11057,1500,42014,7139,4026,1297,6007,7776
GCTCTTCTTGCAGTTG,sample,42981,42790,1308,41482,10424,31058,22437,1684,4684,517,27121,1736,1906,1180,5531,7003
GAGATTCTTGCAGTTG,sample,39164,38945,1644,37301,8293,29008,19032,1140,5441,642,24473,2753,2614,1462,4562,5813
CTAACCGGTGCAGTTG,sample,56242,55878,4344,51534,8987,42547,21151,1580,11558,1099,32709,7159,4047,1262,4577,6522
TAACGAAGTGCAGTTG,sample,60932,60547,3089,57458,9095,48363,28713,2008,10657,1150,39370,5835,3289,1367,4456,6649
TGCGCTCCTGCAGTTG,sample,40539,40266,1877,38389,5404,32985,19932,1603,7758,818,27690,2874,2325,1315,3428,3902
GCGTTACCTGCAGTTG,sample,46452,46036,4007,42029,5690,36339,15920,1197,10436,933,26356,7853,4289,1353,2583,3993
TCTCCTAGTGCAGTTG,sample,54031,53665,2392,51273,7830,43443,29069,2424,6927,938,35996,4085,3090,1621,3820,5313
TCAATCAGTGCAGTTG,sample,59984,59513,4404,55109,6544,48565,23576,1476,12930,1475,36506,9108,5381,1624,3632,4647
ATTCTACCTGCAGTTG,sample,66356,65858,4254,61604,7642,53962,23777,1750,17230,1721,41007,9484,4743,1247,5129,5142
CGCGAGACTGCAGTTG,sample,47145,46889,1422,45467,6743,38724,26241,1741,7551,680,33792,2511,2367,1608,6570,4863
AACCGGTTTCATGCTG,sample,61165,60844,3131,57713,12689,45024,28530,2426,8928,1109,37458,4031,2929,1539,4996,8608
TCTAGGTTTCATGCTG,sample,65985,65573,3396,62177,11973,50204,31262,2541,9841,1014,41103,5546,3738,1571,7417,8263
AGAGTTCTTCATGCTG,sample,53656,53260,2634,50626,7221,43405,23848,1485,12705,1625,36553,3742,2893,1428,3878,5008
GGAGAAGCTCATGCTG,sample,59699,59437,1974,57463,12865,44598,33501,3148,4895,818,38396,2236,2143,1624,7121,9169
CGTCGCCATCATGCTG,sample,51871,51470,5091,46379,8647,37732,17943,1196,9925,1180,27868,7488,4740,1329,3825,5916
TCATCGAATCATGCTG,sample,67340,66821,6189,60632,9762,50870,25395,1762,13166,1267,38561,9280,5520,1388,5660,6719
TCATACCATCATGCTG,sample,69104,68723,2635,66088,11262,54826,40531,3060,6661,864,47192,3710,2806,1691,7457,8158
ATTCAAGGTCATGCTG,sample,53060,52706,2378,50328,9266,41062,28403,1647,6988,853,35391,3171,2839,1717,4641,6697
GCAACTAGTCATGCTG,Neg_Ctrl,289,213,49,164,33,131,92,6,21,2,113,10,63,43,12,23
TCTCAGGATCATGCTG,sample,64642,64231,3635,60596,9310,51286,28089,2322,12006,1269,40095,7600,4155,1688,4614,6492
GATGCGTTTCATGCTG,sample,46636,46330,2834,43496,4855,38641,20386,1692,10977,1180,31363,4406,3007,1299,3333,3439
TGCGCGTTTCATGCTG,Neg_Ctrl,347,300,53,247,31,216,129,16,42,3,171,26,77,53,22,28
AGCGTCTTTCATGCTG,sample,34528,34320,2257,32063,5185,26878,15579,1164,6049,731,21628,3355,2416,1030,3794,3623
CGGTTGGTTCATGCTG,sample,53015,52756,1504,51252,9504,41748,30923,3059,5471,712,36394,1583,1758,1257,7201,7067
GCTCTTCTTCATGCTG,sample,49214,48934,2562,46372,8000,38372,24202,1572,7609,852,31811,4137,3321,1599,3349,5882
GAGATTCTTCATGCTG,sample,47526,47234,2115,45119,7986,37133,23378,2098,7299,730,30677,3628,2809,1462,3801,5751
CTAACCGGTCATGCTG,Neg_Ctrl,570,481,47,434,63,371,226,19,83,10,309,33,158,93,32,41
TAACGAAGTCATGCTG,sample,59057,58702,1795,56907,7449,49458,32892,2403,9846,766,42738,3551,2335,1303,3916,5692
GCTGCTTCTCATGCTG,sample,41213,40965,1150,39815,5321,34494,24172,1940,6329,605,30501,1448,2167,1763,2693,3808
GCCTATTCTCATGCTG,sample,61077,60656,5137,55519,6605,48914,20925,1382,14316,1540,35241,10751,5857,1388,2999,4387
AGCAGAGCTCATGCTG,sample,37953,37647,3116,34531,5420,29111,15492,1400,6897,593,22389,4729,3521,1276,2513,3551
ATACCGCCTCATGCTG,sample,46627,46394,1603,44791,8734,36057,24763,2129,5716,740,30479,2709,2424,1362,4033,6263
GGCGTACCTCATGCTG,sample,45814,45513,2438,43075,6069,37006,23892,1753,6592,860,30484,3909,2774,1191,3724,4559
CAGCTTCGTCATGCTG,Neg_Ctrl,505,418,81,337,56,281,181,15,45,12,226,28,108,77,28,33
CGCGGTCGTCATGCTG,sample,30329,30087,1788,28299,3356,24943,12547,906,6428,769,18975,4293,3295,1251,1929,2314
TAACGCCATCATGCTG,sample,61169,60819,2375,58444,11387,47057,30777,2169,8885,978,39662,4248,3024,1407,4814,8442
ATTCTACCTCATGCTG,sample,73647,73102,5245,67857,9497,58360,26994,1748,17058,1843,44052,10717,5239,1428,3787,6419
GACTAACCTCATGCTG,sample,49980,49671,1710,47961,7809,40152,28633,2027,6181,899,34814,2412,2009,1198,4035,5464
AGATACTATCATGCTG,sample,47411,47001,4706,42295,5566,36729,13617,1246,12338,1253,25955,8275,4600,1324,2062,3551
CCTAACTATCATGCTG,sample,57495,57159,3555,53604,7365,46239,25308,1649,11339,1344,36647,6599,3946,1512,3004,5386
TTAACTGATCATGCTG,sample,3599,3581,119,3462,896,2566,1696,151,426,48,2122,245,619,464,234,590
TCTAGGTTTTAGGCGG,sample,103592,103000,2802,100198,15234,84964,58319,4053,15911,1867,74230,4814,2331,1339,6185,10561
CTGGTCTTTTAGGCGG,Pos_Ctrl,90199,89185,5224,83961,3254,80707,66849,6476,5027,638,71876,1717,5720,7368,3392,1267
GTCGTTCTTTAGGCGG,sample,135047,134142,9318,124824,13661,111163,48341,3889,31294,3250,79635,24389,8591,2000,4550,9526
AGCTGAATTTAGGCGG,sample,136560,135711,6976,128735,17067,111668,73193,6000,19147,2116,92340,11212,3590,1467,10700,11803
GGAGAAGCTTAGGCGG,sample,111364,110673,4910,105763,12351,93412,56993,5221,20344,1715,77337,9139,4013,1585,6519,9154
GAGCCTCCTTAGGCGG,sample,259885,258035,18751,239284,11497,227787,78616,6327,100133,12002,178749,30709,9804,2472,3642,6059
GGTAGAGATTAGGCGG,sample,106966,106423,3259,103164,14115,89049,60059,4008,15534,1955,75593,7493,3690,1697,5939,10668
TCATACCATTAGGCGG,sample,136924,136154,5244,130910,26887,104023,69555,5045,17967,2028,87522,9428,5043,1972,14878,18973
ATTCAAGGTTAGGCGG,sample,150789,150073,4826,145247,29666,115581,87212,6829,13036,2254,100248,6250,4099,2299,15966,21116
TGATTCCGTTAGGCGG,sample,111672,110948,4111,106837,20370,86467,60641,4578,13191,1634,73832,6423,3300,1832,10493,14794
GACTCAAGTTAGGCGG,sample,161497,160621,6018,154603,25246,129357,95501,5618,17164,1910,112665,9164,4702,2667,11515,18911
CCGCAGTCTTAGGCGG,sample,131931,131058,9525,121533,19498,102035,56516,4206,25568,2701,82084,13044,6233,2054,10379,13784
TCTCAGGATTAGGCGG,sample,103415,102910,2700,100210,30041,70169,54206,3558,8063,1185,62269,3157,2733,1760,14053,19542
GATGCGTTTTAGGCGG,sample,136257,135492,5387,130105,24741,105364,69587,6078,16554,1813,86141,11332,4472,1648,11850,16700
ATGGCGTTTTAGGCGG,sample,137964,137072,7260,129812,18449,111363,69756,4687,21866,2530,91622,12524,5743,2026,13409,12706
CGGTTGGTTTAGGCGG,sample,112660,111858,5937,105921,13953,91968,51295,3458,23236,3305,74531,10674,4500,1729,9511,10033
GCTCTTCTTTAGGCGG,sample,119206,118391,5106,113285,16912,96373,64138,6393,15113,1757,79251,8972,4643,1720,10241,12740
GAGATTCTTTAGGCGG,sample,144069,143361,5063,138298,20936,117362,85177,7932,14309,1856,99486,8088,4360,2179,13811,15491
CCTAGCGGTTAGGCGG,sample,70305,69851,2668,67183,11088,56095,38242,2906,9293,1035,47535,4619,3470,1881,5306,7830
CTAACCGGTTAGGCGG,sample,133707,132851,3381,129470,16135,113335,89173,5993,11252,1046,100425,5871,3602,2127,7606,12319
GGCGACGATTAGGCGG,sample,99637,99018,3451,95567,13994,81573,57691,3939,13463,1398,71154,5082,2995,1568,9630,10759
TAACGAAGTTAGGCGG,sample,131465,130577,7138,123439,15336,108103,67810,5430,20055,2044,87865,12764,5228,1710,9436,11394
GCTGCTTCTTAGGCGG,sample,119649,118784,7534,111250,12326,98924,47878,5053,25896,2670,73774,17427,6522,1647,8429,8210
GCCTATTCTTAGGCGG,sample,91104,90517,2561,87956,14823,73133,52598,4682,10363,1139,62961,4351,3066,1374,5413,10479
ATACCGCCTTAGGCGG,sample,135815,134946,7133,127813,18594,109219,65382,5598,24106,2226,89488,11907,5213,1769,10462,12975
ATGAATAGTTAGGCGG,sample,131701,130793,6822,123971,19503,104468,60789,4340,22135,2326,82924,14878,5812,1891,10215,12818
ATTCTACCTTAGGCGG,sample,141245,140404,7019,133385,17277,116108,58460,4106,30712,3085,89172,19745,6459,1985,8250,11657
CGCGAGACTTAGGCGG,sample,133960,132937,14360,118577,15987,102590,38490,3672,31874,3481,70364,25073,9567,1887,7225,10166
CCTAACTATTAGGCGG,sample,127790,126963,6657,120306,16846,103460,55504,4714,29091,2814,84595,11337,5089,1882,7523,12073
GCGCAATATTAGGCGG,sample,111270,110529,4147,106382,20075,86307,52016,4986,17710,1807,69726,9788,4296,1612,7845,13593
AACCGGTTTCAGATAC,sample,42454,42286,1083,41203,8650,32553,23923,2592,3443,309,27366,2286,2105,1417,2412,6032
GTCGTTCTTCAGATAC,sample,71865,71549,1835,69714,11041,58673,42889,3223,9024,864,51913,2673,1906,1327,6746,7909
CATACTCCTCAGATAC,sample,62504,62202,1814,60388,9623,50765,39222,3296,5724,468,44946,2055,1826,1254,5279,6898
TCGAACGATCAGATAC,sample,64921,64433,4360,60073,8421,51652,30635,2452,10395,986,41030,7184,3866,1234,3747,5960
GGTAGAGATCAGATAC,sample,106040,105465,3498,101967,9961,92006,74600,5352,7354,957,81954,3743,2814,1956,3587,6560
TCATACCATCAGATAC,sample,43549,43232,3606,39626,7564,32062,17595,1451,7440,750,25035,4826,3166,1102,3874,5178
CCGCAGTCTCAGATAC,sample,57091,56718,2368,54350,11291,43059,30232,2750,7058,695,37290,2324,2103,1249,6620,7806
ATGGCGTTTCAGATAC,sample,96540,96104,3224,92880,15595,77285,61074,4482,7102,1086,68176,3541,2248,1740,10532,11306
CATTCGGTTCAGATAC,sample,51068,50664,4084,46580,5051,41529,20270,1384,12308,1363,32578,6204,3790,1534,2656,3284
GAGATTCTTCAGATAC,sample,70101,69688,2420,67268,15341,51927,36872,3045,8108,976,44980,2926,2164,1260,8795,10400
TAACGAAGTCAGATAC,sample,75365,74874,4473,70401,7674,62727,38283,2901,12176,1509,50459,7858,4125,1522,3582,5011
GTCGCGAATCAGATAC,sample,60785,60372,2825,57547,9811,47736,32750,2990,7836,684,40586,3476,2599,1252,3264,6811
CGCGGTCGTCAGATAC,sample,50179,49850,2463,47387,6061,41326,26299,1909,8321,936,34620,3861,2669,1245,3395,4388
AGATACTATCAGATAC,sample,81262,80717,2734,77983,8898,69085,41009,3166,17437,1736,58446,5737,2754,1282,4365,6542
CCTAACTATCAGATAC,sample,19567,19399,2060,17339,2595,14744,7236,465,4097,594,11333,2352,2096,813,1374,1810
GCGCAATATCAGATAC,sample,52488,52149,1602,50547,9595,40952,29731,2082,6291,787,36022,2061,1941,1330,5021,6634
AACCGGTTTCGCTAGG,sample,54686,54351,2544,51807,10243,41564,23784,1784,11042,1669,34826,3285,2843,1625,4601,7040
TCTAGGTTTCGCTAGG,sample,77681,77191,2398,74793,17802,56991,45083,2759,5978,613,51061,2558,1942,1363,10424,12606
GTCGTTCTTCGCTAGG,Neg_Ctrl,609,520,73,447,56,391,233,10,86,24,319,38,145,84,44,34
AGCTGAATTCGCTAGG,sample,52608,52222,3756,48466,10093,38373,22541,1668,8541,916,31082,4707,3295,1313,4852,6738
GACGTATGTCGCTAGG,sample,42734,42468,2046,40422,10535,29887,19662,1462,5373,733,25035,2657,2643,1618,4306,7199
GGAGAAGCTCGCTAGG,Neg_Ctrl,675,556,126,430,80,350,210,10,64,19,274,47,147,81,39,64
ATTCAAGGTCGCTAGG,sample,32349,32126,2276,29850,4829,25021,13962,1145,6014,814,19976,3086,2428,1180,2596,3412
TACGCGAGTCGCTAGG,sample,61192,60758,4884,55874,8097,47777,25312,1566,12308,1778,37620,6813,3943,1448,5194,5661
GACTCAAGTCGCTAGG,sample,45655,45352,1379,43973,8858,35115,27348,2370,3400,764,30748,1233,1635,1422,5549,6668
CCGTACGCTCGCTAGG,sample,64776,64391,3479,60912,11001,49911,30549,2573,10053,1039,40602,5697,3752,1432,5957,7791
GGCAGGTTTCGCTAGG,sample,71808,71189,5482,65707,9145,56562,30005,1974,14484,1886,44489,8213,4440,1532,4830,6250
CATTCGGTTCGCTAGG,sample,75548,75023,4148,70875,9197,61678,37748,2674,12306,1157,50054,7793,4367,1708,5779,6013
TAGCGAGTTCGCTAGG,sample,69039,68461,4319,64142,7948,56194,34596,2720,10930,1375,45526,6573,3800,1422,7003,5782
CTAAGCATTCGCTAGG,sample,52267,51934,2900,49034,6965,42069,25310,2160,8854,952,34164,4793,3306,1401,5609,4951
GCCTATTCTCGCTAGG,sample,45432,45154,2488,42666,8520,34146,20012,1760,6988,877,27000,4509,2880,1019,3805,5989
AGCAGAGCTCGCTAGG,sample,150226,149109,12985,136124,7678,128446,41660,2563,50893,5706,92553,27624,9554,2010,1905,3994
TGCGCTCCTCGCTAGG,sample,69456,68998,4042,64956,9381,55575,30061,2389,14077,1332,44138,7716,3955,1271,4367,6902
GTCGCGAATCGCTAGG,sample,66604,66227,1428,64799,8842,55957,47789,3102,3819,305,51608,942,1725,1752,4196,6692
CAGCTTCGTCGCTAGG,sample,56108,55704,2613,53091,7528,45563,29562,2342,8062,956,37624,4641,2796,1033,4337,5545
ATGAATAGTCGCTAGG,sample,83290,82758,2508,80250,12481,67769,53623,3993,6066,858,59689,3229,2474,1981,6538,9169
ATTCTACCTCGCTAGG,Pos_Ctrl,16386,16278,980,15298,702,14596,12094,1185,893,138,12987,286,3060,2928,587,372
GACTAACCTCGCTAGG,sample,83970,83395,6112,77283,9736,67547,32488,2938,17123,1871,49611,13127,6090,1694,4300,6720
CGTAGAACTCGCTAGG,sample,51733,51386,3605,47781,7198,40583,20260,1349,10863,1213,31123,6898,4508,1507,3645,5113
CTGGTCTTCCGTTGCG,sample,65129,64727,3695,61032,14544,46488,29375,2011,9409,1376,38784,4317,3051,1462,6864,10176
GTCGTTCTCCGTTGCG,sample,66927,66555,3194,63361,18206,45155,33434,2286,5729,711,39163,2995,2723,1755,8424,11505
AGCTGAATCCGTTGCG,sample,107772,107121,4833,102288,19774,82514,52360,2945,19286,2080,71646,5843,2981,1524,13043,14192
GGAGAAGCCCGTTGCG,sample,88568,87924,4508,83416,15986,67430,47378,3054,10299,1169,57677,5530,3784,1900,8082,11355
CATACTCCCCGTTGCG,sample,86505,85890,5681,80209,12771,67438,43255,2947,12263,1266,55518,7707,4605,2028,6401,8834
CTAGCGACCCGTTGCG,sample,64739,64382,2638,61744,15227,46517,33380,2382,7295,747,40675,2713,2568,1625,6353,9991
GACTCAAGCCGTTGCG,sample,101072,100345,6680,93665,15047,78618,44271,2627,17766,1725,62037,12229,5058,1469,9912,10880
ATACGTTCCCGTTGCG,sample,94997,94408,5201,89207,14320,74887,46888,3574,15931,1900,62819,6594,3737,1581,9907,10716
CCGCAGTCCCGTTGCG,sample,84476,83763,6750,77013,13184,63829,30634,3138,16266,1798,46900,11993,5798,1694,5132,9031
GGCAGGTTCCGTTGCG,sample,13264,13124,1762,11362,1532,9830,4538,349,2821,302,7359,1820,1890,839,769,962
CGGTTGGTCCGTTGCG,sample,54061,53514,6282,47232,7280,39952,16958,1211,12150,1306,29108,8327,5317,1905,2166,4554
CATTCGGTCCGTTGCG,sample,96002,95326,4449,90877,9739,81138,53823,3962,15301,1321,69124,6731,3633,1854,6241,6839
GCTCTTCTCCGTTGCG,sample,76359,75862,5084,70778,8496,62282,33823,2463,16379,1962,50202,7655,4292,1672,5077,5792
CTAAGCATCCGTTGCG,sample,110854,110215,3288,106927,13549,93378,51786,4131,24359,2722,76145,10380,1771,1462,12049,10533
CTAACCGGCCGTTGCG,sample,65229,64743,3493,61250,9691,51559,32790,2621,9833,1074,42623,5241,3514,1384,5567,7130
GCTGCTTCCCGTTGCG,sample,97675,97048,2855,94193,9065,85128,64970,4513,9739,948,74709,4958,2816,1856,3800,6520
GCGTTACCCCGTTGCG,sample,70988,70610,2902,67708,11989,55719,39538,3060,8905,1251,48443,2965,1906,1071,5860,8541
GGCGTACCCCGTTGCG,sample,48347,48086,1217,46869,10971,35898,29719,2773,2139,374,31858,893,1348,1370,4953,7657
GTCGCGAACCGTTGCG,sample,84246,83779,3643,80136,11987,68149,44581,3813,11092,2042,55673,6621,3743,1346,5199,8566
CGTCGAGGCCGTTGCG,sample,74202,73807,3351,70456,10682,59774,40098,2869,10120,1223,50218,5464,2522,1146,7597,7937
CAGCTTCGCCGTTGCG,sample,105012,104353,7677,96676,11393,85283,41395,3592,21630,2608,63025,16058,6545,1651,4482,7632
ATGAATAGCCGTTGCG,sample,67779,67365,3714,63651,10361,53290,34646,2284,9775,1037,44421,5548,4038,1875,6654,7785
TCAATCAGCCGTTGCG,sample,103905,103336,6465,96871,13824,83047,42149,4591,19575,2291,61724,14441,6988,1721,6359,9143
TAACGCCACCGTTGCG,sample,113955,113272,4886,108386,14667,93719,65214,5079,13825,1642,79039,7959,4997,2486,6456,10177
CGCGAGACCCGTTGCG,sample,63056,62687,2015,60672,11303,49369,36069,3429,6998,665,43067,2208,2309,1761,4928,8481
TTAACTGACCGTTGCG,sample,31798,31603,2501,29102,4719,24383,11686,914,7179,775,18865,3829,2997,1170,1969,3145
ATATGCAACCGTTGCG,sample,278,277,20,257,56,201,116,20,44,5,160,16,86,49,24,33
TCTAGGTTAGGCCAAG,sample,97208,96565,6082,90483,19808,70675,38793,2928,17080,1897,55873,9977,4863,1666,8277,13414
TCGAACGAAGGCCAAG,sample,83601,83104,3547,79557,16045,63512,45141,3132,9800,1051,54941,4388,3244,1680,8125,11190
GCAACTAGAGGCCAAG,sample,28392,28171,1382,26789,3948,22841,12334,1102,6438,718,18772,2249,2380,1173,2239,2724
ATACGTTCAGGCCAAG,sample,26275,26094,2308,23786,3420,20366,10710,756,5458,530,16168,2912,2637,1126,1654,2264
CATTCGGTAGGCCAAG,sample,60880,60443,3821,56622,7760,48862,28375,1611,12606,1463,40981,4807,2729,1403,5368,5555
GCTCTTCTAGGCCAAG,sample,105574,104957,4238,100719,14715,86004,54799,4205,17412,2116,72211,7472,3578,1725,6895,10096
GAGATTCTAGGCCAAG,sample,78232,77539,4236,73303,8760,64543,37125,2277,16365,1914,53490,6862,4044,1733,6629,6073
CTAAGCATAGGCCAAG,sample,124837,124085,6381,117704,19674,98030,59936,4274,21861,2281,81797,9678,3825,1466,12664,13390
AAGGTCTGAGGCCAAG,sample,123935,123086,5309,117777,17365,100412,73426,5619,12922,1783,86348,6662,3953,2201,11806,12240
TAACGAAGAGGCCAAG,sample,103200,102480,7530,94950,9125,85825,44459,3048,24759,2887,69218,10672,5050,2089,5625,6539
GCGTTACCAGGCCAAG,sample,95267,94583,3516,91067,9479,81588,50288,3236,18632,2885,68920,6547,2671,1448,5713,7179
ATTCTACCAGGCCAAG,sample,93005,91994,6398,85596,14399,71197,42065,2514,16105,1432,58170,9081,4523,1559,8684,10138
GACTAACCAGGCCAAG,Neg_Ctrl,681,563,68,495,72,423,258,25,91,14,349,35,180,118,49,44
CGCGAGACAGGCCAAG,sample,101607,101044,5337,95707,14602,81105,45485,4656,18760,1738,64245,10466,5137,1501,6295,10203
AGATACTAAGGCCAAG,sample,123629,123031,5896,117135,17958,99177,61189,4058,19539,2075,80728,12316,5178,1650,11856,12902
CCTAACTAAGGCCAAG,sample,111768,111237,3206,108031,18260,89771,60659,4674,16843,2154,77502,5441,3322,1520,8656,13600
TTAACTGAAGGCCAAG,sample,80460,80142,2365,77777,16669,61108,44285,3979,8655,870,52940,3319,2686,1437,9647,11366
ATATGCAAAGGCCAAG,sample,13790,13701,410,13291,3065,10226,5774,539,2646,304,8420,963,1400,875,735,2067
AGCTGAATAGAACCGC,sample,118066,117324,5001,112323,22028,90295,67169,4972,10876,1150,78045,6128,3606,2073,11487,16126
CGTCGCCAAGAACCGC,sample,97028,96437,4784,91653,18166,73487,43596,3688,15912,1957,59508,8334,3992,1489,10334,12338
TCATACCAAGAACCGC,sample,123202,122484,9729,112755,20883,91872,46871,3198,22553,2330,69424,16920,7003,1682,10642,13835
ATTCAAGGAGAACCGC,sample,121309,120711,3923,116788,23509,93279,70508,5183,11673,1221,82181,4694,3355,1970,13163,17126
ATACGTTCAGAACCGC,sample,111109,110542,5575,104967,19512,85455,52100,4108,17208,1800,69308,10239,4746,1580,11658,14057
GATGCGTTAGAACCGC,sample,103390,102689,6294,96395,14524,81871,50849,3221,16238,2439,67087,9124,4838,1700,7765,10127
AGCGTCTTAGAACCGC,sample,120171,119366,5829,113537,20318,93219,55753,5781,18102,2031,73855,11552,4843,1626,12550,14355
CTAAGCATAGAACCGC,sample,109840,109045,7999,101046,14101,86945,43482,3684,22945,2774,66427,14060,5671,1639,9732,9703
CTAACCGGAGAACCGC,sample,57275,56803,2996,53807,6220,47587,31572,2518,8115,1017,39687,4365,3740,2103,3673,4530
GGCGACGAAGAACCGC,sample,94272,93631,6498,87133,9608,77525,44256,3888,16339,2071,60595,10971,5254,1578,6681,6295
GCCTATTCAGAACCGC,sample,112453,111721,5215,106506,15726,90780,52415,4274,20592,2220,73007,11279,4845,1846,8979,11066
TGCGCTCCAGAACCGC,sample,94467,93894,5472,88422,11479,76943,43605,4439,16270,1768,59875,10861,4607,1367,4922,7778
CAGCTTCGAGAACCGC,sample,100585,99913,4021,95892,14515,81377,56020,4662,13356,1333,69376,6006,3762,1942,6095,9822
TTATGACGAGAACCGC,sample,109036,108154,11789,96365,10263,86102,32023,2072,28594,2875,60617,20538,8168,1761,4953,6388
ATGAATAGAGAACCGC,sample,89495,88950,4027,84923,17722,67201,44919,3483,11307,1121,56226,6371,4139,1973,6311,12559
TCAATCAGAGAACCGC,sample,116453,115584,9716,105868,13291,92577,40194,3174,26650,3025,66844,19534,7268,1732,7707,8757
TAACGCCAAGAACCGC,sample,116780,116197,3046,113151,22350,90801,66612,4812,14682,1762,81294,2933,2283,1749,12414,16943
ATTCTACCAGAACCGC,sample,94946,94358,4920,89438,13481,75957,45597,4440,15027,1739,60624,9154,4799,1475,5131,9494
CGCGAGACAGAACCGC,sample,69621,69107,4506,64601,10371,54230,30747,2084,11986,1384,42733,8029,4398,1401,4650,7304
AGATACTAAGAACCGC,sample,169717,168494,14435,154059,9458,144601,46634,3972,50418,5148,97052,38429,10439,2180,5003,5408
CCTAACTAAGAACCGC,sample,106431,105667,8676,96991,12921,84070,38047,3572,23479,2325,61526,16647,6933,1641,5224,9306
AGAGTTCTCATCAAGC,sample,95963,95358,4660,90698,15963,74735,45357,2640,18244,2128,63601,6366,3829,1963,7952,11576
AGCTGAATCATCAAGC,sample,71723,71154,4265,66889,10947,55942,32628,1997,14107,1961,46735,5249,3428,1710,6769,8223
GAGCCTCCCATCAAGC,sample,87038,86197,10043,76154,9935,66219,26530,1947,20421,2255,46951,15066,6842,1856,4360,6138
CTAGCGACCATCAAGC,sample,98312,97491,8840,88651,7795,80856,35898,3044,23016,2807,58914,16091,6274,1395,4324,4487
GGTAGAGACATCAAGC,sample,119593,118850,6938,111912,10392,101520,56645,5429,22289,2374,78934,14783,5975,1645,5980,6740
TCATACCACATCAAGC,sample,107196,106590,5663,100927,17935,82992,54834,3930,15778,1664,70612,6786,4472,2192,8485,12540
GCAACTAGCATCAAGC,sample,33393,33224,1236,31988,5648,26340,19346,1623,3612,260,22958,1499,1941,1557,3276,4201
CCGCAGTCCATCAAGC,sample,66229,65688,4565,61123,8836,52287,27928,2274,13124,1772,41052,7189,4177,1634,4776,6180
CCGTACGCCATCAAGC,sample,114737,113627,15521,98106,10338,87768,27565,1754,33142,3383,60707,21924,9455,2136,4330,6266
TAGCGAGTCATCAAGC,sample,66292,65847,3450,62397,9439,52958,29727,2270,14203,1589,43930,5169,3097,1328,4748,6460
GCTCTTCTCATCAAGC,sample,66796,66357,3751,62606,8764,53842,31222,1990,13796,1691,45018,5143,3514,1853,4299,6428
CTAAGCATCATCAAGC,sample,102913,102323,3633,98690,15467,83223,56286,4335,13458,1678,69744,7466,2810,1421,10274,11143
GGCGACGACATCAAGC,sample,92056,91380,7664,83716,13285,70431,36712,2727,16282,1937,52994,12773,5749,1545,5549,8515
TAACGAAGCATCAAGC,sample,73804,73403,1760,71643,16213,55430,45864,2931,4664,459,50528,1512,1894,1686,6525,11307
GCTGCTTCCATCAAGC,sample,76158,75540,5163,70377,10780,59597,33703,2722,13500,1348,47203,8324,4569,1393,6970,7276
ATACCGCCCATCAAGC,sample,93253,92716,4324,88392,10455,77937,50718,3636,12675,1798,63393,9110,3583,1260,7658,6889
GCGTTACCCATCAAGC,sample,58895,58504,2790,55714,8767,46947,33044,3885,6000,463,39044,3555,2661,1415,3854,6281
CGTCGAGGCATCAAGC,Pos_Ctrl,16358,16089,1554,14535,792,13743,11437,1048,833,133,12270,292,3065,2700,799,446
TTATGACGCATCAAGC,sample,58731,58385,2041,56344,10012,46332,32596,2293,7818,860,40414,2765,1813,1215,4921,6871
TCTCCTAGCATCAAGC,sample,73665,73248,1898,71350,11786,59564,47004,4596,5565,632,52569,1767,2254,1860,7906,8714
AAGTAGAGCATCAAGC,sample,61502,61140,2914,58226,9057,49169,33090,2418,8739,1020,41829,3902,3550,2254,4070,6711
TCAATCAGCATCAAGC,sample,35564,35427,901,34526,6860,27666,17945,1859,5283,619,23228,1960,1763,1140,2599,4750
AGATACTACATCAAGC,sample,95168,94815,1973,92842,16034,76808,63154,6918,4917,603,68071,1216,1166,1352,9333,12304
GCGCAATACATCAAGC,sample,90362,89858,3576,86282,14362,71920,47492,3695,14638,1480,62130,4615,3053,1565,6232,9809
TTAACTGACATCAAGC,sample,89459,89021,5853,83168,13421,69747,37419,2717,15777,1823,53196,12011,6023,1802,7383,9652
ATATGCAACATCAAGC,sample,57981,57706,1272,56434,15967,40467,31421,2712,4851,499,36272,984,1469,1146,7292,10808
AACCGGTTAGAGAGCC,sample,78763,78317,2293,76024,18745,57279,43328,3173,8217,782,51545,1779,1939,1481,9590,13386
CTGGTCTTAGAGAGCC,sample,57426,57031,3870,53161,9068,44093,27792,1907,8390,984,36182,5020,3345,1710,4107,6671
AGCTGAATAGAGAGCC,sample,40840,40500,2135,38365,5347,33018,19660,1323,8231,1074,27891,2730,2582,1573,3457,3863
TATACGGAAGAGAGCC,sample,65161,64702,3984,60718,10885,49833,31551,1976,9903,897,41454,5506,3860,1785,6177,7828
GGAGAAGCAGAGAGCC,sample,53917,53534,2126,51408,8733,42675,29518,2491,7240,919,36758,2507,2296,1627,4357,6614
GGTAGAGAAGAGAGCC,sample,46736,46433,2860,43573,5933,37640,24074,1080,7530,917,31604,4039,2766,992,4254,4098
CGTCGCCAAGAGAGCC,sample,51870,51500,1942,49558,5830,43728,32093,2509,5488,638,37581,3000,2273,1054,3394,4088
TCATACCAAGAGAGCC,sample,85510,84884,9741,75143,4268,70875,21570,1490,29806,3230,51376,14779,7225,1797,1142,2473
TGATTCCGAGAGAGCC,sample,44632,44272,3829,40443,4452,35991,16112,1359,11341,1036,27453,6143,3782,1147,1754,2846
GCAACTAGAGAGAGCC,sample,14091,14011,401,13610,1971,11639,8139,698,2001,170,10140,631,973,745,1103,1408
TACGCGAGAGAGAGCC,sample,53911,53542,2713,50829,7326,43503,25647,1751,9157,968,34804,5980,3699,1214,3251,5268
ATACGTTCAGAGAGCC,sample,50025,49681,2630,47051,3994,43057,23007,1603,12202,1634,35209,4611,2755,1196,2665,2833
TCTCAGGAAGAGAGCC,sample,43873,43523,3847,39676,7807,31869,18082,1359,6615,749,24697,5064,3514,1367,3488,5414
CCATTCTTAGAGAGCC,sample,44561,44139,2177,41962,8005,33957,25073,2145,4148,619,29221,1972,2178,1617,4110,5976
CTAAGCATAGAGAGCC,sample,69316,68638,5876,62762,6950,55812,26470,2117,15012,1539,41482,10674,5158,1729,4084,4587
AAGGTCTGAGAGAGCC,sample,57783,57513,2078,55435,9773,45662,31888,2693,7374,1550,39262,2157,1767,1157,7567,6945
CCTAGCGGAGAGAGCC,sample,21975,21696,3109,18587,2181,16406,5811,511,5811,582,11622,3691,3192,945,988,1248
CTAACCGGAGAGAGCC,sample,19331,19231,1490,17741,2993,14748,8713,879,3170,415,11883,1571,1814,996,1918,2098
GCCTATTCAGAGAGCC,sample,37422,37072,2793,34279,5336,28943,18383,944,5698,641,24081,3277,2587,1300,3806,3782
AGCAGAGCAGAGAGCC,sample,51026,50646,3176,47470,8308,39162,25516,2306,7118,678,32634,3544,2849,1340,5585,5913
TGCGCTCCAGAGAGCC,sample,43753,43388,2768,40620,4508,36112,21113,1735,8377,964,29490,3923,3279,1651,2616,3257
ATACCGCCAGAGAGCC,sample,31856,31645,1359,30286,7573,22713,15846,1009,3920,419,19766,1519,2033,1055,4005,5146
GGCGTACCAGAGAGCC,sample,41728,41391,3481,37910,5449,32461,15802,1356,8260,849,24062,6194,3947,1439,2554,3642
TCTCCTAGAGAGAGCC,sample,41328,40965,4148,36817,4935,31882,14669,989,9591,1041,24260,5592,3726,1414,2732,3229
ATGAATAGAGAGAGCC,sample,61295,60956,3203,57753,7536,50217,29816,1934,11907,1244,41723,5316,3159,1376,4924,5403
AAGTAGAGAGAGAGCC,sample,23818,23669,1757,21912,3382,18530,10999,763,4012,484,15011,2272,2252,1137,1471,2462
TCAATCAGAGAGAGCC,sample,85619,85011,5321,79690,4497,75193,39855,4162,16730,1700,56585,12746,5860,1476,2996,2601
ATTCTACCAGAGAGCC,sample,52813,52356,3177,49179,9965,39214,20921,1295,9309,852,30230,6837,4161,1370,4286,6760
CGCGAGACAGAGAGCC,sample,47721,47313,5073,42240,4396,37844,13618,957,13846,1493,27464,7930,4268,1227,1744,2755
CGTAGAACAGAGAGCC,sample,60403,59997,4394,55603,8813,46790,24366,1885,12289,1426,36655,6824,4362,1501,4030,5858
AGATACTAAGAGAGCC,sample,66865,66311,6173,60138,6200,53938,22950,1672,15838,1568,38788,11910,5851,1868,2524,3861
ATATGCAAAGAGAGCC,sample,37123,36953,1004,35949,7198,28751,18297,1347,5518,527,23815,3062,2111,1054,2320,4798
GTCGTTCTAGCATTGA,sample,112161,111482,3628,107854,23935,83919,61043,4114,11353,1590,72396,5819,3988,1944,13325,17153
AGCTGAATAGCATTGA,sample,239783,237709,15946,221763,17869,203894,83453,5118,82745,9950,166198,22628,8224,3139,6577,12763
GACGTATGAGCATTGA,sample,110230,109679,3464,106215,25660,80555,62564,4856,8795,716,71359,3624,2445,1679,14095,17778
TATACGGAAGCATTGA,sample,125996,125360,3901,121459,28910,92549,69909,4817,11100,1049,81009,5674,2132,1536,18370,21397
GAGCCTCCAGCATTGA,sample,126292,125451,5748,119703,16419,103284,60079,3710,27461,3242,87540,8792,4406,2071,9654,12239
CATACTCCAGCATTGA,sample,73595,72969,5315,67654,15313,52341,22417,1629,15565,1771,37982,10959,5756,1855,4122,9751
GGTAGAGAAGCATTGA,sample,147364,146432,4886,141546,28672,112874,85258,6142,13360,1202,98618,6912,4164,2430,11483,20565
CGTCGCCAAGCATTGA,sample,128297,127496,4472,123024,24145,98879,68927,5381,15563,1490,84490,7518,4240,2064,10506,17689
GCAACTAGAGCATTGA,sample,40410,40197,2166,38031,8801,29230,18628,1706,5112,592,23740,3192,3246,1591,4478,6000
TACGCGAGAGCATTGA,sample,129549,128857,3899,124958,20397,104561,81695,5535,11535,1000,93230,4796,3758,2548,12162,15569
GACTCAAGAGCATTGA,sample,43508,43222,2243,40979,8344,32635,19951,1492,7226,702,27177,3264,3102,1615,4072,5887
TCTCAGGAAGCATTGA,sample,143820,143118,2883,140235,31784,108451,87796,7127,9690,1137,97486,2701,1998,1851,17354,23089
TGGATCAAAGCATTGA,sample,122079,121401,3652,117749,29018,88731,60547,4087,16721,1677,77268,5699,3297,1567,15498,20372
ATGGCGTTAGCATTGA,sample,85589,84958,5242,79716,15983,63733,39087,3000,12797,1542,51884,7307,4715,2066,5722,10898
CATTCGGTAGCATTGA,sample,111593,110626,9312,101314,13548,87766,39178,3326,26309,2485,65487,16468,6327,1765,7299,9048
TAGCGAGTAGCATTGA,sample,130569,129476,6969,122507,17713,104794,60480,4159,24521,2618,85001,13016,5571,1689,8849,12952
AAGGTCTGAGCATTGA,sample,97849,97167,4833,92334,11004,81330,45334,3618,20961,2368,66295,9049,4134,1944,6449,7710
GGCGACGAAGCATTGA,sample,83958,83436,2569,80867,12702,68165,49690,4601,9324,855,59014,3695,2283,1239,8466,9427
TAACGAAGAGCATTGA,sample,86392,85792,4123,81669,8662,73007,43145,2853,17931,2463,61076,6615,3597,1590,5781,6132
ATACCGCCAGCATTGA,sample,165224,163734,13309,150425,11636,138789,48986,3381,58000,6378,106986,22044,8487,2037,3779,6398
CAGCTTCGAGCATTGA,Neg_Ctrl,987,803,95,708,106,602,374,27,123,8,497,70,238,151,63,57
ATGAATAGAGCATTGA,sample,36036,35815,3124,32691,4676,28015,13601,1105,7813,980,21414,4516,3170,1124,2185,3042
AAGTAGAGAGCATTGA,sample,130212,129438,5860,123578,14269,109309,57872,4371,32946,4453,90818,9667,4234,1601,7965,9597
ATTCTACCAGCATTGA,sample,90573,89990,4672,85318,22384,62934,37582,2780,13661,1568,51243,7343,4366,1696,6395,15091
GACTAACCAGCATTGA,sample,104059,103347,4794,98553,12022,86531,52605,4016,18841,1836,71446,9233,4568,1789,6212,9284
CGTAGAACAGCATTGA,sample,60654,60256,3487,56769,10249,46520,29337,2299,8727,1111,38064,5046,3370,1313,5255,7820
CCTAACTAAGCATTGA,sample,119541,118765,5041,113724,18035,95689,65958,5670,14981,1802,80939,7278,4082,1876,8042,13434
ATATGCAAAGCATTGA,sample,107404,106845,4774,102071,19781,82290,55453,4148,14625,1208,70078,6856,3462,1419,7709,13791
TCTAGGTTAATTACCA,sample,102089,101477,4687,96790,15506,81284,53530,4497,12979,1266,66509,9012,3797,1367,5715,10973
GTCGTTCTAATTACCA,sample,86276,85896,2318,83578,14419,69159,48998,4730,9809,1353,58807,4269,2610,1367,5634,10712
AGAGTTCTAATTACCA,sample,120324,119592,6711,112881,11114,101767,53045,4796,27154,3193,80199,13579,4107,1399,6783,7693
CATAATGGAATTACCA,sample,116552,115583,9781,105802,8766,97036,34359,2061,36111,4128,70470,20377,8032,1688,3216,4842
ATTCAAGGAATTACCA,sample,13596,13493,1739,11754,2105,9649,3453,187,3455,371,6908,2183,2235,776,637,1374
TGATTCCGAATTACCA,sample,68764,68320,4630,63690,9864,53826,31309,2199,12611,1280,43920,6427,4196,2111,4068,6776
ATACGTTCAATTACCA,sample,85620,85133,4775,80358,12081,68277,37704,2030,19278,2035,56982,7230,3776,1702,7689,8131
CCGTACGCAATTACCA,sample,76842,76363,3679,72684,12966,59718,36284,2468,13752,2005,50036,5209,3318,1364,7995,9106
TCTCAGGAAATTACCA,sample,96033,95587,2824,92763,18808,73955,57092,3893,8418,1033,65510,3519,2659,1702,13370,13740
GGCAGGTTAATTACCA,sample,81671,81098,6109,74989,10959,64030,30765,2296,18039,1853,48804,11077,5256,1345,6778,7657
ATGGCGTTAATTACCA,sample,96957,96416,4055,92361,17560,74801,52859,3686,10924,1835,63783,5497,3216,1503,9402,11743
CTAACCGGAATTACCA,sample,106801,105947,7486,98461,7641,90820,42715,2768,25680,3355,68395,16302,6713,1653,4982,5058
GGCGACGAAATTACCA,sample,80249,79628,5132,74496,8085,66411,39927,3304,13458,1406,53385,8316,4558,1609,3944,5791
GCTGCTTCAATTACCA,sample,46034,45607,4652,40955,4695,36260,18188,1553,9368,1039,27556,6112,3836,1246,3023,2955
GTCGCGAAAATTACCA,sample,82988,82424,4875,77549,8462,69087,42151,2857,14265,2152,56416,7662,3775,1473,5464,6176
CAGCTTCGAATTACCA,sample,64771,64364,2008,62356,10601,51755,39325,5175,5383,462,44708,1410,1252,1124,3954,8166
TCTCCTAGAATTACCA,sample,74536,74048,5437,68611,9826,58785,32195,2566,14130,1534,46325,8360,4485,1404,4792,6642
ATGAATAGAATTACCA,sample,123017,122147,6711,115436,15279,100157,63093,5284,17697,1691,80790,12392,5304,2061,7225,10536
TCAATCAGAATTACCA,sample,69740,69285,2015,67270,8652,58618,44740,2963,7239,816,51979,2860,2578,1953,4109,6453
TCTAGGTTTAGATGAC,sample,90921,90406,5945,84461,15252,69209,34504,2391,17735,2102,52239,12477,6166,2298,5993,10533
CTGGTCTTTAGATGAC,Pos_Ctrl,21484,21226,1866,19360,1111,18249,15272,1391,1086,137,16358,363,3421,3088,1382,669
AGCTGAATTAGATGAC,sample,139943,139184,7049,132135,23541,108594,71548,5238,19392,2749,90940,9667,4820,1907,17190,17570
CATAATGGTAGATGAC,sample,118422,117441,13534,103907,13075,90832,36209,2685,29843,3232,66052,18863,8235,2208,6165,8592
GAGCCTCCTAGATGAC,sample,80742,80283,4295,75988,8790,67198,33031,2558,17190,2046,50221,12373,5256,1269,3811,5570
CATACTCCTAGATGAC,Pos_Ctrl,21734,21307,2098,19209,1243,17966,14866,1336,1271,177,16137,316,3697,3151,1322,777
CGTCGCCATAGATGAC,sample,102277,101603,5263,96340,14389,81951,46434,3274,21590,2692,68024,7961,3891,1846,6426,10170
TCATACCATAGATGAC,sample,113311,112580,4135,108445,18041,90404,57062,3824,20023,2671,77085,6824,3561,1679,9931,13244
TGATTCCGTAGATGAC,Pos_Ctrl,18549,18361,1306,17055,849,16206,13406,1243,1014,137,14420,406,3361,3202,684,439
ATACGTTCTAGATGAC,sample,70614,70174,4587,65587,8177,57410,28405,1962,16492,2079,44897,8472,4557,1752,5694,5706
CCGTACGCTAGATGAC,sample,124670,123984,3908,120076,19230,100846,80826,5463,9352,1245,90178,3960,3111,2203,8907,13846
GATGCGTTTAGATGAC,sample,137725,136660,9538,127122,13576,113546,59599,4573,29238,3006,88837,17130,6933,2162,7868,8777
CCATTCTTTAGATGAC,sample,136890,136001,4326,131675,23167,108508,76201,5289,19377,2440,95578,5201,2636,1662,15378,17014
CGGTTGGTTAGATGAC,sample,99791,99016,7087,91929,11404,80525,43008,3245,22392,2596,65400,9284,4910,1923,5727,7947
AAGGTCTGTAGATGAC,sample,143604,142541,13315,129226,18578,110648,44002,3441,34251,3719,78253,25235,8529,1945,9223,12846
GCGTTACCTAGATGAC,sample,91801,91139,4134,87005,13181,73824,51043,4274,11315,1167,62358,6025,3546,1633,6763,9597
GGCGTACCTAGATGAC,sample,90688,90166,3431,86735,10096,76639,54908,5498,10562,1100,65470,4571,2896,1648,4375,7556
GTCGCGAATAGATGAC,sample,115160,114307,8000,106307,14463,91844,51144,5517,18937,2253,70081,13993,5505,1590,6187,10029
CAGCTTCGTAGATGAC,sample,112841,112061,4320,107741,14689,93052,64070,4480,16413,1947,80483,6142,3627,1694,6275,10449
ATGAATAGTAGATGAC,sample,174175,173026,13796,159230,21898,137332,66972,7627,33915,3544,100887,25274,8695,2173,12765,15532
CGCGAGACTAGATGAC,sample,113423,112616,5874,106742,15403,91339,54534,3713,19455,2284,73989,11353,4381,1509,8779,10915
CGTAGAACTAGATGAC,sample,114196,113474,6936,106538,15782,90756,51388,4827,18825,1926,70213,13790,5494,1700,5797,10799
AGATACTATAGATGAC,sample,161869,160819,9809,151010,21524,129486,80134,6088,24169,2006,104303,17089,6663,2148,10735,14903
CCTAACTATAGATGAC,sample,130127,129384,6847,122537,18542,103995,66152,5518,18882,1569,85034,11874,5056,1708,9134,12947
TTAACTGATAGATGAC,sample,66654,66246,4566,61680,8782,52898,29216,1921,13363,1226,42579,7172,3753,1317,4323,6088
CTGGTCTTGTTCAGAA,sample,84053,83618,3330,80288,16722,63566,43364,3177,10343,962,53707,5720,3655,1808,8049,12115
AGAGTTCTGTTCAGAA,sample,76176,75708,2253,73455,11056,62399,42260,3329,11741,1431,54001,3638,2867,1958,6846,8249
GGAGAAGCGTTCAGAA,sample,69457,69097,2588,66509,13726,52783,36078,2210,9439,1129,45517,3927,3382,1711,7782,9754
GAGCCTCCGTTCAGAA,sample,46854,46627,1570,45057,8213,36844,27393,2088,5212,579,32605,1572,2567,2140,4464,6060
TCGAACGAGTTCAGAA,sample,65991,65583,2401,63182,10596,52586,32412,2312,11964,1259,44376,4639,2959,1402,6256,7519
GGTAGAGAGTTCAGAA,sample,34725,34564,907,33657,8649,25008,19425,1696,2607,309,22032,971,1559,1266,3958,5999
TCATCGAAGTTCAGAA,sample,52112,51789,2751,49038,8542,40496,22330,1502,10380,1109,32710,5175,3423,1403,4199,5875
GCAACTAGGTTCAGAA,sample,16516,16425,657,15768,2783,12985,8035,716,2834,414,10869,986,2116,1410,1326,1982
TACGCGAGGTTCAGAA,sample,60896,60541,3263,57278,9991,47287,25796,1981,11977,1397,37773,6136,3815,1330,5285,7698
GACTCAAGGTTCAGAA,sample,77350,76882,3750,73132,14155,58977,37683,2658,10565,1048,48248,7023,4161,1733,6798,10014
ATACGTTCGTTCAGAA,sample,61996,61669,1627,60042,13213,46829,36822,3197,5114,441,41936,1255,1679,1411,6522,9342
CCGCAGTCGTTCAGAA,sample,45785,45410,4112,41298,3586,37712,14270,1027,14313,1356,28583,6746,4824,1701,1832,2243
CCGTACGCGTTCAGAA,sample,62471,62123,1643,60480,10930,49550,39858,2915,4617,536,44475,1624,2079,1761,6417,7482
TGGATCAAGTTCAGAA,sample,73194,72794,3168,69626,11796,57830,34328,2588,12135,1309,46463,7470,4199,1609,6803,8535
GATGCGTTGTTCAGAA,sample,83986,83376,4025,79351,6511,72840,42787,3222,14569,1679,57356,10583,5487,1981,2865,4450
AGCGTCTTGTTCAGAA,sample,67132,66725,1906,64819,12184,52635,38425,3118,7428,1045,45853,2619,1864,1233,6830,9116
ACGCTTAAGTTCAGAA,sample,92977,92393,4603,87790,11939,75851,47065,4204,14677,1633,61742,8272,4260,1708,7258,8601
TAGCGAGTGTTCAGAA,sample,67558,67168,2932,64236,8882,55354,30306,2466,14209,2125,44515,6248,3474,1430,4782,6216
GAGATTCTGTTCAGAA,sample,88087,87500,6730,80770,9805,70965,32405,2513,21194,2996,53599,11857,4906,1618,5741,6500
CTAACCGGGTTCAGAA,sample,46743,46438,1976,44462,5762,38700,24695,1995,7624,1132,32319,3254,2556,1499,3574,4071
GGCGACGAGTTCAGAA,sample,51650,51255,1959,49296,7158,42138,27148,1952,9466,1161,36614,2411,2119,1305,4070,5423
ATACCGCCGTTCAGAA,sample,50915,50547,2163,48384,5530,42854,25807,1802,10058,1157,35865,4030,2444,1238,2730,4152
CGTCGAGGGTTCAGAA,sample,34425,34172,1767,32405,6381,26024,16430,1222,5143,719,21573,2510,2465,1221,2771,4517
ATGAATAGGTTCAGAA,sample,80036,79505,4074,75431,9215,66216,33633,2718,19815,2580,53448,7470,3876,1506,4661,6754
AAGTAGAGGTTCAGAA,sample,49054,48633,3569,45064,5879,39185,21742,1480,9850,1018,31592,5095,3086,1307,2786,4341
GACTAACCGTTCAGAA,sample,54040,53691,1308,52383,6693,45690,36211,3275,4503,370,40714,1331,2133,2110,4869,5245
CGTAGAACGTTCAGAA,sample,63459,63040,3460,59580,7526,52054,30433,2028,11945,1064,42378,6584,4025,1676,4191,5304
CCTAACTAGTTCAGAA,Pos_Ctrl,19952,19624,1290,18334,775,17559,14444,1332,1222,150,15666,411,3361,3232,674,326
AACCGGTTTTCTGGTT,sample,52899,52682,2338,50344,13363,36981,20874,1837,8439,1006,29313,4825,3705,1561,4191,8572
TCTAGGTTTTCTGGTT,sample,75646,75197,2370,72827,11777,61050,38056,2364,14802,1903,52858,3925,2590,1608,6985,8192
GTCGTTCTTTCTGGTT,Neg_Ctrl,777,574,110,464,70,394,231,18,84,8,315,53,153,92,32,45
GAGCCTCCTTCTGGTT,sample,89575,88998,3985,85013,15125,69888,43012,3321,14868,1586,57880,7101,3684,1762,7304,10560
CTAGCGACTTCTGGTT,Neg_Ctrl,679,528,85,443,59,384,264,18,71,15,335,16,173,113,29,37
TCATCGAATTCTGGTT,sample,48247,47964,2040,45924,7911,38013,26926,2234,6232,699,33158,1922,3331,2693,2441,5724
GCAACTAGTTCTGGTT,Neg_Ctrl,366,209,65,144,17,127,71,8,25,4,96,19,74,44,6,10
TCTCAGGATTCTGGTT,sample,114339,113617,2886,110731,17113,93618,74682,4778,10179,934,84861,3045,2509,2117,8724,13115
GGCAGGTTTTCTGGTT,sample,128566,127485,14110,113375,14276,99099,39842,2446,29624,3299,69466,23888,8890,1729,8816,9672
ATGGCGTTTTCTGGTT,sample,61731,61228,3882,57346,7336,50010,30314,2751,9517,1413,39831,6015,3024,1035,3870,4825
GAGATTCTTTCTGGTT,sample,81910,81410,3457,77953,9376,68577,43389,3083,15571,1815,58960,4719,2953,1642,6629,7022
AAGGTCTGTTCTGGTT,sample,29317,29051,2820,26231,3710,22521,12272,958,5217,678,17489,3396,2577,1082,2375,2411
GGCGACGATTCTGGTT,sample,87526,87021,2740,84281,12201,72080,55096,5586,7099,873,62195,3426,2821,2114,6868,8656
CAGCTTCGTTCTGGTT,sample,76854,76364,3784,72580,9703,62877,39240,2903,12393,1397,51633,6944,3431,1177,6184,6595
TCTCCTAGTTCTGGTT,sample,102386,101655,5379,96276,14084,82192,51950,3430,15672,1775,67622,9365,4730,1738,7146,10134
ATGAATAGTTCTGGTT,sample,79628,78994,5741,73253,10420,62833,34739,3648,13567,1495,48306,9384,4395,1457,5113,7118
TAACGCCATTCTGGTT,sample,116013,115236,4322,110914,14966,95948,62681,4880,18145,2658,80826,7584,3435,1707,8556,11532
ATTCTACCTTCTGGTT,sample,109576,108915,5750,103165,14657,88508,52123,4406,18955,1933,71078,11091,4441,1608,9414,10497
GACTAACCTTCTGGTT,sample,85204,84784,2236,82548,13921,68627,54352,3728,6828,1106,61180,2613,2288,1845,5426,10527
CGCGAGACTTCTGGTT,sample,89970,89284,4526,84758,12205,72553,43323,3442,15459,2218,58782,8111,3906,1469,5680,8844
AGATACTATTCTGGTT,sample,72140,71568,5426,66142,9597,56545,27613,2516,14782,1648,42395,9986,4893,1583,3249,6627
AACCGGTTGTTCGGTT,sample,78926,78451,5195,73256,11480,61776,30580,1722,18446,1652,49026,9376,4968,1793,5591,7956
TCTAGGTTGTTCGGTT,sample,104766,104012,4840,99172,14885,84287,42337,2915,25947,3390,68284,9698,4329,1793,5868,10923
AGCTGAATGTTCGGTT,sample,107967,107190,2807,104383,16033,88350,69829,5096,10500,656,80329,2269,2534,2343,7630,12324
CATAATGGGTTCGGTT,sample,76135,75557,4233,71324,10945,60379,34161,2666,14945,1805,49106,6802,4181,2157,5073,7734
TATACGGAGTTCGGTT,sample,110252,109747,2497,107250,25520,81730,58409,4668,13444,1680,71853,3529,2558,1689,12344,17923
GAGCCTCCGTTCGGTT,sample,21300,21109,2585,18524,2564,15960,6339,455,5099,546,11438,3521,2961,1021,1133,1718
CTAGCGACGTTCGGTT,sample,73991,73519,2727,70792,15467,55325,41111,2901,7464,677,48575,3172,2547,1417,9208,10677
TCGAACGAGTTCGGTT,sample,34826,34610,2180,32430,5929,26501,15949,1248,5775,454,21724,3075,2403,1096,3144,4165
TCATACCAGTTCGGTT,sample,82045,81458,4173,77285,15033,62252,37529,2437,13310,1506,50839,7470,3935,1586,9106,10769
TACGCGAGGTTCGGTT,sample,75054,74501,4148,70353,12912,57441,37752,3147,10565,1475,48317,4502,3026,1407,8677,9977
ATACGTTCGTTCGGTT,sample,76989,76413,4205,72208,11587,60621,37185,2711,12610,1886,49795,6229,3847,1590,7929,8232
CCGCAGTCGTTCGGTT,sample,109230,108558,3325,105233,15907,89326,64042,4091,15297,1457,79339,4439,2864,1869,10505,11933
ATGGCGTTGTTCGGTT,sample,132114,131167,8833,122334,14722,107612,52800,4200,28234,3524,81034,18854,6857,1709,7832,10104
AGCGTCTTGTTCGGTT,sample,84892,84299,3798,80501,16879,63622,40735,3265,12117,1566,52852,5939,3261,1509,7746,12317
CGGTTGGTGTTCGGTT,sample,67074,66551,4866,61685,8953,52732,29352,1947,12852,1333,42204,7248,4170,1264,8264,6185
ACGCTTAAGTTCGGTT,sample,115081,114214,7063,107151,13732,93419,49027,3921,24566,2941,73593,12964,5368,1806,8720,9995
CCTAGCGGGTTCGGTT,sample,71419,70948,3183,67765,8820,58945,31509,2079,17554,2051,49063,5752,2819,1433,5333,6283
GGCGACGAGTTCGGTT,sample,85300,84749,3024,81725,11837,69888,52348,3283,9086,839,61434,4332,2973,1707,6752,9043
CAGCTTCGGTTCGGTT,sample,75728,75284,2204,73080,13059,60021,45515,3640,7692,709,53207,2465,2157,1426,7284,10011
CGCGGTCGGTTCGGTT,sample,64823,64415,2558,61857,9523,52334,32582,2143,11451,1512,44033,4646,2566,1219,4756,6798
TCTCCTAGGTTCGGTT,sample,98767,98104,6157,91947,14446,77501,42831,3691,18817,2134,61648,10028,5233,1722,5459,9850
AAGTAGAGGTTCGGTT,sample,74036,73551,4066,69485,11680,57805,36097,2778,11411,1183,47508,6336,3704,1308,6822,7797
TCAATCAGGTTCGGTT,sample,77737,77201,3802,73399,9895,63504,37301,2654,14299,2203,51600,7047,3588,1445,4949,7023
ATTCTACCGTTCGGTT,sample,78195,77775,2352,75423,21318,54105,39429,3441,7716,837,47145,2682,2251,1417,4722,14375
GCGCAATAGTTCGGTT,Neg_Ctrl,752,635,86,549,88,461,290,33,74,18,364,46,185,128,40,52
TTAACTGAGTTCGGTT,sample,93376,92856,3760,89096,14085,75011,45334,3324,16993,2852,62327,6508,3122,1301,6746,10569
AGAGTTCTTGGCGGTT,sample,123636,122874,3384,119490,20761,98729,70407,5240,17005,1833,87412,4244,2902,2407,8986,15559
GACGTATGTGGCGGTT,sample,84879,84270,3091,81179,18484,62695,47269,4012,6891,894,54160,3629,3200,2526,7238,12808
GGAGAAGCTGGCGGTT,sample,104458,103713,4319,99394,16105,83289,59928,3190,12405,1467,72333,6299,3948,1964,7711,11585
GAGCCTCCTGGCGGTT,sample,104871,104211,5179,99032,18792,80240,49936,4005,15524,1695,65460,9080,5319,2371,8703,13247
GGTAGAGATGGCGGTT,sample,27262,27056,1905,25151,3827,21324,10497,628,6645,774,17142,2780,2751,1123,2246,2697
ATTCAAGGTGGCGGTT,sample,143402,142657,4899,137758,20728,117030,83582,6897,15992,2296,99574,8263,4709,2804,10834,14652
GCAACTAGTGGCGGTT,sample,22976,22782,836,21946,4960,16986,12227,1067,2591,336,14818,765,1926,1678,2369,3551
TGGATCAATGGCGGTT,sample,49852,49488,2869,46619,8402,38217,22410,2390,8477,931,30887,4009,3236,1323,3614,5778
GATGCGTTTGGCGGTT,sample,146904,145842,9420,136422,17059,119363,61199,4550,29234,3303,90433,21077,7249,2072,9339,12067
CGGTTGGTTGGCGGTT,sample,93363,92627,7385,85242,11953,73289,34950,2846,20360,2263,55310,12870,6194,1571,7369,7556
CTAAGCATTGGCGGTT,sample,110315,109508,6003,103505,27198,76307,43473,3244,17198,1717,60671,10675,5155,1735,8884,18084
AAGGTCTGTGGCGGTT,sample,90898,90187,5634,84553,11831,72722,35290,2204,21850,2665,57140,10713,5200,1734,7463,8101
GCTGCTTCTGGCGGTT,sample,124846,124050,4932,119118,20492,98626,65950,4342,17120,2091,83070,9123,3574,1633,11149,15050
GCGTTACCTGGCGGTT,sample,104066,103464,2772,100692,16392,84300,65745,5984,7908,1142,73653,3521,2250,1548,7548,12687
GTCGCGAATGGCGGTT,sample,100006,99246,6305,92941,13672,79269,39867,3428,20102,2416,59969,13456,5817,1517,6656,9567
CAGCTTCGTGGCGGTT,sample,113515,112675,5325,107350,17132,90218,54894,5206,17951,1901,72845,10266,5116,1949,7089,11953
CGCGGTCGTGGCGGTT,sample,56647,56345,2236,54109,8648,45461,31618,2425,7334,883,38952,3201,2617,1547,4365,6182
CGCGAGACTGGCGGTT,sample,118057,117393,3847,113546,16114,97432,63924,5675,17012,1778,80936,9043,4128,1596,9349,11604
TCTAGGTTTCCTTATT,sample,33082,32898,1275,31623,6555,25068,18083,1325,3676,453,21759,1531,2300,1752,3036,4637
AGAGTTCTTCCTTATT,sample,62551,62210,2390,59820,12520,47300,33084,2587,7016,753,40100,3860,2749,1554,6661,8835
AGCTGAATTCCTTATT,sample,62649,62180,2754,59426,10746,48680,31344,2265,9575,1326,40919,4170,3004,1641,5187,7530
GAGCCTCCTCCTTATT,sample,49415,49179,2091,47088,7538,39550,23881,1895,9167,895,33048,3712,2718,1436,3286,5315
CATACTCCTCCTTATT,sample,53011,52692,2713,49979,9096,40883,23931,2104,9696,1113,33627,4039,2758,1404,4407,6234
CTAGCGACTCCTTATT,sample,30585,30389,1970,28419,3231,25188,11321,1265,6818,735,18139,5049,2711,872,1332,2052
TCGAACGATCCTTATT,sample,27460,27328,1345,25983,3564,22419,13684,1391,4572,551,18256,2221,1865,998,1492,2383
GGTAGAGATCCTTATT,sample,43863,43662,879,42783,7738,35045,26886,3318,3272,374,30158,1195,1031,897,3162,5579
TCATACCATCCTTATT,sample,39443,39226,1107,38119,8695,29424,23028,1560,3030,401,26058,1405,1627,1194,6279,6052
ATTCAAGGTCCTTATT,sample,11824,11781,460,11321,2160,9161,6294,460,1807,114,8101,486,1292,908,1267,1522
TGATTCCGTCCTTATT,sample,30538,30358,1627,28731,4113,24618,12413,851,8166,975,20579,2213,2696,1493,1705,2912
TACGCGAGTCCTTATT,sample,49477,49091,4139,44952,7587,37365,18062,1343,10700,1043,28762,6217,3731,1306,3083,5354
GACTCAAGTCCTTATT,sample,60513,60083,1969,58114,9413,48701,37925,2755,5201,586,43126,2234,2634,2112,4564,6993
ATACGTTCTCCTTATT,sample,37971,37685,3415,34270,5462,28808,15292,1121,6961,864,22253,4570,3239,1231,3177,3554
CCGTACGCTCCTTATT,sample,53633,53224,4112,49112,8202,40910,21588,1922,10243,1252,31831,5905,3938,1505,4040,5649
TCTCAGGATCCTTATT,sample,49156,48843,2981,45862,8486,37376,22833,1739,7695,685,30528,4424,3046,1284,5525,6028
TGGATCAATCCTTATT,sample,100221,99539,7104,92435,11165,81270,43985,4366,17504,2058,61489,13357,5654,1608,6647,7403
ATGGCGTTTCCTTATT,sample,49535,49278,1414,47864,9164,38700,29461,2646,5047,449,34508,1097,2110,1723,5121,6911
CCATTCTTTCCTTATT,sample,82886,82229,5768,76461,8184,68277,39769,2304,16953,1931,56722,7320,3687,1605,4128,5660
TAGCGAGTTCCTTATT,sample,75632,75067,4877,70190,8578,61612,37281,2858,11881,1671,49162,7921,3702,1441,5635,5686
GCTCTTCTTCCTTATT,sample,80165,79670,3006,76664,9391,67273,52220,4978,5890,855,58110,3330,3101,2425,5030,7252
CTAAGCATTCCTTATT,sample,86741,86019,6940,79079,7228,71851,32476,2293,23964,2267,56440,10851,5068,1656,4583,4605
AAGGTCTGTCCTTATT,sample,12924,12811,1077,11734,1627,10107,5694,350,2463,249,8157,1351,1568,797,1085,1110
CCTAGCGGTCCTTATT,sample,41199,40871,5506,35365,3318,32047,11099,830,10629,1097,21728,8392,4931,1151,1941,2147
TAACGAAGTCCTTATT,sample,46597,46331,3105,43226,7745,35481,22709,1673,6461,692,29170,3946,3066,1514,3775,5343
GCGTTACCTCCTTATT,sample,69881,69460,4123,65337,5371,59966,31354,1955,17259,2078,48613,7320,3871,1418,2266,3639
CGTCGAGGTCCTTATT,Pos_Ctrl,13313,13174,1199,11975,724,11251,9284,928,707,80,9991,252,2698,2368,504,351
CGCGGTCGTCCTTATT,sample,41985,41767,1568,40199,6336,33863,24513,1776,4648,494,29161,2432,2104,1134,4130,4717
TTATGACGTCCTTATT,sample,62220,61850,3040,58810,7963,50847,30891,2921,10372,1183,41263,5480,2885,1319,3688,5877
ATTCTACCTCCTTATT,sample,60379,60037,3125,56912,8795,48117,28247,2938,10223,962,38470,5747,3236,1186,4994,5870
CGCGAGACTCCTTATT,sample,55784,55495,1268,54227,10829,43398,35524,2894,3395,413,38919,1172,1202,1101,4638,7733
AACCGGTTAATAAGGT,sample,115340,114569,4181,110388,20649,89739,55608,4029,20520,2488,76128,7094,3517,2161,10073,15138
GTCGTTCTAATAAGGT,sample,49992,49602,4313,45289,13209,32080,14542,984,9342,911,23884,6301,4023,1485,2886,7959
TGATTCCGAATAAGGT,sample,151019,149904,13179,136725,12152,124573,42219,3741,42827,4388,85046,31398,9314,1969,4239,7250
GCAACTAGAATAAGGT,sample,21347,21155,1270,19885,2830,17055,8675,660,4709,665,13384,2346,2269,906,1209,1963
ATACGTTCAATAAGGT,sample,136163,135275,7324,127951,13836,114115,66288,6979,22940,2581,89228,15327,5461,1550,7529,8946
CCGCAGTCAATAAGGT,sample,132196,131156,7306,123850,13096,110754,72240,6267,17831,1735,90071,12681,5115,1874,7292,8683
TGGATCAAAATAAGGT,sample,152121,151197,5405,145792,23449,122343,90033,5403,15889,1808,105922,9210,4145,2055,16435,16308
GGCAGGTTAATAAGGT,sample,131790,130869,6078,124791,15566,109225,62365,3440,27217,3593,89582,12610,4689,1803,8943,11315
ATGGCGTTAATAAGGT,Pos_Ctrl,26104,25780,2091,23689,1266,22423,18609,1714,1406,209,20015,485,3955,3651,1292,686
CCATTCTTAATAAGGT,sample,95361,94633,7096,87537,11763,75774,39949,2480,19900,2022,59849,11423,5645,1756,6571,8463
AGCGTCTTAATAAGGT,sample,115696,114978,6029,108949,17098,91851,56922,4257,18522,2187,75444,9963,5168,2351,7538,11453
TAGCGAGTAATAAGGT,sample,162063,161078,5638,155440,20852,134588,89464,7466,23071,2653,112535,11934,4076,1988,11417,15450
GAGATTCTAATAAGGT,sample,131406,130568,5101,125467,20863,104604,64189,5862,22266,2695,86455,9592,3714,1558,13374,15732
CCTAGCGGAATAAGGT,Pos_Ctrl,16731,16556,1105,15451,686,14765,12113,1273,934,142,13047,303,3029,2827,594,324
GGCGACGAAATAAGGT,sample,108822,108064,5549,102515,17632,84883,54213,4088,15652,1904,69865,9026,5082,1735,9660,12240
TAACGAAGAATAAGGT,sample,122338,121571,3480,118091,19889,98202,73710,5283,13262,1139,86972,4808,2895,1570,14083,15083
GCCTATTCAATAAGGT,sample,111226,110487,5108,105379,19561,85818,53383,4799,15965,1893,69348,9778,4148,1426,8929,13482
GCGTTACCAATAAGGT,sample,145620,144648,6776,137872,20129,117743,78485,5978,19159,1989,97644,12132,4981,1974,6978,14140
CAGCTTCGAATAAGGT,sample,66472,65974,3894,62080,9681,52399,30727,2224,11169,1130,41896,7149,4018,1320,4326,6953
TCTCCTAGAATAAGGT,sample,133681,133002,3534,129468,19693,109775,83375,7398,12250,2135,95625,4617,2772,1642,8999,14622
ATGAATAGAATAAGGT,sample,143755,142752,8471,134281,19094,115187,61476,4757,29847,3108,91323,15999,5692,1850,6559,13430
AAGTAGAGAATAAGGT,sample,185240,183954,14476,169478,16400,153078,50692,3886,55079,6029,105771,37392,10704,2222,6382,10684
ATTCTACCAATAAGGT,sample,128604,127658,6379,121279,20064,101215,59560,5056,20708,2760,80268,13131,5242,1556,8729,13431
AGATACTAAATAAGGT,sample,135312,134562,7471,127091,15344,111747,61969,3481,28322,2561,90291,15414,5240,1569,8949,10504
GCGCAATAAATAAGGT,sample,126512,125769,5151,120618,20673,99945,70319,6100,14165,1848,84484,7513,3651,1442,10999,14831
ATATGCAAAATAAGGT,sample,434,433,37,396,62,334,191,9,66,6,257,62,135,88,23,45
TCTAGGTTCAGGACCA,sample,108127,107282,7041,100241,20451,79790,48264,2799,16441,1833,64705,10453,5103,1772,11070,13652
CTGGTCTTCAGGACCA,sample,60516,60004,5507,54497,9785,44712,21434,1409,12352,1290,33786,8227,4281,1266,5035,6353
GTCGTTCTCAGGACCA,sample,68663,68204,3988,64216,13858,50358,30257,2261,11018,1563,41275,5259,3475,1571,5761,9814
CATAATGGCAGGACCA,sample,51722,51395,2149,49246,10722,38524,26867,1891,6564,638,33431,2564,2703,1585,6111,7188
TATACGGACAGGACCA,sample,125509,124626,7974,116652,19906,96746,54728,3312,23213,2767,77941,12726,5620,2099,10654,14163
GAGCCTCCCAGGACCA,sample,54992,54465,4670,49795,8121,41674,20263,1641,11172,1257,31435,7341,4471,1419,3969,5613
CTAGCGACCAGGACCA,sample,86989,86345,4359,81986,18779,63207,40635,3136,12134,1114,52769,6188,3802,1916,6140,12717
ATTCAAGGCAGGACCA,sample,131739,131152,4813,126339,24639,101700,69341,5292,16462,1682,85803,8923,4448,1905,13214,17502
GCAACTAGCAGGACCA,sample,34405,34211,1604,32607,6630,25977,15964,1310,5516,679,21480,2508,2463,1293,3280,4499
GACTCAAGCAGGACCA,sample,89224,88638,4072,84566,18089,66477,45258,3708,11460,1493,56718,4558,3761,2041,8716,12663
CCGCAGTCCAGGACCA,sample,69046,68620,3439,65181,8636,56545,34728,3418,10715,1098,45443,6586,3401,1098,3549,6089
TCTCAGGACAGGACCA,sample,89539,88981,3390,85591,16878,68713,45908,3371,13019,1539,58927,4876,3029,1749,10030,12107
TGGATCAACAGGACCA,sample,104428,103705,4487,99218,13353,85865,50133,3513,21446,2797,71579,7976,3897,1979,8071,9505
AGCGTCTTCAGGACCA,sample,101676,100969,3686,97283,19573,77710,52059,4646,13663,1904,65722,5438,3138,1446,9050,14617
CGGTTGGTCAGGACCA,sample,110344,109532,5785,103747,13447,90300,52095,3473,22244,2239,74339,10249,4147,1688,8759,9806
ACGCTTAACAGGACCA,sample,150704,149673,10716,138957,20258,118699,61601,4642,32173,3776,93774,16507,7269,2180,9464,13567
GAGATTCTCAGGACCA,sample,110486,109769,4964,104805,18662,86143,53538,5415,16498,1949,70036,8743,3522,1556,10620,13059
CTAAGCATCAGGACCA,sample,91774,91203,4093,87110,11082,76028,51529,3780,12778,1260,64307,6681,4296,2252,6826,8112
AAGGTCTGCAGGACCA,sample,126830,125943,5355,120588,14387,106201,73422,4501,16944,2257,90366,9077,4137,2126,7542,10513
CCTAGCGGCAGGACCA,sample,72207,71695,6003,65692,7348,58344,25548,1504,16559,1790,42107,12943,5883,1554,3878,4615
GGCGACGACAGGACCA,sample,116020,114954,11560,103394,8229,95165,35257,2517,34826,3643,70083,18922,8034,2054,3854,4720
GGCGTACCCAGGACCA,sample,95008,94292,6897,87395,11003,76392,39093,3629,18049,2377,57142,13244,5987,1409,6400,7730
CGTCGAGGCAGGACCA,sample,69704,69246,2629,66617,10388,56229,38405,3727,9381,825,47786,3891,2729,1269,7042,7647
CAGCTTCGCAGGACCA,Neg_Ctrl,773,656,111,545,95,450,249,16,108,19,357,58,191,105,28,61
CGCGGTCGCAGGACCA,sample,86266,85375,13036,72339,6189,66150,14947,958,26107,2674,41054,21464,8964,1453,2202,3307
CGTAGAACCAGGACCA,sample,114144,113433,6374,107059,15834,91225,52097,3786,19652,2538,71749,13152,5990,1672,6142,11348
AGATACTACAGGACCA,sample,145762,144920,5100,139820,16963,122857,66241,6297,38184,4191,104425,7944,3693,1828,8245,13514
CCTAACTACAGGACCA,sample,119302,118577,3571,115006,19512,95494,66169,5084,16550,3216,82719,4475,2844,1678,6875,13617
GCGCAATACAGGACCA,sample,108126,107534,4701,102833,18648,84185,56808,3945,14649,1519,71457,7264,3640,1337,9597,12728
AACCGGTTCCTCGTTG,sample,95186,94662,4597,90065,12719,77346,42097,2454,22531,2652,64628,7612,3762,1871,7193,9072
GGAGAAGCCCTCGTTG,sample,77886,77300,5382,71918,8068,63850,32888,2366,16568,2425,49456,9603,3871,1062,3383,5420
GAGCCTCCCCTCGTTG,sample,73611,73123,4983,68140,7911,60229,38359,3993,10881,939,49240,6057,3416,1079,3479,5462
TCGAACGACCTCGTTG,sample,57497,57168,1715,55453,15929,39524,30875,2351,3732,662,34607,1904,2065,1659,5744,10043
GGTAGAGACCTCGTTG,sample,110447,109687,5123,104564,16406,88158,56939,3856,16937,1794,73876,8632,5082,2170,9726,12077
TGATTCCGCCTCGTTG,sample,95468,94870,4493,90377,11718,78659,50386,3112,16797,1970,67183,6394,3861,2033,7398,8951
TACGCGAGCCTCGTTG,sample,90408,89749,4700,85049,12059,72990,43460,3699,16238,2055,59698,7538,3725,1515,6089,8963
GATGCGTTCCTCGTTG,sample,108421,107492,8534,98958,10296,88662,36231,2499,32824,3697,69055,13411,5567,1465,6248,6667
TGCGCGTTCCTCGTTG,Neg_Ctrl,567,336,107,229,17,212,160,4,35,3,195,10,95,57,22,12
CATTCGGTCCTCGTTG,sample,104111,103490,4505,98985,18712,80273,58188,6194,10646,1004,68834,4241,1962,1314,10898,13477
GCTCTTCTCCTCGTTG,sample,114856,113994,7008,106986,16736,90250,49243,3620,23505,1907,72748,11975,4815,1681,8143,11876
CCTAGCGGCCTCGTTG,sample,46749,46406,2970,43436,6255,37181,23986,2308,6650,706,30636,3531,2666,1234,4845,4744
CTAACCGGCCTCGTTG,Neg_Ctrl,626,435,101,334,67,267,156,15,69,4,225,23,124,65,8,26
ATACCGCCCCTCGTTG,sample,109737,108898,9210,99688,10088,89600,39907,3414,26287,3135,66194,16857,6996,1703,4359,6531
AAGTAGAGCCTCGTTG,sample,95998,95433,3478,91955,17914,74041,51921,3482,11084,1569,63005,5985,2501,1302,8167,13275
TCAATCAGCCTCGTTG,sample,38145,37868,3444,34424,5053,29371,15472,1456,6710,686,22182,5047,3099,1151,2289,3462
ATTCTACCCCTCGTTG,Pos_Ctrl,15782,15608,1328,14280,681,13599,11292,901,948,116,12240,342,3035,2675,508,331
GACTAACCCCTCGTTG,sample,78329,77803,4457,73346,9849,63497,35042,2469,15577,2011,50619,8398,3690,1249,4878,6959
GCGCAATACCTCGTTG,sample,107169,106481,5002,101479,16523,84956,55280,4424,15247,1541,70527,8464,3881,1460,6152,12369
ATATGCAACCTCGTTG,sample,2491,2462,85,2377,636,1741,1216,124,236,25,1452,140,496,383,115,431
AACCGGTTTTGCGGAC,sample,52811,52568,2909,49659,9944,39715,23504,1714,9345,1132,32849,4020,3606,2080,3414,6926
TCTAGGTTTTGCGGAC,sample,79150,78715,3544,75171,9992,65179,40276,2499,14671,2082,54947,5651,3861,2410,4401,7313
AGAGTTCTTTGCGGAC,sample,95202,94614,5185,89429,15874,73555,40945,2292,18790,1809,59735,9719,5008,1830,9716,10886
CTAGCGACTTGCGGAC,sample,92933,92430,2705,89725,18001,71724,55090,4030,9127,803,64217,2674,2297,1945,8497,12745
TCGAACGATTGCGGAC,sample,84941,84459,4151,80308,12209,68099,40093,2355,17123,2048,57216,6480,3462,1571,7183,9002
CGTCGCCATTGCGGAC,sample,83724,83330,1785,81545,18192,63353,51223,4271,5408,873,56631,1578,2090,2012,9591,13291
TCATCGAATTGCGGAC,sample,98984,98400,3678,94722,18381,76341,53030,4543,11199,1406,64229,6163,3264,1674,8891,13184
TGATTCCGTTGCGGAC,sample,62934,62569,3975,58594,6749,51845,27043,1888,15691,1528,42734,5695,3824,1936,2881,4749
GCAACTAGTTGCGGAC,sample,37566,37358,2237,35121,3036,32085,12779,998,12623,1690,25402,3995,3491,1607,1376,2027
TACGCGAGTTGCGGAC,sample,85382,84880,1943,82937,16567,66370,53002,4488,6807,755,59809,1318,2021,1773,9221,12397
GACTCAAGTTGCGGAC,sample,77785,77235,6934,70301,10424,59877,28442,1866,16406,1800,44848,11363,5896,1494,5934,6885
CCGTACGCTTGCGGAC,sample,89375,88646,6042,82604,8090,74514,37641,2354,23090,2723,60731,8706,4524,1997,3548,5446
TGGATCAATTGCGGAC,sample,92060,91465,3599,87866,14593,73273,46076,3870,15259,1535,61335,6533,3685,1874,6154,11203
ATGGCGTTTTGCGGAC,sample,70064,69550,2956,66594,8875,57719,34689,2637,13534,1662,48223,5197,3435,1742,5359,6354
AGCGTCTTTTGCGGAC,sample,75080,74643,3616,71027,9544,61483,39795,2849,12257,1447,52052,5135,3448,1948,4971,6861
ACGCTTAATTGCGGAC,sample,61195,60818,3790,57028,8804,48224,30195,2186,9038,1011,39233,5794,3389,1463,3983,6365
AAGGTCTGTTGCGGAC,sample,104419,103727,4356,99371,14738,84633,58745,6308,12030,1294,70775,6256,3681,1910,7211,10756
CCTAGCGGTTGCGGAC,sample,29572,29353,2089,27264,3808,23456,12374,1017,6160,679,18534,3226,2520,1030,2162,2603
GCCTATTCTTGCGGAC,sample,51633,51196,4627,46569,5606,40963,17771,1308,11630,1344,29401,8910,4518,1276,2215,3555
GTCGCGAATTGCGGAC,sample,96128,95438,7379,88059,9146,78913,37656,2799,23034,2440,60690,12984,5968,1496,3911,6028
CGTCGAGGTTGCGGAC,sample,62905,62450,4167,58283,8158,50125,28532,2452,10814,1112,39346,7215,3569,1136,3661,5448
CAGCTTCGTTGCGGAC,sample,80868,80335,3054,77281,8796,68485,43419,3526,14082,2242,57501,5216,3059,1345,5020,6814
TCTCCTAGTTGCGGAC,sample,209455,207799,14617,193182,10219,182963,76281,4926,74340,8553,150621,18863,6418,2372,5331,5635
TCAATCAGTTGCGGAC,sample,91142,90502,5956,84546,11111,73435,36911,2322,18392,2119,55303,13691,5916,1494,5632,7813
GACTAACCTTGCGGAC,sample,74133,73704,3364,70340,12613,57727,36545,3358,11242,1059,47787,5523,3178,1276,5998,8716
CGCGAGACTTGCGGAC,sample,82395,81859,4176,77683,11831,65852,40253,2597,14088,1607,54341,7307,3554,1313,5684,8587
CGTAGAACTTGCGGAC,sample,80647,80165,3006,77159,15480,61679,44761,3583,8203,913,52964,4219,2210,1252,8476,11250
CCTAACTATTGCGGAC,sample,110294,109601,5578,104023,11500,92523,50117,3492,24195,3152,74312,11567,4931,1759,5575,7975
GCGCAATATTGCGGAC,sample,86818,86382,2646,83736,15773,67963,50089,5742,8016,889,58105,3227,2628,1316,6418,12049
AACCGGTTTCCATTGG,sample,46199,45890,2356,43534,10441,33093,22198,1314,5680,813,27878,3088,2477,1421,4555,7151
TCTAGGTTTCCATTGG,sample,73055,72616,3242,69374,12328,57046,40325,2921,7540,837,47865,5423,3635,2274,4616,8864
CTGGTCTTTCCATTGG,sample,67987,67608,2746,64862,13862,51000,37241,2557,7514,756,44755,2932,2289,1425,8060,9582
GTCGTTCTTCCATTGG,sample,64188,63778,3220,60558,13935,46623,31577,1681,8817,814,40394,3734,2411,1316,6462,9366
AGAGTTCTTCCATTGG,sample,80644,80218,3499,76719,16588,60131,38207,2777,11438,1401,49645,6308,3487,1468,8675,11412
CATAATGGTCCATTGG,sample,41274,40987,2319,38668,6826,31842,17507,1162,8856,711,26363,3606,2670,1195,3239,4744
GGAGAAGCTCCATTGG,sample,37013,36730,3298,33432,6578,26854,11800,804,8024,877,19824,5349,3543,1148,2428,4457
TCATACCATCCATTGG,sample,19072,18822,3589,15233,1700,13533,3179,241,5414,597,8593,4102,2980,684,458,875
ATTCAAGGTCCATTGG,sample,57087,56590,4618,51972,9772,42200,22367,1852,9800,1068,32167,7113,4104,1573,3924,6224
TGATTCCGTCCATTGG,sample,71545,71065,3865,67200,9500,57700,33783,2496,12903,1412,46686,7106,3810,1542,5247,6635
GCAACTAGTCCATTGG,sample,21324,21192,953,20239,3275,16964,11761,870,2655,348,14416,1330,2277,1645,1163,2356
TACGCGAGTCCATTGG,sample,33853,33664,1360,32304,7059,25245,18377,1519,3327,421,21704,1601,1987,1401,3554,5202
GACTCAAGTCCATTGG,sample,78888,78319,6916,71403,9139,62264,25746,2033,18760,2049,44506,13676,6301,1444,4759,6288
TGCGCGTTTCCATTGG,sample,68999,68623,1738,66885,10053,56832,45176,4405,4798,446,49974,2007,1255,1055,5220,7291
TAGCGAGTTCCATTGG,sample,78196,77818,2825,74993,12276,62717,40607,3594,11084,1470,51691,5962,3166,1511,6398,8792
GCTCTTCTTCCATTGG,sample,57340,57039,3071,53968,9131,44837,24834,2332,10137,1180,34971,6354,3696,1250,4939,6169
AAGGTCTGTCCATTGG,sample,96088,95519,5986,89533,12899,76634,39447,3325,18840,2013,58287,13009,6129,1836,4906,8904
GCTGCTTCTCCATTGG,sample,69864,69501,2524,66977,9294,57683,39571,3140,9139,1074,48710,4759,3261,1456,4587,6812
ATACCGCCTCCATTGG,sample,66529,66043,3654,62389,9095,53294,30689,2668,11577,1428,42266,6932,4263,1328,4535,6299
GCGTTACCTCCATTGG,sample,53999,53704,1895,51809,9160,42649,29416,2946,6045,910,35461,3332,2344,1237,3384,6857
GGCGTACCTCCATTGG,sample,54519,54261,2304,51957,8120,43837,27541,2510,7668,768,35209,5350,3153,1431,3416,5729
AAGTAGAGTCCATTGG,sample,70500,70105,2163,67942,11352,56590,39788,3425,9336,731,49124,3310,2609,1472,5991,8584
TCAATCAGTCCATTGG,sample,57153,56906,2441,54465,9476,44989,28726,2528,8509,882,37235,4344,3388,1585,4054,6590
TAACGCCATCCATTGG,sample,52099,51805,2701,49104,8798,40306,26019,2058,7496,824,33515,3909,3336,1733,3336,6178
GACTAACCTCCATTGG,Neg_Ctrl,742,624,72,552,94,458,265,22,102,12,367,57,196,131,37,58
CGTAGAACTCCATTGG,sample,65477,65096,5404,59692,8461,51231,20400,1727,15730,1593,36130,11781,5654,1258,3469,5696
AGATACTATCCATTGG,sample,52145,51817,3033,48784,5942,42842,20870,1734,13157,1653,34027,5428,3129,1348,2492,3992
CCTAACTATCCATTGG,sample,58434,58145,3324,54821,7838,46983,24245,1827,12453,1494,36698,6964,3386,1155,3896,5238
AACCGGTTCATAGGCG,sample,132375,131665,4008,127657,31738,95919,64376,4724,16678,1809,81054,8332,3675,1759,13129,21898
TCTAGGTTCATAGGCG,sample,33280,32836,8195,24641,3294,21347,3626,246,9058,971,12684,7446,4447,717,544,1699
GACGTATGCATAGGCG,sample,83324,82742,5896,76846,15529,61317,32605,2341,16177,1731,48782,8463,5286,2131,4720,10779
TCGAACGACATAGGCG,sample,89449,88878,4173,84705,18818,65887,42001,2838,13169,1781,55170,6098,3593,1723,7230,12894
GGTAGAGACATAGGCG,sample,75474,75219,1785,73434,17799,55635,40583,3583,7868,748,48451,2853,2345,1492,7947,12161
TCATCGAACATAGGCG,sample,119110,118284,6865,111419,22805,88614,53472,4437,18492,1726,71964,10487,5568,1943,9307,15906
ATTCAAGGCATAGGCG,sample,120135,119295,5687,113608,18001,95607,65927,4881,14873,1512,80800,8414,4245,1801,7592,12964
TACGCGAGCATAGGCG,sample,121843,121203,4281,116922,21207,95715,63847,6380,15823,1689,79670,7976,3444,1747,9478,16424
TCTCAGGACATAGGCG,sample,109379,108753,5534,103219,18806,84413,51108,3870,17925,1591,69033,9919,5244,1779,10407,13455
TGGATCAACATAGGCG,sample,101274,100608,4083,96525,12014,84511,53404,4461,17730,1931,71134,6985,3294,1823,7962,8298
AGCGTCTTCATAGGCG,sample,114441,113538,6087,107451,18779,88672,55267,4409,17586,1818,72853,9592,4632,1608,10157,12804
CATTCGGTCATAGGCG,sample,131477,130383,10763,119620,15231,104389,47750,3749,28516,3560,76266,20814,7996,2071,7611,10031
TAGCGAGTCATAGGCG,sample,112558,111713,4582,107131,15115,92016,65054,4908,13043,1600,78097,7411,4356,2146,8503,10903
GCTCTTCTCATAGGCG,sample,133809,132875,8538,124337,19202,105135,69803,4234,17276,2345,87079,11477,4472,1870,8988,13289
AAGGTCTGCATAGGCG,sample,131826,130993,8076,122917,17877,105040,69416,6804,16789,2151,86205,9880,4613,2010,9073,12667
CGCGGTCGCATAGGCG,sample,74083,73604,4289,69315,6517,62798,31631,2699,17553,1994,49184,8921,4129,1410,5333,3818
ATGAATAGCATAGGCG,sample,74956,74504,2945,71559,11270,60289,40361,3438,11214,1258,51575,4018,3215,1710,6597,8193
TCAATCAGCATAGGCG,sample,93662,93096,3743,89353,16465,72888,48427,4437,11804,1099,60231,7121,4337,1929,7084,11654
CGCGAGACCATAGGCG,sample,101357,100630,5781,94849,11515,83334,39733,2937,26867,3260,66600,10537,4926,1669,4643,7766
CGTAGAACCATAGGCG,sample,94789,94202,3345,90857,15120,75737,48671,3029,15494,2043,64165,6500,2977,1362,7439,10974
GCGCAATACATAGGCG,sample,104734,104237,5115,99122,20206,78916,42912,3931,17798,1931,60710,12344,5984,1668,6551,14346
CTGGTCTTTTGGAGAG,Pos_Ctrl,20953,20668,1495,19173,926,18247,15097,1525,1119,138,16216,368,3339,3194,738,456
AGAGTTCTTTGGAGAG,sample,70190,69696,3882,65814,13879,51935,30775,2033,12049,1544,42824,5534,3504,1463,6520,9202
CATAATGGTTGGAGAG,sample,98791,98144,6210,91934,15044,76890,41281,2939,20993,2206,62274,9471,4587,2008,6179,10357
CATACTCCTTGGAGAG,sample,84458,83869,4605,79264,10224,69040,39233,2805,17232,1844,56465,7926,4084,2130,3953,7718
GGTAGAGATTGGAGAG,sample,90186,89585,3249,86336,15240,71096,47623,3281,13827,1656,61450,4709,3413,2082,5747,10351
ATTCAAGGTTGGAGAG,sample,134898,133970,9381,124589,18044,106545,55696,4250,25214,2624,80910,18761,7212,2092,7592,13382
TGATTCCGTTGGAGAG,Pos_Ctrl,23268,23000,2126,20874,1193,19681,16311,1453,1318,168,17629,431,3829,3418,1226,588
ATACGTTCTTGGAGAG,sample,93235,92688,3574,89114,21927,67187,49757,3696,9082,1122,58839,3530,3298,2307,5723,14962
CCGTACGCTTGGAGAG,sample,97379,96677,6997,89680,13896,75784,41845,3387,16353,2097,58198,12102,6006,1856,5892,9662
TCTCAGGATTGGAGAG,sample,55479,55114,3334,51780,11028,40752,24746,1903,8452,925,33198,4726,3399,1494,4750,7543
ATGGCGTTTTGGAGAG,sample,97519,96818,5707,91111,16432,74679,43813,2689,15677,1527,59490,10973,4734,1295,5151,11134
CCATTCTTTTGGAGAG,sample,142643,141868,4982,136886,22373,114513,75268,6096,22748,3294,98016,7107,3504,1707,9614,16260
AGCGTCTTTTGGAGAG,sample,124211,123346,5101,118245,18339,99906,68754,5078,15573,1829,84327,8672,4095,1630,13045,13177
CGGTTGGTTTGGAGAG,sample,79198,78448,10153,68295,9175,59120,20714,1481,19618,2230,40332,15077,7094,1654,3673,5693
ACGCTTAATTGGAGAG,sample,134564,133778,2992,130786,20307,110479,93659,7535,7355,901,101014,1029,1628,1892,12056,16152
CATTCGGTTTGGAGAG,sample,48419,47996,2754,45242,7228,38014,23922,1918,7985,633,31907,3556,3454,1889,2433,5109
TAGCGAGTTTGGAGAG,sample,101814,101087,8131,92956,14082,78874,49112,3408,17348,2021,66460,6985,3332,1534,7908,12044
AAGGTCTGTTGGAGAG,sample,129396,128574,7656,120918,17054,103864,61868,5022,21259,2766,83127,12949,5314,1802,10281,12868
CTAACCGGTTGGAGAG,sample,84035,83408,3345,80063,11481,68582,44986,3708,11806,1616,56792,6466,2926,1554,5167,8524
GCTGCTTCTTGGAGAG,sample,147504,146374,12125,134249,20648,113601,47873,3685,33720,3103,81593,25220,8578,1755,10101,13348
GCCTATTCTTGGAGAG,sample,23447,23215,2180,21035,2735,18300,8512,505,5515,600,14027,3168,2729,1016,1099,1753
AGCAGAGCTTGGAGAG,sample,159881,158599,15692,142907,14843,128064,42528,3267,46327,5019,88855,30923,9649,2113,5882,9387
TTATGACGTTGGAGAG,sample,76962,76349,5776,70573,11101,59472,29145,2554,15684,1852,44829,10237,5169,1729,4827,7487
TCTCCTAGTTGGAGAG,sample,117910,117176,5559,111617,20331,91286,62429,4756,14610,1324,77039,8167,3924,1581,8448,14852
ATTCTACCTTGGAGAG,sample,99190,98623,3777,94846,15919,78927,47819,4268,18162,1629,65981,7049,3124,1364,7653,11444
CGCGAGACTTGGAGAG,sample,94543,93910,4870,89040,11821,77219,48626,4733,15078,1523,63704,7259,3601,1473,5800,8355
AGATACTATTGGAGAG,sample,116326,115679,4127,111552,13601,97951,67560,4951,16106,1874,83666,7460,3606,1729,4800,10079
TTAACTGATTGGAGAG,sample,94521,93941,3450,90491,13660,76831,57568,3095,9856,1156,67424,5156,3221,1841,7120,9880
ATATGCAATTGGAGAG,sample,106800,106197,4039,102158,17673,84485,52325,5201,16190,1494,68515,9275,4110,1444,7451,11988
TCTAGGTTTTCAAGCC,sample,82382,81837,4502,77335,14934,62401,37246,2997,14081,1696,51327,6381,3729,1472,7934,10445
CTGGTCTTTTCAAGCC,sample,117016,116273,5703,110570,20862,89708,52479,4089,19760,1964,72239,11416,4994,1802,11047,14810
AGAGTTCTTTCAAGCC,sample,126169,125310,8557,116753,20450,96303,46962,3458,27683,3350,74645,14850,5959,1732,10517,14743
GACGTATGTTCAAGCC,sample,72859,72338,3342,68996,13038,55958,34069,2642,12335,1987,46404,4925,3107,1625,5497,9708
TATACGGATTCAAGCC,sample,86974,86461,3837,82624,15251,67373,41700,3385,13294,2050,54994,6944,2966,1330,10401,10988
GGAGAAGCTTCAAGCC,sample,92217,91723,2431,89292,17883,71409,56608,4827,6770,668,63378,2536,2325,1984,7835,12825
CATACTCCTTCAAGCC,sample,93802,93140,5846,87294,13051,74243,44520,3225,15149,1672,59669,9677,5056,1899,6838,8820
CTAGCGACTTCAAGCC,sample,63793,63410,1924,61486,13287,48199,36958,2247,5937,714,42895,2343,2291,1754,5932,9259
TGATTCCGTTCAAGCC,sample,119723,118911,9777,109134,15249,93885,46515,3214,23243,2253,69758,18660,7166,1726,10634,10890
TCTCAGGATTCAAGCC,sample,86180,85693,3108,82585,15204,67381,51217,4036,7763,1093,58980,3272,2638,1631,8455,11731
TGGATCAATTCAAGCC,sample,75367,74826,2698,72128,9450,62678,40816,2783,12607,1450,53423,5022,2593,1391,5523,6781
CCATTCTTTTCAAGCC,sample,106637,105937,5735,100202,15577,84625,52388,3935,17133,1770,69521,9399,4392,1777,7277,10933
CGGTTGGTTTCAAGCC,sample,90192,89566,4035,85531,14749,70782,43233,3729,14031,1629,57264,8160,3855,1464,9868,10588
GCTCTTCTTTCAAGCC,sample,49141,48774,2875,45899,8348,37551,25856,1446,6619,566,32475,3064,3126,2027,2613,6105
CTAAGCATTTCAAGCC,sample,88988,88268,4692,83576,10886,72690,43456,3361,16595,1984,60051,7294,3586,1478,6496,7777
CTAACCGGTTCAAGCC,sample,82159,81489,6812,74677,8006,66671,32227,2472,17474,1770,49701,12728,5530,1445,3774,4960
GCTGCTTCTTCAAGCC,sample,88153,87617,3308,84309,17939,66370,48316,3650,10154,770,58470,3480,2733,1561,7987,12743
AGCAGAGCTTCAAGCC,sample,72160,71565,6444,65121,5781,59340,23451,1190,21577,2645,45028,10477,5482,1599,3007,3726
TGCGCTCCTTCAAGCC,sample,93076,92481,3966,88515,11397,77118,53302,5397,10782,920,64084,6717,3556,1615,5381,8051
ATACCGCCTTCAAGCC,sample,106771,106127,7380,98747,13393,85354,40864,3406,22943,2418,63807,15723,6338,1627,5538,8825
CGTCGAGGTTCAAGCC,Pos_Ctrl,13402,13219,1165,12054,601,11453,9288,952,816,89,10104,308,2763,2390,511,344
TTATGACGTTCAAGCC,sample,92601,91844,6578,85266,9213,76053,37572,2452,21525,1837,59097,12667,5259,1478,4174,6084
TCTCCTAGTTCAAGCC,sample,84589,83858,7147,76711,10186,66525,31889,2516,17752,1806,49641,12562,4954,1337,4680,6772
ATGAATAGTTCAAGCC,sample,112801,111969,7823,104146,12055,92091,44845,3333,26807,3135,71652,13971,5723,1877,5941,8619
TCAATCAGTTCAAGCC,sample,97052,96327,7308,89019,11111,77908,37325,2167,20568,2241,57893,15607,6624,1526,6066,7712
CGCGAGACTTCAAGCC,sample,93207,92745,2538,90207,13466,76741,57478,5600,8397,1070,65875,4196,2751,1590,5942,10421
GTCGTTCTAACTTAAC,Neg_Ctrl,943,799,70,729,114,615,380,26,129,16,509,64,246,134,79,71
GACGTATGAACTTAAC,sample,70052,69550,5987,63563,10309,53254,25156,1786,14430,1479,39586,10403,5730,1957,3563,7050
CATAATGGAACTTAAC,sample,86509,85909,4996,80913,18942,61971,33166,2548,13975,1556,47141,10726,5203,1596,5688,12226
TATACGGAAACTTAAC,sample,108279,107502,8047,99455,13647,85808,43140,2617,23813,2892,66953,13346,5864,2108,6701,9687
TCGAACGAAACTTAAC,sample,76773,76216,2978,73238,10161,63077,39706,3753,11280,1133,50986,7205,3473,1193,4714,7285
TCATACCAAACTTAAC,sample,85226,84724,2878,81846,15290,66556,50346,3888,7677,746,58023,3899,2882,1794,9588,11101
ATTCAAGGAACTTAAC,sample,119288,118368,8253,110115,11546,98569,41976,2765,35437,3943,77413,14448,5953,2027,6052,7865
TACGCGAGAACTTAAC,sample,79303,78803,3859,74944,14444,60500,36425,2695,13770,1549,50195,6061,4052,1841,8471,10157
ATACGTTCAACTTAAC,sample,114533,113874,6017,107857,18513,89344,51209,3679,19421,2028,70630,13007,6107,1832,12879,13142
CCGCAGTCAACTTAAC,sample,97914,97304,6553,90751,14212,76539,43064,2794,19596,2037,62660,9048,4752,1744,7661,10172
TCTCAGGAAACTTAAC,sample,112040,111383,5811,105572,19663,85909,55193,3759,16235,1438,71428,9284,4301,1637,13083,14595
GGCAGGTTAACTTAAC,sample,119244,118312,9566,108746,13073,95673,38823,2772,29215,2872,68038,21991,7762,1649,6326,8247
CGGTTGGTAACTTAAC,sample,100609,100080,4110,95970,17224,78746,53120,4422,14060,1391,67180,5753,3152,1600,10142,12819
AAGGTCTGAACTTAAC,sample,144271,143322,8818,134504,18534,115970,60036,4107,28353,3135,88389,20339,7168,1904,8850,12826
CTAACCGGAACTTAAC,sample,79775,79286,3390,75896,12868,63028,41532,3408,9981,1352,51513,6755,4130,1588,6165,9277
GCCTATTCAACTTAAC,sample,77309,76872,3315,73557,9359,64198,38251,3562,14605,2000,52856,5780,2850,1393,4516,6143
AGCAGAGCAACTTAAC,sample,79919,79395,3632,75763,12404,63359,38361,2848,12662,1686,51023,7802,3923,1254,5588,8420
GTCGCGAAAACTTAAC,sample,88722,88309,2892,85417,14576,70841,52242,4145,9502,1203,61744,3749,2569,1535,7197,10548
CGTCGAGGAACTTAAC,sample,77149,76691,3295,73396,14380,59016,37279,2562,11663,1617,48942,5895,3555,1351,7670,10445
CGCGGTCGAACTTAAC,sample,64538,64215,2465,61750,11950,49800,30325,2981,10077,1092,40402,5325,3071,1185,5245,8117
TTATGACGAACTTAAC,sample,95918,95463,1944,93519,15252,78267,62848,4643,7701,971,70549,2104,1953,1815,7636,11849
ATGAATAGAACTTAAC,sample,107065,106468,6102,100366,15715,84651,41502,4493,22786,2662,64288,13208,6126,1592,6695,10505
TCAATCAGAACTTAAC,sample,69061,68690,3260,65430,11454,53976,30180,2554,13149,1306,43329,6787,3266,1194,5657,8279
ATTCTACCAACTTAAC,sample,88814,88289,3576,84713,6814,77899,43059,3396,22513,2640,65572,6291,3783,1903,3983,4938
GACTAACCAACTTAAC,sample,59168,58792,2362,56430,10700,45730,33200,2871,5838,596,39038,3225,2505,1170,5822,7389
CTGGTCTTATACTTGA,sample,148063,147115,9419,137696,25489,112207,61883,4363,27609,2538,89492,15814,5688,1898,11936,17807
GTCGTTCTATACTTGA,sample,144826,144067,7803,136264,28671,107593,62058,5202,22882,2885,84940,14566,5878,1791,12422,19775
AGAGTTCTATACTTGA,sample,235649,234156,11229,222927,33762,189165,98482,8045,60304,7470,158786,14864,4406,1814,18811,23078
GGAGAAGCATACTTGA,sample,93940,93268,6914,86354,9882,76472,32605,2074,26981,3457,59586,11355,5541,1790,4023,6783
CGTCGCCAATACTTGA,sample,100529,99806,4958,94848,10279,84569,44281,4452,22620,2909,66901,10307,3930,1167,3166,7340
GCAACTAGATACTTGA,sample,30641,30459,1135,29324,5841,23483,18262,1508,2564,186,20826,963,1589,1245,2448,4243
GATGCGTTATACTTGA,sample,183436,182223,15085,167138,17899,149239,63063,4183,50431,5240,113494,26322,7470,1873,8567,11372
ATGGCGTTATACTTGA,sample,133884,132936,9627,123309,10703,112606,51088,3294,39251,4704,90339,14269,5999,2262,4833,7127
GCTCTTCTATACTTGA,sample,78287,77727,6788,70939,13028,57911,28656,2276,14755,1523,43411,10701,4421,1368,3887,8258
GAGATTCTATACTTGA,sample,149103,147978,10408,137570,18996,118574,62546,4527,29099,3529,91645,18873,6640,2003,10420,12948
GCTGCTTCATACTTGA,sample,127733,126788,6864,119924,13147,106777,62672,3675,26241,2694,88913,11495,4547,1784,4988,9471
GTCGCGAAATACTTGA,sample,109531,108971,3013,105958,24996,80962,58423,4857,12481,801,70904,4400,2382,1285,12700,17763
CAGCTTCGATACTTGA,Neg_Ctrl,418,294,52,242,42,200,142,7,33,2,175,16,103,58,12,20
ATATGCAAATACTTGA,sample,1038,1027,111,916,146,770,294,35,231,33,525,177,251,122,32,96
AACCGGTTATCCGCGA,sample,59718,59338,4725,54613,10924,43689,23092,1310,11132,1125,34224,7030,3794,1173,5855,7448
CTGGTCTTATCCGCGA,sample,121792,121074,4270,116804,27007,89797,63673,5086,13946,1700,77619,5392,2478,1516,14954,18507
GTCGTTCTATCCGCGA,sample,124168,123437,6133,117304,25100,92204,54526,4096,20775,2137,75301,10670,4110,1532,13446,17020
AGCTGAATATCCGCGA,sample,95306,94778,4333,90445,28713,61732,43155,2906,9956,1315,53111,4400,3204,1715,9813,17896
GAGCCTCCATCCGCGA,sample,96299,95587,7340,88247,19201,69046,31889,1954,18769,1940,50658,14494,5867,1444,6662,12821
CATACTCCATCCGCGA,sample,99578,98901,5325,93576,20704,72872,46442,3346,13633,1800,60075,7651,4495,2033,6420,13976
TCGAACGAATCCGCGA,sample,108958,108353,3057,105296,22948,82348,60699,5645,10804,1006,71503,4194,2324,1445,12407,15926
GGTAGAGAATCCGCGA,sample,90367,89753,3969,85784,16140,69644,44793,3024,15318,1813,60111,4696,3278,1596,9151,11888
CGTCGCCAATCCGCGA,sample,125096,124426,4414,120012,27078,92934,68522,5297,13393,1717,81915,4005,2291,1560,13178,19107
TCATCGAAATCCGCGA,sample,116101,115238,9021,106217,12843,93374,45611,2684,24584,2782,70195,17713,6763,1735,6502,8702
TCATACCAATCCGCGA,sample,138095,137274,7018,130256,23914,106342,65341,4182,20742,1984,86083,14093,4098,1623,11945,17248
TACGCGAGATCCGCGA,sample,99894,99220,3009,96211,11905,84306,56330,5070,14481,1716,70811,6709,3063,1333,4834,8211
CCGCAGTCATCCGCGA,sample,87739,87079,5223,81856,10423,71433,41414,4174,14236,1516,55650,10093,4147,1145,4199,7364
GATGCGTTATCCGCGA,sample,126012,125241,3845,121396,20741,100655,76865,5886,12224,1506,89089,4174,2454,1387,11726,15470
CATTCGGTATCCGCGA,sample,109194,108435,6555,101880,14657,87223,49202,3977,18859,1941,68061,13244,5967,2034,5463,9332
TGCGCTCCATCCGCGA,sample,79973,79302,6764,72538,10278,62260,27017,2078,17992,1773,45009,13400,6080,1457,3771,6543
GGCGTACCATCCGCGA,sample,106823,106069,7490,98579,13031,85548,47425,3642,18953,2383,66378,13145,5645,1584,9389,8469
CGTCGAGGATCCGCGA,sample,80942,80398,3711,76687,13163,63524,40803,3321,12568,1673,53371,5159,3372,1623,8978,9318
CGCGGTCGATCCGCGA,sample,34984,34727,2623,32104,5781,26323,15291,1111,5733,599,21024,3589,2965,1371,3157,3880
AAGTAGAGATCCGCGA,sample,101150,100291,9070,91221,13152,78069,35257,2065,22801,2275,58058,15671,6566,1755,7377,9071
ATTCTACCATCCGCGA,sample,125503,124493,10244,114249,13449,100800,41639,3138,36746,3888,78385,15389,7354,2294,5645,8547
GACTAACCATCCGCGA,sample,36524,36179,2115,34064,6026,28038,16483,1044,6220,783,22703,3508,2633,1205,4235,4298
AGATACTAATCCGCGA,sample,140630,139759,5708,134051,20913,113138,74255,6828,18559,2359,92814,11137,5659,1696,9972,15499
GCGCAATAATCCGCGA,sample,149493,148654,7751,140903,20739,120164,69821,4300,25782,2610,95603,17651,6585,1727,8113,14539
AACCGGTTAGGACTCA,sample,139360,138719,4649,134070,21320,112750,69044,4870,27045,2715,96089,9076,3686,1994,11916,15412
TCTAGGTTAGGACTCA,sample,101853,101194,6379,94815,10453,84362,41136,2640,25982,3300,67118,11304,5754,2537,4477,7482
AGAGTTCTAGGACTCA,sample,126531,125733,5167,120566,13125,107441,55910,4297,32837,4061,88747,10336,3973,2071,7854,9057
GACGTATGAGGACTCA,sample,94923,94303,4652,89651,14021,75630,44062,3253,16565,1976,60627,9774,4915,2209,5522,9862
GGAGAAGCAGGACTCA,sample,74957,74386,4553,69833,11760,58073,32305,3089,12962,1478,45267,8239,4151,1317,6170,7961
TCGAACGAAGGACTCA,sample,94126,93581,5128,88453,16141,72312,37761,2727,17946,1880,55707,11998,5427,1408,8890,11143
GGTAGAGAAGGACTCA,sample,132589,131751,7202,124549,18128,106421,57714,4617,26313,2631,84027,15146,5771,1968,10188,11887
TGATTCCGAGGACTCA,sample,95514,94940,4725,90215,14477,75738,49551,3807,13211,1334,62762,7835,4171,1816,8815,10860
GCAACTAGAGGACTCA,sample,28752,28543,1431,27112,4381,22731,13882,1084,4649,478,18531,2638,2746,1453,2211,3080
TACGCGAGAGGACTCA,sample,76317,75674,2647,73027,13596,59431,42668,3614,9013,954,51681,3182,2998,1920,7272,9829
ATACGTTCAGGACTCA,sample,90562,89865,4501,85364,10144,75220,51659,3261,11961,1534,63620,6805,2786,1156,6266,7695
CCGCAGTCAGGACTCA,sample,95659,94936,5035,89901,8014,81887,47089,3468,18966,1914,66055,10450,4493,1347,4129,5797
TCTCAGGAAGGACTCA,sample,67147,66695,2939,63756,11759,51997,37179,2727,7459,987,44638,3645,2757,1486,5640,8142
GATGCGTTAGGACTCA,sample,135505,134558,5881,128677,19187,109490,67841,4813,22041,2396,89882,12399,5416,2190,10422,12886
AAGGTCTGAGGACTCA,sample,123602,122815,5178,117637,17303,100334,67778,8112,14313,1517,82091,8614,4452,1644,9558,12371
GCCTATTCAGGACTCA,sample,94446,93786,4729,89057,12910,76147,45575,3851,14908,1843,60483,9970,5005,1528,8281,8992
AGCAGAGCAGGACTCA,sample,119282,118511,4037,114474,15317,99157,62552,4390,22935,1971,85487,7309,2908,1505,6404,11165
TGCGCTCCAGGACTCA,sample,84109,83440,6479,76961,10855,66106,33432,2775,15930,1930,49362,12039,5093,1294,5653,7212
ATACCGCCAGGACTCA,sample,94976,94328,4038,90290,15687,74603,50277,3565,13494,1366,63771,5901,4203,1926,9639,11130
GGCGTACCAGGACTCA,sample,52164,51744,2591,49153,8828,40325,26361,1975,6921,945,33282,4123,3054,1383,4050,6230
CGTCGAGGAGGACTCA,sample,62440,62012,2375,59637,10824,48813,35350,2788,6968,823,42318,2884,3133,2193,7048,7990
ATGAATAGAGGACTCA,sample,119216,118476,5407,113069,14647,98422,58987,4901,20024,1995,79011,12515,4349,1557,9553,10688
CGCGAGACAGGACTCA,sample,74071,73512,4311,69201,9557,59644,33638,2220,13467,1644,47105,8675,4256,1261,6415,6334
AGATACTAAGGACTCA,sample,126724,125816,7000,118816,16069,102747,61024,4229,21508,2538,82532,13448,5322,1638,9985,11302
CCTAACTAAGGACTCA,Pos_Ctrl,6399,6310,450,5860,351,5509,4589,352,376,53,4965,139,1691,1271,378,192
GTCGTTCTTATTGAAC,sample,116645,115964,6384,109580,16890,92690,46851,3759,23921,3350,70772,14809,6414,1918,8376,11623
TATACGGATATTGAAC,sample,137233,136531,5090,131441,30141,101300,71777,5422,14966,1184,86743,7951,4000,1804,13881,20432
GGAGAAGCTATTGAAC,sample,99913,99360,1753,97607,23530,74077,61863,5274,4577,567,66440,1796,1354,1418,11861,15541
GAGCCTCCTATTGAAC,sample,133196,132457,5692,126765,18147,108618,68695,5648,19679,2472,88374,12124,5357,1761,14766,13816
CTAGCGACTATTGAAC,sample,134862,133892,7368,126524,19854,106670,62981,4576,22200,2297,85181,14616,5590,1913,12096,13141
ATTCAAGGTATTGAAC,sample,123236,122484,4231,118253,17046,101207,67486,4554,20045,2119,87531,7003,3601,2060,9160,12620
GACTCAAGTATTGAAC,sample,140069,139053,8768,130285,15751,114534,62503,4628,26981,3172,89484,17250,6681,2113,7807,11499
ATACGTTCTATTGAAC,sample,103147,102429,5317,97112,18724,78388,47555,3956,15668,1856,63223,9353,4860,1659,7997,13443
ATGGCGTTTATTGAAC,sample,126793,126045,7413,118632,17824,100808,57562,3481,22333,2325,79895,15107,5707,1857,13683,12530
TGCGCGTTTATTGAAC,sample,120212,119380,4826,114554,20657,93897,65496,5282,14482,1902,79978,6735,3700,1980,10566,14920
ACGCTTAATATTGAAC,sample,139816,138972,6180,132792,22060,110732,76131,4976,17099,2064,93230,10462,4766,2197,11451,16000
TAGCGAGTTATTGAAC,sample,129623,128773,7486,121287,15430,105857,56824,4105,26169,2933,82993,15826,5934,1922,10422,10744
AAGGTCTGTATTGAAC,sample,147876,146921,7948,138973,16365,122608,75116,4940,23485,2592,98601,16475,5996,1841,9841,11807
GGCGACGATATTGAAC,sample,97894,97247,4582,92665,13376,79289,53258,3937,13389,1506,66647,7199,4107,1521,7386,9879
ATACCGCCTATTGAAC,sample,108030,107394,3332,104062,16382,87680,64802,5039,10923,1385,75725,5531,3265,1689,7455,11898
TTATGACGTATTGAAC,sample,144819,143794,10357,133437,15343,118094,63257,4718,27418,3229,90675,19472,7050,1752,11350,10923
TAACGCCATATTGAAC,sample,113225,112509,5859,106650,13375,93275,59503,4793,17124,2066,76627,9789,5139,1716,8321,9597
GACTAACCTATTGAAC,sample,128225,127310,7504,119806,11979,107827,53011,3253,28358,2987,81369,20218,6733,1869,5497,7795
GTCGTTCTGTTCAACT,sample,31374,31156,1646,29510,4977,24533,15216,1026,4853,649,20069,2789,2373,1058,2526,3449
GACGTATGGTTCAACT,sample,21213,21035,1669,19366,3034,16332,7716,537,4816,524,12532,2739,2374,824,1788,2090
CATAATGGGTTCAACT,sample,15053,14960,698,14262,4011,10251,7972,508,1162,166,9134,443,1295,1085,1504,2614
CTAGCGACGTTCAACT,sample,27142,26984,1100,25884,4876,21008,15555,954,2787,465,18342,1247,1461,1016,3169,3739
TCGAACGAGTTCAACT,sample,25728,25516,789,24727,4494,20233,16352,1344,1817,114,18169,606,1538,1490,2019,3445
TCATCGAAGTTCAACT,sample,23701,23556,993,22563,4811,17752,12282,937,2971,356,15253,1206,1808,1161,2164,3406
TACGCGAGGTTCAACT,sample,49153,48688,4337,44351,4052,40299,17996,1352,11545,1181,29541,8225,4853,1589,2333,2498
ATACGTTCGTTCAACT,sample,22659,22496,1485,21011,4130,16881,10100,702,3756,617,13856,1706,1935,957,1670,2825
GATGCGTTGTTCAACT,sample,30700,30462,1423,29039,2693,26346,14073,781,7887,1167,21960,2438,2330,1322,1616,1841
CGGTTGGTGTTCAACT,sample,20520,20365,836,19529,4087,15442,11139,702,2610,279,13749,712,1487,1119,2025,2811
TAGCGAGTGTTCAACT,sample,33060,32842,1730,31112,5320,25792,16523,1243,5065,529,21588,2432,2350,1334,3247,3971
GAGATTCTGTTCAACT,sample,21568,21429,850,20579,4686,15893,11474,673,2427,303,13901,1016,1522,1099,2608,3332
CTAAGCATGTTCAACT,sample,27589,27408,1304,26104,5952,20152,13406,617,3514,497,16920,2118,1888,912,3055,4280
AAGGTCTGGTTCAACT,sample,17089,16977,1269,15708,1829,13879,6356,391,4531,554,10887,2047,2261,1002,1073,1200
GGCGACGAGTTCAACT,sample,19099,18965,960,18005,3751,14254,10311,787,2094,201,12405,861,1412,1065,2327,2706
TAACGAAGGTTCAACT,sample,31765,31554,993,30561,3733,26828,14698,1010,7919,933,22617,2268,1950,1296,2201,2838
TGCGCTCCGTTCAACT,sample,24400,24162,2141,22021,3328,18693,9413,700,4972,415,14385,3193,2397,868,2720,2288
GCGTTACCGTTCAACT,sample,26104,25861,1450,24411,3899,20512,13158,976,4047,368,17205,1963,2006,1226,2279,2904
GTCGCGAAGTTCAACT,sample,16296,16150,960,15190,2987,12203,8639,639,1765,209,10404,951,1436,966,1872,2173
ATGAATAGGTTCAACT,sample,24593,24350,2424,21926,2359,19567,9607,638,4959,664,14566,3699,2511,802,1631,1430
AAGTAGAGGTTCAACT,sample,24494,24338,746,23592,3957,19635,14495,1233,2396,273,16891,1238,1473,1048,1852,2797
GACTAACCGTTCAACT,sample,24768,24600,1169,23431,3083,20348,13285,851,3562,504,16847,2146,1865,1017,1458,2199
GCGCAATAGTTCAACT,Neg_Ctrl,235,222,26,196,31,165,99,7,37,2,136,20,59,35,12,26
TCTAGGTTCTGAGGTT,sample,193188,191699,16186,175513,19644,155869,60143,5227,48957,5681,109100,35861,9564,2310,10028,13061
AGAGTTCTCTGAGGTT,sample,209358,207983,10697,197286,29971,167315,94364,6794,42317,4841,136681,18999,6105,2003,18351,22018
AGCTGAATCTGAGGTT,sample,195359,193924,18019,175905,21100,154805,61874,4172,51726,5461,113600,31572,9526,2368,9790,13468
GACGTATGCTGAGGTT,sample,130676,129930,5189,124741,16642,108099,65679,4439,25782,3398,91461,8801,4384,2240,9338,11944
TATACGGACTGAGGTT,sample,153257,152418,5542,146876,19038,127838,76108,6321,31195,3979,107303,10235,3844,1995,9468,13934
TCATACCACTGAGGTT,sample,119995,119009,8667,110342,9405,100937,40739,3109,37484,4625,78223,14980,5564,2177,3528,5945
GCAACTAGCTGAGGTT,sample,40461,40209,1514,38695,8135,30560,20927,1797,5622,456,26549,1758,2066,1411,3832,6008
GACTCAAGCTGAGGTT,sample,115529,114715,5307,109408,11674,97734,59741,4691,18254,1968,77995,13080,4805,1553,7746,8033
TCTCAGGACTGAGGTT,sample,136797,135873,5530,130343,18867,111476,73363,6065,20161,2264,93524,9623,4001,1945,9736,13945
CGGTTGGTCTGAGGTT,sample,121518,120695,4084,116611,21098,95513,76983,4686,9483,741,86466,3620,2487,1704,13796,15062
AAGGTCTGCTGAGGTT,sample,159639,158560,8495,150065,20805,129260,88642,5218,20628,2294,109270,12478,5865,2506,12124,15679
GCTGCTTCCTGAGGTT,sample,155547,154548,6091,148457,21005,127452,92602,8177,18522,2028,111124,6123,3455,1867,13779,16237
TGCGCTCCCTGAGGTT,sample,144124,143049,7900,135149,18028,117121,69364,7063,24383,2767,93747,13544,5502,1761,9239,13094
GCGTTACCCTGAGGTT,sample,117055,116272,4258,112014,18970,93044,71453,5504,10782,1209,82235,4096,3042,1870,12486,13928
GGCGTACCCTGAGGTT,sample,92270,91651,3308,88343,18313,70030,54322,4046,7737,808,62059,3117,2218,1333,9992,13375
CAGCTTCGCTGAGGTT,sample,73705,73126,2550,70576,10588,59988,44357,3475,7925,962,52282,3269,2630,1658,5494,7792
TTATGACGCTGAGGTT,sample,166231,165280,4980,160300,18334,141966,117219,8844,9357,1423,126576,5123,3644,2395,7203,13245
TCTCCTAGCTGAGGTT,sample,164767,163877,7710,156167,17456,138711,87559,8076,23152,2575,110711,17349,6243,2208,7884,12137
AAGTAGAGCTGAGGTT,sample,174482,173415,16342,157073,19842,137231,60385,5312,37477,3906,97862,30151,9121,1924,10699,12680
CGCGAGACCTGAGGTT,sample,78589,78081,2997,75084,12757,62327,42671,3506,9872,1243,52543,5035,3190,1366,6903,8464
CGTAGAACCTGAGGTT,sample,106447,105827,3287,102540,17749,84791,61422,4887,11263,1902,72685,5317,3246,1604,8545,12710
AGAGTTCTAGACCGTT,sample,152801,151886,5679,146207,29097,117110,80558,6445,18743,2284,99301,9080,3883,1771,17712,22122
GACGTATGAGACCGTT,sample,108928,108301,2357,105944,21183,84761,62122,5365,12519,1358,74641,3397,2162,1460,10919,15468
CATAATGGAGACCGTT,sample,122571,121792,5454,116338,21229,95109,57778,5676,18691,2569,76469,10395,4522,1604,13289,15388
TATACGGAAGACCGTT,sample,132040,131155,4193,126962,16102,110860,71763,4907,23471,3595,95234,7124,3307,1815,11720,11429
GGAGAAGCAGACCGTT,sample,101595,100985,3194,97791,19265,78526,60435,6253,8042,1163,68477,2633,2319,1498,12788,13938
TCATACCAAGACCGTT,sample,138312,137352,7050,130302,14490,115812,69804,5908,25020,2642,94824,12438,5158,2320,7423,10191
TGATTCCGAGACCGTT,sample,102463,101866,3351,98515,18834,79681,57698,3952,11307,1265,69005,5459,3134,1544,10344,13513
TACGCGAGAGACCGTT,sample,117666,117139,4425,112714,23450,89264,60899,5572,14418,1821,75317,6554,3867,1854,11287,16362
GACTCAAGAGACCGTT,sample,106734,106019,6285,99734,20249,79485,47753,3550,17193,1810,64946,9179,4692,1882,8876,13742
TGGATCAAAGACCGTT,sample,135323,134292,4277,130015,19380,110635,82108,5550,14106,2395,96214,6476,3457,2019,13525,14094
GATGCGTTAGACCGTT,sample,101506,100842,3956,96886,18801,78085,53689,4651,11849,1901,65538,5995,3802,1699,9068,13703
TGCGCGTTAGACCGTT,sample,177163,176009,7121,168888,23427,145461,107082,7852,17951,2615,125033,9961,4441,1970,12139,18488
CCATTCTTAGACCGTT,sample,150962,149864,8633,141231,19585,121646,66669,6210,27854,3021,94523,17892,6657,2132,10906,13806
CGGTTGGTAGACCGTT,sample,89980,89320,5039,84281,13709,70572,45204,3427,12983,1479,58187,7479,4294,1491,9253,9633
ACGCTTAAAGACCGTT,sample,148950,147929,10219,137710,18539,119171,63940,4847,25641,2379,89581,22364,6836,1722,11022,13537
CTAAGCATAGACCGTT,sample,170776,169712,5123,164589,21792,142797,112112,8967,13707,1547,125819,6464,4021,2459,11077,16593
AAGGTCTGAGACCGTT,sample,122219,121412,4735,116677,20417,96260,66287,4956,15082,1937,81369,7998,3055,1488,10349,14939
CCTAGCGGAGACCGTT,sample,76555,76116,2313,73803,12847,60956,43446,3868,10272,1034,53718,2336,2241,1618,5639,9350
CTAACCGGAGACCGTT,sample,101115,100307,8035,92272,14979,77293,45552,2950,16419,2004,61971,10368,4815,1553,9417,10063
GCCTATTCAGACCGTT,sample,151679,150719,7769,142950,15261,127689,71233,4518,28107,3046,99340,20785,7639,2048,11127,10368
ATACCGCCAGACCGTT,sample,119248,118598,2972,115626,21516,94110,77739,6083,6729,1756,84468,1803,1335,1367,13087,16431
GTCGCGAAAGACCGTT,sample,137221,136199,9126,127073,15015,112058,53349,4763,28882,3555,82231,21509,7350,1957,8790,10959
CGTCGAGGAGACCGTT,sample,80978,80360,5304,75056,10766,64290,36668,3450,13807,1483,50475,8882,4255,1396,5408,7451
CAGCTTCGAGACCGTT,sample,115409,114386,7234,107152,15357,91795,53107,4625,19219,1931,72326,12913,5138,1596,8369,10666
CGCGAGACAGACCGTT,sample,94269,93784,3722,90062,11057,79005,56556,4474,10244,1389,66800,6342,3677,1533,6565,7845
TCTAGGTTCTTGAGTT,sample,162183,161456,5386,156070,27269,128801,82351,6273,27565,2971,109916,9641,4764,2140,14517,18624
CATAATGGCTTGAGTT,sample,131928,131193,5699,125494,22850,102644,62241,5622,20981,2081,83222,11719,5034,1802,15078,15447
GGAGAAGCCTTGAGTT,sample,159820,158962,4606,154356,24960,129396,90285,5941,22438,2777,112723,7955,4053,2374,11334,18555
CATACTCCCTTGAGTT,sample,189204,187887,17868,170019,23638,146381,58104,4099,44893,4331,102997,34954,10517,2539,10572,15296
TCATCGAACTTGAGTT,sample,160159,159349,6528,152821,21984,130837,75631,5246,31878,3318,107509,14764,5210,2079,12109,16982
ATTCAAGGCTTGAGTT,sample,96462,95814,4801,91013,12659,78354,44321,3149,21468,2139,65789,7277,4267,2229,6529,9237
ATACGTTCCTTGAGTT,sample,153875,152911,7757,145154,22699,122455,74545,4727,26014,2720,100559,14449,5831,2428,10260,16115
TCTCAGGACTTGAGTT,sample,152683,151792,6681,145111,25120,119991,81986,7483,18305,2032,100291,10185,4536,1740,14531,17350
GGCAGGTTCTTGAGTT,sample,222895,221448,12068,209380,23416,185964,108158,9038,41539,4220,149697,23009,6868,2221,9332,16253
GATGCGTTCTTGAGTT,sample,150916,150022,5569,144453,22793,121660,82825,8461,20325,1604,103150,8445,4145,1718,12995,16497
ATGGCGTTCTTGAGTT,sample,128148,127221,9275,117946,19528,98418,46638,3717,27302,3012,73940,17749,6463,1725,7634,14172
CGGTTGGTCTTGAGTT,sample,157504,156568,7691,148877,30972,117905,73533,6318,22310,2229,95843,13515,5714,2076,10907,20609
CCTAGCGGCTTGAGTT,sample,94160,93440,6001,87439,7523,79916,39970,2342,23926,2852,63896,10826,4876,1800,3805,5434
GGCGACGACTTGAGTT,sample,139466,138454,8635,129819,18931,110888,58122,5651,25359,3101,83481,18655,6224,1615,10347,13949
GCTGCTTCCTTGAGTT,sample,174287,172929,10909,162020,17797,144223,76168,8104,34703,3547,110871,21701,7515,2111,10225,11725
ATACCGCCCTTGAGTT,sample,126105,125191,6356,118835,18385,100450,63965,5225,18773,2395,82738,10092,4548,1612,12733,13902
GGCGTACCCTTGAGTT,sample,103927,103200,5512,97688,12649,85039,52744,5007,15288,1513,68032,10487,5193,1762,6163,9311
TTATGACGCTTGAGTT,sample,141313,140467,5264,135203,21599,113604,74789,6672,21082,2710,95871,8351,4032,1555,8233,15688
TCTCCTAGCTTGAGTT,sample,160756,159758,7169,152589,19218,133371,89877,5037,21848,2397,111725,14212,5476,1849,7349,13843
ATTCTACCCTTGAGTT,sample,170557,169531,8183,161348,18789,142559,95002,6838,23124,2880,118126,14715,6393,2106,9676,13457
GACTAACCCTTGAGTT,sample,126982,126129,4695,121434,14572,106862,67941,6235,21155,2790,89096,8741,3963,1728,6095,10258
CCTAACTACTTGAGTT,sample,124573,123686,7876,115810,14958,100852,57216,6562,20875,2151,78091,14048,5287,1493,9715,10377
GTCGTTCTTCGGAGTT,sample,74890,74433,3837,70596,10814,59782,31219,2254,15679,2402,46898,8228,4482,1571,6310,7401
CATAATGGTCGGAGTT,sample,74200,73683,4798,68885,10667,58218,32514,2296,14020,1211,46534,8177,4379,1559,6547,7614
GGAGAAGCTCGGAGTT,sample,72116,71648,3228,68420,10199,58221,36599,2606,12660,1725,49259,4631,2826,1841,5093,7690
GAGCCTCCTCGGAGTT,sample,55069,54716,2379,52337,10401,41936,28094,1862,8125,688,36219,3167,2991,1617,6647,7611
CTAGCGACTCGGAGTT,sample,80149,79624,3153,76471,13029,63442,48070,3523,7629,997,55699,3223,2609,1635,9432,9262
GGTAGAGATCGGAGTT,sample,88704,88143,3641,84502,13144,71358,51505,3466,10045,1299,61550,5043,3028,1563,9260,9440
CGTCGCCATCGGAGTT,sample,76141,75577,3017,72560,12989,59571,41202,4051,8425,950,49627,4943,2565,1302,7890,9966
TGATTCCGTCGGAGTT,sample,68693,68259,2936,65323,10498,54825,38631,2410,8510,1126,47141,4148,2770,1428,7411,7604
GCAACTAGTCGGAGTT,sample,24211,24062,892,23170,4052,19118,14872,1235,1906,244,16778,861,1893,1775,1637,3043
TGGATCAATCGGAGTT,sample,96184,95613,3024,92589,14261,78328,62557,4884,6576,761,69133,3550,2241,1786,8814,10480
ATGGCGTTTCGGAGTT,sample,78502,77826,3357,74469,8962,65507,43581,2729,12720,1909,56301,4568,2771,1667,5909,6458
TGCGCGTTTCGGAGTT,sample,96845,96295,3781,92514,11717,80797,58951,4903,9862,1007,68813,6074,3373,1883,7064,8103
GAGATTCTTCGGAGTT,sample,108397,107605,8377,99228,10132,89096,38253,3539,26712,3676,64965,16916,7467,1689,4934,6566
AAGGTCTGTCGGAGTT,sample,68133,67452,7059,60393,6599,53794,20307,1394,17696,1708,38003,12689,6317,1616,2360,4217
GGCGACGATCGGAGTT,sample,44686,44350,1994,42356,7090,35266,24435,2328,5387,550,29822,2566,2289,1263,3945,5268
GCCTATTCTCGGAGTT,sample,71186,70765,2504,68261,7372,60889,39292,3926,12536,1251,51828,3884,3093,1741,3034,5242
AGCAGAGCTCGGAGTT,sample,74729,74159,3343,70816,8220,62596,38416,3790,12808,2054,51224,5528,2999,1274,2307,5927
CGTCGAGGTCGGAGTT,Pos_Ctrl,17118,16910,966,15944,636,15308,12830,1183,918,116,13748,261,3087,2980,657,247
TCTCCTAGTCGGAGTT,sample,93072,92383,6172,86211,9490,76721,38285,4286,19487,2126,57772,12537,5044,1402,3392,6329
TAACGCCATCGGAGTT,sample,72167,71766,2940,68826,9472,59354,39237,2621,10852,1101,50089,5543,3184,1223,4855,6778
ATTCTACCTCGGAGTT,sample,59331,58933,2348,56585,11566,45019,26827,1943,9137,1075,35964,6037,3363,1012,4185,7792
GACTAACCTCGGAGTT,sample,41841,41501,2996,38505,3446,35059,17556,1571,9686,975,27242,5271,3539,1304,2002,2166
GCGCAATATCGGAGTT,sample,82524,82164,2747,79417,12601,66816,46770,3836,10079,910,56849,5221,3095,1273,6331,9334
TTAACTGATCGGAGTT,sample,54536,54126,3388,50738,5529,45209,21360,2262,13219,1284,34579,7084,3768,1126,2210,3630
TCTAGGTTTGAACCTT,sample,182935,181726,9094,172632,26851,145781,90590,8514,26099,3395,116689,17183,6289,2343,13586,19009
CTGGTCTTTGAACCTT,Pos_Ctrl,20338,20128,1486,18642,1035,17607,14737,1381,1036,108,15773,345,3283,3031,1102,591
GGTAGAGATGAACCTT,Pos_Ctrl,22830,22516,1838,20678,1107,19571,16375,1477,1128,173,17503,418,3688,3429,1216,555
CGTCGCCATGAACCTT,sample,117264,116620,4135,112485,22508,89977,68713,5473,9366,1503,78079,4922,2578,1606,16390,16861
CCGTACGCTGAACCTT,sample,91122,90262,12817,77445,9867,67578,25025,1852,23841,2738,48866,14122,7263,2085,2922,5838
TCTCAGGATGAACCTT,sample,116233,115449,5725,109724,22454,87270,57256,4978,17389,1104,74645,6543,3589,1616,8795,16267
ATGGCGTTTGAACCTT,Pos_Ctrl,96372,95268,5158,90110,3391,86719,71828,7118,5377,716,77205,1680,5711,7443,3020,1188
CCATTCTTTGAACCTT,sample,50583,50196,3541,46655,5428,41227,23055,2013,9558,1105,32613,5496,3398,1395,3775,3945
GCTCTTCTTGAACCTT,sample,126001,125195,5651,119544,19061,100483,61663,4780,18473,2478,80136,13089,5276,1559,8806,13947
AAGGTCTGTGAACCTT,sample,137813,136844,8457,128387,14290,114097,70656,4884,21632,2166,92288,14759,6296,2366,5765,10154
CCTAGCGGTGAACCTT,Pos_Ctrl,18500,18282,1123,17159,677,16482,13815,1298,954,134,14769,281,3272,3103,669,257
TGCGCTCCTGAACCTT,sample,27064,26846,1394,25452,3168,22284,14555,1326,4069,420,18624,1914,1984,1139,2114,2319
CGCGGTCGTGAACCTT,sample,96321,95724,5190,90534,8177,82357,46718,4871,17790,1976,64508,11002,5027,1462,5759,5781
ATGAATAGTGAACCTT,sample,253507,251794,19311,232483,16097,216386,71645,4507,85870,8756,157515,45608,11805,2637,7505,8633
ATTCTACCTGAACCTT,Pos_Ctrl,27683,27444,1689,25755,1151,24604,20404,2040,1444,180,21848,536,4030,4085,1037,455
GACTAACCTGAACCTT,sample,134068,133328,7973,125355,13364,111991,56371,6511,26098,2822,82469,20189,6886,1742,7002,9306
CGCGAGACTGAACCTT,sample,99981,99506,2637,96869,18717,78152,59665,5797,8205,1175,67870,3310,2829,1879,5829,12777
AGATACTATGAACCTT,sample,130631,129951,8787,121164,19383,101781,57447,5503,20992,1837,78439,16002,5524,1684,6714,13333
CCTAACTATGAACCTT,sample,143821,142975,7383,135592,11878,123714,58620,4422,38600,3659,97220,18413,5824,1834,5839,8029
TTAACTGATGAACCTT,sample,130469,129742,3731,126011,13223,112788,88876,7638,9917,1086,98793,5271,3202,1914,6563,8944
GTCGTTCTACCGAATT,sample,69363,68857,5543,63314,8875,54439,23029,1741,17938,1921,40967,9810,5198,1706,4010,5993
CATAATGGACCGAATT,sample,31953,31769,2455,29314,4408,24906,12873,975,7090,765,19963,3203,2714,1231,1937,3073
TATACGGAACCGAATT,sample,177315,176149,10091,166058,28853,137205,74684,7322,31823,3125,106507,20251,7587,2027,15310,21870
GGAGAAGCACCGAATT,sample,72035,71621,3043,68578,10945,57633,41054,3257,8747,855,49801,3720,3192,2378,5276,8460
CTAGCGACACCGAATT,sample,144455,143500,11183,132317,23112,109205,55031,4101,27572,2627,82603,19874,8032,1897,9822,15550
GGTAGAGAACCGAATT,sample,148880,148070,5115,142955,20110,122845,79919,5112,27196,2591,107115,8027,3485,1976,13862,14851
TGCGCGTTACCGAATT,sample,115397,114617,5632,108985,17666,91319,62340,4294,15589,1169,77929,7927,3726,1565,10253,13113
AGCGTCTTACCGAATT,sample,154125,153107,7144,145963,19306,126657,76446,6108,28918,3001,105364,12184,4000,1633,11999,14033
CATTCGGTACCGAATT,sample,91256,90567,4550,86017,11639,74378,44989,3627,15837,2279,60826,7646,3707,1549,6621,8590
AAGGTCTGACCGAATT,sample,149511,148287,14868,133419,10652,122767,45101,3333,39389,3600,84490,31344,8675,2016,3595,6874
GGCGACGAACCGAATT,sample,86546,85840,5110,80730,7186,73544,44350,3432,14679,1867,59029,9216,3831,1134,2700,4471
TGCGCTCCACCGAATT,sample,149546,148427,8192,140235,14286,125949,70441,6054,26175,3412,96616,19867,6722,1828,6402,10088
ATACCGCCACCGAATT,sample,87526,86915,5405,81510,13645,67865,38610,3343,15482,2016,54092,8414,4375,1324,6046,9161
CAGCTTCGACCGAATT,Neg_Ctrl,655,443,84,359,54,305,172,10,65,14,237,44,119,78,14,29
TCTCCTAGACCGAATT,sample,99690,98826,9756,89070,13653,75417,33057,1946,23162,2204,56219,15048,6255,1622,8166,8936
TCAATCAGACCGAATT,sample,45498,45116,3049,42067,8143,33924,21917,1012,6648,602,28565,3745,2842,1358,5242,5631
CGCGAGACACCGAATT,sample,79665,79099,4449,74650,11493,63157,39690,2807,12425,1170,52115,7065,3747,1187,5783,8216
TTAACTGAACCGAATT,sample,92928,92394,3555,88839,12685,76154,47171,5536,12990,1376,60161,9081,4344,1143,7232,8201
TCTAGGTTGGTCTGGT,sample,114589,114082,3660,110422,21147,89275,58112,4879,17688,2223,75800,6373,3441,1552,13085,14328
GTCGTTCTGGTCTGGT,Neg_Ctrl,791,616,85,531,85,446,251,27,110,13,361,45,187,117,44,48
GACGTATGGGTCTGGT,sample,65411,65021,3014,62007,10624,51383,32655,2538,9391,1025,42046,5774,3410,1423,7258,7640
CATACTCCGGTCTGGT,sample,132988,132098,9619,122479,20283,102196,52450,3983,24252,2474,76702,19037,8071,1798,12437,14143
TCGAACGAGGTCTGGT,sample,95194,94690,2395,92295,19347,72948,57961,4979,7019,671,64980,2318,2182,1601,11331,13933
CGTCGCCAGGTCTGGT,Neg_Ctrl,548,428,62,366,53,313,200,24,50,6,250,33,125,81,28,25
TGGATCAAGGTCTGGT,sample,126380,125477,8959,116518,12397,104121,47459,3896,29554,3124,77013,20088,6962,1706,7981,8111
TGCGCGTTGGTCTGGT,Neg_Ctrl,523,325,106,219,30,189,122,6,35,7,157,19,89,56,18,15
CCATTCTTGGTCTGGT,sample,90484,89898,3242,86656,10049,76607,48868,4020,15474,1258,64342,6987,3374,1300,7044,6710
CATTCGGTGGTCTGGT,sample,93519,92872,3848,89024,9001,80023,55960,4072,12333,1043,68293,6615,3400,1361,6205,6249
CTAAGCATGGTCTGGT,sample,104371,103747,3017,100730,12216,88514,65064,5937,12444,1264,77508,3805,2021,1410,7426,9196
AAGGTCTGGGTCTGGT,sample,114615,113885,5902,107983,14096,93887,55611,4693,18758,2126,74369,12699,5741,1704,7173,9876
CTAACCGGGGTCTGGT,Neg_Ctrl,697,568,66,502,71,431,246,22,96,11,342,56,193,121,31,43
GCCTATTCGGTCTGGT,sample,88712,88188,3504,84684,14477,70207,46166,4604,11568,1416,57734,6453,3640,1372,6587,10271
GCGTTACCGGTCTGGT,sample,117443,116748,3766,112982,15531,97451,77404,5468,8772,1323,86176,4484,3215,2260,6518,11362
CAGCTTCGGGTCTGGT,sample,90261,89679,3587,86092,17074,69018,48718,3402,10898,1392,59616,4608,3311,1923,8736,12388
TTATGACGGGTCTGGT,sample,90941,90333,5469,84864,14310,70554,41396,3058,14522,2352,55918,9226,4595,1261,6341,9517
TCAATCAGGGTCTGGT,sample,85503,84951,3194,81757,6869,74888,38861,2067,23851,2411,62712,7698,3481,1550,2395,4740
GACTAACCGGTCTGGT,Neg_Ctrl,856,678,87,591,62,529,300,15,147,6,447,61,226,128,41,44
CGTAGAACGGTCTGGT,sample,82181,81455,6470,74985,8052,66933,30786,2130,19054,1788,49840,13175,6201,1346,4055,5073
CCTAACTAGGTCTGGT,sample,104481,103871,3448,100423,14828,85595,58252,4204,15163,1707,73415,6269,3155,1490,8709,11144
TTAACTGAGGTCTGGT,sample,77430,76990,4584,72406,8747,63659,33484,2806,15122,2041,48606,10206,4796,1246,3579,6340
TCTAGGTTCGACGTTA,sample,186902,185629,15324,170305,26981,143324,70393,3717,38576,4114,108969,26524,9106,2199,12860,17757
AGAGTTCTCGACGTTA,sample,105501,104920,4719,100201,18279,81922,53680,4939,15384,2089,69064,5830,3657,1895,10734,13238
AGCTGAATCGACGTTA,sample,189676,188478,7878,180600,34956,145644,101498,7504,22438,2811,123936,11393,5042,2093,18966,25793
CTAGCGACCGACGTTA,sample,28658,28524,694,27830,6128,21702,14834,1570,3887,555,18721,856,1552,1263,2280,4199
TGATTCCGCGACGTTA,sample,164399,163249,6850,156399,27326,129073,81654,5102,24751,3675,106405,13891,5494,1821,11652,19554
GACTCAAGCGACGTTA,sample,141162,140425,3670,136755,27653,109102,82700,7413,13368,1364,96068,4257,2742,2001,11931,19780
ATACGTTCCGACGTTA,sample,156272,155343,7713,147630,27949,119681,71716,5980,24629,2226,96345,15130,5295,1755,13004,19555
TCTCAGGACGACGTTA,sample,174227,173181,3796,169385,37743,131642,108259,8686,11044,1109,119303,2544,2308,2046,19923,27434
CCATTCTTCGACGTTA,sample,135896,135054,4556,130498,19663,110835,82673,6788,13321,1620,95994,6433,4565,3214,8872,14397
AGCGTCTTCGACGTTA,sample,125438,124703,5434,119269,20882,98387,64961,5170,17956,2134,82917,8166,3959,1700,16628,15377
CGGTTGGTCGACGTTA,sample,113492,112821,4228,108593,24238,84355,55728,4300,15887,1559,71615,6881,4140,1769,13202,17503
ACGCTTAACGACGTTA,sample,167163,166131,7067,159064,25425,133639,86149,6374,25086,2881,111235,13149,4666,1821,14778,17894
TAGCGAGTCGACGTTA,sample,128576,127882,6291,121591,23978,97613,65821,5162,15787,1559,81608,9284,4653,1843,14240,16603
GCTCTTCTCGACGTTA,sample,107089,106263,8589,97674,13057,84617,38657,2896,22814,2257,61471,17993,6118,1511,5869,8487
CTAAGCATCGACGTTA,sample,150353,149503,6240,143263,22694,120569,74992,6581,21174,2332,96166,15490,3777,1290,13475,15794
AAGGTCTGCGACGTTA,sample,114176,113452,4704,108748,21047,87701,56726,6366,13856,1600,70582,9153,3619,1380,6272,13505
GCTGCTTCCGACGTTA,sample,139478,138685,4485,134200,21470,112730,81301,9893,12371,2076,93672,7089,2754,1555,11934,15872
GCCTATTCCGACGTTA,sample,154115,153407,3696,149711,12734,136977,109225,10604,11882,1556,121107,3710,3246,2565,5408,9492
CGTCGAGGCGACGTTA,sample,30441,30339,844,29495,7898,21597,14837,1431,3659,384,18496,1286,1930,1405,2774,5174
TCAATCAGCGACGTTA,sample,957,950,48,902,148,754,474,36,161,12,635,71,301,197,82,107
CGTAGAACCGACGTTA,sample,8153,8099,278,7821,1272,6549,4403,527,1045,83,5448,491,998,804,323,834
GCGCAATACGACGTTA,sample,175978,174939,10348,164591,19416,145175,67458,7183,41532,4378,108990,24624,8851,2311,7816,12949
ATATGCAACGACGTTA,sample,54634,54413,1513,52900,11123,41777,30507,2789,5066,625,35573,2790,2268,1215,3816,7498
TATACGGATACTAAGT,sample,73827,73395,3865,69530,12010,57520,37524,2967,10243,1201,47767,5585,3691,1717,6758,8651
CATACTCCTACTAAGT,sample,58217,57812,3537,54275,9471,44804,24608,1959,10386,1465,34994,6386,3821,1332,4527,6814
CTAGCGACTACTAAGT,sample,62499,62084,2710,59374,10758,48616,32208,2374,8610,760,40818,4664,3586,1740,4354,7423
CGTCGCCATACTAAGT,sample,76528,76067,3062,73005,7725,65280,35640,2528,17700,2803,53340,6609,2918,1580,4501,5483
TCATACCATACTAAGT,sample,80980,80573,3884,76689,13214,63475,31888,2748,16789,1551,48677,10499,5381,1861,4575,9273
GGCAGGTTTACTAAGT,sample,67278,66819,3395,63424,8028,55396,30205,1659,15010,2147,45215,6375,3598,1622,4470,5905
CCATTCTTTACTAAGT,sample,72121,71660,2759,68901,12602,56299,37337,3681,9861,1360,47198,4060,2567,1168,6004,8979
CTAAGCATTACTAAGT,sample,57629,57227,3974,53253,9503,43750,23839,1522,10700,1228,34539,6461,3600,1259,4570,6571
AAGGTCTGTACTAAGT,sample,14732,14625,722,13903,3378,10525,7229,522,1761,253,8990,760,1698,1194,1331,2336
CTAACCGGTACTAAGT,sample,32804,32499,1287,31212,5649,25563,17705,1194,4605,553,22310,1506,2267,1684,3327,4118
TAACGAAGTACTAAGT,sample,56245,55832,3584,52248,9634,42614,27863,2039,7304,663,35167,4745,3211,1406,6794,7022
GCCTATTCTACTAAGT,sample,59938,59503,3914,55589,7893,47696,26370,1907,11873,1333,38243,6213,4260,1622,4975,5294
GGCGTACCTACTAAGT,sample,40847,40494,2024,38470,6381,32089,21135,1564,5836,730,26971,2824,2564,1476,4189,4707
CGTCGAGGTACTAAGT,sample,42341,42032,3363,38669,4234,34435,18273,1247,7959,988,26232,5968,3307,1192,3191,2792
ATGAATAGTACTAAGT,sample,161335,159985,15321,144664,10924,133740,43525,2991,47482,5703,91007,34039,10671,2108,3669,6085
TAACGCCATACTAAGT,sample,93803,93227,3016,90211,11225,78986,55993,4965,11721,1613,67714,4694,2937,1451,5968,8143
ATTCTACCTACTAAGT,sample,70413,69961,2839,67122,6685,60437,36410,3095,12557,1395,48967,6980,2685,1141,4448,4653
AGATACTATACTAAGT,sample,79966,79433,4825,74608,9025,65583,36891,2670,13937,1606,50828,10479,4395,1222,5772,6532
AACCGGTTTTGCCGCT,sample,168426,167650,4456,163194,28637,134557,97845,8852,17208,2040,115053,8612,4457,2350,13737,20102
GACGTATGTTGCCGCT,sample,172857,171898,4748,167150,29357,137793,108811,8072,13847,1116,122658,5947,3894,2841,13881,22129
CATAATGGTTGCCGCT,sample,159859,158876,8020,150856,29559,121297,72378,5922,25270,2473,97648,15254,6142,1854,17316,21299
GAGCCTCCTTGCCGCT,sample,103853,103115,6712,96403,18518,77885,38995,2402,21281,2209,60276,12998,6604,2194,7205,12765
CATACTCCTTGCCGCT,sample,68503,68018,4078,63940,8564,55376,30547,2339,14107,1884,44654,6499,4805,2407,3043,5770
TGATTCCGTTGCCGCT,sample,150917,149997,7189,142808,21967,120841,77301,5870,22376,2436,99677,12858,5689,2054,13588,15515
CCGTACGCTTGCCGCT,sample,175308,174273,5903,168370,34672,133698,94150,6620,18880,2137,113030,11911,3933,1795,21428,23557
ATGGCGTTTTGCCGCT,sample,137281,136180,7212,128968,20552,108416,63109,6712,22309,2094,85418,14192,5615,1857,9252,14310
CCATTCTTTTGCCGCT,sample,97580,96729,4461,92268,11027,81241,45470,2559,22102,3001,67572,8109,3321,1665,6845,7888
CGGTTGGTTTGCCGCT,sample,113951,112936,9687,103249,12472,90777,44453,3464,25273,2831,69726,14756,5882,1838,8575,8306
GAGATTCTTTGCCGCT,sample,145077,144284,4639,139645,31577,108068,82157,7120,12057,1410,94214,5324,2845,1600,21532,22618
AAGGTCTGTTGCCGCT,sample,65988,65523,5108,60415,9454,50961,25794,2397,12712,1282,38506,8776,4933,1671,5329,6762
CTAACCGGTTGCCGCT,sample,42413,42159,1411,40748,9177,31571,21833,1851,5721,905,27554,1261,2021,1432,4816,6270
GCTGCTTCTTGCCGCT,sample,128999,127759,11173,116586,13746,102840,48828,3381,26618,2620,75446,21393,8092,1724,8873,9307
TGCGCTCCTTGCCGCT,sample,105961,105227,5138,100089,16318,83771,51221,4399,16522,1694,67743,9935,5018,1874,6559,11593
GGCGTACCTTGCCGCT,sample,54243,53709,4534,49175,7685,41490,20230,1905,10762,1401,30992,7192,4191,1388,3454,5277
TCTCCTAGTTGCCGCT,sample,141056,140020,9281,130739,12570,118169,65332,6192,25653,2951,90985,18041,6830,1762,6256,8709
ATGAATAGTTGCCGCT,sample,148192,147151,9652,137499,15054,122445,60996,5659,30023,2787,91019,22980,6800,1779,8435,11118
TAACGCCATTGCCGCT,sample,131049,130084,4472,125612,17904,107708,67675,7082,20214,1857,87889,10880,4500,1543,7444,12547
ATTCTACCTTGCCGCT,sample,132143,131333,5313,126020,16504,109516,74378,6538,14951,1940,89329,11709,3886,1407,10016,11970
GACTAACCTTGCCGCT,sample,144981,144018,6776,137242,17085,120157,67670,5168,30189,4665,97859,12465,4303,1573,8627,12472
CCTAACTATTGCCGCT,sample,157570,156515,8891,147624,21532,126092,68498,6255,28824,3760,97322,18755,6001,1790,8613,14324
ATATGCAATTGCCGCT,sample,124373,123711,6219,117492,12918,104574,48158,4485,29436,3065,77594,19430,7701,1697,5691,9568
GTCGTTCTTTCGACCT,sample,123588,122897,4035,118862,19838,99024,66634,4350,19937,2791,86571,5312,3060,1749,12797,14526
AGAGTTCTTTCGACCT,sample,197267,195984,11467,184517,26646,157871,94684,5315,31492,3134,126176,23246,7371,2610,15983,18234
CATAATGGTTCGACCT,sample,119927,119043,6165,112878,17018,95860,58698,3706,22258,2225,80956,8973,4311,1767,9779,12116
GGAGAAGCTTCGACCT,sample,143808,142897,5244,137653,20912,116741,65985,4432,32233,3024,98218,11067,3619,1719,11502,14966
CATACTCCTTCGACCT,sample,106092,105369,3688,101681,21986,79695,55870,4648,12082,2026,67952,5069,3258,1964,9175,14910
TCGAACGATTCGACCT,sample,58469,58065,4108,53957,9012,44945,21039,1589,12811,1382,33850,8124,4686,1591,3337,6126
TGATTCCGTTCGACCT,sample,132271,131389,4725,126664,20202,106462,78787,6659,13325,1898,92112,5793,3759,1953,12171,15149
TCTCAGGATTCGACCT,sample,152589,151647,7358,144289,22575,121714,82381,6474,18635,2128,101016,12096,5518,2702,8116,16540
GGCAGGTTTTCGACCT,sample,150699,149697,7574,142123,21845,120278,72135,6281,23031,2891,95166,15940,6351,1881,9632,15780
GATGCGTTTTCGACCT,sample,62586,61937,8068,53869,5293,48576,19498,1294,15093,1351,34591,11340,5921,1907,1783,3283
GCTCTTCTTTCGACCT,sample,91403,90766,3890,86876,14865,72011,47484,4868,11980,1695,59464,5984,3450,1479,10176,9865
CTAAGCATTTCGACCT,sample,208881,207570,7612,199958,21687,178271,122662,10372,26012,3064,148674,16161,5790,2180,13844,16436
GCCTATTCTTCGACCT,sample,111763,111036,6607,104429,9467,94962,56898,3787,18577,2001,75475,13699,4812,1244,6008,5849
GCGTTACCTTCGACCT,sample,178492,177391,6814,170577,21462,149115,104027,8529,24101,3692,128128,8766,3988,1912,10672,16223
GGCGTACCTTCGACCT,sample,118935,118300,4898,113402,18162,95240,63652,6816,14953,1423,78605,8396,4480,1652,8169,13324
CGTCGAGGTTCGACCT,sample,123143,122148,7180,114968,14725,100243,50271,4090,23740,2439,74011,19703,7225,1884,9183,10505
CAGCTTCGTTCGACCT,sample,108197,107491,4006,103485,16766,86719,61396,5299,11762,1607,73158,6655,3222,1313,8435,12131
TAACGCCATTCGACCT,sample,146036,145207,7724,137483,15618,121865,64745,5481,28944,3257,93689,19438,5762,1639,7667,9992
CCTAACTATTCGACCT,sample,113210,112674,2105,110569,24402,86167,69867,6480,7003,1696,76870,1121,1039,1165,12440,17310
ATATGCAATTCGACCT,sample,82291,81742,4591,77151,5549,71602,38800,4456,16277,1585,55077,10484,4115,1074,1879,3250
GTCGTTCTTCCAGACT,sample,77551,77104,2228,74876,12778,62098,42153,3162,12395,1550,54548,2838,2608,2039,5639,9507
AGCTGAATTCCAGACT,sample,81265,80587,8522,72065,5960,66105,22702,1656,26692,3026,49394,12029,5999,1950,2635,3444
CATAATGGTCCAGACT,sample,107430,106790,4641,102149,15027,87122,52938,3969,18232,1863,71170,10120,5385,2245,6612,11299
TATACGGATCCAGACT,sample,99124,98514,4727,93787,16068,77719,47053,3041,17699,1643,64752,8283,3874,1615,8329,11688
CATACTCCTCCAGACT,sample,106046,105376,5634,99742,17703,82039,46999,2919,17877,1794,64876,12450,5446,1798,10057,12683
GGTAGAGATCCAGACT,sample,77000,76443,2387,74056,14721,59335,43817,2979,7411,712,51228,4416,2335,1313,7903,10389
CCGTACGCTCCAGACT,sample,100095,99356,4419,94937,10073,84864,51521,4409,16908,1990,68429,10036,4558,1621,7684,7043
TGGATCAATCCAGACT,sample,46747,46346,3859,42487,4065,38422,17313,1029,12851,1340,30164,5889,3956,1629,2051,2589
GATGCGTTTCCAGACT,sample,110016,109086,10135,98951,8961,89990,32501,2182,31816,3224,64317,20267,7137,1645,5141,6641
CCATTCTTTCCAGACT,sample,17058,16843,1727,15116,4696,10420,4621,365,3024,321,7645,2089,1830,705,1032,2738
CGGTTGGTTCCAGACT,sample,72912,72385,3816,68569,9614,58955,33984,2576,13797,1429,47781,7169,3493,1406,5892,7109
GAGATTCTTCCAGACT,sample,78149,77595,2070,75525,9861,65664,45861,3671,10771,1394,56632,3967,2703,1324,5825,6861
CTAAGCATTCCAGACT,sample,140674,139638,8975,130663,11570,119093,63196,4597,28841,3387,92037,19072,6328,1867,8732,8312
AAGGTCTGTCCAGACT,sample,30127,29921,1766,28155,3968,24187,15538,1188,4639,514,20177,2308,2149,1095,2620,2786
TGCGCTCCTCCAGACT,Pos_Ctrl,12127,11949,997,10952,526,10426,8840,673,592,96,9432,225,2623,2125,640,254
ATACCGCCTCCAGACT,sample,26067,25855,3174,22681,2038,20643,8460,611,6643,861,15103,4068,2959,1022,1196,1199
GCGTTACCTCCAGACT,sample,53356,52936,2593,50343,6157,44186,29046,2029,7995,851,37041,4265,3232,1643,3604,4511
CGTCGAGGTCCAGACT,Pos_Ctrl,25692,25292,1910,23382,872,22510,18840,1685,1382,173,20222,430,3825,3762,937,366
CGCGGTCGTCCAGACT,sample,55972,55537,2031,53506,7220,46286,32200,3045,7252,1074,39452,2715,1979,1087,4049,5045
CGTAGAACTCCAGACT,sample,86047,85314,6579,78735,8040,70695,29057,2037,22891,2305,51948,14405,5684,1448,2086,5280
ATATGCAATCCAGACT,sample,69463,69036,3295,65741,10369,55372,33389,2298,12095,1059,45484,6531,3198,1006,3010,7602
AACCGGTTACCATTAT,sample,102481,101667,10574,91093,16291,74802,32238,2489,22303,2449,54541,15323,6924,1978,6252,10232
TCTAGGTTACCATTAT,sample,154283,153414,4281,149133,30598,118535,84927,6857,19642,2349,104569,4760,2616,1940,15555,21597
GTCGTTCTACCATTAT,sample,149518,148934,3283,145651,37922,107729,85658,7495,9936,1963,95594,2677,2504,2070,16829,25887
GAGCCTCCACCATTAT,sample,160212,158915,16222,142693,23971,118722,48786,2907,36508,3527,85294,26994,9361,1930,9855,16573
TCATACCAACCATTAT,sample,120142,119474,4731,114743,23304,91439,66791,6222,11919,1089,78710,5418,2413,1463,19260,16221
TCTCAGGAACCATTAT,sample,184852,183547,9211,174336,19787,154549,91985,6124,33582,4330,125567,18528,6269,2006,10068,13105
TGGATCAAACCATTAT,sample,140383,139328,10823,128505,16655,111850,51684,5137,30679,3075,82363,21275,7676,1933,9144,11263
TGCGCGTTACCATTAT,sample,169828,168953,5524,163429,32433,130996,95777,8480,16215,1760,111992,8764,3510,1628,18032,22858
AGCGTCTTACCATTAT,sample,273448,271466,23583,247883,28652,219231,87391,6618,68970,7199,156361,49053,11814,2659,13046,19840
CGGTTGGTACCATTAT,sample,112095,111530,3169,108361,29118,79243,61931,5069,8061,1261,69992,2921,2353,1735,9584,18962
ACGCTTAAACCATTAT,sample,213568,212268,9648,202620,35725,166895,84395,8929,40662,4475,125057,28434,7982,2202,9685,27003
CATTCGGTACCATTAT,sample,147101,146217,4783,141434,18200,123234,75847,6298,30926,1975,106773,8188,2799,1255,11158,13296
TAACGAAGACCATTAT,sample,145860,144891,7859,137032,19386,117646,74019,6798,20402,2311,94421,14116,4783,1727,8856,13705
GCTGCTTCACCATTAT,sample,114616,113912,8329,105583,10870,94713,38935,3131,29032,3150,67967,20465,7565,2003,5811,6961
AAGTAGAGACCATTAT,sample,171108,170032,5316,164716,20700,144016,111073,9036,14758,1565,125831,7584,3675,1732,9906,15179
TCAATCAGACCATTAT,sample,117368,116640,7634,109006,8227,100779,44730,5137,27115,3028,71845,20769,5541,1290,5003,4766
ATTCTACCACCATTAT,sample,153076,152260,7717,144543,19143,125400,74059,5681,27421,3509,101480,14730,5958,1872,9034,13204
AGATACTAACCATTAT,sample,133705,132877,6703,126174,14717,111457,74040,5662,19784,2053,93824,9918,4087,1546,6031,9652
TCTAGGTTCAATGGAT,sample,95669,95132,6243,88889,16219,72670,43180,2947,14975,1590,58155,9978,4668,1584,8504,11125
CTGGTCTTCAATGGAT,sample,223025,221822,9868,211954,43073,168881,104906,8514,31957,3577,136863,19927,7097,2202,17692,29267
AGAGTTCTCAATGGAT,sample,187649,186674,5632,181042,41351,139691,112470,8721,11203,1429,123673,5868,3695,2965,15041,28678
GGAGAAGCCAATGGAT,sample,97788,97196,2877,94319,19215,75104,59545,3639,8959,713,68504,2248,2542,1972,8815,14532
TCATCGAACAATGGAT,sample,178550,177385,10086,167299,26991,140308,82592,6326,28518,3084,111110,19788,7559,2338,13137,19236
GACTCAAGCAATGGAT,sample,193790,192591,9203,183388,27170,156218,88394,6746,39904,3840,128298,17334,6211,2236,11246,19683
ATACGTTCCAATGGAT,sample,129861,128970,6349,122621,18915,103706,64601,4243,21781,2958,86382,10123,4223,1809,12743,14570
TGGATCAACAATGGAT,sample,149672,148750,3890,144860,33075,111785,89622,7821,9508,1432,99130,3402,2061,1527,16093,22804
GATGCGTTCAATGGAT,sample,78976,78528,2833,75695,19246,56449,39307,3403,8749,864,48056,4126,3321,2061,4813,12503
CCATTCTTCAATGGAT,sample,70976,70502,3576,66926,10774,56152,34254,2487,11625,1233,45879,6553,4031,1615,4591,7692
GAGATTCTCAATGGAT,sample,331282,328826,20697,308129,14066,294063,116791,7359,118993,18147,235784,32773,8524,2765,7321,8321
CTAAGCATCAATGGAT,sample,139660,138774,5947,132827,21972,110855,69507,6488,20471,2319,89978,12070,5024,1473,11392,15342
AAGGTCTGCAATGGAT,sample,122419,121666,5618,116048,16178,99870,58988,4637,22236,2310,81224,11699,5245,1646,9040,12353
GGCGACGACAATGGAT,sample,90450,89934,4376,85558,8903,76655,40286,2824,22858,2605,63144,8082,4226,1731,6790,6638
TAACGAAGCAATGGAT,sample,53226,52912,1503,51409,7751,43658,28723,2181,8434,1507,37157,2813,2186,1664,2806,5308
AGCAGAGCCAATGGAT,sample,103830,102536,16009,86527,6776,79751,19389,1246,30868,3244,50257,25004,9384,1724,2508,3644
ATACCGCCCAATGGAT,Neg_Ctrl,1658,1320,200,1120,128,992,562,48,240,21,802,121,384,203,67,67
GCGTTACCCAATGGAT,sample,173419,172330,7636,164694,21171,143523,93740,8651,24561,2464,118301,14107,6129,2084,11549,15256
CGTCGAGGCAATGGAT,sample,90746,90072,5609,84463,11399,73064,42013,3897,15028,1445,57041,10681,4584,1288,6286,8095
CAGCTTCGCAATGGAT,Neg_Ctrl,1015,795,101,694,88,606,352,36,131,11,483,76,265,166,61,57
CGCGGTCGCAATGGAT,sample,198959,197450,14131,183319,10604,172715,71912,6061,61648,7977,133560,25117,8521,2047,3615,5026
TCTCCTAGCAATGGAT,sample,141777,140850,5772,135078,16407,118671,72159,8107,23639,2886,95798,11880,4283,1548,5595,11356
ATGAATAGCAATGGAT,sample,112441,111627,7559,104068,7494,96574,51526,6994,20321,2483,71847,15250,5757,1410,5346,4577
TCAATCAGCAATGGAT,sample,110160,109326,5845,103481,12022,91459,52684,4538,18957,2326,71641,12954,5405,1459,5286,8670
CGCGAGACCAATGGAT,sample,128149,127162,7696,119466,12322,107144,63663,6036,21469,2494,85132,13482,5312,1737,7823,8550
AGATACTACAATGGAT,sample,175389,174145,7867,166278,15499,150779,102087,7870,21902,2766,123989,16154,5838,2048,6892,9906
CCTAACTACAATGGAT,Pos_Ctrl,11168,10886,1216,9670,596,9074,7409,663,645,68,8054,289,2387,1798,554,343
TCTAGGTTAGATTCAT,sample,31140,30920,1468,29452,4949,24503,16951,1035,4671,417,21622,1429,2206,1661,2736,3768
TATACGGAAGATTCAT,sample,109834,109182,4614,104568,18678,85890,61091,4104,13474,1695,74565,5526,3587,2129,8711,13287
GAGCCTCCAGATTCAT,sample,71778,71242,4979,66263,14435,51828,30196,1849,11638,1237,41834,6908,4305,1683,5718,10142
TGATTCCGAGATTCAT,sample,96239,95669,3904,91765,17295,74470,54041,3521,11052,977,65093,4879,3232,1865,8937,11863
TCTCAGGAAGATTCAT,sample,111163,110436,5412,105024,12770,92254,53019,3552,24488,2128,77507,9067,3826,1516,8200,8967
GGCAGGTTAGATTCAT,sample,54486,54113,1743,52370,9568,42802,31196,2371,6132,890,37328,2213,2161,1583,4430,6899
CCATTCTTAGATTCAT,sample,109457,108777,5066,103711,13276,90435,52807,3961,21420,2836,74227,9411,4112,1716,7034,10210
ACGCTTAAAGATTCAT,sample,93056,92504,2682,89822,14970,74852,55450,4990,9759,1475,65209,3178,2114,1338,5600,11190
GAGATTCTAGATTCAT,sample,90867,90220,6053,84167,9135,75032,33219,2368,22817,2819,56036,13809,5631,1354,4913,6490
CTAACCGGAGATTCAT,sample,59994,59499,3621,55878,9697,46181,28161,2229,9814,757,37975,5220,3491,1397,4733,7005
GCCTATTCAGATTCAT,sample,73687,73175,3711,69464,10362,59102,35244,3083,11700,1308,46944,7767,3864,1025,5097,7044
GTCGCGAAAGATTCAT,sample,34768,34473,2483,31990,4206,27784,14582,963,7436,845,22018,3958,2831,1054,1861,2839
TTATGACGAGATTCAT,sample,70244,69799,1900,67899,12439,55460,43658,4565,4854,503,48512,1880,1579,1262,3922,9322
TCAATCAGAGATTCAT,sample,51075,50665,2210,48455,5008,43447,25205,2430,9255,1109,34460,5448,2775,926,2559,3245
CGCGAGACAGATTCAT,sample,115847,114971,7277,107694,8910,98784,50492,3549,25287,2696,75779,16760,5851,1543,6185,5986
AGATACTAAGATTCAT,sample,118029,117173,7813,109360,8300,101060,52002,6730,24282,2797,76284,15249,5480,1462,1876,5042
CCTAACTAAGATTCAT,sample,172616,171349,9421,161928,14722,147206,70656,5086,38135,5450,108791,27879,8238,2017,6249,10304
ATATGCAAAGATTCAT,sample,92202,91565,5321,86244,10074,76170,40549,3151,18270,2622,58819,11578,4899,1318,4795,7144
AGCTGAATCAATCTTG,sample,167498,166502,7149,159353,27889,131464,89618,5883,21080,2740,110698,12143,5499,2412,14040,19995
CTAGCGACCAATCTTG,sample,153468,152645,6128,146517,23609,122908,80191,5706,25658,3518,105849,7835,3780,2061,14678,17010
GCAACTAGCAATCTTG,sample,49302,49033,1832,47201,7579,39622,25770,2001,8288,812,34058,2751,2734,1662,5438,5337
GGCAGGTTCAATCTTG,sample,75757,75207,3761,71446,10682,60764,34590,3020,13040,1503,47630,8611,4192,1478,4875,7328
ATGGCGTTCAATCTTG,sample,109689,109027,4533,104494,20470,84024,55606,5452,13737,1207,69343,8022,3738,1411,14538,15065
TGCGCGTTCAATCTTG,sample,143662,142824,4981,137843,18836,119007,89856,6662,13735,1377,103591,7377,4173,2413,10785,14411
CCATTCTTCAATCTTG,sample,92624,91771,5632,86139,9610,76529,44562,2602,16768,1796,61330,10801,4490,1186,5380,6321
AGCGTCTTCAATCTTG,sample,154087,152770,8152,144618,17744,126874,70155,7377,29118,3441,99273,16783,5690,1465,8730,12027
ACGCTTAACAATCTTG,sample,191623,190119,15266,174853,16280,158573,65283,5600,45674,5048,110957,36968,9155,1907,6564,10116
GAGATTCTCAATCTTG,sample,161803,160564,7470,153094,17699,135395,69253,6768,35802,4503,105055,19069,5917,1681,8371,12537
GGCGACGACAATCTTG,sample,72892,72297,3912,68385,7994,60391,33226,2341,15994,1681,49220,7149,3759,1448,5291,5404
GCCTATTCCAATCTTG,sample,147096,146063,6136,139927,13533,126394,77537,5749,28838,3179,106375,11091,5093,1925,7673,9416
TGCGCTCCCAATCTTG,sample,126099,125329,4568,120761,15720,105041,63843,5400,24904,2450,88747,8444,3372,1325,8752,11565
CAGCTTCGCAATCTTG,sample,98419,97577,7739,89838,13808,76030,36689,2586,22573,2793,59262,11389,5840,1956,8020,9815
ATGAATAGCAATCTTG,sample,118669,117890,5970,111920,15848,96072,59249,4571,18821,1796,78070,11635,4795,1555,10310,11173
GACTAACCCAATCTTG,sample,100911,100093,5835,94258,14998,79260,44108,3639,18858,2018,62966,10637,5086,1456,6433,10549
CGTAGAACCAATCTTG,sample,150073,149115,6134,142981,17396,125585,75489,6304,30395,3465,105884,9932,4246,1846,7587,12093
AGATACTACAATCTTG,sample,146066,145269,5187,140082,22470,117612,80388,5952,17415,2935,97803,10922,4030,1555,11717,16583
GCGCAATACAATCTTG,Neg_Ctrl,1024,846,112,734,84,650,375,19,171,2,546,83,262,162,58,53
GTCGTTCTCGTTCCGA,sample,122352,121358,11741,109617,14982,94635,41410,2876,28508,3014,69918,18827,7485,1946,9852,9889
CATAATGGCGTTCCGA,sample,144794,143841,7346,136495,21826,114669,78964,6185,16283,1700,95247,11537,4564,1806,17040,16581
TATACGGACGTTCCGA,sample,61447,61036,3616,57420,12219,45201,25745,2311,10222,1294,35967,5629,3816,1652,4797,8710
CATACTCCCGTTCCGA,sample,135261,134411,5188,129223,25136,104087,70979,5681,18961,2072,89940,6394,3453,1701,12298,18298
CGTCGCCACGTTCCGA,sample,115334,114533,5864,108669,16713,91956,55319,4458,20265,2613,75584,9301,3766,1564,11740,12294
TGATTCCGCGTTCCGA,sample,125263,124365,7476,116889,16778,100111,59859,4986,20201,2591,80060,12474,5805,2108,8315,11963
ATACGTTCCGTTCCGA,sample,58564,58191,2215,55976,8642,47334,33089,2605,8155,762,41244,2723,2866,1988,4680,6546
ACGCTTAACGTTCCGA,sample,93481,92763,8153,84610,11992,72618,39596,2382,17872,2058,57468,10710,5330,1913,7787,8547
CATTCGGTCGTTCCGA,sample,76365,75823,5421,70402,12591,57811,35423,2966,12395,1225,47818,5802,4079,2409,4619,8954
TAGCGAGTCGTTCCGA,sample,67342,66865,4514,62351,12262,50089,31838,2475,8788,1111,40626,5877,3448,1475,7649,8169
CCTAGCGGCGTTCCGA,sample,80319,79724,2548,77176,9702,67474,52784,3759,7109,840,59893,2982,2340,1644,5297,7644
TAACGAAGCGTTCCGA,sample,155626,154472,7920,146552,16179,130373,73538,5454,32434,3558,105972,15389,5294,1743,7394,11003
AGCAGAGCCGTTCCGA,sample,125112,124084,9264,114820,14886,99934,55131,5024,22369,2422,77500,14988,6162,1583,5840,10353
CAGCTTCGCGTTCCGA,sample,88919,88326,4765,83561,12786,70775,40582,2782,20041,2095,60623,5275,4102,2231,6310,9703
ATTCTACCCGTTCCGA,sample,146805,145656,11158,134498,14068,120430,58489,5604,34225,3966,92714,18146,7168,2016,6855,10067
GACTAACCCGTTCCGA,sample,201428,199813,20024,179789,12266,167523,58835,4379,60454,7463,119289,36392,11135,2626,4388,6617
GCGCAATACGTTCCGA,sample,113044,112458,5156,107302,12534,94768,58958,4696,18383,2252,77341,10479,4989,1942,4283,8519
AACCGGTTCAATTCGG,sample,174767,173775,5473,168302,33090,135212,91125,6922,23120,2867,114245,11178,4726,1953,17540,23364
TCTAGGTTCAATTCGG,sample,159353,158384,5618,152766,36911,115855,80278,5582,19177,2289,99455,8529,4352,2191,12912,24410
CTGGTCTTCAATTCGG,Pos_Ctrl,37956,37472,2144,35328,1330,33998,28080,2816,2031,342,30111,729,4329,4637,1341,462
GTCGTTCTCAATTCGG,sample,152719,151809,6578,145231,23366,121865,78360,7231,22388,2178,100748,11708,5132,2143,12814,16707
CATACTCCCAATTCGG,Pos_Ctrl,29801,29217,2373,26844,1409,25435,20940,1973,1751,207,22691,564,4341,4186,1337,760
CTAGCGACCAATTCGG,sample,122108,121294,4841,116453,25110,91343,63206,6201,13002,1987,76208,6947,3656,1501,13705,17099
TGATTCCGCAATTCGG,sample,139469,138560,4202,134358,26437,107921,81878,5541,13892,1538,95770,5072,3037,1676,18770,19004
GACTCAAGCAATTCGG,Pos_Ctrl,41007,40489,2791,37698,1620,36078,30250,2668,2140,271,32390,749,4993,5203,2052,710
ATACGTTCCAATTCGG,sample,184657,183490,15530,167960,24791,143169,68366,4658,37548,3799,105914,28798,10064,2461,11517,16765
CCGTACGCCAATTCGG,sample,105886,105123,3519,101604,24714,76890,55079,4232,12276,1222,67355,4081,3613,2087,11477,17238
TGGATCAACAATTCGG,sample,81147,80600,4732,75868,12813,63055,37525,2204,14621,1890,52146,6815,4033,1884,7602,9420
ATGGCGTTCAATTCGG,Pos_Ctrl,81376,80468,4261,76207,2982,73225,60671,5829,4711,556,65382,1458,5620,7021,3200,1069
CCATTCTTCAATTCGG,sample,151578,150730,3462,147268,29006,118262,93014,8448,11781,1157,104795,3862,3081,2265,14430,21026
AGCGTCTTCAATTCGG,sample,146659,145779,6341,139438,22781,116657,76995,5528,19733,2458,96728,11943,5727,2744,11510,16856
TAGCGAGTCAATTCGG,sample,137576,136881,4177,132704,34288,98416,82080,5830,7890,1099,89970,1517,1608,1601,20513,24781
GAGATTCTCAATTCGG,Pos_Ctrl,35782,35482,1887,33595,1494,32101,26701,2612,1944,266,28645,578,4415,4810,1319,667
CTAACCGGCAATTCGG,sample,119398,118623,5067,113556,16819,96737,53763,3026,28048,3222,81811,8678,4053,1966,8084,12372
GCTGCTTCCAATTCGG,sample,112759,112089,4681,107408,23122,84286,60258,4464,11930,1334,72188,6300,4243,2327,11126,16166
GCCTATTCCAATTCGG,sample,121613,120767,6187,114580,16807,97773,59838,4308,19154,2135,78992,12338,5192,2146,11426,11732
AGCAGAGCCAATTCGG,Pos_Ctrl,33322,33032,1655,31377,1260,30117,25069,2505,1758,236,26827,549,4324,4674,1162,521
TGCGCTCCCAATTCGG,sample,66832,66421,3433,62988,14155,48833,30111,2484,9814,1269,39925,5155,3545,1473,7286,9712
ATACCGCCCAATTCGG,sample,101739,101083,5767,95316,13725,81591,42323,2917,23462,2540,65785,10349,4952,2012,8156,9733
GTCGCGAACAATTCGG,sample,104655,104095,3271,100824,22875,77949,56207,4008,13062,1371,69269,3301,2319,1748,12014,16026
CGTCGAGGCAATTCGG,Pos_Ctrl,51878,51455,2331,49124,1939,47185,39336,4162,2574,280,41910,833,5204,6058,2216,660
AAGTAGAGCAATTCGG,sample,143514,142790,3015,139775,19203,120572,100946,7837,7786,1381,108732,2622,1827,1706,6032,14432
TCAATCAGCAATTCGG,sample,103661,103145,3837,99308,12657,86651,50855,5367,17250,1577,68105,11602,4084,1484,5965,9159
TTAACTGACAATTCGG,sample,185542,184563,7210,177353,23736,153617,104303,10501,22739,1904,127042,14170,6240,2541,8269,17036
ATATGCAACAATTCGG,sample,84103,83549,5671,77878,8391,69487,32339,2065,19869,2429,52208,12785,5675,1516,3670,5538
TCTAGGTTAACTCCGG,sample,145789,145037,5658,139379,25265,114114,75398,5565,22311,3535,97709,7305,3762,2291,10359,17938
TATACGGAAACTCCGG,sample,164638,163670,4226,159444,32023,127421,97356,7759,14112,2015,111468,6179,3100,2147,14225,22617
ATTCAAGGAACTCCGG,sample,151780,150648,8542,142106,15854,126252,70293,4695,32451,4523,102744,14290,6565,2343,8076,11993
TGATTCCGAACTCCGG,sample,89148,88591,4418,84173,14237,69936,45982,3697,11098,1483,57080,7676,4157,1801,6792,10371
GACTCAAGAACTCCGG,sample,47579,47297,1921,45376,5101,40275,25810,2777,6386,840,32196,4462,2688,901,1995,3266
CCGCAGTCAACTCCGG,sample,107946,107090,5917,101173,14524,86649,45490,2757,24675,3603,70165,10124,4966,1946,7443,10467
TGGATCAAAACTCCGG,sample,129327,128496,6852,121644,13661,107983,64313,3929,26342,2900,90655,10499,4918,1872,8665,9092
GATGCGTTAACTCCGG,sample,120566,119684,8769,110915,15059,95856,47419,3874,23935,2437,71354,18191,6778,1701,6586,10831
TAGCGAGTAACTCCGG,sample,78422,77949,4972,72977,14393,58584,35482,2206,13031,1291,48513,6574,3833,1533,8104,10351
GCTCTTCTAACTCCGG,sample,123201,122314,6728,115586,19348,96238,60888,5299,17897,1850,78785,10304,4962,2100,10687,14069
GAGATTCTAACTCCGG,sample,107059,106370,4860,101510,12782,88728,50689,3520,24385,3145,75074,6989,4020,2041,7937,9396
CCTAGCGGAACTCCGG,sample,54717,54336,2886,51450,7111,44339,26468,1603,10404,1224,36872,4640,3267,1680,4243,5067
CTAACCGGAACTCCGG,sample,17145,16992,1653,15339,2563,12776,6953,456,2976,309,9929,2082,1994,991,1604,1741
TAACGAAGAACTCCGG,sample,123694,122908,4838,118070,20807,97263,68220,5802,14078,1249,82298,7914,3688,1693,9686,15192
GGCGTACCAACTCCGG,sample,88683,88012,3616,84396,14005,70391,48765,3856,10799,1018,59564,5953,3535,1518,5560,10474
CGTCGAGGAACTCCGG,sample,115015,114148,5532,108616,11393,97223,54789,3655,25433,2850,80222,10496,4803,1756,6858,7972
AAGTAGAGAACTCCGG,sample,121266,120625,4343,116282,15329,100953,74464,7153,13056,989,87520,5291,2781,1463,8807,10923
ATTCTACCAACTCCGG,sample,88080,87313,4763,82550,12408,70142,38644,4067,16435,1836,55079,9160,4755,1292,5166,8753
CGCGAGACAACTCCGG,sample,140207,139138,7228,131910,17014,114896,74840,5865,18683,1919,93523,13589,5525,1933,6584,11707
ATATGCAAAACTCCGG,sample,205383,203894,16811,187083,10973,176110,62564,4360,63800,7057,126364,38329,11117,2265,3891,5723
GGAGAAGCCCTGAAGG,sample,94202,93497,4605,88892,12970,75922,48414,3154,15737,1901,64151,6716,3311,1616,6194,9520
CATACTCCCCTGAAGG,sample,111217,110302,5694,104608,16778,87830,56527,4859,15930,1665,72457,8849,3941,1627,7101,12164
CTAGCGACCCTGAAGG,Neg_Ctrl,731,562,115,447,79,368,225,13,71,12,296,47,147,81,42,37
TCATACCACCTGAAGG,sample,109343,108560,4875,103685,20474,83211,51760,5425,16582,2243,68342,7201,3229,1503,6860,14428
ATACGTTCCCTGAAGG,Neg_Ctrl,1013,818,182,636,98,538,359,29,89,10,448,51,222,141,50,58
TGCGCGTTCCTGAAGG,Neg_Ctrl,681,392,165,227,34,193,119,19,27,4,146,24,81,61,21,10
CCATTCTTCCTGAAGG,sample,127896,126968,6884,120084,18249,101835,65009,5077,18506,2249,83515,10994,4458,1640,10794,12535
CGGTTGGTCCTGAAGG,sample,59018,58462,4084,54378,7327,47051,27652,2019,9990,1227,37642,6163,3171,1117,5501,5057
CTAAGCATCCTGAAGG,Neg_Ctrl,891,735,95,640,83,557,354,31,111,12,465,49,212,134,56,45
CTAACCGGCCTGAAGG,sample,102447,101721,3846,97875,14196,83679,61439,4937,11439,1638,72878,4226,2885,1807,7140,10769
TAACGAAGCCTGAAGG,sample,125732,124776,8055,116721,15161,101560,53968,4443,24295,2783,78263,16071,5863,1737,6588,10582
TGCGCTCCCCTGAAGG,Neg_Ctrl,514,403,129,274,40,234,138,10,50,5,188,31,113,68,12,21
ATACCGCCCCTGAAGG,sample,107588,106709,9246,97463,10640,86823,36656,3422,27497,2680,64153,16568,6772,1563,5570,6824
GCGTTACCCCTGAAGG,sample,115519,114763,6321,108442,15285,93157,56831,4142,19082,2047,75913,11055,3774,1668,10731,10582
GGCGTACCCCTGAAGG,sample,103858,103219,4889,98330,11760,86570,57916,5246,14761,1570,72677,7077,3137,1588,9230,8120
GTCGCGAACCTGAAGG,sample,101449,100730,6636,94094,14436,79658,43922,3924,17132,2087,61054,12593,5005,1445,7364,9582
CGTCGAGGCCTGAAGG,sample,66211,65753,3794,61959,6338,55621,29587,2437,14736,1658,44323,7203,3501,1406,3566,4171
CAGCTTCGCCTGAAGG,Neg_Ctrl,619,459,108,351,45,306,224,6,48,6,272,22,137,87,29,27
TCTCCTAGCCTGAAGG,sample,98521,97866,6821,91045,11946,79099,42496,3880,18383,2086,60879,12254,5458,1413,7096,8083
TAACGCCACCTGAAGG,sample,53283,52885,4231,48654,4899,43755,22892,1859,10747,1005,33639,7252,3731,1004,2542,3259
ATTCTACCCCTGAAGG,sample,98684,97964,7115,90849,12029,78820,41124,2378,19178,2084,60302,14056,5996,1316,4811,7952
AGATACTACCTGAAGG,sample,84145,83524,4816,78708,10554,68154,40625,3688,13868,1912,54493,8061,4401,1388,4570,7680
GTCGTTCTAATATTCG,sample,147327,146298,8074,138224,20158,118066,58161,4062,31954,3257,90115,20632,7600,2279,9833,14758
GACGTATGAATATTCG,sample,102954,102229,3284,98945,15684,83261,59790,3858,13698,1334,73488,4581,2825,1931,10661,11681
CATAATGGAATATTCG,sample,104954,104220,3778,100442,14141,86301,54342,4408,19563,2072,73905,5916,2933,1576,10048,10166
CTAGCGACAATATTCG,sample,116937,116197,4077,112120,22331,89789,66329,5472,12138,911,78467,4939,3417,1888,9854,15964
ATTCAAGGAATATTCG,sample,130768,129865,6230,123635,29850,93785,61287,5337,15476,1874,76763,9811,4335,1834,10715,20632
TGATTCCGAATATTCG,sample,127179,126238,6747,119491,14269,105222,62461,4172,24832,3031,87293,10726,4860,1948,8706,10711
ATACGTTCAATATTCG,sample,122208,121392,5545,115847,18192,97655,68891,4302,14668,1618,83559,8176,4624,2774,6861,13720
CCGTACGCAATATTCG,sample,90063,89323,4232,85091,15050,70041,43689,2813,14930,1774,58619,6835,3736,1653,5839,10800
GATGCGTTAATATTCG,sample,98577,97892,3058,94834,16264,78570,59046,5149,9129,1002,68175,4244,1914,1304,13107,11974
CCATTCTTAATATTCG,sample,104164,103307,4740,98567,12381,86186,54743,4074,17086,2068,71829,8215,3483,1623,8436,8730
CATTCGGTAATATTCG,sample,130790,130065,3977,126088,20621,105467,81743,6384,11384,1257,93127,4699,2913,1730,9143,15609
CTAAGCATAATATTCG,sample,181465,180064,10350,169714,27545,142169,76733,6076,31718,3469,108451,24173,7324,2060,12598,19121
AAGGTCTGAATATTCG,sample,110360,109633,4858,104775,15908,88867,58019,4766,15864,1561,73883,8657,4553,1931,8066,12103
CTAACCGGAATATTCG,sample,108050,107296,4808,102488,14166,88322,59566,5255,14834,1709,74400,6958,3773,1492,7843,10607
GGCGACGAAATATTCG,sample,112325,111505,3805,107700,13537,94163,60644,5881,17530,2224,78174,7884,3342,1717,8291,10254
GCTGCTTCAATATTCG,sample,121253,120500,4324,116176,16050,100126,62966,4717,19604,1699,82570,11140,3659,1506,8698,12185
GCCTATTCAATATTCG,sample,58997,58556,2907,55649,13313,42336,26254,1974,8222,967,34476,4919,3498,1736,3060,8907
CGTCGAGGAATATTCG,sample,88907,88258,5155,83103,8120,74983,41612,2988,17106,1964,58718,11313,5009,1705,3312,5526
CGCGGTCGAATATTCG,sample,74155,73676,2455,71221,8736,62485,43212,2921,11446,1215,54658,3691,2665,1450,5195,6435
AAGTAGAGAATATTCG,sample,133666,132683,6097,126586,13139,113447,70556,4904,23731,2841,94287,11415,4660,1601,5944,9257
GACTAACCAATATTCG,sample,116241,115361,7666,107695,9156,98539,45910,3637,29735,3229,75645,16028,5749,1570,4413,5685
CGTAGAACAATATTCG,sample,121415,120446,6345,114101,11438,102663,57995,4554,23268,2594,81263,14252,5545,1650,6628,7874
GCGCAATAAATATTCG,sample,113200,112289,10241,102048,9869,92179,42989,3215,24753,2483,67742,18739,6611,1552,5375,6424
AGCTGAATAGTCTCCG,sample,142408,141623,3495,138128,19879,118249,76939,4961,27794,2908,104733,5647,2898,1955,10032,14319
TATACGGAAGTCTCCG,sample,151366,150556,6488,144068,25057,119011,73513,4706,25078,2654,98591,13060,5739,2317,12898,17256
CTAGCGACAGTCTCCG,sample,136778,136028,5745,130283,24009,106274,60779,5457,23473,2130,84252,14435,5579,1718,12528,16876
CGTCGCCAAGTCTCCG,sample,126991,126287,6359,119928,21001,98927,56825,5255,20217,2216,77042,14414,6117,2045,9232,14245
GCAACTAGAGTCTCCG,sample,38907,38635,2706,35929,4935,30994,18147,1607,7629,986,25776,2625,2738,1399,3595,3400
ATACGTTCAGTCTCCG,sample,120274,119630,3854,115776,24520,91256,63407,5254,15376,1228,78783,5991,3589,1895,12474,17703
CCGTACGCAGTCTCCG,sample,139624,138793,5007,133786,19612,114174,77751,6338,20164,2236,97915,7685,4283,2169,9183,15036
TCTCAGGAAGTCTCCG,sample,155031,154023,8384,145639,22698,122941,74906,5682,24921,2962,99827,14470,6112,1828,12177,15810
CTAAGCATAGTCTCCG,sample,107129,106426,3794,102632,13702,88930,62515,4729,13260,1719,75775,6707,3970,2094,7258,9604
TAACGAAGAGTCTCCG,sample,120942,120214,6049,114165,18470,95695,57295,4455,20016,2116,77311,11813,5241,1557,8131,13129
TTATGACGAGTCTCCG,sample,84328,83800,3813,79987,9593,70394,42232,5648,13769,1186,56001,7559,3673,1146,3861,6567
TCTCCTAGAGTCTCCG,sample,117480,116701,4225,112476,11745,100731,63054,5581,19662,3012,82716,9422,4054,1440,4733,8642
TCAATCAGAGTCTCCG,sample,108119,107373,6483,100890,8825,92065,39784,3669,31490,3129,71274,13993,5530,1610,3401,6076
CGTAGAACAGTCTCCG,sample,117833,117174,4191,112983,13024,99959,66623,5605,17653,2064,84276,8014,3690,1576,6794,9296
CCTAACTAAGTCTCCG,sample,147708,146692,5840,140852,15397,125455,69031,7319,32635,3473,101666,12997,4616,1612,5118,11165
AGCTGAATTGCCTACG,sample,111696,110830,7659,103171,14694,88477,46072,3424,22033,2427,68105,14521,6355,1974,6439,10183
GAGCCTCCTGCCTACG,sample,99694,98880,8079,90801,8504,82297,41703,2544,21734,2411,63437,13905,6135,2156,4168,5785
GGTAGAGATGCCTACG,sample,121805,120973,7464,113509,16030,97479,55354,3509,20416,2319,75770,15881,7013,1999,9017,11297
TCATACCATGCCTACG,sample,111187,110421,7133,103288,12855,90433,54562,3872,17484,1881,72046,12634,5673,1973,7182,9151
TACGCGAGTGCCTACG,sample,77183,76851,2507,74344,14816,59528,43593,3527,8222,981,51815,3205,2619,1888,7280,10774
TGGATCAATGCCTACG,sample,78555,78090,3697,74393,10210,64183,42232,3642,10977,1049,53209,6283,3762,1815,5050,7470
GCTCTTCTTGCCTACG,sample,68221,67759,2220,65539,9456,56083,43308,3889,5673,665,48981,2548,2385,1865,5480,6971
GAGATTCTTGCCTACG,sample,76542,75985,4630,71355,8661,62694,33557,2221,16529,2058,50086,8329,4530,1826,4347,5579
CTAAGCATTGCCTACG,sample,84745,84091,4967,79124,8408,70716,35791,2410,19323,2099,55114,11093,4372,1377,4213,5537
CCTAGCGGTGCCTACG,sample,47490,47165,2031,45134,5882,39252,26790,2103,6450,907,33240,3002,2393,1381,2964,4407
AGCAGAGCTGCCTACG,sample,97048,96182,9977,86205,9575,76630,27761,2142,23932,2419,51693,20376,8109,1477,4114,6061
ATACCGCCTGCCTACG,sample,81598,81140,2351,78789,8819,69970,52871,3894,8497,1367,61368,3341,2440,1720,3317,6549
GTCGCGAATGCCTACG,sample,99874,99161,7521,91640,8764,82876,41476,3061,21310,2293,62786,14736,6570,1905,3757,5420
CGTCGAGGTGCCTACG,sample,75323,74774,5225,69549,5832,63717,29014,2095,21232,2416,50246,8960,4934,1613,2394,3823
CGCGGTCGTGCCTACG,sample,61803,61383,3297,58086,5412,52674,30397,3713,11775,1280,42172,5509,3424,1280,2219,3940
ATGAATAGTGCCTACG,sample,62747,62381,3231,59150,9048,50102,30601,2003,9805,1631,40406,6062,3301,981,4026,6257
GACTAACCTGCCTACG,Neg_Ctrl,657,566,99,467,57,410,255,19,87,11,342,38,193,117,41,39
AGATACTATGCCTACG,sample,90327,89760,4220,85540,11589,73951,51739,5460,9836,890,61575,6026,3446,1370,6783,7994
GCGCAATATGCCTACG,sample,70963,70514,2232,68282,10762,57520,44404,4474,6325,394,50729,1923,1822,1123,4951,7955
GGAGAAGCCTTAGTTC,sample,148406,147244,9791,137453,19512,117941,62088,4660,27893,3794,89981,19506,7299,2239,11756,14152
CATACTCCCTTAGTTC,sample,164302,163210,5921,157289,20199,137090,85529,6224,31431,3799,116960,10107,4358,2435,8845,14558
TCGAACGACTTAGTTC,sample,141461,140590,3537,137053,29199,107854,79526,6131,13954,2332,93480,5911,2991,1766,18617,21538
GGTAGAGACTTAGTTC,sample,177469,176413,6218,170195,39346,130849,96902,6193,17553,2638,114455,7563,3425,1957,19052,27242
ATTCAAGGCTTAGTTC,sample,145819,144703,9097,135606,20334,115272,66228,4974,25272,2571,91500,16227,6263,2116,10294,14316
TACGCGAGCTTAGTTC,sample,120339,119529,4430,115099,21654,93445,60563,5317,17697,2759,78260,7109,3842,2058,11378,16007
GGCAGGTTCTTAGTTC,sample,147739,146570,7363,139207,21001,118206,69858,6265,25808,3283,95666,12992,5347,1730,11735,15118
GATGCGTTCTTAGTTC,sample,160149,159153,7921,151232,22232,129000,71118,4900,32876,3239,103994,16867,6141,1926,14336,16150
AGCGTCTTCTTAGTTC,sample,204812,203580,8814,194766,28244,166522,108537,10137,27437,2892,135974,17519,6035,2128,15276,20948
CATTCGGTCTTAGTTC,sample,101903,101131,4818,96313,17700,78613,51268,3952,14912,1940,66180,6541,3919,1715,10345,12884
GAGATTCTCTTAGTTC,sample,66001,65551,3851,61700,10557,51143,30519,2990,10207,1032,40726,6395,3506,1287,4804,7185
GCTGCTTCCTTAGTTC,sample,123185,122213,6629,115584,15109,100475,56370,5106,22221,2442,78591,14336,5370,1643,8487,10439
GCCTATTCCTTAGTTC,sample,173308,172038,13176,158862,16815,142047,63323,5731,37921,3973,101244,31099,8920,1988,8244,11377
AGCAGAGCCTTAGTTC,sample,141203,140148,7981,132167,18253,113914,54892,4445,32790,3207,87682,18580,7024,2147,5810,12929
GGCGTACCCTTAGTTC,sample,103158,102420,5732,96688,12911,83777,52610,4122,15685,1687,68295,9673,4569,1419,10071,9248
GTCGCGAACTTAGTTC,sample,99480,98781,4391,94390,13437,80953,51158,4560,15559,1851,66717,7825,4036,1554,5290,9382
CGTCGAGGCTTAGTTC,sample,117774,117004,4923,112081,12876,99205,59835,4784,21992,2395,81827,10199,3945,1471,5363,9087
CAGCTTCGCTTAGTTC,sample,113556,112649,3843,108806,13004,95802,70952,5851,12560,884,83512,5555,3482,1570,8027,9656
TTATGACGCTTAGTTC,sample,108611,107869,4205,103664,14897,88767,58605,6768,12733,1512,71338,9149,2887,1255,6717,10279
TCTCCTAGCTTAGTTC,sample,147905,147111,5263,141848,17995,123853,81697,7421,19837,1975,101534,12923,4510,1992,8153,13945
ATGAATAGCTTAGTTC,sample,133998,133104,3489,129615,13250,116365,81113,5971,21177,2609,102290,5495,2625,1346,7106,9844
TAACGCCACTTAGTTC,sample,134637,133689,7881,125808,16830,108978,59256,5803,25075,2540,84331,16304,5647,1576,7038,12140
GACTAACCCTTAGTTC,sample,118739,117867,5294,112573,13249,99324,65134,5213,16828,1512,81962,10637,4859,1597,8559,9932
CGCGAGACCTTAGTTC,sample,109424,108598,6449,102149,12555,89594,52533,5293,17071,1633,69604,13064,5259,1248,7548,8493
GCGCAATACTTAGTTC,sample,120598,119699,6300,113399,10672,102727,53494,4721,27825,3259,81319,13428,5874,2120,6109,7324
AGCTGAATCGAGCTTC,sample,162230,161305,4162,157143,35352,121791,92090,8154,15624,1301,107714,4622,2227,1576,18544,25770
TCATCGAACGAGCTTC,sample,83840,83263,4227,79036,13131,65905,35751,2676,17422,2193,53173,7863,4835,2217,6275,9496
TCATACCACGAGCTTC,sample,174058,172783,11425,161358,29218,132140,65276,4791,33258,3652,98534,25163,9001,2214,12352,20574
TGATTCCGCGAGCTTC,sample,147144,146235,6536,139699,29840,109859,73524,5705,18112,2369,91636,10149,4854,1899,13310,19840
ATACGTTCCGAGCTTC,sample,167404,166232,8402,157830,17894,139936,77971,5552,36862,3979,114833,15572,5901,2672,8699,12944
CCGCAGTCCGAGCTTC,sample,131452,130620,4272,126348,21280,105068,76377,6080,16136,1855,92513,4620,3028,1837,10435,15497
CCGTACGCCGAGCTTC,sample,123378,122543,3987,118556,18425,100131,66872,4806,18504,2479,85376,7470,3569,1733,11107,13397
TCTCAGGACGAGCTTC,sample,140437,139645,5534,134111,26452,107659,73594,5465,17115,2071,90709,9414,4591,1671,13579,18980
CGGTTGGTCGAGCTTC,sample,98999,98384,5422,92962,12066,80896,46394,4703,16233,1677,62627,11889,3988,1292,5404,8057
GCTCTTCTCGAGCTTC,sample,92237,91593,3562,88031,10924,77107,50179,3405,15379,1671,65558,6473,3491,1738,7584,7911
CCTAGCGGCGAGCTTC,sample,68956,68420,4134,64286,8256,56030,29979,2481,13533,1438,43512,8599,4466,1192,5329,5221
CTAACCGGCGAGCTTC,sample,81926,81454,3159,78295,12638,65657,47029,3718,9446,1197,56475,4267,2858,1333,5792,8627
GGCGACGACGAGCTTC,sample,87751,87131,4309,82822,8429,74393,45010,3831,15478,1366,60488,8708,4105,1306,5019,5698
GCTGCTTCCGAGCTTC,sample,103652,102788,5689,97099,10987,86112,44436,3399,24555,2035,68991,11687,4345,1329,4315,7612
GCGTTACCCGAGCTTC,sample,111444,110642,4761,105881,14277,91604,53514,3834,21344,2054,74858,10858,4543,1638,5052,9655
GGCGTACCCGAGCTTC,sample,81813,81293,3460,77833,13143,64690,42377,3896,11145,1075,53522,6197,3599,1518,5054,9826
CGCGGTCGCGAGCTTC,sample,77346,76772,3683,73089,9149,63940,37540,2770,13896,1630,51436,8104,4210,1442,4522,5971
TTATGACGCGAGCTTC,sample,92508,91803,5383,86420,7958,78462,38355,2669,23224,2398,61579,11816,5152,1598,4209,5264
TCTCCTAGCGAGCTTC,sample,98844,98183,3303,94880,17477,77403,60158,5124,7995,675,68153,3451,2806,1758,4673,12678
GACTAACCCGAGCTTC,sample,66375,65883,1809,64074,10157,53917,43566,4028,4382,201,47948,1740,1362,1102,4943,7170
CGTAGAACCGAGCTTC,sample,238710,236587,19708,216879,12503,204376,78754,4522,79207,8762,157961,33131,10410,2369,5873,7030
GCGCAATACGAGCTTC,sample,117811,116908,5241,111667,11297,100370,64648,5647,16729,1719,81377,11627,5050,1665,4849,8390
CTGGTCTTGTAGAATG,Pos_Ctrl,26256,25806,2045,23761,1152,22609,18868,1637,1491,184,20359,429,3886,3522,1429,576
GTCGTTCTGTAGAATG,sample,135829,134892,6222,128670,14591,114079,59830,4231,35001,4726,94831,10291,4680,1804,9527,10073
TATACGGAGTAGAATG,sample,127362,126612,3498,123114,29012,94102,76892,5110,8725,772,85617,2603,1883,1624,16416,20580
GAGCCTCCGTAGAATG,sample,106937,106278,2456,103822,23564,80258,64461,5870,7685,332,72146,1910,1341,1519,11251,16870
CATACTCCGTAGAATG,sample,131921,130984,7406,123578,20319,103259,60171,4574,21421,2598,81592,14495,5661,1843,10771,14817
TCGAACGAGTAGAATG,sample,92005,91495,3586,87909,16520,71389,50146,4360,10641,1179,60787,5063,3254,1743,8023,11622
TCATACCAGTAGAATG,sample,137190,136233,4230,132003,21657,110346,84941,6415,11911,1339,96852,5740,3716,2323,10025,16209
ATTCAAGGGTAGAATG,sample,139162,138300,6002,132298,19425,112873,76471,5650,19048,2958,95519,8746,4346,1883,12571,13996
GCAACTAGGTAGAATG,Pos_Ctrl,4632,4589,235,4354,235,4119,3268,381,289,45,3557,136,1615,1462,221,104
TACGCGAGGTAGAATG,sample,125756,124721,9246,115475,14041,101434,47132,3309,29466,3562,76598,17965,7118,2106,5674,10011
CCGCAGTCGTAGAATG,sample,93544,92672,6048,86624,8923,77701,36518,4433,20153,2289,56671,14308,5493,1185,2086,6286
GGCAGGTTGTAGAATG,sample,119298,118513,5770,112743,18388,94355,59259,5104,18252,1936,77511,9804,4274,1601,8474,13445
CATTCGGTGTAGAATG,sample,91468,90314,11050,79264,8389,70875,25828,1908,23730,2352,49558,17057,7448,1779,4119,5372
GCTCTTCTGTAGAATG,Pos_Ctrl,38475,37877,2122,35755,1228,34527,28462,2605,2451,227,30913,782,4466,4794,1212,386
GGCGACGAGTAGAATG,sample,106072,105359,6321,99038,13397,85641,53976,4447,15167,2080,69143,9971,4574,1829,4615,9129
GCCTATTCGTAGAATG,sample,131062,130056,7309,122747,13502,109245,59266,5935,25917,2703,85183,15424,5739,1730,6008,9307
ATACCGCCGTAGAATG,sample,117434,116506,4954,111552,15463,96089,52744,5880,23002,3273,75746,11190,3690,1460,6443,12126
GTCGCGAAGTAGAATG,sample,108609,107756,8767,98989,19817,79172,46218,3330,15621,1702,61839,12301,5973,2031,9925,13182
CGCGGTCGGTAGAATG,Pos_Ctrl,35076,34600,1875,32725,1133,31592,26411,2351,1948,247,28359,635,4383,4771,1257,388
ATGAATAGGTAGAATG,sample,148565,147468,11539,135929,17551,118378,54934,4451,31624,3534,86558,23835,7835,1780,7201,11269
TAACGCCAGTAGAATG,sample,18255,18081,1242,16839,3516,13323,7361,482,3477,370,10838,1633,1892,938,947,2294
ATTCTACCGTAGAATG,sample,125171,124391,4535,119856,16696,103160,70082,4736,18823,2570,88905,6949,3404,1827,8285,11791
CGTAGAACGTAGAATG,sample,122993,122090,6880,115210,16645,98565,54832,3856,21853,2085,76685,15939,6741,1675,7855,12005
GACGTATGCAATAGTC,sample,85932,85455,3620,81835,16431,65404,44132,3653,10964,1100,55096,5555,3289,1384,11148,11550
TATACGGACAATAGTC,sample,115116,114472,5136,109336,24820,84516,49087,3268,17707,2143,66794,12311,5695,1775,9142,17553
GGAGAAGCCAATAGTC,sample,107886,107221,5098,102123,14085,88038,45797,3738,23489,3121,69286,11893,4945,1822,4734,10009
GACTCAAGCAATAGTC,sample,132516,131914,3227,128687,23422,105265,80006,6700,12766,1608,92772,4185,3049,1801,13433,16758
TCTCAGGACAATAGTC,sample,81457,80986,3376,77610,10795,66815,40524,3373,15713,1653,56237,5552,3260,1793,8499,7884
TGGATCAACAATAGTC,sample,98680,98192,2133,96059,13058,83001,57912,4153,15400,2033,73312,3503,2527,2021,7184,10084
GATGCGTTCAATAGTC,sample,127466,126673,8219,118454,22001,96453,56805,4455,19615,1897,76420,13681,5140,1591,14831,15644
ATGGCGTTCAATAGTC,sample,67157,66692,4166,62526,9180,53346,31199,2311,11270,1229,42469,7337,4177,1616,6335,6438
TGCGCGTTCAATAGTC,sample,158640,157719,5531,152188,25805,126383,90997,6169,17541,1450,108538,10226,5287,2438,9090,18679
CCATTCTTCAATAGTC,sample,136901,136026,6365,129661,19078,110583,72463,5440,19124,2385,91587,11171,5249,1956,10296,13690
AGCGTCTTCAATAGTC,sample,131701,130951,5000,125951,22282,103669,65098,5665,22910,2719,88008,7277,2836,1495,13423,15654
CTAAGCATCAATAGTC,sample,116257,115474,3968,111506,14675,96831,75209,4854,11301,1097,86510,4370,3461,2657,8602,11048
AAGGTCTGCAATAGTC,sample,23440,23247,1487,21760,3333,18427,10900,740,4315,440,15215,2032,2279,1208,2058,2460
GGCGACGACAATAGTC,sample,85678,85160,2708,82452,13423,69029,49507,2997,11648,1499,61155,3378,2749,1967,9280,9995
TAACGAAGCAATAGTC,sample,72324,71824,2727,69097,15311,53786,40726,2797,6702,820,47428,2741,3018,2253,6171,10880
AGCAGAGCCAATAGTC,sample,131529,130197,11343,118854,9951,108903,42715,2868,43638,4834,86353,14848,7012,2573,4025,7144
GGCGTACCCAATAGTC,sample,69147,68686,3304,65382,10960,54422,34120,1924,13389,1524,47509,3465,3134,2080,5228,8043
GTCGCGAACAATAGTC,sample,81099,80596,2589,78007,19428,58579,44460,3644,6869,640,51329,2966,2159,1574,9537,13947
CGTCGAGGCAATAGTC,sample,99619,98897,4875,94022,9038,84984,48520,4127,20473,1920,68993,9944,4728,1904,4741,6348
ATGAATAGCAATAGTC,sample,134252,133389,5534,127855,13933,113922,73699,6736,19402,2109,93101,11976,4676,1901,6678,9797
TAACGCCACAATAGTC,sample,137470,136466,8296,128170,15513,112657,51038,3983,32568,2913,83606,22155,7745,1831,4808,11243
GACTAACCCAATAGTC,sample,112974,112115,6690,105425,15971,89454,47781,3934,21473,2242,69254,14024,6309,1698,6631,11172
GCGCAATACAATAGTC,sample,106009,105303,4475,100828,18950,81878,49363,4411,18004,1737,67367,8363,4384,1472,6268,13649
AACCGGTTCGTTACTC,sample,214901,213689,9875,203814,28057,175757,95053,7292,48649,5067,143702,19696,6857,2759,13225,19983
GTCGTTCTCGTTACTC,Neg_Ctrl,1030,809,123,686,129,557,335,26,131,13,466,52,226,128,62,67
GAGCCTCCCGTTACTC,sample,118294,117613,4747,112866,20569,92297,56081,6332,17777,2265,73858,9842,4595,1441,10631,14195
TACGCGAGCGTTACTC,Neg_Ctrl,1006,811,110,701,111,590,402,35,93,10,495,50,227,146,83,55
TGGATCAACGTTACTC,sample,189219,187873,7195,180678,25942,154736,96134,8219,36124,3258,132258,11001,4115,1758,14169,18444
GGCAGGTTCGTTACTC,sample,211907,210264,13270,196994,25918,171076,94350,6818,38529,4277,132879,27102,8757,2880,8354,16816
ATGGCGTTCGTTACTC,sample,215432,214059,9742,204317,29184,175133,111387,10385,32254,3223,143641,17884,5861,2153,15708,21839
TAGCGAGTCGTTACTC,sample,198050,196736,9115,187621,37443,150178,91755,7952,30614,2633,122369,17224,5658,2124,16823,26896
GCTCTTCTCGTTACTC,sample,164788,163756,8790,154966,28501,126465,80919,6142,23343,2253,104262,13808,5687,1998,15284,19665
GAGATTCTCGTTACTC,Neg_Ctrl,1347,1115,146,969,153,816,514,33,181,15,695,73,331,201,62,86
AAGGTCTGCGTTACTC,sample,149922,148788,7593,141195,19905,121290,72345,4918,28583,3303,100928,12141,5323,2426,11684,14930
CTAACCGGCGTTACTC,sample,60762,60383,2304,58079,16757,41322,31229,2308,5071,550,36300,2164,2753,1942,6414,11210
TAACGAAGCGTTACTC,sample,157691,156384,9188,147196,15863,131333,63101,5253,42165,4673,105266,16141,5694,1852,7774,11334
AGCAGAGCCGTTACTC,sample,186401,185211,7872,177339,28182,149157,108080,8674,18938,2608,127018,10857,4988,2037,12886,20643
GGCGTACCCGTTACTC,sample,54920,54529,2633,51896,10473,41423,28799,1998,7457,875,36256,2294,2075,1131,4358,7290
TTATGACGCGTTACTC,Neg_Ctrl,813,589,117,472,71,401,239,32,88,11,327,31,177,105,44,30
TCAATCAGCGTTACTC,sample,133620,132925,3542,129383,24002,105381,77861,6278,13656,1672,91517,5914,2746,1341,10254,16829
CGCGAGACCGTTACTC,sample,151103,150047,7504,142543,19894,122649,70075,6389,29558,3582,99633,13045,4767,1643,9552,13748
TTAACTGACGTTACTC,sample,149892,148963,5869,143094,15664,127430,78487,7062,24711,2950,103198,14220,5000,1554,6479,11455
GAGCCTCCTGGACTGC,sample,102433,101582,5450,96132,15510,80622,49685,4221,16563,1690,66248,8463,5227,2289,7216,10247
TCATCGAATGGACTGC,sample,123472,122834,4871,117963,23464,94499,61581,5063,16034,1755,77615,10066,4153,1636,9663,16773
TGATTCCGTGGACTGC,sample,100721,100048,5903,94145,14863,79282,45987,3961,17319,2077,63306,9938,4909,1644,6885,10758
CCGCAGTCTGGACTGC,sample,37868,37546,1847,35699,7667,28032,18855,1308,5279,569,24134,2021,2176,1147,4135,5376
GATGCGTTTGGACTGC,sample,136455,135572,6068,129504,19010,110494,75890,5688,17497,1498,93387,9921,4712,2041,8430,13358
AGCGTCTTTGGACTGC,sample,141649,140579,8751,131828,17856,113972,66059,4862,24430,2721,90489,15900,6107,1921,9506,12331
CGGTTGGTTGGACTGC,sample,139427,138352,5629,132723,15084,117639,70415,5035,31367,2685,101782,8137,3680,1884,7827,11281
GAGATTCTTGGACTGC,sample,126360,125389,5875,119514,14590,104924,62202,5521,24435,2734,86637,10032,4877,1835,7644,10460
CTAAGCATTGGACTGC,sample,122225,121401,4389,117012,18110,98902,68080,5051,16248,2092,84328,7431,3271,1358,10491,13401
CTAACCGGTGGACTGC,sample,85395,84782,4193,80589,14898,65691,41989,3568,12654,1411,54643,6069,3674,1401,6421,10720
GGCGACGATGGACTGC,sample,99487,98832,4109,94723,18521,76202,58658,4651,7630,1478,66288,3785,2862,1714,6904,13320
TAACGAAGTGGACTGC,sample,137827,136931,5553,131378,17718,113660,82813,5371,14513,1530,97326,9433,4758,2518,7043,12684
AGCAGAGCTGGACTGC,sample,88775,88014,6398,81616,9639,71977,37441,2896,16980,1786,54421,12874,5456,1496,2818,6369
TTATGACGTGGACTGC,sample,111044,110295,5286,105009,10991,94018,54585,4860,20795,2392,75380,11386,4853,1785,6023,7869
TCAATCAGTGGACTGC,sample,84093,83481,5053,78428,10809,67619,36429,3425,15598,1549,52027,10618,4599,1115,6477,7424
ATTCTACCTGGACTGC,sample,179079,177523,14043,163480,13025,150455,55510,5225,51969,5293,107479,32458,9622,2149,4762,8275
GACTAACCTGGACTGC,sample,107318,106519,6154,100365,8778,91587,47175,2812,26975,3009,74150,11616,5183,1655,5793,5916
AGATACTATGGACTGC,sample,103878,103128,4626,98502,14661,83841,52722,3747,18330,2006,71052,7036,3418,1440,6279,10488
GCGCAATATGGACTGC,sample,70067,69515,5257,64258,5775,58483,28208,2435,14263,1506,42471,12071,4860,1019,2785,3719
AACCGGTTCCTTGAGC,sample,150430,149677,4126,145551,25748,119803,79669,6271,22614,2484,102283,8765,4473,2150,12215,19204
TCTAGGTTCCTTGAGC,sample,106940,106315,4932,101383,18718,82665,57838,4345,13073,1227,70911,6182,3511,1620,10506,13929
AGAGTTCTCCTTGAGC,sample,117267,116453,5148,111305,12948,98357,60326,4204,22700,2695,83026,8432,4835,2748,4243,9166
GAGCCTCCCCTTGAGC,Pos_Ctrl,24001,23638,2259,21379,1050,20329,16893,1490,1276,166,18169,504,3894,3495,1282,618
CATACTCCCCTTGAGC,sample,126695,125572,10370,115202,18536,96666,48853,3727,25559,3038,74412,15489,7096,2074,8692,12972
GGTAGAGACCTTGAGC,sample,117114,116285,6083,110202,21761,88441,54298,4103,15859,2236,70157,11945,4491,1522,10223,15167
ATTCAAGGCCTTGAGC,sample,97104,96418,5270,91148,18718,72430,46747,4011,13181,1894,59928,6597,3795,1557,8462,12892
TGATTCCGCCTTGAGC,sample,82497,82052,3160,78892,16581,62311,43803,3078,9219,1046,53022,5165,3359,1832,9286,11801
TACGCGAGCCTTGAGC,sample,98411,97727,3872,93855,22761,71094,49121,3719,11678,1478,60799,5098,3460,2092,8464,15334
GACTCAAGCCTTGAGC,sample,141453,140348,8993,131355,20497,110858,69964,5104,20818,2048,90782,12924,5962,2352,8358,14300
CCGTACGCCCTTGAGC,sample,123027,122082,5872,116210,17650,98560,69823,5274,14156,1722,83979,7585,4439,2323,9000,11866
GGCAGGTTCCTTGAGC,Pos_Ctrl,22146,21817,1637,20180,867,19313,16071,1420,1229,196,17300,397,3652,3453,739,314
GATGCGTTCCTTGAGC,sample,76099,75477,5241,70236,11949,58287,33452,2535,12663,1360,46115,8277,4036,1335,5245,8177
AGCGTCTTCCTTGAGC,sample,137942,136882,6735,130147,15897,114250,69585,6844,25250,2707,94835,9864,4266,1868,8591,11630
CCTAGCGGCCTTGAGC,sample,82429,81827,4187,77640,9729,67911,40831,3167,13825,1623,54656,8465,4255,1624,4914,7259
GCTGCTTCCCTTGAGC,Pos_Ctrl,75645,74517,3533,70984,2312,68672,57742,5356,3719,432,61461,1423,4602,6207,2255,604
AGCAGAGCCCTTGAGC,sample,138502,137388,11258,126130,14886,111244,48876,4689,29865,3349,78741,24465,7748,1817,7560,10512
GGCGTACCCCTTGAGC,sample,94209,93374,8326,85048,10854,74194,32963,2156,21680,2133,54643,15262,6217,1667,4176,7285
CGTCGAGGCCTTGAGC,sample,90663,89960,5351,84609,13286,71323,45702,3299,13063,1433,58765,7826,4230,1686,5392,9557
TTATGACGCCTTGAGC,sample,121965,121084,5228,115856,15102,100754,60403,4678,23107,3607,83510,8959,4020,1425,6081,11556
TCAATCAGCCTTGAGC,sample,107441,106627,6454,100173,12274,87899,45937,4645,21220,2012,67157,14085,5581,1579,4230,7954
ATTCTACCCCTTGAGC,sample,135819,134810,5322,129488,15698,113790,82448,7191,14395,1341,96843,8415,4755,2124,4834,11458
CGCGAGACCCTTGAGC,sample,119476,118658,6656,112002,14082,97920,58131,5989,19210,1701,77341,12889,4948,1532,6401,10075
CGTAGAACCCTTGAGC,sample,135694,134593,10619,123974,16115,107859,50273,4927,28190,2943,78463,21526,7065,1938,5349,10300
CCTAACTACCTTGAGC,Pos_Ctrl,50209,49679,2442,47237,1694,45543,38092,3742,2607,288,40699,814,4594,5556,1667,578
TCTAGGTTCGATATCC,sample,117402,116748,4676,112072,24085,87987,57368,4400,16005,1726,73373,8488,4491,1793,10839,16867
AGAGTTCTCGATATCC,sample,29127,29034,1079,27955,8180,19775,12848,1420,3312,379,16160,1816,2029,1086,2336,5159
AGCTGAATCGATATCC,sample,138193,137567,3553,134014,30199,103815,79720,7650,10923,1246,90643,4276,2973,1929,14127,21728
GACGTATGCGATATCC,sample,113049,112526,2969,109557,20473,89084,62562,4864,16160,1681,78722,3817,3107,1896,11126,14645
GGAGAAGCCGATATCC,sample,146124,145469,5226,140243,27917,112326,76311,7505,17596,2019,93907,8895,4542,1972,15382,19949
CTAGCGACCGATATCC,sample,137998,137314,4118,133196,29462,103734,79433,5262,11131,1634,90564,6274,2658,1674,16141,21804
TCATACCACGATATCC,sample,154081,153222,6800,146422,30732,115690,75861,6014,20035,2128,95896,11652,5080,1942,12720,20430
GCAACTAGCGATATCC,sample,36849,36589,1740,34849,6033,28816,16187,1482,6975,828,23162,3344,3280,1565,2108,4140
GACTCAAGCGATATCC,sample,165304,164369,6555,157814,29831,127983,82906,4567,24984,2847,107890,12679,5223,2098,13249,20733
TAGCGAGTCGATATCC,sample,144024,143021,6890,136131,22964,113167,74972,6038,18589,2116,93561,11452,4879,1771,9559,16726
GAGATTCTCGATATCC,sample,111070,110431,3051,107380,21627,85753,66001,6088,8096,1203,74097,4365,2858,1661,7182,15246
CTAAGCATCGATATCC,sample,163507,162622,5087,157535,20931,136604,94979,8554,22208,2760,117187,8103,3320,1904,8273,15204
AAGGTCTGCGATATCC,sample,102888,102131,4566,97565,11481,86084,46770,3946,23402,2670,70172,9296,4018,1640,4889,8066
CCTAGCGGCGATATCC,sample,95634,95029,4789,90240,10398,79842,44813,3626,17512,2351,62325,11540,5536,1782,4184,7529
TAACGAAGCGATATCC,sample,162008,161014,7117,153897,20963,132934,85933,6529,25168,2714,111101,12590,5075,1892,9426,14875
GCCTATTCCGATATCC,sample,56117,55692,2433,53259,6916,46343,27797,3481,9407,898,37204,4760,2566,968,1367,4991
TGCGCTCCCGATATCC,sample,78756,78119,4341,73778,7399,66379,38818,3978,13436,1370,52254,8777,4083,1151,2911,4905
GCGTTACCCGATATCC,sample,87952,87330,3986,83344,10761,72583,45910,3290,15811,1740,61721,5832,3777,1512,8590,8434
GACTAACCCGATATCC,sample,120434,119600,6635,112965,14414,98551,60360,4443,18133,1915,78493,13700,5561,1656,6767,10377
AGATACTACGATATCC,sample,161203,160191,6322,153869,22168,131701,96478,7153,16230,1984,112708,9856,4598,1891,8541,18095
GCGCAATACGATATCC,sample,126408,125697,3526,122171,18159,104012,77256,9530,10662,1565,87918,4999,2655,1542,9114,13178
TTAACTGACGATATCC,sample,91420,90830,3037,87793,15205,72588,49391,4212,11722,789,61113,6474,3076,1084,6401,11519
AACCGGTTATCTGACC,sample,5811,5773,233,5540,1192,4348,2730,262,876,131,3606,349,940,664,383,861
TCTAGGTTATCTGACC,sample,113832,113060,7616,105444,16719,88725,45966,2879,22222,2797,68188,14861,5395,1544,9159,11374
CATACTCCATCTGACC,Neg_Ctrl,784,619,89,530,76,454,263,8,87,11,350,85,169,103,37,45
TCGAACGAATCTGACC,sample,118047,117245,5241,112004,13773,98231,62809,4524,19134,2117,81943,9647,4398,2145,6613,10029
TCATACCAATCTGACC,sample,96205,95717,2215,93502,24004,69498,55879,4584,6596,704,62475,1735,1869,1685,11023,16332
TGATTCCGATCTGACC,sample,139889,138758,11562,127196,12446,114750,41543,2859,40262,4509,81805,25577,8783,2076,5846,7952
ATACGTTCATCTGACC,sample,113093,112358,5286,107072,16747,90325,54384,4325,19568,2024,73952,10024,5102,1709,6943,12148
CCGCAGTCATCTGACC,sample,95044,94325,6350,87975,11204,76771,43763,3113,16851,1897,60614,11147,5280,2011,5387,8582
GGCAGGTTATCTGACC,sample,51420,50963,2847,48116,5870,42246,22398,1630,12364,1445,34762,4409,3388,1798,2359,4089
GATGCGTTATCTGACC,Neg_Ctrl,824,659,64,595,105,490,262,34,143,13,405,38,191,104,66,48
CTAACCGGATCTGACC,sample,104108,103217,7744,95473,10684,84789,35571,3164,25264,2492,60835,18298,7028,1859,3276,6995
GGCGACGAATCTGACC,sample,65231,64693,5253,59440,6970,52470,27809,1772,12659,1532,40468,8698,4590,1387,4309,4769
GCCTATTCATCTGACC,Neg_Ctrl,707,548,64,484,76,408,239,15,84,12,323,58,155,91,28,41
ATACCGCCATCTGACC,sample,105336,104532,7200,97332,13363,83969,44042,3326,19234,2073,63276,15294,6041,1812,3505,9035
GTCGCGAAATCTGACC,sample,77603,77133,2660,74473,11600,62873,43221,3843,11046,1049,54267,3714,2070,1214,4862,9248
CGTAGAACATCTGACC,sample,64473,63582,8883,54699,4354,50345,14357,922,18661,2022,33018,14383,6515,1477,1572,2471
GCGCAATAATCTGACC,Neg_Ctrl,563,406,73,333,32,301,184,8,60,7,244,42,111,67,21,17
TTAACTGAATCTGACC,sample,76055,75608,4500,71108,12559,58549,34135,2207,13239,1442,47374,7526,4334,1485,4983,8881
ATATGCAAATCTGACC,sample,57857,57619,2751,54868,7397,47471,26557,2578,10205,1025,36762,7106,3881,1154,3321,4870
AACCGGTTCTTCTTAC,sample,156265,155224,7556,147668,22934,124734,75899,7057,24608,3196,100507,13974,5516,1679,14364,16252
CTGGTCTTCTTCTTAC,sample,194148,192739,14944,177795,24529,153266,62480,3642,50775,5144,113255,31225,8448,2068,11865,16338
TCATCGAACTTCTTAC,sample,158548,157442,7036,150406,20824,129582,77489,7217,29177,3334,106666,12365,5411,1931,13721,14707
ATTCAAGGCTTCTTAC,sample,167814,166535,10399,156136,17959,138177,68347,4699,42694,4101,111041,18336,5845,2004,9705,12173
ATACGTTCCTTCTTAC,sample,141751,140721,5646,135075,21270,113805,69569,5992,26217,3430,95786,8597,3481,1574,10803,14567
TGGATCAACTTCTTAC,sample,173690,172485,10626,161859,21553,140306,78908,5918,31630,3466,110538,20384,6985,2152,13456,15181
GATGCGTTCTTCTTAC,sample,80936,80108,8415,71693,13247,58446,19646,1654,19854,2241,39500,15051,7042,2221,2327,8147
CGGTTGGTCTTCTTAC,sample,140152,139137,4937,134200,18532,115668,82639,6018,16929,1435,99568,8647,3183,1867,10009,14192
TAGCGAGTCTTCTTAC,sample,285532,283035,22717,260318,19172,241146,90088,6001,93574,12531,183662,38952,10424,2509,5618,11285
GAGATTCTCTTCTTAC,sample,169459,168240,9054,159186,16184,143002,76697,5389,39992,4322,116689,16602,5736,2207,6596,10310
AAGGTCTGCTTCTTAC,sample,132016,131019,10519,120500,15408,105092,42150,2994,30996,3394,73146,25558,7634,1665,6539,10341
CTAACCGGCTTCTTAC,sample,98600,97797,3641,94156,8847,85309,47440,3266,24453,2508,71893,7642,3148,1472,5469,6201
TAACGAAGCTTCTTAC,sample,114732,113846,6817,107029,15041,91988,52043,3811,22218,2330,74261,11586,4889,1588,5792,11360
ATACCGCCCTTCTTAC,sample,128116,127121,8113,119008,14439,104569,64066,4842,19265,1968,83331,14428,5931,1749,5423,9881
CGCGAGACCTTCTTAC,sample,94412,93706,3330,90376,15167,75209,55133,6655,8195,807,63328,4419,2447,1309,5719,10957
AGAGTTCTACTTCTAC,sample,119252,118487,5418,113069,19891,93178,58071,4806,17125,1995,75196,11181,5745,2537,6574,14330
GAGCCTCCACTTCTAC,sample,96844,96385,2639,93746,21014,72732,57052,4500,7814,957,64866,2409,2120,1460,12897,15222
CATACTCCACTTCTAC,sample,95936,95402,4411,90991,13492,77499,53638,3698,11865,1525,65503,6773,4225,2325,7474,9547
CTAGCGACACTTCTAC,sample,98985,98505,3163,95342,20010,75332,56115,4526,9732,1499,65847,3460,2875,1871,9197,14478
TCGAACGAACTTCTAC,sample,103120,102546,4077,98469,18470,79999,51775,4414,15354,1626,67129,6830,3810,1931,7592,13159
CGTCGCCAACTTCTAC,sample,90197,89743,3101,86642,19172,67470,51227,3696,7586,674,58813,4287,2940,1799,9660,13520
TCATCGAAACTTCTAC,sample,106233,105597,4200,101397,19461,81936,54471,4065,13777,1667,68248,7956,3602,1557,11635,14912
ATTCAAGGACTTCTAC,sample,130915,130005,6558,123447,20302,103145,65612,4605,20948,2404,86560,9576,5024,2596,5927,14708
TGATTCCGACTTCTAC,sample,95947,95411,3411,92000,15134,76866,53934,3461,12885,1432,66819,5154,3518,1819,9924,11353
GCAACTAGACTTCTAC,sample,28428,28260,1063,27197,4360,22837,14470,1017,5221,679,19691,1450,2479,1859,1668,3329
TACGCGAGACTTCTAC,sample,76415,75905,4840,71065,10853,60212,36668,2169,11810,1283,48478,8282,4734,2173,5812,7327
CCGCAGTCACTTCTAC,sample,111837,111137,5201,105936,16791,89145,61533,4699,13774,1570,75307,7569,3993,1740,10298,11339
GATGCGTTACTTCTAC,sample,78187,77604,3707,73897,9786,64111,41498,3019,12492,1519,53990,5583,3251,1739,4360,7097
CCATTCTTACTTCTAC,sample,121536,120625,6666,113959,16265,97694,57901,4923,19341,2488,77242,13041,4912,1681,7462,11860
TAGCGAGTACTTCTAC,sample,90764,90159,3040,87119,14884,72235,51252,4243,10245,1267,61497,5228,3625,1510,8729,11391
GAGATTCTACTTCTAC,sample,43838,43384,3780,39604,6062,33542,14816,1037,9459,1003,24275,7227,4089,1158,2365,3884
CTAACCGGACTTCTAC,sample,99999,99234,7901,91333,10436,80897,34771,2631,23547,2872,58318,17076,6344,1515,5351,6722
GGCGACGAACTTCTAC,sample,79327,78702,4813,73889,11077,62812,37097,2949,12608,1491,49705,8667,4436,1749,4671,7424
GCCTATTCACTTCTAC,sample,85141,84421,6659,77762,8374,69388,29102,2356,20720,1843,49822,15367,5820,1373,2746,5405
TGCGCTCCACTTCTAC,sample,94311,93587,6705,86882,10522,76360,35779,3198,19654,2347,55433,15382,6017,1378,4338,6826
ATACCGCCACTTCTAC,sample,85396,84913,2523,82390,14344,68046,52948,4240,6342,923,59290,3593,2736,1846,5737,10451
GGCGTACCACTTCTAC,sample,78406,77790,5675,72115,9102,63013,37056,3961,12101,1121,49157,8774,4371,1413,4277,5916
GTCGCGAAACTTCTAC,sample,118205,117221,7276,109945,10809,99136,47061,4258,29923,3337,76984,14557,5488,1566,6784,6602
CGTCGAGGACTTCTAC,sample,108038,107230,7480,99750,9739,90011,38619,2987,26646,3062,65265,18697,7210,1726,4724,6444
ATGAATAGACTTCTAC,sample,74462,74019,1634,72385,15379,57006,46332,4415,4206,816,50538,1237,1203,1011,5475,10095
ATTCTACCACTTCTAC,sample,116010,115288,6875,108413,14137,94276,53758,5408,19860,1853,73618,13397,5397,1535,5392,9352
GACTAACCACTTCTAC,sample,89532,88806,7233,81573,10195,71378,33650,3361,17780,2040,51430,14547,5575,1368,4564,6773
CCTAACTAACTTCTAC,sample,106035,105223,4827,100396,11619,88777,65619,5463,10033,971,75652,6691,3791,1912,4758,7998
TCTAGGTTAGAAGTAA,sample,137699,136881,4429,132452,18570,113882,71706,5676,23728,2696,95434,10076,4981,2696,9004,13073
TATACGGAAGAAGTAA,sample,212478,211250,8316,202934,35332,167602,113959,6932,28878,2968,142837,14865,5696,2258,17597,25173
CATACTCCAGAAGTAA,sample,175045,173933,8287,165646,29134,136512,76204,5836,32086,4142,108290,18244,6304,1945,17355,20121
TCATCGAAAGAAGTAA,sample,167890,166745,7476,159269,31540,127729,71110,6424,28280,3167,99390,18748,7171,2503,9551,22454
GACTCAAGAGAAGTAA,sample,179495,178382,5844,172538,27291,145247,97818,6671,27782,2675,125600,10301,4109,1857,15064,20886
ATACGTTCAGAAGTAA,sample,94866,94023,6450,87573,10039,77534,31208,1630,27539,2661,58747,14496,5557,1593,5230,6923
CCGTACGCAGAAGTAA,sample,138983,137898,9599,128299,17077,111222,56682,4952,28264,3232,84946,18092,7047,1888,6654,11555
CGGTTGGTAGAAGTAA,sample,96095,95424,2737,92687,14140,78547,56595,4383,10640,1845,67235,5084,2779,1140,7915,10250
GAGATTCTAGAAGTAA,sample,107816,107202,3322,103880,13485,90395,64964,5478,13171,2119,78135,4663,2733,1582,8701,9744
ATACCGCCAGAAGTAA,sample,134754,133792,6285,127507,17172,110335,71099,5881,20278,2533,91377,10544,4705,1431,8271,12842
GTCGCGAAAGAAGTAA,sample,215854,214284,19842,194442,17225,177217,55163,5208,60960,6827,116123,49059,12317,2661,6437,10579
CAGCTTCGAGAAGTAA,sample,122138,121229,6263,114966,12761,102205,60552,5232,20722,2868,81274,12831,4017,1249,6517,8656
CGCGGTCGAGAAGTAA,sample,107496,106671,5920,100751,11664,89087,44135,4269,24450,3159,68585,13074,4269,1304,6101,7982
ATGAATAGAGAAGTAA,sample,176558,175430,9923,165507,15697,149810,77764,6995,39753,3390,117517,21908,6638,1915,6894,10426
TAACGCCAAGAAGTAA,sample,157266,156185,5512,150673,16616,134057,93388,7409,20767,2694,114155,9799,4170,1985,11899,12762
ATTCTACCAGAAGTAA,sample,160142,159113,10129,148984,21786,127198,78209,7071,22830,2382,101039,16706,6145,1918,8310,14208
GACTAACCAGAAGTAA,sample,129904,129044,4021,125023,12330,112693,73958,8226,19249,2946,93207,8314,3202,1598,5838,8519
Short,Non_sample,0,NA,NA,NA,NA,NA,NA,NA,NA,NA,NA,NA,NA,NA,NA,NA
Unselected,Non_sample,2410367,NA,NA,NA,NA,NA,NA,NA,NA,NA,NA,NA,NA,NA,NA,NA
Undetermined,Non_sample,162503800,NA,NA,NA,NA,NA,NA,NA,NA,NA,NA,NA,NA,NA,NA,NA
