Barcode,Sample,Barcoded_Reads,Trimmed_Reads,Unmapped_Reads,Mapped_Reads,Multimapped_Reads,Uniquely_Mapped_Reads,Exon_Reads,Ambiguous_Exon_Reads,Intron_Reads,Ambiguous_Intron_Reads,Gene_Reads,Intergenic_Reads,No_of_Genes,No_of_Transcripts,Mitochondrial_Reads,Ribosomal_Reads
ATTCTCTTCGTTGGTT,sample,58182,57903,2494,55409,13523,41886,24613,1828,9232,975,33845,5238,3615,1587,5492,8858
TTCGTAATCGTTGGTT,sample,132419,131840,5415,126425,28173,98252,71162,4192,14681,1955,85843,6262,3451,1823,30348,19483
TGAGCGCGCGTTGGTT,sample,75274,74996,1396,73600,18249,55351,46218,2788,4709,384,50927,1252,1681,1696,17588,12603
GGACCTCTCGTTGGTT,sample,12146,11967,3296,8671,555,8116,662,33,3823,415,4485,3183,2119,152,71,242
CCAGAGCGCGTTGGTT,sample,78979,78569,3616,74953,12878,62075,42839,2588,10690,1289,53529,4669,3925,2024,15815,8957
CCGCAACGCGTTGGTT,sample,32927,32731,2050,30681,5912,24769,12906,1017,6572,755,19478,3519,3451,1559,3991,3859
ACCTCGAGCGTTGGTT,sample,75910,75617,3197,72420,13748,58672,39766,2569,10489,1248,50255,4600,3815,1987,15242,9733
TGGACGAGCGTTGGTT,sample,7456,7403,595,6808,1490,5318,2342,180,1795,224,4137,777,1312,621,387,952
CGAGGCAGCGTTGGTT,sample,54412,54215,1203,53012,12496,40516,33681,1989,3538,344,37219,964,2076,2025,10826,8552
ACGACTTCCGTTGGTT,sample,32072,31955,1383,30572,6889,23683,16517,1274,3311,418,19828,2163,2517,1471,5500,4495
AATCCGTCCGTTGGTT,sample,75767,75437,2086,73351,16380,56971,43521,3115,6886,535,50407,2914,2831,1975,16036,11285
CGTACGTCCGTTGGTT,sample,89283,88984,1774,87210,20489,66721,56717,3366,5132,680,61849,826,1478,1536,26013,14651
AGTCCGCACGTTGGTT,sample,58509,58300,3171,55129,11306,43823,27951,1831,7932,838,35883,5271,4485,2076,8566,7603
GTCCTGCCCGTTGGTT,sample,25524,25365,1476,23889,5516,18373,11054,729,3764,418,14818,2408,2489,1191,3841,3478
CTAGGACCCGTTGGTT,sample,40532,40328,1749,38579,6207,32372,19596,1340,7177,1052,26773,3207,2741,1533,4793,4208
AACTCGTACGTTGGTT,sample,40024,39835,1872,37963,6376,31587,20304,1391,5678,693,25982,3521,2864,1450,6088,4087
AATATATCCGTTGGTT,sample,17840,17768,1388,16380,2389,13991,6806,521,3982,582,10788,2100,2616,1140,1870,1446
ACCAATGCCGTTGGTT,sample,3305,3276,151,3125,637,2488,1640,133,440,59,2080,216,683,454,533,426
TGCTTCGCCGTTGGTT,sample,4237,4193,317,3876,533,3343,1253,145,1207,134,2460,604,1043,475,131,332
AGGTCGGACGTTGGTT,sample,151,149,12,137,21,116,77,2,20,2,97,15,48,25,27,18
GGAGAGTTCTATCGTT,sample,82556,82205,2218,79987,14585,65402,54227,4382,4352,652,58579,1789,2584,2651,14105,10699
ATTCTCTTCTATCGTT,sample,15049,14932,797,14135,3534,10601,6271,385,2467,301,8738,1177,1511,773,1551,2248
TCCAACTTCTATCGTT,sample,80126,79754,3443,76311,13719,62592,45162,3157,9186,1033,54348,4054,3308,2165,14920,9808
GGTTGCGTCTATCGTT,sample,95531,95133,2749,92384,17504,74880,59486,4178,7168,914,66654,3134,2569,1831,22592,12400
ACGTAAGTCTATCGTT,sample,98607,98232,2995,95237,17817,77420,63403,4288,6058,820,69461,2851,2360,1944,25093,13053
TTCTAATGCTATCGTT,sample,80108,79777,2676,77101,15983,61118,47037,2717,6875,769,53912,3720,2846,1521,21370,11355
TGAGCGCGCTATCGTT,sample,87127,86491,7811,78680,7208,71472,30815,1652,26488,3363,57303,9154,6131,2174,8869,4774
AATGGTAACTATCGTT,sample,90936,90393,6075,84318,12000,72318,46142,2347,14550,1587,60692,7692,4610,1685,18826,8786
TTAGAAGTCTATCGTT,sample,106105,105385,6570,98815,14230,84585,53983,3822,14504,1515,68487,10761,5091,2037,17890,10903
CAAGGCCTCTATCGTT,sample,95294,94772,3693,91079,13911,77168,58849,4940,8464,707,67313,4208,2568,1628,17450,9892
GGAGGACGCTATCGTT,sample,30548,30394,934,29460,6749,22711,18409,1111,2183,213,20592,795,1783,1513,6319,4710
TGGACGAGCTATCGTT,sample,87920,87438,4449,82989,13176,69813,53058,2853,8516,1187,61574,4199,3433,2129,17587,9885
GACGATAACTATCGTT,sample,49376,48910,4446,44464,5247,39217,16671,971,12304,1329,28975,7942,4631,1431,4786,3733
CATTGCAGCTATCGTT,sample,53333,52935,4243,48692,8575,40117,24024,1361,8290,834,32314,5608,3528,1324,10124,5796
ACGACTTCCTATCGTT,sample,49219,48905,1535,47370,7524,39846,30547,1842,5045,861,35592,1551,2329,2129,8819,5729
CATGATTCCTATCGTT,sample,59486,58960,4332,54628,7991,46637,26261,1714,10731,1175,36992,6756,4541,2053,4181,5092
GCCTGAACCTATCGTT,sample,90113,89461,6840,82621,7881,74740,46787,3282,13423,1781,60210,9467,4705,1829,13862,5343
CGTATGAACTATCGTT,sample,87715,87215,2599,84616,13830,70786,57248,3666,6668,536,63916,2668,1979,1479,22293,10865
GAAGGCGCCTATCGTT,sample,60860,60360,4673,55687,7207,48480,29100,1643,10479,1309,39579,5949,3688,1629,8951,5114
TTGGTTAACTATCGTT,sample,14850,14749,475,14274,2200,12074,9030,640,1647,140,10677,617,1356,1081,2779,1540
TATCAGTTGTCTTCTT,sample,60903,60591,2553,58038,8444,49594,33006,2489,9408,1182,42414,3509,3252,2262,8102,5921
ATTCTCTTGTCTTCTT,Pos_Ctrl,23353,23145,1753,21392,1180,20212,16961,1552,1173,135,18134,391,3629,3241,1870,618
TCCAACTTGTCTTCTT,sample,77733,77372,3988,73384,12756,60628,36510,2288,12599,1398,49109,7833,4779,1679,14834,8839
GGTTGCGTGTCTTCTT,sample,65447,65126,2902,62224,16104,46120,31016,2045,7486,876,38502,4697,3725,1768,10924,10902
TCCTCCGTGTCTTCTT,sample,43336,43107,1792,41315,6855,34460,24547,1754,5207,657,29754,2295,3138,2332,5840,5072
CCTCTAGAGTCTTCTT,Pos_Ctrl,26256,25722,2188,23534,1396,22138,18572,1643,1327,236,19899,360,4014,3635,2013,728
TTCGTAATGTCTTCTT,sample,81337,80946,1860,79086,17225,61861,53276,3667,3851,553,57127,514,1790,2094,16306,12359
ACGTTATGGTCTTCTT,sample,74736,74458,2010,72448,14927,57521,47672,2983,4716,576,52388,1574,2027,1877,17539,10474
GCCTTGCTGTCTTCTT,sample,42127,41819,2345,39474,5254,34220,23070,1694,5474,800,28544,3182,3125,1750,6018,3634
CAAGGCCTGTCTTCTT,sample,69811,69400,3214,66186,8088,58098,39814,2889,9121,888,48935,5386,3296,1441,13330,5891
CCAGAGCGGTCTTCTT,sample,43768,43503,2001,41502,7194,34308,25530,1522,4623,512,30153,2121,2139,1555,10225,5341
CCGCAACGGTCTTCTT,sample,5342,5278,572,4706,525,4181,2680,136,868,80,3548,417,1090,638,612,358
GGACGTAGGTCTTCTT,sample,36253,35922,2421,33501,4877,28624,15828,887,7609,770,23437,3530,2971,1406,4692,3540
CGAGGCAGGTCTTCTT,sample,46171,45934,1486,44448,9997,34451,27462,2003,3422,367,30884,1197,1934,1635,10080,7152
TTGGTACCGTCTTCTT,sample,34190,33959,2281,31678,3407,28271,13723,713,9307,1357,23030,3171,3001,1493,2467,2323
CTAGGACCGTCTTCTT,sample,22821,22626,1505,21121,2766,18355,10844,712,4107,448,14951,2244,2284,1095,3503,1829
CGGATTACGTCTTCTT,sample,36700,36379,3318,33061,4101,28960,16213,1267,6367,696,22580,4417,3376,1268,5020,2933
GCCTGAACGTCTTCTT,sample,54422,54115,2042,52073,7626,44447,34002,1981,5338,490,39340,2636,2257,1344,11738,5666
ACCAATGCGTCTTCTT,sample,63973,63557,2309,61248,9225,52023,38652,3081,6269,879,44921,3142,2962,1755,11729,7012
AAGAGCGCGTCTTCTT,sample,67833,67540,1621,65919,10204,55715,48389,3260,3035,295,51424,736,1625,1982,15237,7577
TTGGTTAAGTCTTCTT,sample,56075,55812,1848,53964,9774,44190,33414,2427,5623,755,39037,1971,2318,1579,11435,6849
TCAATATAGTCTTCTT,sample,53179,52992,1097,51895,10290,41605,35040,2422,3040,495,38080,608,1385,1534,13212,7538
AGGTCGGAGTCTTCTT,Pos_Ctrl,982,975,68,907,58,849,717,40,43,2,760,47,365,266,67,19
AAGTTCGTTAGGCTCT,sample,150530,149540,9731,139809,27652,112157,54094,4081,29966,3725,84060,20291,7235,1891,17336,18965
AGTACCATTAGGCTCT,sample,151236,150561,7878,142683,27418,115265,77016,5069,18648,1975,95664,12557,5872,2844,22684,19687
ATGCCTGGTAGGCTCT,sample,137124,136473,5112,131361,26676,104685,82612,5366,10563,1346,93175,4798,4393,3209,23313,18864
GGACCTCTTAGGCTCT,sample,128730,127821,5569,122252,21776,100476,70867,4453,16428,1779,87295,6949,4096,2044,24688,15503
TCGCATCTTAGGCTCT,sample,115330,114584,8910,105674,16919,88755,57023,3770,15238,1499,72261,11225,6005,2733,17059,11555
GCCTTGCTTAGGCTCT,sample,107944,107212,5120,102092,15114,86978,56973,3770,17201,2095,74174,6939,4256,2260,17931,11376
CATAACCTTAGGCTCT,sample,65041,64400,4071,60329,10928,49401,34309,2282,7911,945,42220,3954,4591,3192,6075,7825
GGAGGACGTAGGCTCT,sample,97507,96730,5903,90827,15710,75117,47894,2747,14913,1568,62807,7995,5205,2262,15521,10764
GACGATAATAGGCTCT,sample,160465,159574,5196,154378,28189,126189,102419,6890,10890,1467,113309,4523,2407,1845,45675,20657
GGCCAGAGTAGGCTCT,sample,141428,140412,8668,131744,21263,110481,74994,3719,18763,2007,93757,10998,5518,2114,29233,14925
CATTGCAGTAGGCTCT,sample,45213,44901,1688,43213,8576,34637,28233,1438,3742,349,31975,875,1396,1210,13307,6310
CGAGGCAGTAGGCTCT,sample,132296,131381,6186,125195,20870,104325,71291,3901,17970,2020,89261,9143,4754,2253,21436,14553
CATGATTCTAGGCTCT,sample,72660,72123,4277,67846,8885,58961,33376,2509,14793,1656,48169,6627,3785,1665,10035,5949
AGTCCGCATAGGCTCT,sample,159249,158374,6515,151859,27471,124388,96204,6691,13329,1804,109533,6360,4333,2696,32968,20822
TTGGTACCTAGGCTCT,sample,150207,149396,3879,145517,13031,132486,107815,7695,11766,1282,119581,3928,3422,3400,17723,10227
ACGTATTATAGGCTCT,sample,122210,121372,6789,114583,14848,99735,63234,4028,22713,2233,85947,7527,4163,2153,19599,11728
TTGGCCTCTAGGCTCT,sample,82628,82070,4001,78069,13687,64382,41640,2708,13298,1282,54938,5454,4013,1994,9213,9740
ACCAATGCTAGGCTCT,sample,163196,162401,3826,158575,28434,130141,112312,6564,8639,1113,120951,1513,1978,2126,36336,20952
AAGAGCGCTAGGCTCT,sample,162437,161514,8568,152946,26630,126316,79900,5032,24575,3237,104475,13572,5442,1900,32564,18833
TTGGTTAATAGGCTCT,sample,169318,168409,6874,161535,27411,134124,95425,5759,21030,2935,116455,8975,4483,2143,35208,19367
GTACCGTATAGGCTCT,sample,72892,72159,6164,65995,5412,60583,22518,1323,23441,2806,45959,10495,5508,2001,2374,3271
TTATTCGATAGGCTCT,sample,5177,5092,252,4840,1074,3766,2210,125,789,101,2999,541,963,620,432,701
TCCAACTTTTGACTAT,Neg_Ctrl,643,483,329,154,30,124,70,0,38,1,108,15,51,27,20,15
ACGTAAGTTTGACTAT,sample,55451,54978,5465,49513,5496,44017,22217,1375,12004,1176,34221,7245,3874,1328,8508,3807
AGTACCATTTGACTAT,Neg_Ctrl,948,785,527,258,17,241,120,7,44,3,164,67,60,32,41,31
TGAGCGCGTTGACTAT,sample,4401,4311,826,3485,370,3115,1409,83,870,83,2279,670,799,291,541,200
TTCCGTCTTTGACTAT,Pos_Ctrl,5641,5559,661,4898,297,4601,3815,326,311,36,4126,113,1419,962,394,159
GGACCTCTTTGACTAT,sample,55088,54648,3540,51108,7204,43904,28324,1553,8229,792,36553,5006,3771,1679,9416,4956
CAAGGCCTTTGACTAT,sample,54360,53971,2093,51878,9219,42659,35122,2433,3120,384,38242,1600,2255,2020,11780,6932
GACGGAGATTGACTAT,sample,49328,48974,2696,46278,6615,39663,28531,2074,6070,661,34601,2327,2884,2145,8058,4632
CCAGAGCGTTGACTAT,sample,41161,40804,2404,38400,5672,32728,22585,1413,4856,633,27441,3241,2817,1725,7549,4297
GTTAGCCGTTGACTAT,sample,40471,40213,2394,37819,4182,33637,19553,988,8711,843,28264,3542,3229,1831,4175,2946
CCGCAACGTTGACTAT,Pos_Ctrl,18123,17906,1285,16621,902,15719,13298,1340,756,95,14054,230,3087,2888,1521,452
CTTGATAGTTGACTAT,sample,82605,82007,5200,76807,12642,64165,43872,2453,10253,1103,54125,6484,4105,1993,15561,8816
TGGACGAGTTGACTAT,sample,55606,55234,3384,51850,7058,44792,31330,2284,6706,625,38036,3847,3603,2307,7454,5366
GGCCAGAGTTGACTAT,sample,42968,42709,1696,41013,5943,35070,26523,1848,4564,451,31087,1684,2554,2133,6704,4327
CATTGCAGTTGACTAT,sample,51800,51530,2222,49308,6637,42671,30526,1718,6934,946,37460,2547,2683,1954,8688,5141
CCATGAAGTTGACTAT,sample,78276,77789,5313,72476,12368,60108,37707,2721,11210,1076,48917,7394,4236,1927,12938,8403
CATGATTCTTGACTAT,sample,67949,67486,3800,63686,9163,54523,40517,2716,6487,717,47004,4086,4111,2923,9050,6788
AATCCGTCTTGACTAT,Pos_Ctrl,34165,33724,2586,31138,1366,29772,24731,2278,1902,227,26633,634,4378,4563,2005,720
CGTACGTCTTGACTAT,sample,81570,80818,7834,72984,9050,63934,30555,1800,17336,1744,47891,12499,6039,1710,11705,6073
AGTCCGCATTGACTAT,sample,55097,54736,2835,51901,9406,42495,29350,1585,7017,922,36367,3621,2717,1429,11634,6782
TTGGCCTCTTGACTAT,Pos_Ctrl,20341,20094,1652,18442,944,17498,14439,1427,1119,122,15558,391,3408,3049,1172,418
ACCAATGCTTGACTAT,sample,66193,65831,2567,63264,8969,54295,44221,2692,4972,531,49193,1879,2566,2181,12631,6797
TGCTTCGCTTGACTAT,sample,38011,37666,3425,34241,3998,30243,13400,766,9043,1043,22443,5991,3502,1187,2935,2603
GAAGGCGCTTGACTAT,sample,65808,65267,6483,58784,7363,51421,22438,1424,15231,1572,37669,10756,5283,1362,8481,4612
AAGAGCGCTTGACTAT,sample,40837,40547,2532,38015,4738,33277,20237,1426,7479,855,27716,3280,2738,1494,6958,3324
GTCTTAGCTTGACTAT,sample,45670,45331,2638,42693,5674,37019,27344,1804,4600,418,31944,2853,3303,2329,6747,4153
TTGGTTAATTGACTAT,sample,84824,84298,3013,81285,13347,67938,52628,3307,7917,747,60545,3339,2232,1588,20199,10333
AGGTCGGATTGACTAT,sample,37254,37069,2252,34817,6262,28555,20785,1336,3543,495,24328,2396,2457,1554,7545,4660
TTATTCGATTGACTAT,Neg_Ctrl,407,299,113,186,24,162,84,7,56,1,140,14,63,40,17,24
ATGACCGATTGACTAT,sample,317,302,20,282,40,242,150,15,40,3,190,34,75,44,60,24
GGAGAGTTTGCAGTTG,sample,43090,42905,929,41976,4927,37049,28766,2314,4574,432,33340,963,2316,2294,5146,3730
AAGTTCGTTGCAGTTG,sample,84818,84396,2594,81802,8691,73111,56745,3479,7915,729,64660,4243,3372,1980,12032,6170
GGTTGCGTTGCAGTTG,sample,72332,71932,2537,69395,8870,60525,46992,3401,5653,659,52645,3820,2769,1766,13272,6669
CCTCTAGATGCAGTTG,sample,52863,52626,1432,51194,8141,43053,35203,2616,3337,467,38540,1430,1425,1215,11255,6234
TTCTAATGTGCAGTTG,sample,89559,88892,6539,82353,6401,75952,37488,2543,20150,1944,57638,13827,6557,1716,10614,4230
TTAGAAGTTGCAGTTG,sample,53557,53313,1228,52085,9221,42864,36371,2343,2978,249,39349,923,1878,1814,13061,6575
GACGGAGATGCAGTTG,sample,39673,39407,1228,38179,8625,29554,25125,1573,2043,287,27168,526,1724,1794,8346,6085
GTTAGCCGTGCAGTTG,sample,52980,52672,2112,50560,8543,42017,33196,2135,4207,566,37403,1913,2637,2005,11471,6243
CCGCAACGTGCAGTTG,sample,44604,44248,3682,40566,6176,34390,13041,936,10625,1128,23666,8660,4330,1104,4654,4161
ACCTCGAGTGCAGTTG,sample,48924,48630,1857,46773,7321,39452,31423,1726,3743,546,35166,2014,2569,1890,9349,5602
GACGATAATGCAGTTG,sample,47767,47405,3439,43966,6739,37227,24288,1426,6429,632,30717,4452,3545,1698,8413,4880
GTCCTGCCTGCAGTTG,sample,41007,40723,1587,39136,4136,35000,21953,916,8256,1226,30209,2649,2010,1079,3540,2849
CGGATTACTGCAGTTG,sample,62968,62518,4363,58155,6998,51157,27006,1686,12159,1140,39165,9166,4672,1454,9178,4742
AACTCGTATGCAGTTG,sample,49817,49569,1572,47997,8936,39061,30872,2049,3743,557,34615,1840,2273,1737,9371,6511
AAGAGCGCTGCAGTTG,sample,69226,68733,4432,64301,6666,57635,35214,2189,12442,1308,47656,6482,4654,2159,8514,4847
GTCTTAGCTGCAGTTG,sample,32877,32674,2324,30350,4133,26217,15321,980,5422,521,20743,3973,3415,1579,5321,2776
GTACCGTATGCAGTTG,sample,38568,38316,1628,36688,3644,33044,20004,1310,8155,950,28159,2625,2511,1641,5442,2660
TATCAGTTTCATGCTG,sample,25496,25401,1551,23850,3230,20620,12410,1043,3869,427,16279,2871,2515,1061,3330,2198
GGTTGCGTTCATGCTG,sample,3011,2962,99,2863,596,2267,1387,166,453,79,1840,182,647,471,119,386
CCTCTAGATCATGCTG,sample,43493,43271,1378,41893,5670,36223,28999,2081,3207,366,32206,1570,1959,1438,9044,4469
AGTACCATTCATGCTG,sample,40019,39827,1624,38203,4897,33306,25610,1796,3523,343,29133,2034,2418,1755,6517,3563
TTAGAAGTTCATGCTG,sample,51747,51476,1469,50007,7043,42964,37011,2876,2261,296,39272,520,1726,1909,8864,5473
TTCCGTCTTCATGCTG,sample,24679,24446,2058,22388,2410,19978,10953,600,4943,550,15896,2932,2409,1072,3156,1732
GGACCTCTTCATGCTG,Neg_Ctrl,215,121,75,46,4,42,18,4,9,0,27,11,18,10,3,3
TCGCATCTTCATGCTG,sample,37305,37028,3550,33478,4440,29038,16208,941,6758,827,22966,4304,3434,1276,6021,3080
CAAGGCCTTCATGCTG,sample,22513,22290,1585,20705,3108,17597,10087,667,3695,431,13782,2717,2262,1019,2136,2130
GTTAGCCGTCATGCTG,sample,5890,5821,1081,4740,486,4254,1082,57,1667,201,2749,1247,1185,310,259,249
GGACGTAGTCATGCTG,Neg_Ctrl,237,165,50,115,20,95,59,6,3,2,62,25,28,19,23,9
CGTACGTCTCATGCTG,Neg_Ctrl,207,142,50,92,5,87,65,1,12,0,77,9,38,25,15,6
GTCCTGCCTCATGCTG,sample,16258,16094,1884,14210,1472,12738,6631,328,3127,347,9758,2305,2450,1030,1897,1012
CTAGGACCTCATGCTG,sample,28560,28284,2158,26126,3822,22304,12262,828,5362,701,17624,3151,2731,1109,3563,2640
CGGATTACTCATGCTG,sample,36425,36258,1668,34590,4789,29801,20885,1152,4361,541,25246,2862,2850,1783,4860,3605
GTTAGGACTCATGCTG,sample,25690,25585,612,24973,5917,19056,16100,968,1369,166,17469,453,1343,1291,6052,4148
ACGTATTATCATGCTG,sample,25250,25077,1726,23351,4639,18712,10943,693,3932,477,14875,2667,2364,1120,2884,3044
AATATATCTCATGCTG,Neg_Ctrl,368,267,170,97,25,72,43,9,13,0,56,7,37,26,10,19
CCAATTCCTCATGCTG,sample,16240,16065,1045,15020,1592,13428,7606,488,3431,340,11037,1563,2311,1292,1078,1133
TTGGTTAATCATGCTG,sample,39970,39727,1272,38455,5817,32638,26408,1985,2932,355,29340,958,1239,1122,11344,4592
GTACCGTATCATGCTG,sample,13131,13033,1271,11762,1358,10404,5612,344,2642,295,8254,1511,1783,827,1923,906
TCAATATATCATGCTG,sample,29231,29009,2006,27003,2931,24072,14294,802,5831,674,20125,2471,2555,1329,4966,2101
TCGCCTGATCATGCTG,sample,22858,22692,1913,20779,2490,18289,11981,721,3442,294,15423,1851,2450,1552,2452,1806
ATGACCGATCATGCTG,sample,490,474,26,448,76,372,220,21,81,2,301,48,142,86,71,56
TATCAGTTTTAGGCGG,sample,129134,128407,8173,120234,11653,108581,60133,3885,24745,2473,84878,17345,6909,2244,10543,8339
ATTCTCTTTTAGGCGG,Pos_Ctrl,28508,28241,2250,25991,1376,24615,20869,1875,1319,145,22188,407,4042,3783,2536,676
CCTCTAGATTAGGCGG,Pos_Ctrl,27522,27143,1786,25357,1171,24186,20270,1950,1331,161,21601,474,3965,3985,1716,527
ACGTTATGTTAGGCGG,sample,166621,165657,11949,153708,12720,140988,75478,5058,39754,5567,115232,15131,7151,2298,19429,8177
TAGTACGGTTAGGCGG,sample,126037,125146,8678,116468,13306,103162,56107,3966,22620,2214,78727,18255,6452,2132,12590,8686
AATGGTAATTAGGCGG,sample,147462,146500,9182,137318,15134,122184,77838,5499,23096,2726,100934,13025,5408,1979,22865,10483
TTCCGTCTTTAGGCGG,sample,75833,75330,3212,72118,10096,62022,46362,3763,7090,908,53452,3899,3708,2477,10185,7461
GCCTTGCTTTAGGCGG,sample,109791,109307,2733,106574,17321,89253,76415,5099,6002,742,82417,995,1334,1521,29408,13236
CAAGGCCTTTAGGCGG,sample,13857,13724,1026,12698,2695,10003,7097,454,1355,121,8452,976,1516,1030,1818,1837
ACTATACTTTAGGCGG,sample,49204,48873,2621,46252,8893,37359,27068,1793,4898,656,31966,2944,2568,1571,10710,6276
GGAGGACGTTAGGCGG,sample,88690,88201,3383,84818,16303,68515,52868,3577,7262,810,60130,3998,3116,2022,20090,11866
GGACGTAGTTAGGCGG,sample,70080,69560,3192,66368,10722,55646,41064,2555,7408,870,48472,3749,3296,2017,11535,7729
CGTACGTCTTAGGCGG,sample,61033,60449,4268,56181,10112,46069,25486,1913,10736,1369,36222,6565,3879,1376,7361,6873
TTGGTACCTTAGGCGG,sample,30517,30371,874,29497,8936,20561,17137,1255,1621,183,18758,365,1229,1156,4428,5968
CTAGGACCTTAGGCGG,sample,119603,118925,4178,114747,15141,99606,79638,6184,8565,753,88203,4466,3094,2358,20650,11733
GTTAGGACTTAGGCGG,sample,125508,124855,6689,118166,15547,102619,66072,3696,20252,1983,86324,10616,4826,1624,21977,11503
CGTATGAATTAGGCGG,sample,129084,128436,3911,124525,19942,104583,83718,5232,10285,1332,94003,4016,2296,1705,27250,15771
AATATATCTTAGGCGG,sample,72501,71896,5661,66235,8194,58041,32800,2303,13076,1413,45876,8449,5199,2142,7922,5479
GAAGGCGCTTAGGCGG,sample,97918,97318,4545,92773,13275,79498,56621,3488,11903,1192,68524,6294,4133,1950,18460,10151
AAGAGCGCTTAGGCGG,sample,82084,81432,6711,74721,10343,64378,33094,1692,16850,1949,49944,10793,5784,1642,9332,7004
CCAATTCCTTAGGCGG,sample,95789,95265,3140,92125,18097,74028,62595,3417,5529,961,68124,1526,1664,1456,25405,13228
GGCATATATTAGGCGG,sample,88325,87830,4118,83712,12513,71199,53142,3854,8635,847,61777,4721,3455,2097,14666,8785
TCAATATATTAGGCGG,sample,104333,103628,5766,97862,12389,85473,54806,2692,16949,1676,71755,9350,5142,1962,18622,9273
CTTCATGATTAGGCGG,sample,55862,55321,3162,52159,5320,46839,28701,1512,10737,1207,39438,4682,3555,1985,6537,3990
TTATTCGATTAGGCGG,sample,74852,74436,4706,69730,10490,59240,35439,2323,12546,1234,47985,7698,4556,1623,11911,7647
GGAGAGTTTCAGATAC,sample,48684,48463,2440,46023,4892,41131,28720,2180,6293,773,35013,3165,3381,2226,5097,3409
TATCAGTTTCAGATAC,sample,66359,65963,4879,61084,6867,54217,32521,2261,10963,1178,43484,7294,4299,1832,8118,5025
ATTCTCTTTCAGATAC,sample,83095,82612,4927,77685,8707,68978,46426,2949,10660,1282,57086,7661,4106,1952,11081,5890
ACGTAAGTTCAGATAC,sample,69373,68906,4104,64802,8113,56689,39589,2135,8302,826,47891,5837,3844,1882,9888,5867
TTCTAATGTCAGATAC,sample,40115,39874,2968,36906,4006,32900,19240,1281,7404,854,26644,4121,3035,1351,5308,2842
CAACCGCGTCAGATAC,sample,30191,29934,1541,28393,4051,24342,18037,1155,3271,369,21308,1510,2255,1586,4820,2921
GGACCTCTTCAGATAC,sample,50520,50177,3134,47043,7334,39709,27053,1718,5969,689,33022,4280,3136,1391,7244,5023
GGACGTAGTCAGATAC,sample,77780,77324,4603,72721,7472,65249,40325,3037,12797,1354,53122,7736,4167,1275,15458,5148
CTTGATAGTCAGATAC,sample,60784,60436,2302,58134,10770,47364,37805,2304,4558,524,42363,2173,2187,1623,13815,7848
TGGACGAGTCAGATAC,sample,7476,7416,630,6786,1036,5750,3984,187,1010,93,4994,476,994,598,1562,746
CATTGCAGTCAGATAC,sample,42894,42463,3533,38930,5432,33498,20247,1280,6753,781,27000,4437,3574,1581,6677,3812
AGTCCGCATCAGATAC,sample,63003,62643,4113,58530,9685,48845,32327,1951,9054,820,41381,4693,3396,1631,12292,6696
TTGGTACCTCAGATAC,sample,101060,100413,6382,94031,9646,84385,57832,3678,12439,1539,70271,8897,5093,2569,11366,6143
CGGATTACTCAGATAC,sample,87113,86682,2826,83856,15150,68706,55146,4180,6104,483,61250,2793,2281,1723,16265,10793
GTTAGGACTCAGATAC,sample,135410,134427,13408,121019,11110,109909,47828,2833,33091,4117,80919,22040,8182,1950,15320,7012
GCCTGAACTCAGATAC,sample,60588,60138,3063,57075,9936,47139,28758,1886,9478,910,38236,6107,3427,1340,8457,6825
AACTCGTATCAGATAC,sample,78785,78375,2769,75606,11686,63920,49422,4007,6332,795,55754,3364,2965,2158,11772,8309
TTGGCCTCTCAGATAC,sample,90194,89502,7613,81889,9592,72297,36697,1859,18511,1878,55208,13352,5981,1489,10734,6687
GTCTTAGCTCAGATAC,sample,93960,93575,2407,91168,12936,78232,64871,4562,6245,547,71116,2007,2221,2072,16851,10084
TCAATATATCAGATAC,sample,89096,88621,4947,83674,13169,70505,49799,3952,9396,1233,59195,6125,3658,1834,12910,9736
GGAGAGTTTCGCTAGG,sample,67703,67260,5080,62180,8691,53489,31227,1900,11417,1165,42644,7780,4716,1696,12348,5766
TCCAACTTTCGCTAGG,Neg_Ctrl,440,285,236,49,2,47,28,3,11,0,39,5,23,11,5,2
AGTACCATTCGCTAGG,Neg_Ctrl,766,593,448,145,23,122,51,4,34,2,85,31,33,16,19,32
TGAGCGCGTCGCTAGG,sample,23381,23170,2292,20878,2872,18006,9818,715,4508,527,14326,2438,2746,1457,1133,1971
GGACCTCTTCGCTAGG,sample,37245,36953,2491,34462,5354,29108,18902,1460,5125,572,24027,3049,3247,1912,5238,3763
ACTATACTTCGCTAGG,sample,71648,71251,3163,68088,10887,57201,40990,2596,8188,755,49178,4672,3115,1799,14318,8431
GACGGAGATCGCTAGG,sample,39755,39445,2092,37353,6197,31156,21169,1305,5553,617,26722,2512,2708,1770,4131,4458
GACGATAATCGCTAGG,sample,14459,14152,4098,10054,822,9232,1820,98,3734,385,5554,3195,2351,411,406,346
GGCCAGAGTCGCTAGG,sample,25181,25010,1449,23561,3389,20172,13671,958,3721,398,17392,1424,2445,1702,3631,2354
CGAGGCAGTCGCTAGG,sample,34979,34775,1079,33696,6264,27432,23137,1601,1902,160,25039,632,1881,1895,8174,4775
CATGATTCTCGCTAGG,sample,64222,63762,4499,59263,8253,51010,30144,1608,10526,1355,40670,7377,4213,1486,12883,5600
ACGTATTATCGCTAGG,sample,73736,73299,4001,69298,9295,60003,37786,2749,10315,1397,48101,7756,4268,1799,9565,6174
CGTATGAATCGCTAGG,sample,42219,41945,2121,39824,7626,32198,23335,1397,4434,606,27769,2426,2640,1744,6264,5309
TTGGCCTCTCGCTAGG,sample,18785,18640,2022,16618,1399,15219,8230,586,3658,397,11888,2348,2405,1127,2225,1074
GTACCGTATCGCTAGG,Pos_Ctrl,21080,20861,1551,19310,1017,18293,15271,1417,1160,127,16431,318,3510,3329,1380,501
CTTCATGATCGCTAGG,sample,39647,39343,2169,37174,6130,31044,20657,1244,5976,600,26633,2567,2553,1375,6492,4411
AGGTCGGATCGCTAGG,sample,57351,56817,5719,51098,6186,44912,16288,741,14503,1523,30791,11857,5397,1240,5641,3961
TATCAGTTCCGTTGCG,sample,11140,11062,913,10149,1616,8533,4469,302,2346,338,6815,1078,1424,711,1685,1151
GGTTGCGTCCGTTGCG,sample,43260,43003,2552,40451,8187,32264,22259,1399,5360,640,27619,2606,2942,1717,8661,5517
CCTCTAGACCGTTGCG,sample,34351,34009,3231,30778,5275,25503,14259,1045,5787,589,20046,3823,3842,1891,3717,3608
TAGTACGGCCGTTGCG,sample,79782,79323,3414,75909,15315,60594,47191,2887,6875,913,54066,2728,2789,1786,18136,10925
GCCTTGCTCCGTTGCG,sample,88265,87357,11120,76237,4983,71254,21422,1708,27339,3220,48761,17565,8259,1999,4372,2807
CATAACCTCCGTTGCG,sample,101191,100563,6595,93968,8785,85183,48248,2912,20334,2436,68582,11253,5002,1911,11672,5562
ACTATACTCCGTTGCG,sample,99373,98685,6774,91911,8905,83006,49943,2788,17248,1884,67191,11143,5388,1571,18509,6449
CCAGAGCGCCGTTGCG,sample,33315,33026,2396,30630,6033,24597,16258,1128,4386,451,20644,2374,3333,2069,4278,4223
CCGCAACGCCGTTGCG,sample,68457,67677,8548,59129,7520,51609,20681,1303,16869,1937,37550,10819,6359,1860,7134,4670
GGACGTAGCCGTTGCG,sample,66792,66315,4761,61554,12003,49551,28962,1548,11155,1047,40117,6839,4072,1379,11004,7997
ACCTCGAGCCGTTGCG,sample,70052,69573,5001,64572,6676,57896,39326,2312,10362,1132,49688,4764,4382,2807,6595,4857
CATTGCAGCCGTTGCG,sample,105200,104293,9713,94580,12559,82021,36524,2706,24787,2870,61311,15134,6860,1790,12762,8743
CATGATTCCCGTTGCG,sample,65378,64859,3852,61007,7284,53723,28315,1709,15697,1870,44012,6132,3395,1501,2768,5152
CGTACGTCCCGTTGCG,sample,56530,56206,1709,54497,8311,46186,36612,2852,4669,613,41281,1440,2587,2526,8172,6059
AGTCCGCACCGTTGCG,sample,96915,96461,3788,92673,17812,74861,61641,4448,5792,700,67433,2280,2282,2222,19552,12876
GCCTGAACCCGTTGCG,sample,98542,98081,3435,94646,16031,78615,63547,4683,6346,866,69893,3173,2590,1953,22386,11870
ACGTATTACCGTTGCG,sample,54684,54252,4196,50056,5219,44837,23445,1645,11836,1653,35281,6258,3574,1602,6238,3479
AACTCGTACCGTTGCG,sample,62925,62494,5692,56802,5901,50901,23863,1798,15098,1728,38961,8414,5066,1801,5931,3878
TTGGCCTCCCGTTGCG,sample,10145,10032,1393,8639,716,7923,2660,180,2968,401,5628,1714,1884,640,555,423
ACCAATGCCCGTTGCG,sample,108727,108155,4776,103379,15319,88060,63989,4633,12675,1252,76664,5511,3300,1933,21813,11632
TGCTTCGCCCGTTGCG,sample,69499,69122,2414,66708,9873,56835,43585,3052,6122,656,49707,3420,3092,2023,11999,7331
GAAGGCGCCCGTTGCG,sample,78375,77863,5014,72849,10741,62108,43311,2809,9093,1146,52404,5749,3889,2292,10385,7397
GTCTTAGCCCGTTGCG,sample,129282,128328,10260,118068,11992,106076,54772,3341,25381,2703,80153,19879,7084,1919,17935,8220
CCAATTCCCCGTTGCG,sample,109595,109057,3660,105397,15959,89438,69194,4981,10267,1036,79461,3960,2638,1640,24997,11653
TTGGTTAACCGTTGCG,sample,57168,56802,3507,53295,7006,46289,31335,2009,7369,834,38704,4742,3102,1279,12772,5226
GTACCGTACCGTTGCG,sample,109329,108779,3482,105297,20231,85066,67598,3724,8755,1197,76353,3792,2275,1520,27028,14707
GACCGGAACCGTTGCG,sample,6552,6484,248,6236,1389,4847,3201,237,845,91,4046,473,1105,795,860,924
TCCAACTTAGGCCAAG,sample,155739,155112,4005,151107,27530,123577,103952,7821,8720,1050,112672,2034,2217,2608,29815,20625
TGAGCGCGAGGCCAAG,sample,64288,63821,3327,60494,8699,51795,39006,2203,6442,771,45448,3373,3160,1928,12612,6199
TTCCGTCTAGGCCAAG,sample,127672,126984,5415,121569,16567,105002,76445,5094,14303,1632,90748,7528,4318,2434,21529,12075
GCCTTGCTAGGCCAAG,sample,160950,159602,15207,144395,11513,132882,52469,3547,40303,3998,92772,32565,9271,2145,14412,7069
CAAGGCCTAGGCCAAG,sample,58113,57490,6223,51267,3824,47443,20724,1311,14629,1748,35353,9031,5133,1712,4504,2319
CATAACCTAGGCCAAG,sample,149249,147997,11624,136373,13201,123172,66499,4523,28495,3024,94994,20631,7488,2065,18511,9434
CCGCAACGAGGCCAAG,sample,61462,61007,3814,57193,7935,49258,32854,1869,9347,952,42201,4236,3710,1803,12911,5531
GACGATAAAGGCCAAG,sample,59067,58635,4124,54511,6763,47748,30466,1967,9142,1035,39608,5138,4465,2550,6739,4989
GGCCAGAGAGGCCAAG,sample,134045,133229,6348,126881,16131,110750,81937,5485,13350,1643,95287,8335,4250,2331,26712,11495
CCATGAAGAGGCCAAG,sample,98662,97923,6874,91049,12523,78526,50075,3127,14871,1668,64946,8785,5584,2694,13216,9391
CATGATTCAGGCCAAG,sample,83704,83018,7299,75719,13084,62635,29562,2065,17393,2051,46955,11564,5095,1487,7986,9038
AATCCGTCAGGCCAAG,sample,42141,41723,4208,37515,6673,30842,13503,625,9678,1019,23181,6017,4117,1398,2833,4379
AATATATCAGGCCAAG,sample,117066,116502,3854,112648,12910,99738,76977,4636,12297,1721,89274,4107,3147,2648,15488,10292
AAGAGCGCAGGCCAAG,sample,138623,137515,13453,124062,11188,112874,43778,2642,40276,4570,84054,21608,8672,2226,12172,6670
CCAATTCCAGGCCAAG,sample,77974,77589,2006,75583,12445,63138,52205,3882,4859,682,57064,1510,2036,1958,18783,9237
TTGGTTAAAGGCCAAG,sample,151027,150255,5877,144378,20062,124316,91331,6513,17202,1965,108533,7305,4272,2319,27430,15589
GGCATATAAGGCCAAG,Neg_Ctrl,417,273,93,180,23,157,106,7,22,0,128,22,66,45,18,14
TCAATATAAGGCCAAG,sample,146381,145617,7730,137887,21384,116503,79267,5579,18389,2198,97656,11070,5878,2621,22640,15762
CTTCATGAAGGCCAAG,sample,65201,64690,3907,60783,8195,52588,34220,2238,10263,1061,44483,4806,4014,2394,8978,5863
AGGTCGGAAGGCCAAG,sample,52620,52167,5106,47061,5125,41936,18121,1248,12993,1376,31114,8198,5076,1737,4741,3459
ATTCTCTTAGAACCGC,sample,43688,43195,5744,37451,6772,30679,10359,577,10339,1172,20698,8232,4329,996,3745,4252
TCCTCCGTAGAACCGC,sample,20933,20722,1902,18820,4747,14073,8120,595,3158,403,11278,1797,2102,1051,2103,2911
ACGTAAGTAGAACCGC,sample,88991,88474,3908,84566,13768,70798,54224,3733,8485,978,62709,3378,3752,2873,15154,10407
CCTCTAGAAGAACCGC,sample,60018,59641,2671,56970,14483,42487,29720,1727,7475,759,37195,2806,2765,1545,13358,9249
AGTACCATAGAACCGC,sample,112273,111445,8185,103260,19539,83721,49420,2986,18250,1945,67670,11120,5582,2057,19936,13211
TTCGTAATAGAACCGC,sample,63891,63478,5005,58473,10090,48383,27516,1857,11451,1158,38967,6401,4274,1833,10575,6783
ATGCCTGGAGAACCGC,sample,102700,102023,6716,95307,19483,75824,48060,2524,15552,1577,63612,8111,4585,1548,19817,13246
TAGTACGGAGAACCGC,sample,115031,114505,3904,110601,23969,86632,69578,5078,8016,813,77594,3147,2640,1839,29939,16260
TTCCGTCTAGAACCGC,sample,135731,134822,10387,124435,15740,108695,69877,3746,20860,1866,90737,12346,5341,1904,26197,10662
TCGCATCTAGAACCGC,sample,123352,122553,7249,115304,17723,97581,63837,3647,17205,1905,81042,10987,4598,1688,26208,12773
ACTATACTAGAACCGC,sample,133718,132857,6513,126344,21724,104620,78547,4029,14045,1727,92592,6272,3637,1904,32367,16059
CCAGAGCGAGAACCGC,sample,89389,88581,7549,81032,9897,71135,39341,2578,16237,1573,55578,11406,6059,2573,7549,6217
GGAGGACGAGAACCGC,sample,87355,86782,4474,82308,14026,68282,49367,2922,10281,1307,59648,4405,3860,2095,16930,10078
CCGCAACGAGAACCGC,sample,40699,40297,4400,35897,3284,32613,14107,832,10944,1373,25051,5357,4364,1678,2517,1992
GGACGTAGAGAACCGC,sample,105044,104427,4461,99966,16438,83528,62417,3854,10923,1207,73340,5127,3185,1927,21709,12320
TGGACGAGAGAACCGC,sample,54693,54159,5342,48817,10483,38334,21145,1251,8964,886,30109,6088,4164,1424,8781,6942
CATTGCAGAGAACCGC,sample,128787,127966,6250,121716,16010,105706,70753,5255,18154,2413,88907,9131,4348,2263,24438,12304
CGAGGCAGAGAACCGC,sample,113147,112382,6837,105545,14031,91514,62568,3983,14457,1478,77025,9028,4909,2384,21392,9764
CATGATTCAGAACCGC,sample,44624,44243,3904,40339,4455,35884,18762,1070,9610,1046,28372,5396,3601,1405,4590,2827
AATCCGTCAGAACCGC,sample,68882,68373,4010,64363,7365,56998,38424,2923,8813,999,47237,5839,4351,2728,5879,5181
AGTCCGCAAGAACCGC,sample,104948,104218,6082,98136,15467,82669,57552,3570,12135,1508,69687,7904,4580,2452,13776,11276
GTCCTGCCAGAACCGC,sample,116079,115280,7698,107582,16127,91455,52165,3090,20560,2456,72725,13184,6648,2278,17128,11377
CTAGGACCAGAACCGC,sample,124043,123226,5793,117433,12723,104710,78103,5462,13528,1497,91631,6120,4711,2973,14338,9507
CGTATGAAAGAACCGC,sample,69963,69444,5584,63860,8153,55707,30066,1663,13432,1295,43498,9251,4898,1728,10915,5509
TTGGCCTCAGAACCGC,sample,173726,172756,15307,157449,20203,137246,86101,4646,25101,2536,111202,18862,7987,2238,31904,13532
AATATATCAGAACCGC,sample,73393,72931,3290,69641,14898,54743,40996,2791,6718,814,47714,3424,3390,2431,12821,10351
ACCAATGCAGAACCGC,sample,122835,122091,6635,115456,17411,98045,67682,4079,16132,1928,83814,8224,4688,1986,23430,12824
TGCTTCGCAGAACCGC,sample,13681,13592,866,12726,1818,10908,7950,494,1525,123,9475,816,1571,1134,2398,1330
GAAGGCGCAGAACCGC,sample,60912,60469,4581,55888,10142,45746,29025,1852,8665,1022,37690,5182,4531,2123,8564,7420
CCAATTCCAGAACCGC,sample,63043,62601,4531,58070,8748,49322,31605,2028,8786,1057,40391,5846,4236,1845,9785,6115
GTACCGTAAGAACCGC,sample,70403,69925,4492,65433,8072,57361,30407,2082,16790,1728,47197,6354,3937,1813,3860,6074
TCAATATAAGAACCGC,sample,147462,146591,8089,138502,18923,119579,83305,5630,16963,1885,100268,11796,5765,3102,18952,13966
CTTCATGAAGAACCGC,sample,96315,95568,8901,86667,10058,76609,38288,2296,22001,2355,60289,11669,5833,2014,9033,6864
TTATTCGAAGAACCGC,sample,83707,83172,5090,78082,16651,61431,32680,2185,14336,1685,47016,10545,5008,1480,10232,10658
ATGACCGAAGAACCGC,sample,121681,121037,4294,116743,24188,92555,68890,5299,11187,1042,80077,6137,3401,2157,22497,18001
GGTTGCGTCATCAAGC,sample,162082,160990,10810,150180,13124,137056,79280,5187,28255,2870,107535,21464,9064,2957,15689,8785
ACGTAAGTCATCAAGC,sample,66242,65707,4805,60902,6321,54581,29052,1838,14946,2074,43998,6671,4350,2128,7533,4770
AGTACCATCATCAAGC,sample,96250,95488,8297,87191,15130,72061,41133,2561,17070,1801,58203,9496,5216,1804,14984,10701
ACGTTATGCATCAAGC,sample,94008,93370,4711,88659,14964,73695,52152,3207,11304,1008,63456,6024,4063,2129,18804,10597
CAACCGCGCATCAAGC,sample,55107,54630,4405,50225,7926,42299,23519,1448,9188,1143,32707,7001,4977,2111,6314,5663
TTAGAAGTCATCAAGC,sample,127604,126698,10204,116494,15220,101274,56490,3333,22203,2542,78693,16706,6353,1490,27917,10178
TTCCGTCTCATCAAGC,sample,37273,37024,2300,34724,4392,30332,21831,1448,4237,440,26068,2376,2686,1823,6738,3248
GACGGAGACATCAAGC,sample,72751,72119,6000,66119,5649,60470,31583,1832,17898,2069,49481,7088,4594,2245,7332,4087
GTTAGCCGCATCAAGC,sample,107188,106636,3097,103539,15652,87887,72355,5063,7398,747,79753,2324,2726,2491,20384,12427
CCGCAACGCATCAAGC,sample,76137,75679,2727,72952,12215,60737,48151,2817,6691,908,54842,2170,2183,1685,17832,9134
GGACGTAGCATCAAGC,sample,71869,71421,3497,67924,11823,56101,41946,2748,7386,880,49332,3141,3527,2313,12840,8802
ACCTCGAGCATCAAGC,sample,64527,63815,7459,56356,5127,51229,19450,1277,17722,2087,37172,10693,5742,1963,2643,3181
GACGATAACATCAAGC,sample,77583,77031,5379,71652,12075,59577,39761,2392,10175,1193,49936,6056,4254,2184,9406,8561
GGCCAGAGCATCAAGC,sample,81189,80753,3708,77045,14177,62868,47058,3633,7893,821,54951,3463,3334,2151,14405,10278
ACGACTTCCATCAAGC,sample,46057,45746,2437,43309,9581,33728,22553,1563,6382,579,28935,2651,2976,1812,4705,6620
CATGATTCCATCAAGC,sample,137768,136943,8322,128621,18314,110307,73526,5085,19639,1982,93165,10075,3800,2063,26066,12674
CGTACGTCCATCAAGC,sample,122263,121433,8961,112472,18788,93684,62069,4269,15125,1520,77194,10701,5275,2138,20897,13462
AGTCCGCACATCAAGC,sample,78493,77977,5325,72652,14425,58227,33615,1886,13451,1428,47066,7847,4422,1662,10034,9793
GTCCTGCCCATCAAGC,sample,109048,108242,6513,101729,11928,89801,58750,4107,16441,2093,75191,8410,5336,2146,17575,8055
CTAGGACCCATCAAGC,sample,99766,99047,6298,92749,12186,80563,47488,3505,17450,1775,64938,10345,5097,1466,19324,8958
GTTAGGACCATCAAGC,sample,122297,121399,8008,113391,14341,99050,58727,3247,21885,2290,80612,12901,5476,1472,24480,10073
ACGTATTACATCAAGC,sample,11303,11181,1315,9866,1565,8301,5047,305,1646,137,6693,1166,1492,780,1746,1057
AACTCGTACATCAAGC,sample,115968,115396,3976,111420,16887,94533,75206,4369,10194,989,85400,3775,2929,2244,23317,13026
CGTATGAACATCAAGC,sample,58206,57741,5302,52439,5988,46451,28492,2101,8362,973,36854,6523,4552,2077,6590,4013
TTGGCCTCCATCAAGC,Pos_Ctrl,26076,25825,2086,23739,1082,22657,19097,1865,1177,119,20274,399,3846,3815,1488,462
AATATATCCATCAAGC,sample,113283,112679,3415,109264,19182,90082,72737,4219,7786,847,80523,4493,2969,2110,26261,14268
ACCAATGCCATCAAGC,sample,89737,89194,3707,85487,10898,74589,59551,4339,6654,814,66205,3231,3485,2924,10580,8368
AAGAGCGCCATCAAGC,sample,137473,136655,5645,131010,15366,115644,77803,4827,22530,2171,100333,8313,3725,2225,21750,11229
CCAATTCCCATCAAGC,sample,111331,110492,9250,101242,12622,88620,46071,2856,21989,2553,68060,15151,6476,1904,13863,8897
TTGGTTAACATCAAGC,sample,103039,102492,4352,98140,17602,80538,58100,3271,11863,1088,69963,6216,3749,1828,21586,13232
CTTCATGACATCAAGC,sample,56028,55634,3338,52296,6220,46076,23089,1507,14029,1812,37118,5639,3282,1590,2390,4326
ATGACCGACATCAAGC,sample,63823,63427,3444,59983,9147,50836,23381,1320,18573,1758,41954,5804,3293,1314,3179,5927
GGAGAGTTAGAGAGCC,sample,62531,62153,5173,56980,10063,46917,19512,1371,13609,1686,33121,10739,5326,1401,6343,6516
TATCAGTTAGAGAGCC,sample,97838,97376,3090,94286,13298,80988,64494,4890,7142,1057,71636,3405,2708,2046,15271,9904
TCCAACTTAGAGAGCC,sample,38505,38239,2139,36100,4393,31707,20212,1233,6143,752,26355,3367,2519,1059,7842,3002
AAGTTCGTAGAGAGCC,sample,56732,56433,2541,53892,5087,48805,37004,2363,5343,645,42347,3450,3530,2567,6099,3372
TTCGTAATAGAGAGCC,sample,146366,145565,8101,137464,10033,127431,79450,5489,29404,2930,108854,10158,3557,1553,23447,7238
ATGCCTGGAGAGAGCC,sample,33280,33058,1860,31198,3744,27454,18765,1471,4667,566,23432,1985,2290,1212,5401,2682
AATGGTAAAGAGAGCC,sample,46152,45804,2559,43245,5443,37802,26320,1731,6357,701,32677,2693,3158,2160,4499,3897
TTAGAAGTAGAGAGCC,sample,98477,97924,4199,93725,14384,79341,59609,3538,10160,1295,69769,4739,3162,1874,20708,10806
CATAACCTAGAGAGCC,sample,88142,87425,4391,83034,9964,73070,55853,3433,7741,1049,63594,4994,4046,2392,11294,7124
CCAGAGCGAGAGAGCC,sample,69968,69455,4402,65053,10865,54188,35347,2178,10338,974,45685,5351,3768,1464,14503,7765
ACCTCGAGAGAGAGCC,sample,51145,50879,1792,49087,10946,38141,31340,2141,2894,546,34234,1220,2081,1968,10853,7742
GACGATAAAGAGAGCC,sample,63985,63572,4047,59525,12340,47185,28518,2006,9680,1248,38198,5733,3331,1179,11117,8441
GGCCAGAGAGAGAGCC,sample,80609,80249,2705,77544,13365,64179,51766,3139,6061,855,57827,2358,2305,1638,20429,9934
CATTGCAGAGAGAGCC,sample,92462,91976,4699,87277,11523,75754,51763,3320,12191,1418,63954,7062,4133,1957,18512,8189
CGAGGCAGAGAGAGCC,sample,52670,52222,2737,49485,6770,42715,33767,2481,3802,386,37569,2279,3601,3209,5613,4886
CGTACGTCAGAGAGCC,sample,52100,51657,4000,47657,7501,40156,25413,1479,7974,1006,33387,4284,3453,1623,10148,5172
AGTCCGCAAGAGAGCC,sample,52296,51891,3203,48688,7031,41657,22499,1490,11513,1278,34012,4877,3373,1458,4288,4978
GTCCTGCCAGAGAGCC,sample,39407,39091,3927,35164,3498,31666,16945,1183,7595,871,24540,5072,3938,1687,4153,2368
AATATATCAGAGAGCC,sample,83440,82931,3036,79895,13581,66314,51464,2619,7370,1000,58834,3861,2356,1489,20429,9715
GTCTTAGCAGAGAGCC,sample,86306,85942,2739,83203,13107,70096,55110,3779,7407,1035,62517,2765,2240,1504,21043,9827
TCGCCTGAAGAGAGCC,sample,58741,58429,2467,55962,6735,49227,38474,2099,5040,595,43514,3019,3231,2496,7067,4848
AGGTCGGAAGAGAGCC,sample,52228,51763,3939,47824,8051,39773,21898,1246,9643,901,31541,6085,3701,1152,6324,5874
GACCGGAAAGAGAGCC,sample,30343,30109,3529,26580,4525,22055,8140,662,7018,696,15158,5539,3737,1024,2777,2970
TCCAACTTAGCATTGA,sample,105758,104997,7351,97646,11887,85759,53133,3403,17188,1560,70321,10475,5104,1541,19348,8327
GGTTGCGTAGCATTGA,sample,172066,171206,5174,166032,17980,148052,118560,9326,12792,1123,131352,6251,4313,3014,22335,14094
TTCTAATGAGCATTGA,sample,180939,179924,11139,168785,17940,150845,88699,6569,29599,3115,118298,22863,8150,1914,29119,12263
TAGTACGGAGCATTGA,sample,181648,180943,5098,175845,21685,154160,129655,7460,11728,1091,141383,4226,2488,2038,40316,15863
TGAGCGCGAGCATTGA,sample,119753,119175,3164,116011,17173,98838,80199,7161,7455,1428,87654,2595,2214,1456,28136,13570
GCCTTGCTAGCATTGA,sample,63687,62996,6384,56612,7704,48908,15960,1536,17110,1752,33070,12550,5654,1117,3030,5091
CATAACCTAGCATTGA,sample,167483,166592,6369,160223,26062,134161,109656,6696,10565,1406,120221,5838,3270,2357,33808,19600
ACTATACTAGCATTGA,sample,167339,166560,4945,161615,27476,134139,109223,6633,10991,1223,120214,6069,3619,2513,33898,20643
GGACGTAGAGCATTGA,sample,98358,97663,5813,91850,13713,78137,50827,3407,13082,1603,63909,9218,5068,2314,15082,9978
CTTGATAGAGCATTGA,sample,79730,79246,2474,76772,11718,65054,52168,3523,6094,732,58262,2537,3563,3158,12865,9107
CCATGAAGAGCATTGA,sample,77088,76584,3822,72762,11222,61540,45690,3459,7197,754,52887,4440,3785,2159,12741,8110
GTCCTGCCAGCATTGA,sample,76460,75943,4731,71212,11350,59862,36942,2577,11890,1340,48832,7113,4893,2132,9685,7955
CGGATTACAGCATTGA,sample,133178,132295,6030,126265,14504,111761,74043,4664,18175,2330,92218,12549,5566,2210,16898,10393
ACGTATTAAGCATTGA,sample,117395,116788,4302,112486,15059,97427,76190,4955,10451,1287,86641,4544,3518,2403,22033,11554
CGTATGAAAGCATTGA,sample,104264,103640,3345,100295,15972,84323,60495,5174,11084,1193,71579,6377,3918,2156,16602,11796
AATATATCAGCATTGA,Neg_Ctrl,782,642,322,320,32,288,215,11,42,4,257,16,110,70,42,65
TGCTTCGCAGCATTGA,sample,66012,65627,2212,63415,9149,54266,42758,2698,5931,790,48689,2089,2190,1655,13629,6935
GAAGGCGCAGCATTGA,sample,87103,86674,3148,83526,8625,74901,49076,3282,15755,1751,64831,5037,3585,2056,9348,6658
CCAATTCCAGCATTGA,sample,102565,101997,3682,98315,13864,84451,63794,4455,9952,1387,73746,4863,3857,2402,18054,10243
CTTCATGAAGCATTGA,sample,78813,78123,6071,72052,10262,61790,34900,2109,13400,1490,48300,9891,5371,2186,11815,7019
TTCTAATGAATTACCA,sample,48315,47924,4783,43141,6414,36727,16668,1034,10872,1411,27540,6742,4404,1613,4741,4087
ATGCCTGGAATTACCA,sample,36293,35950,4371,31579,5074,26505,10550,590,8384,792,18934,6189,3826,1031,3813,3130
TTAGAAGTAATTACCA,sample,108908,108281,6282,101999,11472,90527,57963,4637,14885,1894,72848,11148,4853,1805,14478,7305
TTCCGTCTAATTACCA,sample,82866,82328,6228,76100,5387,70713,35500,2361,20187,2395,55687,10270,4805,1633,9634,3373
TCGCATCTAATTACCA,sample,78115,77686,3366,74320,7820,66500,46495,3123,11010,1054,57505,4818,2913,1513,14662,5605
CATAACCTAATTACCA,sample,40902,40544,4873,35671,5028,30643,13625,852,8296,956,21921,6914,3923,1201,4400,3269
ACTATACTAATTACCA,sample,83869,83303,6437,76866,11954,64912,35254,2155,16241,1708,51495,9554,4609,1494,12806,8094
GACGGAGAAATTACCA,sample,70132,69686,4768,64918,9101,55817,35774,2582,10860,1016,46634,5585,3776,1767,12979,6424
GGCCAGAGAATTACCA,sample,38359,38000,3307,34693,5257,29436,20433,1281,4446,485,24879,2791,2856,1663,4940,3602
ACGACTTCAATTACCA,sample,51778,51436,1839,49597,9168,40429,33237,2279,3108,439,36345,1366,2310,2195,10521,6751
GCCTGAACAATTACCA,sample,54899,54573,2623,51950,6636,45314,33016,2267,5914,613,38930,3504,3416,2169,8815,4984
AACTCGTAAATTACCA,sample,61135,60616,5940,54676,6575,48101,27260,1449,10494,1044,37754,7854,4395,1594,7562,4232
ACCAATGCAATTACCA,sample,66745,66328,2605,63723,7881,55842,39721,2819,9179,828,48900,3295,3143,2318,7506,5321
GAAGGCGCAATTACCA,sample,3866,3807,1044,2763,283,2480,268,18,1140,128,1408,926,758,80,35,143
AAGAGCGCAATTACCA,sample,60844,60495,2369,58126,6756,51370,38993,2607,6530,651,45523,2589,2603,2005,10021,5327
GTCTTAGCAATTACCA,sample,87524,87125,4446,82679,10085,72594,47697,4305,11617,1308,59314,7667,3987,1414,13600,7324
CCAATTCCAATTACCA,sample,28433,28206,2395,25811,2943,22868,14267,872,4468,628,18735,2633,2678,1555,3773,2069
ATGACCGAAATTACCA,sample,76730,76332,4144,72188,12333,59855,43607,3583,7807,1092,51414,3766,2884,1789,12805,8505
ATTCTCTTTAGATGAC,Pos_Ctrl,22607,22457,1736,20721,1202,19519,16507,1540,933,153,17440,386,3438,3170,1973,733
TCCAACTTTAGATGAC,sample,84793,84228,5452,78776,12441,66335,45493,2214,11439,1278,56932,5911,4088,2003,17307,9094
AGTACCATTAGATGAC,sample,79443,78878,5758,73120,12680,60440,37959,1979,11536,1302,49495,7664,4330,1712,17374,9132
TTCGTAATTAGATGAC,sample,37725,37467,2654,34813,8920,25893,16016,987,4918,552,20934,3420,2845,1317,5872,5714
ACGTTATGTAGATGAC,Pos_Ctrl,23124,22898,1566,21332,908,20424,17206,1592,1138,147,18344,341,3656,3583,1455,443
TGAGCGCGTAGATGAC,sample,58247,57980,1691,56289,10504,45785,37223,2369,4385,436,41608,1372,2212,1976,13023,7458
CAACCGCGTAGATGAC,sample,43406,43158,1257,41901,7839,34062,28682,1752,2552,248,31234,828,1589,1550,10851,5810
TTCCGTCTTAGATGAC,Pos_Ctrl,35515,35184,2140,33044,1462,31582,26622,2468,1667,255,28289,570,4340,4654,1873,707
CAAGGCCTTAGATGAC,sample,36120,35892,2036,33856,6150,27706,19461,1105,4785,633,24246,1722,2283,1388,8106,4391
GTTAGCCGTAGATGAC,sample,39186,38909,2350,36559,5074,31485,17257,1154,8551,1277,25808,3246,3167,1547,3763,3620
CCGCAACGTAGATGAC,sample,81385,80818,4091,76727,12730,63997,46153,2603,8779,1131,54932,5331,4052,2212,12895,9753
CGAGGCAGTAGATGAC,sample,67600,67111,4031,63080,9801,53279,37681,2386,8155,956,45836,4101,3584,2111,9561,6484
ACGACTTCTAGATGAC,sample,15380,15275,1149,14126,1984,12142,8509,544,1979,229,10488,881,2321,1674,1678,1477
CATGATTCTAGATGAC,sample,23967,23632,5910,17722,1412,16310,2883,195,7023,742,9906,5467,3778,717,362,557
CGTACGTCTAGATGAC,sample,46063,45749,2348,43401,10086,33315,23329,1684,5473,784,28802,2045,2434,1607,8830,6573
CGGATTACTAGATGAC,sample,57052,56559,4074,52485,7029,45456,29885,2001,7968,1032,37853,4570,3683,1906,6594,4959
GTTAGGACTAGATGAC,sample,64361,64047,3233,60814,7770,53044,33819,2346,11285,1186,45104,4408,2841,1441,8315,5574
GCCTGAACTAGATGAC,sample,48943,48650,2459,46191,5856,40335,25302,1655,8684,1173,33986,3521,2886,1634,7269,3989
CGTATGAATAGATGAC,sample,20530,20241,2205,18036,2273,15763,8307,592,3964,510,12271,2390,2225,936,3095,1428
ACCAATGCTAGATGAC,sample,91523,90896,5584,85312,10503,74809,57435,4124,8061,928,65496,4261,3796,2630,10382,8655
AAGAGCGCTAGATGAC,sample,71491,71030,3237,67793,8656,59137,42644,2895,8544,778,51188,4276,3524,2070,13465,6203
GTCTTAGCTAGATGAC,sample,85558,85129,3859,81270,13423,67847,40062,2936,14797,1313,54859,8739,4415,1508,10610,9451
GGCATATATAGATGAC,sample,53423,53116,3210,49906,7356,42550,25546,2262,8270,770,33816,5702,3307,1377,7335,5046
TATCAGTTGTTCAGAA,sample,68164,67885,1762,66123,13543,52580,44872,2751,3633,800,48505,524,1189,1250,21710,9490
AAGTTCGTGTTCAGAA,sample,51176,50766,3103,47663,7665,39998,23093,1659,8741,991,31834,5514,3794,1849,3856,5215
ACGTTATGGTTCAGAA,sample,46803,46478,2495,43983,5599,38384,23712,1490,9082,1136,32794,2964,3375,2123,6220,4168
TTCTAATGGTTCAGAA,sample,43807,43536,2682,40854,7953,32901,22327,1293,5685,694,28012,2902,2612,1331,9437,5441
TAGTACGGGTTCAGAA,sample,51642,51338,2397,48941,9594,39347,30020,1879,4574,529,34594,2345,2350,1628,11216,7027
TGAGCGCGGTTCAGAA,sample,57620,57323,1628,55695,9313,46382,38250,2788,3655,442,41905,1247,1794,1866,13100,6999
AATGGTAAGTTCAGAA,sample,63623,63318,2015,61303,13211,48092,40367,2587,3239,420,43606,1479,2488,2432,11728,9166
TTAGAAGTGTTCAGAA,sample,67254,66808,4453,62355,9112,53243,32480,1757,10927,1212,43407,6867,4392,1890,11336,6160
TTCCGTCTGTTCAGAA,sample,64463,64161,2904,61257,6788,54469,36690,1995,10591,1218,47281,3975,3035,1946,12339,5403
CAAGGCCTGTTCAGAA,sample,72344,71843,5035,66808,9401,57407,32618,1999,13570,1685,46188,7535,4350,1658,11881,6641
ACTATACTGTTCAGAA,sample,85172,84733,3158,81575,13969,67606,49218,3352,10241,874,59459,3921,2978,1658,19022,10208
TGGACGAGGTTCAGAA,sample,51546,51268,2714,48554,7869,40685,29156,1836,6142,738,35298,2813,2834,1643,11804,5590
GACGATAAGTTCAGAA,sample,80733,80358,2207,78151,14468,63683,54333,3048,4585,394,58918,1323,1926,1942,20254,10565
CATTGCAGGTTCAGAA,sample,66794,66448,2993,63455,10043,53412,38852,2216,8078,757,46930,3509,2927,1796,15521,7472
AGTCCGCAGTTCAGAA,sample,43716,43414,1263,42151,6821,35330,29122,2029,2968,388,32090,823,2261,2271,7716,5161
AACTCGTAGTTCAGAA,sample,76525,76220,2593,73627,11868,61759,51655,3800,4686,493,56341,1125,1407,1472,17822,9436
CGTATGAAGTTCAGAA,sample,55487,55230,1918,53312,8489,44823,30605,2004,7624,960,38229,3630,2598,1508,8279,6239
TGCTTCGCGTTCAGAA,sample,49713,49417,1699,47718,6041,41677,29363,2066,6998,828,36361,2422,2665,2090,6151,4263
AAGAGCGCGTTCAGAA,sample,47093,46819,2819,44000,6862,37138,22020,1318,8218,840,30238,4742,3404,1091,6965,4917
GTACCGTAGTTCAGAA,sample,78146,77803,5028,72775,8016,64759,33751,2369,15370,1559,49121,11710,6112,1970,11117,5394
GGCATATAGTTCAGAA,sample,59773,59484,1239,58245,9746,48499,43283,2180,2154,486,45437,396,1412,1717,13219,6945
TCGCCTGAGTTCAGAA,sample,69710,69462,2112,67350,11729,55621,44900,3345,4982,431,49882,1963,2030,1538,18055,8637
AGGTCGGAGTTCAGAA,Pos_Ctrl,30103,29943,1231,28712,1440,27272,22888,2506,1228,187,24116,463,4112,4351,2573,643
TCCAACTTTTCTGGTT,Neg_Ctrl,346,201,75,126,11,115,75,4,18,5,93,13,47,30,18,7
TCCTCCGTTTCTGGTT,sample,49488,49153,2521,46632,10109,36523,24570,1463,7061,527,31631,2902,2758,1453,8782,7008
AGTACCATTTCTGGTT,sample,77135,76659,3596,73063,11729,61334,44460,2769,9462,1318,53922,3325,2632,1676,17376,8930
ACGTTATGTTCTGGTT,sample,59309,58570,4641,53929,8940,44989,27242,1718,9416,929,36658,5684,3643,1379,11614,6527
TTCTAATGTTCTGGTT,Neg_Ctrl,456,302,160,142,7,135,51,1,36,4,87,43,33,16,20,7
TGAGCGCGTTCTGGTT,sample,38202,37889,2341,35548,6575,28973,17937,910,6395,713,24332,3018,2859,1575,4915,4566
GGACCTCTTTCTGGTT,Neg_Ctrl,426,246,91,155,21,134,84,3,22,2,106,23,52,32,15,6
CAAGGCCTTTCTGGTT,sample,97715,97044,5541,91503,9116,82387,50099,3333,16622,1893,66721,10440,4996,1565,17781,6747
CCAGAGCGTTCTGGTT,sample,54129,53696,4038,49658,6872,42786,24707,1382,9878,1063,34585,5756,3854,1684,4510,5125
CCGCAACGTTCTGGTT,sample,60458,60050,3315,56735,8670,48065,34892,2286,6312,818,41204,3757,3012,1701,13547,6378
ACCTCGAGTTCTGGTT,sample,50503,50132,2318,47814,8010,39804,29748,1864,5618,666,35366,1908,2004,1603,10681,5998
GACGATAATTCTGGTT,sample,67656,67240,3335,63905,10781,53124,37473,2271,7828,793,45301,4759,3609,1653,15381,7633
CGAGGCAGTTCTGGTT,sample,65055,64553,5121,59432,7016,52416,30819,1867,10626,1224,41445,7880,4679,2124,7870,4843
TTGGTACCTTCTGGTT,sample,69833,69487,2462,67025,12259,54766,47134,2724,3467,411,50601,1030,2038,2219,15808,9359
CGGATTACTTCTGGTT,sample,47268,46918,4777,42141,5298,36843,18190,1304,9420,936,27610,6993,4025,1090,7564,3286
GTTAGGACTTCTGGTT,sample,46621,46160,4216,41944,5131,36813,18377,1000,9289,981,27666,7166,4175,1384,5737,3291
TTGGCCTCTTCTGGTT,sample,80407,79992,2413,77579,11932,65647,52739,4432,5553,470,58292,2453,2750,2250,12499,8685
AATATATCTTCTGGTT,sample,110260,109282,13704,95578,9683,85895,41653,2926,21791,2162,63444,17363,7931,1950,11794,5875
GTCTTAGCTTCTGGTT,sample,51639,51176,4559,46617,5774,40843,20553,1526,10843,1161,31396,6760,4157,1334,5973,3794
GTACCGTATTCTGGTT,sample,83423,82724,8651,74073,7398,66675,25410,1801,20659,2308,46069,16497,6068,1295,3711,4793
TCGCCTGATTCTGGTT,sample,23668,23461,1865,21596,2289,19307,10223,591,5321,677,15544,2495,2524,1195,3003,1509
AGGTCGGATTCTGGTT,sample,63287,62833,4328,58505,6886,51619,33528,2213,9440,955,42968,5483,3793,1728,10015,5099
TCCAACTTGTTCGGTT,sample,38549,38254,3377,34877,5346,29531,14028,711,8503,937,22531,5352,4083,1560,4697,3717
TTCGTAATGTTCGGTT,sample,143824,142972,11160,131812,16931,114881,62050,3530,29985,3992,92035,15324,6899,2244,23352,11499
ATGCCTGGGTTCGGTT,sample,71397,70940,3360,67580,12314,55266,40360,2434,7377,853,47737,4242,3800,2408,10472,8737
TGAGCGCGGTTCGGTT,sample,85127,84739,2327,82412,14720,67692,54813,4207,5511,532,60324,2629,2188,1584,21371,10465
TTAGAAGTGTTCGGTT,sample,37863,37723,858,36865,5617,31248,24292,1980,3535,502,27827,939,2449,2281,5502,3887
CAAGGCCTGTTCGGTT,sample,113979,113562,3637,109925,14276,95649,71405,5158,11593,1366,82998,6127,3535,1724,23147,10483
GTTAGCCGGTTCGGTT,sample,48981,48658,2374,46284,11302,34982,23699,1260,6354,690,30053,2979,2903,1619,8235,7626
CATGATTCGTTCGGTT,sample,59495,59082,3056,56026,8398,47628,30915,1807,9796,893,40711,4217,3576,2003,10045,6005
AATCCGTCGTTCGGTT,sample,65820,65281,6002,59279,9073,50206,23584,1429,13854,1482,37438,9857,5351,1604,6881,6200
CGTACGTCGTTCGGTT,sample,67653,67142,4377,62765,11478,51287,28884,2163,12265,1422,41149,6553,4148,1409,11377,7662
TGCTTCGCGTTCGGTT,sample,45777,45458,2302,43156,4941,38215,21543,1578,10291,1155,31834,3648,3112,1577,4172,3290
CCAATTCCGTTCGGTT,sample,74454,73993,3115,70878,8809,62069,45700,2214,9379,962,55079,3814,3006,1620,15829,6920
TTGGTTAAGTTCGGTT,sample,170649,169674,9197,160477,13788,146689,87117,6189,36535,3951,123652,12897,5592,2132,21691,9168
TTATTCGAGTTCGGTT,Neg_Ctrl,554,443,135,308,44,264,185,8,40,2,225,29,106,59,60,40
ATGACCGAGTTCGGTT,sample,48928,48590,5293,43297,6374,36923,26438,2083,5020,594,31458,2788,2887,1825,6663,5999
ATTCTCTTTGGCGGTT,sample,143236,142520,5119,137401,29341,108060,82643,5629,13112,1341,95755,5335,3803,2540,27087,19288
TCCAACTTTGGCGGTT,sample,124528,123754,6464,117290,22820,94470,62911,3926,17008,2312,79919,8313,4529,1886,22032,15294
ACGTAAGTTGGCGGTT,sample,150584,149766,6268,143498,23412,120086,87760,5042,17800,1899,105560,7585,4201,2110,33776,17064
CCTCTAGATGGCGGTT,sample,123912,123122,5259,117863,22587,95276,71613,3845,11825,1482,83438,6511,4381,2765,19034,16606
ACGTTATGTGGCGGTT,sample,144239,143540,4329,139211,26586,112625,89487,5891,11647,1774,101134,3826,2468,1866,36541,19281
TAGTACGGTGGCGGTT,sample,140184,139499,4136,135363,24092,111271,93091,5575,8527,892,101618,3186,2721,2270,33717,18148
CAACCGCGTGGCGGTT,sample,100799,100199,2858,97341,14561,82780,67082,4108,9322,671,76404,1597,1725,1577,26759,11274
TTCCGTCTTGGCGGTT,sample,16206,16006,2080,13926,2027,11899,6467,409,2939,287,9406,1797,2027,879,2417,1287
GCCTTGCTTGGCGGTT,sample,98431,97609,7174,90435,9004,81431,46178,2911,19775,2003,65953,10564,5488,2696,10295,6017
CAAGGCCTTGGCGGTT,sample,102922,102170,6059,96111,16746,79365,46239,2855,17577,1757,63816,10937,5014,1758,18677,11865
CCAGAGCGTGGCGGTT,sample,177133,176173,10907,165266,18638,146628,83107,4890,32575,3846,115682,22210,7958,2155,33736,12785
CTTGATAGTGGCGGTT,sample,98924,98277,5822,92455,16205,76250,49582,2651,14086,1575,63668,8356,4228,1498,19737,11147
ACCTCGAGTGGCGGTT,sample,88740,88129,5710,82419,8705,73714,39306,2079,20296,2399,59602,9634,5177,1975,13585,5970
CGAGGCAGTGGCGGTT,sample,128521,127644,6728,120916,18309,102607,72555,3940,16060,1365,88615,8687,4717,1831,32523,13564
AGTCCGCATGGCGGTT,sample,96417,95860,4424,91436,14482,76954,56582,3953,10802,1105,67384,4512,4031,2760,16060,10504
CTAGGACCTGGCGGTT,sample,146002,145137,7088,138049,12240,125809,76742,4929,26786,2934,103528,14418,5473,1933,21405,8668
ACGTATTATGGCGGTT,sample,162570,161599,8075,153524,18242,135282,95690,6860,18966,2188,114656,11578,6531,3374,21205,13311
ACCAATGCTGGCGGTT,sample,124154,123352,7182,116170,12054,104116,57600,4254,27797,3270,85397,11195,5177,2022,15920,8131
TGCTTCGCTGGCGGTT,sample,102699,102175,2943,99232,16124,83108,66132,5243,7927,982,74059,2824,2299,1862,22940,11984
GGCATATATGGCGGTT,sample,74491,74017,4197,69820,8930,60890,38540,2252,12189,1185,50729,6724,4583,2311,12270,6259
CTTCATGATGGCGGTT,sample,97191,96638,3546,93092,14780,78312,58086,3561,11529,1411,69615,3725,3419,2468,17395,10493
ATTCTCTTTCCTTATT,sample,82850,82257,9447,72810,7869,64941,25607,1846,20455,2002,46062,15031,6977,1325,7617,4409
AAGTTCGTTCCTTATT,sample,51089,50793,2060,48733,5752,42981,30918,2256,6914,664,37832,2229,2238,1459,8520,4151
CCTCTAGATCCTTATT,sample,23989,23810,1264,22546,2836,19710,12140,582,4716,592,16856,1680,2055,1186,4135,2170
TTCGTAATTCCTTATT,sample,56348,56089,1842,54247,8749,45498,38163,2590,3091,438,41254,1216,2188,2040,10927,6710
AATGGTAATCCTTATT,sample,39772,39531,2303,37228,5168,32060,24541,1532,3559,477,28100,1951,2524,1906,6556,3818
ACCTCGAGTCCTTATT,sample,27744,27657,760,26897,4794,22103,18235,1296,1777,185,20012,610,1218,1101,8162,3472
GACGATAATCCTTATT,sample,43081,42798,3002,39796,4703,35093,22159,1057,6515,664,28674,4698,3547,1399,8518,3116
CGAGGCAGTCCTTATT,sample,47383,47151,2865,44286,6703,37583,25135,1360,6282,739,31417,4067,3185,1421,10124,4863
CCATGAAGTCCTTATT,sample,55009,54716,3485,51231,7338,43893,26178,2075,8656,897,34834,6087,4287,1772,8644,4867
ACGACTTCTCCTTATT,sample,52727,52413,2685,49728,6298,43430,31316,1859,5827,824,37143,3604,3263,1971,9867,4386
AGTCCGCATCCTTATT,sample,55207,54868,4454,50414,6233,44181,23972,1517,10274,1008,34246,7410,4807,1670,8305,4091
TTGGCCTCTCCTTATT,Pos_Ctrl,16292,16155,1274,14881,714,14167,12044,1062,700,102,12744,259,2921,2669,1099,320
AATATATCTCCTTATT,sample,45579,45241,4392,40849,6489,34360,13123,1003,10499,1226,23622,8509,4909,1444,2118,4456
GTCTTAGCTCCTTATT,sample,27411,27240,1767,25473,3330,22143,14070,936,4346,496,18416,2295,2682,1460,4283,2384
CCAATTCCTCCTTATT,sample,31579,31459,922,30537,6220,24317,20825,1531,1329,201,22154,431,1576,1611,6799,4464
TTGGTTAATCCTTATT,sample,64510,64242,1663,62579,9233,53346,43594,2568,5075,633,48669,1476,1593,1382,16448,7036
GGCATATATCCTTATT,sample,38723,38498,2403,36095,5950,30145,20427,1418,5051,552,25478,2697,2260,957,9879,4331
CTTCATGATCCTTATT,sample,52024,51732,2494,49238,7641,41597,31336,2172,5012,568,36348,2509,2639,1991,7948,5561
ACGTAAGTAATAAGGT,sample,127948,127272,4389,122883,9994,112889,84213,6454,16096,1550,100309,4576,3584,2868,15080,7518
AGTACCATAATAAGGT,sample,94627,94003,4836,89167,11081,78086,51405,4898,12218,1676,63623,7889,4320,2161,5870,7191
TTCGTAATAATAAGGT,sample,104396,103797,5318,98479,14891,83588,50777,3436,17292,2521,68069,9562,4527,1653,10890,9662
CAACCGCGAATAAGGT,sample,99705,99094,4220,94874,9373,85501,61747,3837,13647,1619,75394,4651,3646,2537,12668,7421
CCAGAGCGAATAAGGT,sample,68216,67782,2328,65454,13829,51625,41617,3018,4806,523,46423,1661,2448,2030,13808,9741
GGAGGACGAATAAGGT,sample,87349,86731,6871,79860,10863,68997,32462,1513,21581,2363,54043,11078,5068,1474,10491,7424
CCGCAACGAATAAGGT,Pos_Ctrl,25096,24720,1535,23185,1135,22050,18575,1751,1147,122,19722,455,3809,3790,1424,498
GGACGTAGAATAAGGT,sample,123481,122558,6854,115704,16082,99622,67181,4314,16352,1934,83533,9841,5404,2528,19266,11785
CTTGATAGAATAAGGT,sample,95153,94463,5635,88828,13690,75138,42694,2786,16747,1921,59441,10990,5050,1781,13137,9452
ACCTCGAGAATAAGGT,sample,101882,101229,4936,96293,12880,83413,59595,3468,11572,1360,71167,7418,4532,2550,15628,9066
GGCCAGAGAATAAGGT,sample,72700,72178,4029,68149,9966,58183,43855,3017,6792,824,50647,3695,3805,2650,11161,7459
AATCCGTCAATAAGGT,Pos_Ctrl,20769,20676,760,19916,1050,18866,15885,1896,721,79,16606,285,3268,3614,1314,392
GTCCTGCCAATAAGGT,sample,140547,139706,7131,132575,14076,118499,79057,5926,19063,2051,98120,12402,6445,2696,19967,9705
GTCTTAGCAATAAGGT,sample,74199,73665,4849,68816,10505,58311,40396,2686,8309,1016,48705,5904,4335,2086,12395,7562
TATCAGTTCAGGACCA,sample,151406,150520,12523,137997,11805,126192,55358,3377,35424,3728,90782,28305,9306,2554,13542,6826
AATGGTAACAGGACCA,sample,111761,111145,4201,106944,13871,93073,53623,4065,23491,3062,77114,8832,3550,1656,12495,9949
ACTATACTCAGGACCA,sample,111565,110789,6919,103870,17378,86492,52798,3836,17280,1893,70078,10685,5807,2284,16319,12022
GTTAGCCGCAGGACCA,sample,91588,91192,2382,88810,19065,69745,54754,3476,6961,716,61715,3838,3097,2111,12797,13195
GGAGGACGCAGGACCA,sample,84268,83818,2322,81496,10368,71128,61053,3923,4063,434,65116,1655,3428,3749,7959,8129
ACCTCGAGCAGGACCA,sample,139199,138431,6561,131870,21075,110795,69528,4743,20941,2420,90469,13163,5478,1855,26135,15134
CGTACGTCCAGGACCA,sample,58680,58138,4843,53295,4645,48650,22619,1353,15009,2111,37628,7558,4293,1585,5944,3176
AGTCCGCACAGGACCA,sample,79953,79314,5000,74314,12164,62150,40414,3262,10914,1066,51328,6494,3920,1711,14041,8713
TTGGTACCCAGGACCA,sample,114359,113626,6424,107202,19798,87404,50990,4171,18547,2388,69537,11308,5015,1530,15165,13766
CTAGGACCCAGGACCA,sample,52711,52019,6102,45917,6120,39797,18706,1408,10847,1198,29553,7638,5333,1826,6360,3987
CGGATTACCAGGACCA,sample,29521,29322,5932,23390,3337,20053,13538,663,3931,438,17469,1483,2177,1234,5385,3759
AATATATCCAGGACCA,Neg_Ctrl,718,541,358,183,34,149,93,9,26,2,119,19,58,32,30,22
ACCAATGCCAGGACCA,sample,136114,135431,6790,128641,17184,111457,80100,4838,14563,1635,94663,10321,5466,2320,24554,12472
CCAATTCCCAGGACCA,sample,134499,133423,8930,124493,14541,109952,64633,4375,23100,2942,87733,14902,6577,2243,19973,10654
TCAATATACAGGACCA,sample,157628,156915,6420,150495,20941,129554,97385,6346,16525,1725,113910,7573,4400,2481,28000,14950
GACCGGAACAGGACCA,sample,66781,66413,3422,62991,9671,53320,32703,2284,10132,1271,42835,6930,4633,2093,6760,6808
GGTTGCGTCCTCGTTG,sample,68946,68486,3867,64619,6354,58265,35098,1838,13001,1849,48099,6479,3434,1375,11344,4608
ACGTAAGTCCTCGTTG,sample,112739,112210,4922,107288,12132,95156,74415,5727,9361,906,83776,4747,3862,2500,17591,9334
TTCCGTCTCCTCGTTG,sample,94450,93946,4684,89262,10632,78630,56712,3771,10403,1151,67115,6593,3512,1565,15426,7501
GGACCTCTCCTCGTTG,sample,81156,80568,4974,75594,8460,67134,45486,3602,10393,1282,55879,6371,3902,1859,12342,6008
GACGGAGACCTCGTTG,sample,62842,62427,3062,59365,8438,50927,32410,1685,11630,1121,44040,4081,3378,1710,9331,5938
CCGCAACGCCTCGTTG,sample,65568,64872,7382,57490,6343,51147,24141,1515,13222,1353,37363,10916,5838,1916,5782,4066
GGACGTAGCCTCGTTG,Neg_Ctrl,707,531,212,319,29,290,89,2,176,10,265,13,54,28,32,25
CGAGGCAGCCTCGTTG,sample,68507,68053,3858,64195,10389,53806,34178,2167,8802,1097,42980,7562,4134,1712,9902,7102
AATCCGTCCCTCGTTG,sample,27257,27018,895,26123,4861,21262,18185,1381,1170,114,19355,412,1717,1737,5499,3569
CGTACGTCCCTCGTTG,Neg_Ctrl,569,406,263,143,7,136,74,0,46,1,120,15,53,24,29,15
CGGATTACCCTCGTTG,sample,84182,83656,4291,79365,10523,68842,51749,4077,7354,729,59103,4933,3231,1999,13867,7400
ACGTATTACCTCGTTG,sample,96279,95687,3452,92235,10770,81465,62998,5524,8745,1018,71743,3180,2581,2360,14196,8342
CGTATGAACCTCGTTG,sample,63520,62879,8298,54581,4274,50307,19835,1194,16422,1747,36257,11109,5501,1866,1872,2243
AAGAGCGCCCTCGTTG,sample,73052,72590,4087,68503,10164,58339,39655,2793,8833,1174,48488,5884,3729,1678,14107,7339
GTACCGTACCTCGTTG,Pos_Ctrl,34065,33784,2764,31020,1581,29439,24612,2409,1660,189,26272,569,4258,4409,1781,791
AGGTCGGACCTCGTTG,sample,92070,91659,3179,88480,15399,73081,59696,4185,5880,965,65576,2355,2529,2014,19766,11188
ATGACCGACCTCGTTG,sample,91066,90645,3241,87404,14112,73292,58582,4545,6254,837,64836,3074,2723,2003,17646,10685
ACGTTATGTTGCGGAC,sample,62185,61891,1918,59973,11534,48439,39414,2941,4101,449,43515,1534,2274,2026,14890,8665
ATGCCTGGTTGCGGAC,sample,11214,11100,1579,9521,1137,8384,3303,210,2835,279,6138,1757,1882,590,1206,750
CAACCGCGTTGCGGAC,sample,37372,37171,1104,36067,8271,27796,23914,1715,1466,211,25380,490,1700,1883,8090,6023
CAAGGCCTTTGCGGAC,sample,85513,85063,3716,81347,11699,69648,48633,3441,10880,1323,59513,5371,3594,2271,15410,8880
ACTATACTTTGCGGAC,sample,96740,96298,3651,92647,15722,76925,61743,4351,7071,886,68814,2874,2601,1920,22141,11646
CCAGAGCGTTGCGGAC,sample,49751,49412,2348,47064,8463,38601,27399,1800,5876,699,33275,2827,2837,1869,7296,6095
ACCTCGAGTTGCGGAC,sample,57360,56886,4978,51908,6602,45306,27692,1339,8763,894,36455,6618,4175,1466,12518,4684
CATGATTCTTGCGGAC,sample,64930,64524,4051,60473,10020,50453,31470,1586,10478,1132,41948,5787,3901,1634,12254,7108
CTAGGACCTTGCGGAC,sample,58155,57802,2341,55461,5480,49981,38839,2736,5545,566,44384,2295,3296,2788,7904,4253
CGGATTACTTGCGGAC,sample,39837,39524,2430,37094,5393,31701,18057,1390,6724,877,24781,4653,3279,1542,2165,3579
GCCTGAACTTGCGGAC,sample,98800,98285,3769,94516,11973,82543,58517,3089,13329,1293,71846,6315,3400,1572,21093,8477
AACTCGTATTGCGGAC,sample,100154,99464,6291,93173,9403,83770,44698,2950,19637,1957,64335,14528,6094,1907,10193,6198
TTGGCCTCTTGCGGAC,sample,79837,79379,5119,74260,10368,63892,35993,2410,13811,1720,49804,9958,4665,1327,10272,7392
TGCTTCGCTTGCGGAC,sample,54498,54250,1541,52709,8474,44235,36095,2481,4144,467,40239,1048,1984,1806,9167,6316
AAGAGCGCTTGCGGAC,sample,41615,41337,2502,38835,5024,33811,20866,1351,7161,788,28027,3645,2986,1373,6432,3573
GTCTTAGCTTGCGGAC,sample,26059,25892,1884,24008,2847,21161,10483,823,5423,511,15906,3921,3095,1284,2243,1921
AGGTCGGATTGCGGAC,sample,67597,67151,3694,63457,9446,54011,35826,2436,8997,1514,44823,5238,3884,1732,12047,6718
TTATTCGATTGCGGAC,sample,74882,74472,4306,70166,11299,58867,37066,2633,11122,1310,48188,6736,4490,1851,11841,8264
TATCAGTTTCCATTGG,sample,42391,42188,2373,39815,6905,32910,24684,1519,4230,437,28914,2040,2549,1953,7677,5071
ACGTAAGTTCCATTGG,sample,49640,49360,1951,47409,8476,38933,30982,1988,3950,409,34932,1604,2454,2003,8428,6326
TTCTAATGTCCATTGG,sample,23294,23134,1182,21952,3234,18718,11711,728,4279,568,15990,1432,2103,1278,3558,2201
TAGTACGGTCCATTGG,sample,28687,28488,2984,25504,3300,22204,12356,770,4872,528,17228,3678,2823,1139,5008,2313
GGACCTCTTCCATTGG,sample,30740,30553,2589,27964,3679,24285,14398,863,5046,506,19444,3472,2906,1245,4769,2627
TCGCATCTTCCATTGG,sample,43618,43433,1242,42191,7170,35021,30399,2124,1731,195,32130,572,1685,1877,9405,5410
GCCTTGCTTCCATTGG,sample,29614,29435,1532,27903,3837,24066,15389,901,4978,653,20367,2145,2349,1488,3986,2789
ACTATACTTCCATTGG,sample,46250,45990,3119,42871,6474,36397,23658,1318,6644,853,30302,3924,3022,1319,9485,4589
GACGGAGATCCATTGG,sample,33712,33475,3386,30089,4222,25867,11579,799,7625,891,19204,4973,3387,1025,2502,2741
CCAGAGCGTCCATTGG,sample,43411,43170,2378,40792,5496,35296,24230,1627,5320,504,29550,3615,3290,1818,7735,3850
GTTAGCCGTCCATTGG,sample,35815,35585,2792,32793,5729,27064,11601,793,7726,829,19327,6115,3979,994,4129,3970
GGACGTAGTCCATTGG,sample,47562,47290,1366,45924,5761,40163,34577,1808,2543,315,37120,920,2129,2264,7931,4622
GACGATAATCCATTGG,sample,27486,27335,1078,26257,5006,21251,15943,1094,2574,231,18517,1409,2154,1555,4461,3455
CCATGAAGTCCATTGG,sample,13982,13869,1162,12707,2128,10579,6487,483,2075,245,8562,1289,1732,882,2166,1407
CATGATTCTCCATTGG,sample,29314,29093,2478,26615,3245,23370,10796,925,6142,705,16938,4802,3730,1694,763,2091
AATCCGTCTCCATTGG,sample,53294,52954,3140,49814,6930,42884,25867,1568,8399,821,34266,6229,4120,1641,8952,4897
AGTCCGCATCCATTGG,sample,50635,50366,2760,47606,7419,40187,25822,1531,7172,914,32994,4748,3167,1332,10501,5352
GTCCTGCCTCCATTGG,sample,41171,41010,1829,39181,5581,33600,23866,1542,4716,400,28582,3076,2674,1523,9747,3837
CGGATTACTCCATTGG,sample,40512,40247,1625,38622,5170,33452,25484,1693,3884,463,29368,1928,2104,1487,5720,3803
AACTCGTATCCATTGG,sample,43801,43619,1559,42060,5916,36144,27975,2012,3472,414,31447,2271,1813,1330,9200,4662
CGTATGAATCCATTGG,sample,34678,34491,1435,33056,3952,29104,19402,1391,5406,611,24808,2294,2494,1718,3584,2820
TTGGCCTCTCCATTGG,sample,35768,35596,1863,33733,4684,29049,21695,1104,3920,551,25615,1779,1985,1335,7807,3497
AATATATCTCCATTGG,sample,47807,47496,2893,44603,6073,38530,25686,1461,6371,747,32057,4265,3192,1565,8143,4357
GTCTTAGCTCCATTGG,sample,41333,41048,3147,37901,3305,34596,19315,1343,7671,840,26986,5427,4308,1969,3809,2158
GGCATATATCCATTGG,Neg_Ctrl,273,158,59,99,18,81,52,6,13,3,65,7,27,20,11,8
ATGACCGATCCATTGG,sample,25563,25408,2082,23326,3652,19674,10530,760,5028,559,15558,2797,2587,1186,1628,2280
GGAGAGTTCATAGGCG,sample,18268,18020,4629,13391,1199,12192,1807,156,5250,591,7057,4388,2918,431,396,593
TCCAACTTCATAGGCG,sample,30492,30259,2692,27567,5228,22339,11853,778,5004,478,16857,4226,3171,1385,3958,3460
ACGTTATGCATAGGCG,sample,37538,37267,3470,33797,6666,27131,13304,634,7098,778,20402,5317,3651,1176,5856,4503
TGAGCGCGCATAGGCG,sample,38828,38588,2274,36314,6463,29851,19559,1329,6008,551,25567,2404,2655,1639,6330,4513
TTAGAAGTCATAGGCG,sample,36011,35747,3430,32317,3798,28519,16286,1099,6769,719,23055,3646,3431,1756,4502,2501
GGACCTCTCATAGGCG,sample,136841,135716,11665,124051,10554,113497,45384,2832,34917,3598,80301,26766,8849,1926,14268,6673
GCCTTGCTCATAGGCG,sample,97548,97050,3402,93648,12047,81601,65314,5545,6619,845,71933,3278,2889,2188,15413,8429
ACTATACTCATAGGCG,sample,88513,87961,5270,82691,9363,73328,48946,3749,13214,1572,62160,5847,3807,1976,12754,6614
GGAGGACGCATAGGCG,sample,67291,66907,3388,63519,10033,53486,39973,2166,7293,614,47266,3440,3141,1961,13777,7044
CCGCAACGCATAGGCG,sample,40084,39789,3552,36237,3838,32399,16907,1142,9069,958,25976,4323,3728,1690,4606,2792
GGACGTAGCATAGGCG,sample,74809,74310,4439,69871,9358,60513,40557,2886,10390,1405,50947,5275,4059,2294,12215,6650
ACCTCGAGCATAGGCG,sample,65787,65337,3425,61912,10965,50947,32147,1744,10549,1146,42696,5361,3548,1573,10327,7631
TTGGTACCCATAGGCG,sample,67203,66862,3360,63502,12957,50545,36782,2096,7163,888,43945,3616,3198,1820,13500,9189
CGGATTACCATAGGCG,sample,81325,80816,4796,76020,8207,67813,41877,2791,13962,1863,55839,7320,4060,1933,12372,5662
AACTCGTACATAGGCG,sample,88151,87665,5597,82068,9808,72260,48281,3187,12232,1149,60513,7411,4845,2303,11042,6676
AATATATCCATAGGCG,sample,34599,34301,3027,31274,4360,26914,15749,1223,5537,620,21286,3785,3364,1683,4676,2965
TGCTTCGCCATAGGCG,sample,34097,33938,797,33141,6876,26265,21150,1516,2315,305,23465,979,1605,1277,8348,4732
GAAGGCGCCATAGGCG,sample,86465,85919,3684,82235,12659,69576,51533,4119,8567,903,60100,4454,3418,1840,15947,9761
TTGGTTAACATAGGCG,sample,70425,70013,2904,67109,7864,59245,38305,2698,12811,1398,51116,4033,2811,1696,9383,5112
GTACCGTACATAGGCG,sample,88566,88005,5702,82303,9674,72629,44343,2842,15666,2041,60009,7737,4098,1727,11588,6856
ATGACCGACATAGGCG,sample,47443,47184,2896,44288,6878,37410,26517,1718,5180,553,31697,3442,3130,1836,7553,4956
ATTCTCTTTTGGAGAG,Pos_Ctrl,24019,23769,2375,21394,1029,20365,17196,1516,1139,142,18335,372,3593,3194,2009,584
TGAGCGCGTTGGAGAG,sample,42313,42056,2346,39710,4391,35319,22025,1649,8017,715,30042,2913,2668,1508,6891,3242
CAACCGCGTTGGAGAG,sample,54702,54258,3985,50273,6538,43735,27064,1689,8497,950,35561,5535,4304,1913,7504,4692
TTCCGTCTTTGGAGAG,Pos_Ctrl,24794,24534,1816,22718,1073,21645,18108,1724,1232,161,19340,420,3686,3584,1496,465
CCGCAACGTTGGAGAG,sample,21936,21817,1170,20647,3839,16808,12948,795,1938,283,14886,844,2101,1609,3862,2674
CGTACGTCTTGGAGAG,sample,40602,40093,4160,35933,5537,30396,11366,575,10690,1100,22056,6665,3650,786,2086,3434
GTCCTGCCTTGGAGAG,sample,64239,63842,3285,60557,10056,50501,36231,2492,7131,855,43362,3792,3550,2051,12068,7342
TTGGTACCTTGGAGAG,sample,95043,94271,9434,84837,9403,75434,27848,1310,24019,2615,51867,19642,7831,1513,11383,6223
GCCTGAACTTGGAGAG,sample,9024,8919,1124,7795,790,7005,3306,208,2019,202,5325,1270,1498,631,939,485
AATATATCTTGGAGAG,sample,108004,107353,5266,102087,11976,90111,64738,4498,12144,1218,76882,7513,4141,1980,18182,9380
TGCTTCGCTTGGAGAG,sample,21273,21117,1355,19762,2989,16773,10139,929,3148,374,13287,2183,2135,1099,1887,2120
TCAATATATTGGAGAG,sample,53294,52962,4195,48767,5958,42809,24596,1821,9856,946,34452,5590,4307,2231,4662,4096
TCGCCTGATTGGAGAG,sample,19841,19658,1076,18582,2661,15921,8619,747,3903,412,12522,2240,2143,1122,851,1791
CTTCATGATTGGAGAG,sample,40787,40428,3787,36641,4675,31966,19437,1126,6588,748,26025,4067,3487,1566,6098,2800
GACCGGAATTGGAGAG,sample,84314,83973,2285,81688,14566,67122,54662,3306,5975,759,60637,2420,2307,1741,21047,10524
GGAGAGTTTTCAAGCC,sample,49580,49183,5322,43861,3269,40592,12845,876,14351,1527,27196,10993,4733,1020,1188,1643
TCCAACTTTTCAAGCC,sample,47980,47712,3269,44443,6463,37980,20477,1060,9961,1320,30438,5162,3515,1402,6332,4409
GGTTGCGTTTCAAGCC,sample,39608,39287,2654,36633,6347,30286,19024,1113,5712,551,24736,3886,3100,1486,7490,4558
ACGTTATGTTCAAGCC,sample,39141,38911,1982,36929,5803,31126,21024,1239,6036,587,27060,2240,2628,1726,5143,4136
TCGCATCTTTCAAGCC,sample,37826,37594,2520,35074,5040,30034,21757,1102,4193,489,25950,2493,2734,1593,7420,3634
CAAGGCCTTTCAAGCC,sample,54392,54006,2660,51346,8419,42927,28575,1661,8835,696,37410,3160,2104,1233,12197,6361
CATAACCTTTCAAGCC,sample,73090,72653,3927,68726,8789,59937,46577,2987,6206,703,52783,3464,2977,1748,16506,6623
GACGGAGATTCAAGCC,sample,61800,61356,4267,57089,8101,48988,33131,1840,8184,895,41315,4938,3767,1563,11897,5677
CCAGAGCGTTCAAGCC,sample,16911,16711,2569,14142,2077,12065,3748,206,4185,474,7933,3452,2435,560,1123,1313
CCGCAACGTTCAAGCC,sample,56617,56151,4346,51805,7015,44790,28771,1457,8693,966,37464,4903,3314,1336,12377,4801
TGGACGAGTTCAAGCC,sample,60458,60091,3290,56801,7864,48937,34689,2249,7105,1076,41794,3818,3113,1655,12837,5686
CATTGCAGTTCAAGCC,sample,70400,70000,4852,65148,9194,55954,36368,1961,10481,1182,46849,5962,3773,1606,13643,6518
CTAGGACCTTCAAGCC,sample,63962,63636,2060,61576,7496,54080,43122,2817,5043,560,48165,2538,2488,2031,12172,5364
AACTCGTATTCAAGCC,sample,32440,32101,4225,27876,3214,24662,9662,715,7670,856,17332,5759,3813,1070,3236,2098
TTGGCCTCTTCAAGCC,Pos_Ctrl,22693,22409,1934,20475,912,19563,16304,1466,1214,160,17518,419,3573,3479,1147,397
GTCTTAGCTTCAAGCC,sample,40190,39964,1027,38937,7581,31356,26822,1981,1846,167,28668,540,1877,2009,7659,5314
TTGGTTAATTCAAGCC,sample,73015,72562,2176,70386,10726,59660,49194,3207,4408,645,53602,2206,2320,2136,14488,8071
GTACCGTATTCAAGCC,sample,45982,45672,2108,43564,6986,36578,27629,1857,4805,405,32434,1882,2155,1398,10380,4729
TCGCCTGATTCAAGCC,sample,55451,55168,2857,52311,8575,43736,31433,1875,5941,841,37374,3646,2679,1439,13276,6232
TCCAACTTAACTTAAC,Neg_Ctrl,385,149,82,67,7,60,31,14,11,1,42,3,24,15,8,1
AGTACCATAACTTAAC,sample,44812,44406,3159,41247,7587,33660,21560,1277,6749,857,28309,3217,2668,1302,9246,5378
ATGCCTGGAACTTAAC,sample,74179,73850,1983,71867,7077,64790,52374,4436,4942,479,57316,2559,2223,1739,15149,5409
TTAGAAGTAACTTAAC,sample,71468,71060,5759,65301,8307,56994,30093,1730,14312,1645,44405,9214,4940,1695,11460,5596
GGACCTCTAACTTAAC,Neg_Ctrl,278,142,64,78,10,68,45,4,10,1,55,8,24,15,25,2
TCGCATCTAACTTAAC,sample,38473,38248,2756,35492,5468,30024,19005,1360,5515,682,24520,3462,3029,1302,7334,3719
GCCTTGCTAACTTAAC,sample,29336,29152,2310,26842,3566,23276,13069,667,5458,568,18527,3514,3003,1160,4662,2478
GACGGAGAAACTTAAC,sample,42289,42095,2158,39937,6465,33472,24992,1572,4178,430,29170,2300,2686,1728,9230,4739
CCAGAGCGAACTTAAC,sample,58199,57881,1340,56541,9632,46909,40335,2334,2998,437,43333,805,1483,1614,14730,7317
ACCTCGAGAACTTAAC,sample,24689,24566,2498,22068,3785,18283,8866,475,5292,576,14158,3074,2628,902,2567,2832
GACGATAAAACTTAAC,sample,35011,34761,3803,30958,3394,27564,13356,853,7081,840,20437,5434,3747,1269,4474,2183
TTGGTACCAACTTAAC,sample,57117,56808,3737,53071,7662,45409,29133,1753,8207,763,37340,5553,3468,1487,9512,5376
CTAGGACCAACTTAAC,sample,67279,66939,4128,62811,7914,54897,33865,2347,10266,1094,44131,7325,4031,1316,11779,5132
ACGTATTAAACTTAAC,sample,63796,63480,1962,61518,9266,52252,42129,3085,4567,625,46696,1846,2480,2123,9562,6599
ACCAATGCAACTTAAC,sample,66075,65787,3248,62539,9466,53073,39138,2416,6912,720,46050,3887,3024,1600,14623,6920
GGCATATAAACTTAAC,sample,48244,47912,3177,44735,6332,38403,20877,1342,8453,1012,29330,6719,4297,1635,5114,4201
TCAATATAAACTTAAC,sample,64775,64463,2829,61634,11070,50564,38196,2546,6199,544,44395,3079,2485,1584,13914,7832
AGGTCGGAAACTTAAC,sample,63098,62778,2068,60710,9014,51696,42373,2923,4050,429,46423,1921,2453,1964,12627,6854
TATCAGTTATACTTGA,sample,80150,79850,3725,76125,8980,67145,49075,3551,8764,922,57839,4833,2710,1267,16335,6533
AAGTTCGTATACTTGA,sample,140511,139715,9034,130681,10770,119911,66337,4606,32207,3651,98544,13110,5902,2151,14024,7878
TCCTCCGTATACTTGA,sample,103794,103117,7905,95212,9375,85837,48511,2793,18301,2109,66812,14123,5660,1613,11976,6274
TTCTAATGATACTTGA,sample,100740,100089,6633,93456,7702,85754,45353,3013,19663,2294,65016,15431,6772,2106,9844,5050
TGAGCGCGATACTTGA,sample,54943,54771,1134,53637,10061,43576,36706,2576,2903,423,39609,968,1466,1429,14618,7185
AATGGTAAATACTTGA,sample,92876,92281,5665,86616,11787,74829,46779,3223,13930,1435,60709,9462,5043,2171,14113,8051
TCGCATCTATACTTGA,sample,40616,40370,2976,37394,6446,30948,18900,1170,6170,691,25070,4017,3262,1397,7256,4496
GCCTTGCTATACTTGA,sample,56469,56094,3105,52989,7123,45866,31673,2347,7193,853,38866,3800,3447,2040,10233,4985
CAAGGCCTATACTTGA,sample,65280,64825,4507,60318,10610,49708,32712,1840,8707,998,41419,5451,3525,1587,10690,7565
CATAACCTATACTTGA,sample,82923,82452,4045,78407,9062,69345,46392,2942,12352,997,58744,6662,3759,1785,12362,6247
CCAGAGCGATACTTGA,sample,44853,44472,4153,40319,6707,33612,19339,1283,6971,676,26310,5343,3851,1453,3689,4356
GTTAGCCGATACTTGA,sample,45665,45386,1920,43466,4876,38590,26533,1671,7255,768,33788,2363,2807,1982,6720,3677
GGAGGACGATACTTGA,sample,55844,55559,1838,53721,9411,44310,35529,2159,4402,529,39931,1691,1970,1592,13379,6894
GGACGTAGATACTTGA,sample,7482,7403,860,6543,1091,5452,3285,162,1052,135,4337,818,1064,565,1232,737
TGGACGAGATACTTGA,sample,84121,83607,4694,78913,8355,70558,46303,2620,12415,1356,58718,7864,4698,1930,17593,5870
GACGATAAATACTTGA,sample,14179,14025,1913,12112,1441,10671,4726,298,3386,389,8112,1872,2168,856,1378,972
CGAGGCAGATACTTGA,sample,80514,80056,2662,77394,11845,65549,51381,3235,8135,702,59516,2096,2277,1979,14924,8855
AATCCGTCATACTTGA,sample,78311,77845,2532,75313,12557,62756,49986,3380,6169,940,56155,2281,1921,1568,21208,9978
CGTACGTCATACTTGA,sample,43076,42744,2270,40474,5840,34634,22864,1997,6495,632,29359,2646,2820,1834,4842,3986
ACGTATTAATACTTGA,sample,91421,90779,8631,82148,9710,72438,37724,2062,17968,1900,55692,12784,6248,1782,13234,6352
AATATATCATACTTGA,Neg_Ctrl,585,458,264,194,35,159,99,9,28,3,127,20,64,37,35,39
AAGAGCGCATACTTGA,sample,59454,59162,2289,56873,7813,49060,37422,2519,6398,671,43820,2050,2792,2485,7198,6132
TTATTCGAATACTTGA,sample,60477,60103,3354,56749,6377,50372,30751,1860,11776,1441,42527,4544,3821,2276,5816,4805
ATGACCGAATACTTGA,sample,79156,78689,5277,73412,10403,63009,40346,2815,11624,1143,51970,7081,4248,1712,12774,7605
ACGTAAGTATCCGCGA,sample,38021,37787,2474,35313,3841,31472,20957,1740,4898,525,25855,3352,3663,2390,2690,2483
CAACCGCGATCCGCGA,sample,108227,107622,3701,103921,12062,91859,69698,3530,11751,1111,81449,5769,2983,1637,21548,8937
TCGCATCTATCCGCGA,sample,115640,114837,10257,104580,12681,91899,49176,3409,22508,2502,71684,14304,6466,1926,17815,8859
GCCTTGCTATCCGCGA,sample,99202,98542,6942,91600,11267,80333,48732,3500,16342,1861,65074,9898,5746,2788,11220,7920
CTTGATAGATCCGCGA,sample,120876,120224,6164,114060,16355,97705,65818,4222,16868,1680,82686,9117,4626,2139,21330,11187
TGGACGAGATCCGCGA,sample,99129,98752,2867,95885,19393,76492,64353,4066,5943,697,70296,1433,1735,1545,28999,14365
CATTGCAGATCCGCGA,sample,108810,108119,8683,99436,12358,87078,49106,3696,19839,2151,68945,12286,5664,1871,17634,8420
CGGATTACATCCGCGA,sample,99381,98578,7255,91323,9438,81885,48120,2926,19666,2505,67786,8668,5044,2316,11831,6321
GCCTGAACATCCGCGA,sample,78975,78279,8347,69932,8089,61843,33392,1845,14343,1605,47735,10658,5850,2015,11326,5405
ACCAATGCATCCGCGA,sample,88342,87714,6916,80798,10429,70369,41565,2341,14516,1455,56081,10492,5680,1727,14305,7445
GAAGGCGCATCCGCGA,sample,108841,108305,3821,104484,16870,87614,70453,4654,8098,878,78551,3531,2597,1828,23831,12423
AAGAGCGCATCCGCGA,sample,102763,102276,3144,99132,18825,80307,61743,4704,10596,965,72339,2299,2161,1564,23848,13877
GTCTTAGCATCCGCGA,sample,36652,36442,1771,34671,4768,29903,20086,1261,5966,637,26052,1953,2724,1938,3645,3489
TTGGTTAAATCCGCGA,sample,144146,143474,6598,136876,18376,118500,87892,6614,15452,2227,103344,6315,3316,1952,28687,13354
TTATTCGAATCCGCGA,sample,64681,64326,1513,62813,15085,47728,38879,2563,4163,732,43042,1391,1702,1456,11826,10552
AAGTTCGTAGGACTCA,sample,103146,102569,3988,98581,9463,89118,53992,3644,22058,2450,76050,6974,3040,1745,11633,6701
GGTTGCGTAGGACTCA,sample,107582,106867,7234,99633,10377,89256,53710,3635,19146,1757,72856,11008,5516,1768,14978,7301
ACGTAAGTAGGACTCA,sample,29795,29606,1908,27698,3421,24277,16469,1142,3928,386,20397,2352,2121,1279,4921,2403
TTCGTAATAGGACTCA,sample,115859,115209,5020,110189,13274,96915,65387,4417,15093,1808,80480,10210,5270,2184,15975,9536
TGAGCGCGAGGACTCA,sample,58089,57664,3901,53763,6998,46765,27034,2055,10018,1099,37052,6559,4221,1602,5876,4629
CAACCGCGAGGACTCA,sample,57573,57286,2142,55144,7708,47436,36555,3424,5089,519,41644,1849,2346,1815,8400,5559
ACTATACTAGGACTCA,sample,11278,11194,814,10380,1676,8704,4909,271,2122,335,7031,1067,1443,753,1763,1172
CCGCAACGAGGACTCA,sample,10769,10605,1909,8696,616,8080,2129,198,3077,379,5206,2297,2060,674,132,276
ACGACTTCAGGACTCA,sample,80587,79659,13785,65874,4390,61484,21140,1455,23289,2600,44429,13000,7434,2554,3167,2090
CATGATTCAGGACTCA,sample,80386,79811,5174,74637,9708,64929,44115,2769,10616,1193,54731,6236,3917,1731,17174,6947
AATCCGTCAGGACTCA,sample,38152,37757,4675,33082,3998,29084,13142,813,8117,897,21259,6115,3819,1066,4855,2649
GTTAGGACAGGACTCA,sample,104800,104348,2480,101868,15485,86383,72407,4771,6378,1102,78785,1725,1728,1586,22296,12128
TTGGCCTCAGGACTCA,sample,38135,37907,2066,35841,6866,28975,17721,1467,5953,668,23674,3166,2463,1099,2835,4615
AAGAGCGCAGGACTCA,sample,50265,49881,3404,46477,8049,38428,22215,1482,8817,1132,31032,4782,3127,1150,3982,5141
CCAATTCCAGGACTCA,sample,53122,52746,3159,49587,5785,43802,27921,1828,8553,884,36474,4616,3344,1748,7745,4047
TTGGTTAAAGGACTCA,sample,87048,86510,5429,81081,7087,73994,47673,3248,13080,1514,60753,8479,4830,2035,13776,4698
GGCATATAAGGACTCA,sample,61972,61614,3444,58170,7430,50740,29965,2094,10294,1160,40259,7227,4245,1753,8419,5282
TCGCCTGAAGGACTCA,sample,67666,67356,2302,65054,8348,56706,43660,2893,6755,830,50415,2568,2915,2156,12915,6294
AGGTCGGAAGGACTCA,Pos_Ctrl,34109,33842,1705,32137,1463,30674,25945,2296,1749,191,27694,493,4409,4584,2437,567
GGAGAGTTTATTGAAC,sample,3342,3317,144,3173,750,2423,1587,147,436,51,2023,202,607,421,504,482
ATTCTCTTTATTGAAC,sample,57490,57215,2751,54464,8920,45544,31117,2242,7538,779,38655,3868,3786,2408,7723,6221
AAGTTCGTTATTGAAC,sample,53954,53710,2213,51497,10618,40879,29385,1793,6028,911,35413,2762,3051,2151,6326,7243
ACGTAAGTTATTGAAC,sample,71510,71109,3640,67469,11163,56306,33720,2540,11065,1183,44785,7798,4548,1902,9525,8271
TTCGTAATTATTGAAC,sample,49725,49362,2144,47218,6358,40860,26897,1980,8302,1079,35199,2602,3075,2248,6816,4670
TTCCGTCTTATTGAAC,sample,50455,50144,3195,46949,8495,38454,21837,1294,9195,956,31032,5172,2977,1079,5890,5652
CAAGGCCTTATTGAAC,sample,49230,48991,1701,47290,9994,37296,30102,1963,3227,404,33329,1600,2144,1763,12158,7283
GACGGAGATATTGAAC,sample,52815,52407,2406,50001,6662,43339,32149,2276,5365,711,37514,2838,3380,2678,7108,4550
GGACGTAGTATTGAAC,sample,58873,58353,4721,53632,5888,47744,27119,2060,11089,1215,38208,6261,4467,2016,8168,3981
CATTGCAGTATTGAAC,sample,81887,81474,3229,78245,13686,64559,51054,3339,6633,703,57687,2830,2059,1441,21079,10303
AGTCCGCATATTGAAC,sample,77699,77188,4671,72517,9090,63427,40415,2762,11503,1540,51918,7207,4106,1646,13225,6475
TTGGTACCTATTGAAC,sample,85864,85371,3538,81833,11051,70782,54129,3726,7668,751,61797,4508,3842,2479,14501,8033
GTTAGGACTATTGAAC,sample,82627,82084,4171,77913,8433,69480,44748,3758,11057,1110,55805,8807,4000,1678,9666,5843
TTGGCCTCTATTGAAC,sample,51600,51321,1675,49646,5159,44487,34622,2681,5007,506,39629,1671,3139,2809,6426,3812
GGCATATATATTGAAC,sample,84981,84563,4547,80016,10316,69700,47494,3172,10901,1186,58395,6947,3528,1419,19574,7416
GGAGAGTTGTTCAACT,sample,33335,33216,1341,31875,5119,26756,21531,1466,2506,188,24037,1065,1948,1727,6856,3497
AAGTTCGTGTTCAACT,sample,29646,29449,1696,27753,3371,24382,14220,940,5943,708,20163,2571,2602,1400,2985,2335
ATGCCTGGGTTCAACT,sample,23002,22860,1631,21229,2592,18637,11887,765,3270,467,15157,2248,1867,838,4815,1845
TAGTACGGGTTCAACT,sample,19725,19558,1986,17572,1985,15587,7210,482,4351,520,11561,3024,2520,843,1789,1248
TGAGCGCGGTTCAACT,sample,24204,24002,1997,22005,1770,20235,10330,648,5231,591,15561,3435,2976,1074,3697,1197
AATGGTAAGTTCAACT,sample,36329,36054,2439,33615,2977,30638,18835,1052,6564,827,25399,3360,2979,1585,5521,2163
TCGCATCTGTTCAACT,sample,30966,30750,1890,28860,2836,26024,17724,1197,4184,469,21908,2450,2669,1504,5174,1954
GCCTTGCTGTTCAACT,sample,19053,18911,1252,17659,2613,15046,10336,589,2497,331,12833,1293,2009,1209,3384,1811
CCAGAGCGGTTCAACT,sample,24030,23853,1448,22405,3609,18796,12491,876,3206,339,15697,1884,2375,1305,4029,2558
CTTGATAGGTTCAACT,sample,35829,35639,1740,33899,4709,29190,21514,1437,3828,436,25342,1975,2297,1420,7675,3353
ACCTCGAGGTTCAACT,sample,22959,22832,1364,21468,3126,18342,12566,697,2943,435,15509,1701,2015,1135,4535,2283
GACGATAAGTTCAACT,sample,41939,41595,5034,36561,3102,33459,14564,912,9735,1055,24299,7193,4711,1279,5441,1933
GTCCTGCCGTTCAACT,sample,30426,30195,1529,28666,3807,24859,19334,1132,2532,239,21866,1622,1740,1321,6300,3075
TTGGTACCGTTCAACT,sample,30033,29840,1464,28376,3978,24398,17500,1251,3670,362,21170,1615,2202,1569,4839,3035
CGGATTACGTTCAACT,sample,27699,27514,1165,26349,4188,22161,18412,1470,1686,82,20098,511,1280,1255,6727,3341
GTTAGGACGTTCAACT,sample,30529,30348,1411,28937,4501,24436,19206,1286,2386,302,21592,1256,1597,1244,6406,3242
AACTCGTAGTTCAACT,sample,28968,28752,1912,26840,3028,23812,15639,881,4409,420,20048,2463,2479,1399,4235,2188
TTGGCCTCGTTCAACT,sample,22795,22660,981,21679,1781,19898,13995,1054,3335,301,17330,1213,1807,1390,3590,1150
ACCAATGCGTTCAACT,sample,23646,23439,1852,21587,2188,19399,11078,608,4293,597,15371,2823,2581,1334,2348,1549
TTGGTTAAGTTCAACT,sample,29129,28916,2908,26008,2195,23813,12430,783,5893,633,18323,4074,2946,1003,4534,1545
GTACCGTAGTTCAACT,sample,21876,21708,2107,19601,2129,17472,8418,495,4604,455,13022,3500,2402,672,3394,1406
TCAATATAGTTCAACT,sample,28008,27778,2374,25404,2503,22901,11725,804,5596,534,17321,4242,3400,1402,2286,1568
TTATTCGAGTTCAACT,Neg_Ctrl,111,77,15,62,2,60,41,0,9,1,50,9,35,19,10,3
GACCGGAAGTTCAACT,sample,20396,20228,1389,18839,2671,16168,10020,533,3297,410,13317,1908,1936,908,2985,1814
TCCAACTTCTGAGGTT,sample,140437,139282,10301,128981,16257,112724,50307,4013,32334,4047,82641,22023,7829,1974,15810,10686
AGTACCATCTGAGGTT,sample,200380,199309,9806,189503,26933,162570,118980,6306,22321,2317,141301,12646,4288,1764,52716,20077
TTCGTAATCTGAGGTT,sample,149828,148846,6961,141885,18415,123470,89334,5267,17052,1956,106386,9861,5072,2720,15116,13322
TTCTAATGCTGAGGTT,sample,183980,183180,5516,177664,15682,161982,125094,10517,15907,2206,141001,8258,3753,2113,35315,12553
CAACCGCGCTGAGGTT,sample,94629,94069,4064,90005,13646,76359,56960,4207,8436,1064,65396,5692,4522,2529,18004,10125
AATGGTAACTGAGGTT,sample,153145,152412,8683,143729,24540,119189,79108,5536,19325,2156,98433,13064,5899,2468,26978,16150
TTAGAAGTCTGAGGTT,sample,125780,125091,4946,120145,16692,103453,80219,5262,12449,1424,92668,4099,3551,2883,19907,12414
GGACCTCTCTGAGGTT,sample,77678,77058,6208,70850,9624,61226,35142,2296,12610,1512,47752,9666,5173,1635,13391,6863
CATAACCTCTGAGGTT,sample,94539,93965,3551,90414,15272,75142,60962,3970,6410,786,67372,3014,3419,2715,18078,11346
GACGATAACTGAGGTT,sample,146523,145633,6726,138907,18761,120146,87705,4902,16363,2574,104068,8602,4462,1905,33563,13504
CATTGCAGCTGAGGTT,sample,126562,125585,8623,116962,15492,101470,53790,4490,23883,2499,77673,16808,6754,1995,10595,10471
CGAGGCAGCTGAGGTT,sample,111344,110809,4147,106662,27576,79086,66323,4737,5226,626,71549,2174,2556,2542,19453,18751
CGTACGTCCTGAGGTT,sample,6938,6817,566,6251,1251,5000,2205,180,1531,188,3736,896,1321,587,323,781
CGGATTACCTGAGGTT,sample,144998,144016,7154,136862,18923,117939,81592,5312,18493,2350,100085,10192,4979,2221,23041,13987
AACTCGTACTGAGGTT,sample,161192,160119,8282,151837,21313,130524,95583,5135,17582,1873,113165,10351,4747,2174,28232,15219
TTGGCCTCCTGAGGTT,sample,65718,65276,4871,60405,5719,54686,33771,2095,10186,1045,43957,7589,4702,1865,8729,3937
CCAATTCCCTGAGGTT,sample,183552,182479,13785,168694,14944,153750,82297,5589,35063,3811,117360,26990,9060,2352,26425,9301
TTGGTTAACTGAGGTT,sample,109338,108638,5925,102713,11161,91552,50923,3669,22609,2374,73532,11977,5306,2049,9534,7644
TCGCCTGACTGAGGTT,sample,149187,148614,2969,145645,15619,130026,114215,8161,5067,839,119282,1744,2110,2232,30041,11598
TTATTCGACTGAGGTT,sample,116242,115462,9167,106295,12957,93338,38895,2276,28325,2968,67220,20874,7526,1684,8230,8120
GACCGGAACTGAGGTT,sample,79405,78996,3265,75731,12486,63245,36805,3045,13564,1677,50369,8154,4383,1485,12943,8557
GGAGAGTTAGACCGTT,sample,74708,74121,6992,67129,8713,58416,31297,2067,14628,1719,45925,8705,5295,2170,8985,5888
ATTCTCTTAGACCGTT,sample,82896,82438,4910,77528,7704,69824,36962,2238,20249,1933,57211,8442,4133,1880,7109,5222
GGTTGCGTAGACCGTT,sample,52688,52369,3588,48781,11232,37549,24601,1366,6601,979,31202,4002,3373,1566,10092,7667
TCCTCCGTAGACCGTT,sample,88506,88005,4152,83853,12722,71131,53635,3980,7624,787,61259,5105,4027,2781,14605,9495
ACGTAAGTAGACCGTT,sample,17505,17330,1729,15601,2144,13457,8258,515,2628,247,10886,1809,1995,981,2748,1465
TGAGCGCGAGACCGTT,sample,20452,20291,1093,19198,3708,15490,12016,813,1718,149,13734,794,2188,1738,2906,2653
CAACCGCGAGACCGTT,sample,42178,41929,2206,39723,7014,32709,23220,1280,5167,738,28387,2304,2720,1860,4960,4782
GCCTTGCTAGACCGTT,sample,114238,113509,4669,108840,13498,95342,70801,5305,11726,1394,82527,6116,4036,2291,20228,9915
CAAGGCCTAGACCGTT,sample,70066,69708,2244,67464,12255,55209,44047,3382,5274,602,49321,1904,2646,2157,13465,8877
CATAACCTAGACCGTT,sample,129582,128708,9049,119659,13035,106624,65302,4111,21271,2602,86573,13338,6464,2370,23021,8849
ACTATACTAGACCGTT,sample,64046,63661,3684,59977,4966,55011,30462,2337,15104,1674,45566,5434,3968,2093,4267,3245
GTTAGCCGAGACCGTT,sample,135314,134524,6106,128418,18344,110074,78393,4601,17307,2209,95700,7564,3729,2027,29160,13175
CCGCAACGAGACCGTT,sample,100824,100347,4342,96005,14084,81921,61901,4393,10235,856,72136,4536,3286,1851,23590,9904
GGACGTAGAGACCGTT,sample,132727,131907,5070,126837,17109,109728,84749,6417,11848,1210,96597,5504,2855,1565,36334,12541
CATTGCAGAGACCGTT,sample,111071,110383,5108,105275,13903,91372,67400,4311,12202,1188,79602,6271,4341,2284,20695,10325
ACGACTTCAGACCGTT,sample,98442,97841,4488,93353,15110,78243,49793,4203,14415,1621,64208,8211,4553,2203,12237,10531
CGTACGTCAGACCGTT,sample,26586,26360,2117,24243,2581,21662,12852,800,5044,544,17896,2422,2594,1178,5587,1771
GTCCTGCCAGACCGTT,sample,169945,168688,12303,156385,16005,140380,74133,4892,33783,3443,107916,24129,8908,2561,24773,11230
CGGATTACAGACCGTT,sample,112042,111378,10742,100636,11237,89399,36675,2241,26534,2881,63209,21068,8157,1929,11769,6418
GAAGGCGCAGACCGTT,sample,117627,116995,4622,112373,9088,103285,75162,5248,14311,1919,89473,6645,3560,1851,22232,6341
GTCTTAGCAGACCGTT,sample,138572,137859,6597,131262,11637,119625,80916,5204,21068,2435,101984,10002,4261,1857,28037,7667
CCAATTCCAGACCGTT,sample,131527,130801,3914,126887,14635,112252,87612,7258,11363,847,98975,5172,2870,1895,26617,10506
GGCATATAAGACCGTT,sample,85912,85305,5779,79526,7794,71732,43687,2763,15430,1618,59117,8234,4997,1738,13223,5537
CTTCATGAAGACCGTT,sample,134904,134359,2706,131653,16931,114722,97964,8096,5737,990,103701,1935,1834,1994,25423,12034
ATGACCGAAGACCGTT,sample,123694,123144,9595,113549,16922,96627,76197,5222,10519,836,86716,3853,2834,1724,26750,16088
GACCGGAAAGACCGTT,sample,79583,79248,4041,75207,9511,65696,38484,3038,14779,1450,53263,7945,4832,1714,13362,6339
ATTCTCTTCTTGAGTT,sample,196891,196084,7580,188504,29313,159191,117955,7576,19993,2361,137948,11306,4875,2152,51574,22477
TCCAACTTCTTGAGTT,sample,149459,148757,6724,142033,23291,118742,83902,5385,17883,2079,101785,9493,5004,2377,28963,16101
AAGTTCGTCTTGAGTT,sample,102108,101558,5690,95868,23500,72368,40928,3711,15708,1730,56636,10291,5015,1717,12145,15392
TCCTCCGTCTTGAGTT,sample,133426,132804,7260,125544,18019,107525,77617,5460,13502,1662,91119,9284,4876,2342,25564,13343
CCTCTAGACTTGAGTT,sample,86442,86017,3965,82052,14084,67968,48773,3344,9386,1275,58159,5190,4044,2087,18519,9610
TTCTAATGCTTGAGTT,sample,99512,98859,6303,92556,9307,83249,37898,2365,28614,3711,66512,10661,4871,2044,6725,6243
GGACCTCTCTTGAGTT,sample,104091,103525,4721,98804,15020,83784,64348,4539,9033,974,73381,4890,4018,2523,18331,10824
TCGCATCTCTTGAGTT,sample,63730,63325,3493,59832,10167,49665,31813,2257,9570,1139,41383,4886,4014,1964,11548,7549
CATAACCTCTTGAGTT,sample,137662,136870,5175,131695,18640,113055,84463,6152,13848,1449,98311,7143,4780,3350,18835,13634
ACTATACTCTTGAGTT,sample,104911,104036,7695,96341,13984,82357,38063,2753,23318,2828,61381,15395,6114,1442,9759,9083
CCAGAGCGCTTGAGTT,sample,107894,107117,6179,100938,14705,86233,54220,4280,17524,1742,71744,8467,5186,2934,12193,10028
CTTGATAGCTTGAGTT,sample,165601,164415,11864,152551,17640,134911,78115,4760,29507,2975,107622,19554,7801,2579,24312,12384
TGGACGAGCTTGAGTT,sample,159750,158941,4788,154153,24354,129799,111718,5822,8130,1503,119848,2626,2256,2274,37015,18081
GACGATAACTTGAGTT,sample,44947,44643,2391,42252,8742,33510,23790,1854,4987,574,28777,2305,3285,2355,4541,6088
CGAGGCAGCTTGAGTT,sample,147480,146527,6492,140035,19282,120753,92239,5106,15211,1605,107450,6592,4027,2441,27741,14900
ACGACTTCCTTGAGTT,sample,61749,61301,4084,57217,7764,49453,30158,1932,10972,1339,41130,5052,4101,2219,7754,5246
CATGATTCCTTGAGTT,sample,169938,168817,10258,158559,22714,135845,93310,6119,20752,2503,114062,13161,6294,3162,22380,16885
CTAGGACCCTTGAGTT,sample,131478,130547,9367,121180,15334,105846,72669,4464,16277,1661,88946,10775,5291,1931,30374,10669
GTTAGGACCTTGAGTT,sample,178634,177684,7849,169835,21430,148405,97234,7553,25146,3160,122380,15312,5666,2453,32414,16354
ACGTATTACTTGAGTT,sample,238471,237085,10282,226803,27644,199159,145811,9897,25518,2436,171329,15497,6609,2727,43057,19716
CGTATGAACTTGAGTT,sample,96261,95529,6511,89018,12498,76520,50043,3648,12230,1376,62273,9223,5077,2485,11972,9480
AATATATCCTTGAGTT,sample,206237,204985,10165,194820,23474,171346,108942,8353,31195,3688,140137,19168,5777,2370,36641,15729
TGCTTCGCCTTGAGTT,sample,154288,153249,10239,143010,11537,131473,71800,5372,30977,3385,102777,19939,7665,2577,19359,7401
TCAATATACTTGAGTT,sample,174496,173309,10370,162939,16788,146151,88359,5015,28388,3022,116747,21367,7603,2420,17220,11326
TCGCCTGACTTGAGTT,sample,69150,68645,2946,65699,11786,53913,36685,2368,8415,941,45100,5504,3397,1488,7796,7887
GGAGAGTTTCGGAGTT,sample,49742,49418,2659,46759,4851,41908,26063,1789,8733,997,34796,4326,3405,1886,6979,3490
ATTCTCTTTCGGAGTT,sample,86294,85719,5709,80010,7855,72155,38691,1909,17173,1803,55864,12579,5830,1769,15346,5382
AAGTTCGTTCGGAGTT,sample,61834,61508,2502,59006,9179,49827,39539,2677,4982,617,44521,2012,2144,1589,15734,6856
CCTCTAGATCGGAGTT,sample,58745,58316,3346,54970,6457,48513,31885,1748,8764,1031,40649,5085,3410,1613,9927,4584
TGAGCGCGTCGGAGTT,sample,31796,31596,1403,30193,4759,25434,20539,1283,2518,361,23057,733,1783,1487,7678,3425
CAACCGCGTCGGAGTT,sample,41339,41000,2239,38761,4589,34172,25251,1546,4313,404,29564,2658,2890,1869,6018,3126
TTCCGTCTTCGGAGTT,sample,70794,70377,3925,66452,9322,57130,38899,2759,8980,838,47879,5654,3584,1719,14310,6798
ACTATACTTCGGAGTT,sample,59353,58829,4885,53944,6437,47507,26867,1522,10831,1396,37698,6891,4457,1529,10881,4456
GTTAGCCGTCGGAGTT,sample,60258,59785,4385,55400,6013,49387,30019,1569,10320,983,40339,6496,4167,1346,12690,4346
ACCTCGAGTCGGAGTT,sample,12699,12524,1834,10690,847,9843,2375,178,3936,418,6311,2936,2138,514,192,399
TGGACGAGTCGGAGTT,sample,55069,54707,2594,52113,4740,47373,33791,2531,6849,608,40640,3594,3415,2256,7805,3562
CATGATTCTCGGAGTT,sample,3820,3769,517,3252,331,2921,1436,104,810,70,2246,501,1009,520,118,175
AGTCCGCATCGGAGTT,sample,52919,52595,1874,50721,5575,45146,34816,2457,4919,771,39735,2183,2618,1957,9055,4162
CGGATTACTCGGAGTT,sample,75421,75011,3685,71326,6963,64363,42947,2396,12181,1262,55128,5577,2976,1646,13501,5708
GTTAGGACTCGGAGTT,sample,66743,66351,2975,63376,7729,55647,41555,2680,7074,1106,48629,3232,2010,1294,15042,6026
TTGGCCTCTCGGAGTT,Pos_Ctrl,23349,23250,849,22401,1003,21398,18112,2011,871,133,18983,271,3546,3852,1506,323
AATATATCTCGGAGTT,sample,47287,47002,3082,43920,7059,36861,21165,1234,8028,802,29193,5632,3337,1190,7819,4957
GTCTTAGCTCGGAGTT,sample,78004,77574,5215,72359,6433,65926,40741,2351,12006,1325,52747,9503,4384,1497,13994,4482
CTTCATGATCGGAGTT,sample,53695,53270,2386,50884,3831,47053,34304,2465,6244,713,40548,3327,4014,3090,3060,2611
ATGACCGATCGGAGTT,sample,48302,48068,2146,45922,5701,40221,26802,1716,6507,815,33309,4381,3328,1436,6701,4050
ATTCTCTTTGAACCTT,Pos_Ctrl,35449,35011,2492,32519,1443,31076,25946,2463,1805,220,27751,642,4496,4369,2556,736
GGTTGCGTTGAACCTT,sample,4783,4698,503,4195,797,3398,1531,115,1116,101,2647,535,956,423,281,483
CCTCTAGATGAACCTT,sample,134452,133641,6027,127614,16899,110715,84092,5548,13404,1774,97496,5897,3069,2035,32023,13319
ATGCCTGGTGAACCTT,sample,100429,99543,8729,90814,5325,85489,22917,1826,33073,3756,55990,23917,8283,1833,1210,2282
TAGTACGGTGAACCTT,Pos_Ctrl,26247,25920,2078,23842,1341,22501,18887,1690,1386,181,20273,357,3934,3538,2149,654
CAACCGCGTGAACCTT,sample,116684,115832,9099,106733,10130,96603,55762,3466,20073,1999,75835,15303,7234,1925,15188,6626
TTAGAAGTTGAACCTT,sample,67147,66705,4344,62361,9300,53061,29621,2352,13456,1453,43077,6179,4324,2046,4474,6935
TCGCATCTTGAACCTT,sample,136720,136062,4927,131135,16322,114813,88897,5879,13995,1670,102892,4372,2617,1999,33158,12790
CATAACCTTGAACCTT,sample,67648,67011,7551,59460,6205,53255,21240,1302,17959,2084,39199,10670,5642,1895,3844,3829
GTTAGCCGTGAACCTT,sample,101159,100481,6888,93593,10469,83124,47487,2606,18691,1930,66178,12410,6237,2179,15698,7472
CCGCAACGTGAACCTT,Pos_Ctrl,26328,25849,1985,23864,1212,22652,19093,1735,1192,185,20285,447,3849,3643,2065,627
GGACGTAGTGAACCTT,sample,116411,115719,8036,107683,15487,92196,54367,3936,19914,2231,74281,11748,5569,1813,19067,10584
GGCCAGAGTGAACCTT,sample,26559,26354,1776,24578,4483,20095,12329,796,4147,528,16476,2295,2752,1616,1951,2931
AATCCGTCTGAACCTT,Pos_Ctrl,46377,45922,2638,43284,1802,41482,34732,3348,2354,299,37086,749,4817,5454,2481,709
CGGATTACTGAACCTT,sample,152898,151490,17174,134316,14642,119674,52370,3440,33014,4237,85384,26613,9432,1924,17463,9119
ACGTATTATGAACCTT,sample,122694,121945,7457,114488,12201,102287,60156,4016,23110,2941,83266,12064,5586,2445,14276,8182
AACTCGTATGAACCTT,sample,44239,43940,3102,40838,5065,35773,19299,1609,8812,890,28111,5163,3724,1533,4030,3305
CGTATGAATGAACCTT,sample,124776,124002,6958,117044,13539,103505,68079,4996,16768,1610,84847,12052,6129,2772,18795,9532
TTGGCCTCTGAACCTT,sample,107213,106611,7142,99469,11378,88091,51505,3830,18288,2128,69793,12340,5909,2224,16382,7320
ACCAATGCTGAACCTT,sample,127108,126210,8307,117903,10953,106950,54039,4447,27490,3184,81529,17790,7265,2468,10283,7219
GTCTTAGCTGAACCTT,sample,104127,103583,3377,100206,11808,88398,70318,5897,7662,658,77980,3863,3276,2643,15301,8777
TTGGTTAATGAACCTT,sample,102502,101960,3502,98458,11577,86881,73850,5617,4801,520,78651,2093,2807,2605,16921,8479
GTACCGTATGAACCTT,Pos_Ctrl,39869,39534,2245,37289,1498,35791,29809,3178,1865,267,31674,672,4567,5028,2389,486
TTATTCGATGAACCTT,sample,157937,157103,8936,148167,16578,131589,82605,5887,24461,2661,107066,15975,6734,2426,20589,11843
ATGACCGATGAACCTT,sample,77932,77380,7601,69779,6670,63109,23574,1578,19573,1906,43147,16478,6427,1553,7013,3761
GGAGAGTTACCGAATT,sample,80443,79795,6441,73354,9771,63583,30823,2546,18304,2304,49127,9606,5037,1855,3845,6574
TTCGTAATACCGAATT,sample,147085,146115,9907,136208,21998,114210,62334,3491,29232,3745,91566,15408,5555,1667,23379,14870
TTCTAATGACCGAATT,sample,90514,89886,8085,81801,12371,69430,35630,2178,17939,1757,53569,11926,5990,2021,13951,8178
ATGCCTGGACCGAATT,sample,174742,173955,4419,169536,25903,143633,126253,7099,7834,790,134087,1657,1777,2156,40987,19993
TGAGCGCGACCGAATT,sample,79104,78630,4309,74321,11319,63002,44704,2836,9547,1122,54251,4793,3981,2026,16523,8259
CAAGGCCTACCGAATT,sample,91268,90722,3843,86879,11361,75518,56036,4292,10341,1248,66377,3601,3551,2607,14093,8276
ACTATACTACCGAATT,sample,42235,41935,2649,39286,5506,33780,22546,1700,5956,615,28502,2963,3797,2373,6124,4050
GTTAGCCGACCGAATT,sample,134132,133310,7292,126018,15325,110693,79590,5077,15841,1474,95431,8711,4818,2324,25552,11157
ACCTCGAGACCGAATT,sample,158951,157897,10401,147496,14796,132700,79349,5341,27332,3120,106681,17558,7135,2445,24987,9567
CCATGAAGACCGAATT,sample,161642,160783,5212,155571,21994,133577,108952,7813,11713,1065,120665,4034,2726,2020,38692,17859
AATCCGTCACCGAATT,sample,145811,144803,8931,135872,17683,118189,65592,4363,26347,3065,91939,18822,7101,2184,21131,12598
AACTCGTAACCGAATT,sample,34934,34700,2107,32593,3682,28911,16874,1230,7203,774,24077,2830,2925,1749,3738,2503
AATATATCACCGAATT,Neg_Ctrl,749,567,267,300,21,279,189,14,31,8,220,37,89,50,73,34
ACCAATGCACCGAATT,sample,148811,147977,6880,141097,15621,125476,89685,7104,17652,1613,107337,9422,5126,2442,24073,11192
GAAGGCGCACCGAATT,sample,104237,103668,3175,100493,8986,91507,72056,4958,10592,1410,82648,2491,3166,2997,12180,7137
TTGGTTAAACCGAATT,sample,196805,195981,6205,189776,25382,164394,137075,11230,10753,1365,147828,3971,2163,1899,48382,18625
GGCATATAACCGAATT,sample,118611,118077,3790,114287,18352,95935,75786,5173,8915,1293,84701,4768,2571,1617,27447,12864
TCAATATAACCGAATT,sample,191802,191029,4780,186249,29421,156828,132338,9952,9690,1396,142028,3452,1972,1627,52831,21438
ATGACCGAACCGAATT,sample,161910,161054,6616,154438,18211,136227,94958,5143,22545,2715,117503,10866,4345,1971,27240,14017
GACCGGAAACCGAATT,sample,115639,115119,7789,107330,10492,96838,45160,3363,26149,2739,71309,19427,8019,2531,11584,7969
GGAGAGTTGGTCTGGT,sample,125416,124900,5415,119485,14841,104644,66873,4669,18987,2254,85860,11861,5617,2129,25200,10234
TCCAACTTGGTCTGGT,Neg_Ctrl,754,569,333,236,34,202,107,15,61,1,168,18,63,38,45,37
GGTTGCGTGGTCTGGT,sample,115410,114834,5865,108969,16608,92361,64063,5051,13578,1406,77641,8263,4940,2234,20108,11637
TTCGTAATGGTCTGGT,sample,90275,89686,4257,85429,13482,71947,58464,4412,5184,475,63648,3412,4772,4361,11154,10122
ACGTTATGGGTCTGGT,sample,64904,64329,3619,60710,9203,51507,27416,1723,14434,2217,41850,5717,3321,1557,4679,6335
TAGTACGGGGTCTGGT,sample,99720,99183,4690,94493,10062,84431,52619,3960,16770,2237,69389,8845,4265,1913,16075,7024
TGAGCGCGGGTCTGGT,Neg_Ctrl,440,309,109,200,33,167,122,4,28,0,150,13,80,46,36,21
TTAGAAGTGGTCTGGT,sample,83659,83207,4763,78444,7311,71133,47391,3910,10756,1562,58147,7514,4200,1697,14211,4595
CATAACCTGGTCTGGT,sample,69896,69378,3944,65434,9837,55597,34609,2270,10516,1259,45125,6943,5027,2291,8321,6699
GACGGAGAGGTCTGGT,sample,36975,36749,2284,34465,4135,30330,18044,1399,6931,926,24975,3030,3459,1901,4726,3014
GGACGTAGGGTCTGGT,Neg_Ctrl,498,369,139,230,49,181,117,8,31,2,148,23,81,45,33,26
ACCTCGAGGGTCTGGT,sample,102021,101541,3231,98310,15117,83193,62758,4342,9566,973,72324,5554,3178,1890,21509,11522
TGGACGAGGGTCTGGT,sample,105378,104968,2870,102098,14732,87366,74937,3978,6278,1102,81215,1071,1173,1316,32600,11278
GGCCAGAGGGTCTGGT,sample,69731,69125,4513,64612,7989,56623,32864,1942,12688,1437,45552,7692,4707,1973,6672,5481
CGTACGTCGGTCTGGT,Neg_Ctrl,419,287,86,201,25,176,110,10,22,9,132,25,68,36,53,23
GCCTGAACGGTCTGGT,sample,96294,95696,4986,90710,9217,81493,50457,3869,17812,2192,68269,7163,4096,2182,10981,6372
TTGGCCTCGGTCTGGT,sample,58929,58554,4301,54253,5156,49097,25740,1713,13226,1519,38966,6899,4944,2331,4232,3196
ACCAATGCGGTCTGGT,sample,134090,133491,3849,129642,18107,111535,92726,4791,9245,902,101971,3871,2205,1595,34682,13919
GAAGGCGCGGTCTGGT,sample,109048,108415,5339,103076,10503,92573,60991,4589,16200,1906,77191,8887,5193,2052,19187,7572
AAGAGCGCGGTCTGGT,sample,80596,80241,2669,77572,10453,67119,53869,4207,5635,694,59504,2714,3588,3054,11709,7544
CCAATTCCGGTCTGGT,sample,59235,58894,1643,57251,6247,51004,35761,2403,8462,1253,44223,3125,2302,1821,6902,4197
TTGGTTAAGGTCTGGT,sample,37925,37706,1663,36043,3929,32114,22450,1715,5169,653,27619,2127,3061,2173,5417,2819
GGCATATAGGTCTGGT,Neg_Ctrl,351,237,94,143,13,130,69,7,30,8,99,16,45,28,27,11
AGGTCGGAGGTCTGGT,sample,99519,99089,2823,96266,15419,80847,68851,3909,5569,603,74420,1915,1762,1509,27934,11641
TATCAGTTCGACGTTA,sample,165056,164202,5469,158733,31415,127318,99420,6711,14048,1443,113468,5696,3798,2295,35851,22140
TTCGTAATCGACGTTA,sample,94274,93642,4037,89605,17162,72443,53097,2851,11179,1264,64276,4052,3821,2699,15584,12467
CATAACCTCGACGTTA,sample,174041,172972,8421,164551,27067,137484,88529,5176,26037,3018,114566,14724,6129,2065,37577,18422
GACGGAGACGACGTTA,sample,191055,190080,6409,183671,30799,152872,128461,8665,10863,1834,139324,3049,2541,1960,52170,23435
CCAGAGCGCGACGTTA,sample,205317,204288,7084,197204,30390,166814,127485,10584,17670,2632,145155,8443,4581,2696,37336,22002
GGAGGACGCGACGTTA,sample,70712,70196,5238,64958,7215,57743,34570,2081,12932,1406,47502,6754,5368,2906,7472,4700
CCGCAACGCGACGTTA,sample,77207,76739,3388,73351,14329,59022,39604,2767,10499,1031,50103,5121,3881,1981,15575,9667
AATCCGTCCGACGTTA,sample,270280,269209,9294,259915,38110,221805,178155,12729,19646,2335,197801,8940,4344,2841,47933,27592
CTAGGACCCGACGTTA,sample,191900,190973,7731,183242,24010,159232,109967,7546,25608,2805,135575,13306,5855,2725,31187,17212
AATATATCCGACGTTA,sample,190574,189812,6052,183760,25257,158503,125271,9595,15217,1642,140488,6778,4022,2382,36963,19258
ACCAATGCCGACGTTA,sample,144914,144115,5762,138353,20301,118052,82741,5634,16642,1869,99383,11166,5327,1983,19273,13635
GTCTTAGCCGACGTTA,sample,122115,121563,6154,115409,15950,99459,57359,3497,21842,2129,79201,14632,6577,2004,17001,10562
TCAATATACGACGTTA,sample,258575,257537,16426,241111,26487,214624,109514,8601,51194,5351,160708,39964,11647,2823,35709,16182
AGGTCGGACGACGTTA,sample,215136,214315,8827,205488,27079,178409,124368,10465,25667,2762,150035,15147,6042,2259,40931,19250
GACCGGAACGACGTTA,sample,131247,130759,5236,125523,17157,108366,73106,5436,17877,2078,90983,9869,5411,2084,25046,11519
ATTCTCTTTACTAAGT,sample,75059,74395,7216,67179,7360,59819,24742,1328,18213,2489,42955,13047,5689,1510,5903,4420
TCCTCCGTTACTAAGT,sample,65361,65055,1931,63124,10248,52876,47510,2362,2406,170,49916,428,1389,1675,17298,7968
ACGTAAGTTACTAAGT,sample,54481,54107,2675,51432,8310,43122,33166,2089,4840,497,38006,2530,2472,1583,12784,6088
TTCTAATGTACTAAGT,sample,27019,26778,1809,24969,4972,19997,12962,771,3446,392,16408,2426,2393,1241,4351,3453
TAGTACGGTACTAAGT,sample,108900,108174,9055,99119,9366,89753,55136,3638,16207,1707,71343,13065,6634,2394,14753,6354
TCGCATCTTACTAAGT,sample,70641,70294,2665,67629,8213,59416,45564,2627,6761,942,52325,3522,2226,1467,15553,5739
CATAACCTTACTAAGT,sample,64739,64348,3793,60555,6650,53905,37468,2718,7504,713,44972,5502,3193,1520,14258,5099
TGGACGAGTACTAAGT,sample,63048,62767,1975,60792,9210,51582,44296,3237,3065,439,47361,545,1406,1569,16338,6839
GACGATAATACTAAGT,sample,63745,63296,4239,59057,4170,54887,29410,1824,14518,1834,43928,7301,4527,2063,6142,2788
CATTGCAGTACTAAGT,sample,61242,60791,3797,56994,6536,50458,35712,2019,7515,882,43227,4330,2891,1546,13249,4854
CGAGGCAGTACTAAGT,sample,66596,66159,2542,63617,8373,55244,43465,2900,5422,594,48887,2863,2255,1505,14461,6761
CATGATTCTACTAAGT,sample,38225,37850,4012,33838,3060,30778,16387,1017,7106,785,23493,5483,3734,1200,6276,2049
AATCCGTCTACTAAGT,sample,57438,57053,4624,52429,5179,47250,27419,1691,10720,1139,38139,6281,4493,1740,7934,3694
CTAGGACCTACTAAGT,sample,32138,31890,1959,29931,4513,25418,15386,1159,5121,550,20507,3202,2940,1540,3029,3345
GCCTGAACTACTAAGT,sample,28470,28259,3226,25033,2939,22094,9370,614,6447,630,15817,5033,3699,1309,1894,1966
GTCTTAGCTACTAAGT,sample,50172,49847,2795,47052,4211,42841,26413,2127,8637,1188,35050,4476,2950,1647,4922,3114
TTGGTTAATACTAAGT,sample,52874,52642,2786,49856,4735,45121,27904,2149,9351,982,37255,4735,3406,1488,8624,3117
TCAATATATACTAAGT,sample,86784,86451,2461,83990,10073,73917,59202,4209,6165,820,65367,3521,2244,1427,20073,6756
TATCAGTTTTGCCGCT,sample,103223,102492,5266,97226,10249,86977,55824,3634,17481,2477,73305,7561,4200,2437,15434,7636
ATTCTCTTTTGCCGCT,sample,187301,186408,5592,180816,34777,146039,121420,8740,9641,1449,131061,4789,3092,2528,38945,25469
GCCTTGCTTTGCCGCT,sample,41082,40762,3107,37655,6664,30991,17567,1380,6305,690,23872,5049,3761,1909,4368,4335
CATAACCTTTGCCGCT,sample,33061,32910,1361,31549,5684,25865,16590,1472,5133,736,21723,1934,2135,1388,2994,3931
ACCTCGAGTTGCCGCT,sample,89501,89065,4028,85037,9527,75510,45665,3757,18098,1945,63763,6045,3958,2098,13116,6478
TGGACGAGTTGCCGCT,sample,133209,132722,4000,128722,24070,104652,88053,7212,6507,565,94560,2315,2521,2560,25815,17539
GACGATAATTGCCGCT,sample,77869,77427,3871,73556,12567,60989,33209,2660,15075,2144,48284,7901,4601,1751,7465,8703
GGCCAGAGTTGCCGCT,sample,136634,135956,4780,131176,32412,98764,77728,5449,9648,764,87376,5175,2624,1630,28705,22103
CATTGCAGTTGCCGCT,sample,122672,121936,9620,112316,17964,94352,51205,3105,21617,2266,72822,16159,7668,2479,17273,11643
CGTACGTCTTGCCGCT,sample,116843,116173,4855,111318,17119,94199,66423,5234,13204,1998,79627,7340,4329,1989,15379,11878
GCCTGAACTTGCCGCT,sample,176911,176008,7100,168908,21220,147688,106909,7490,20172,2002,127081,11115,5486,2512,34432,15344
ACGTATTATTGCCGCT,sample,186837,185985,7918,178067,29119,148948,109482,7689,20087,2656,129569,9034,4963,3109,30023,21031
TTGGCCTCTTGCCGCT,sample,174321,173661,5060,168601,20692,147909,120196,9261,11590,1553,131786,5309,3864,2747,34603,15604
AATATATCTTGCCGCT,sample,116933,116501,3002,113499,20409,93090,75985,5367,7800,991,83785,2947,3003,2429,22207,14810
AAGAGCGCTTGCCGCT,sample,142056,141196,6350,134846,17244,117602,75539,5284,21444,2308,96983,13027,5848,2235,15798,11489
TTGGTTAATTGCCGCT,sample,201502,200537,6354,194183,25898,168285,127030,10488,18874,2486,145904,9407,4656,2091,43273,17501
ATTCTCTTTTCGACCT,sample,86217,85419,10635,74784,7904,66880,24937,1290,22034,2338,46971,16281,6812,1657,8053,4781
AAGTTCGTTTCGACCT,sample,101279,100779,5269,95510,15524,79986,57894,3825,10545,1434,68439,6288,4105,2078,23047,11006
ACGTAAGTTTCGACCT,sample,18020,17896,1810,16086,2254,13832,7955,491,2761,292,10716,2333,1893,841,3501,1579
TTCGTAATTTCGACCT,sample,175231,174435,5463,168972,31430,137542,120676,7128,6268,699,126944,2771,2525,2741,36485,23134
AATGGTAATTCGACCT,sample,147213,146353,6084,140269,17901,122368,88678,5951,16366,2331,105044,9042,5258,3011,22469,12922
TTCCGTCTTTCGACCT,sample,101488,100862,4758,96104,17118,78986,58804,4202,9904,1109,68708,4967,3941,2609,15481,12005
CAAGGCCTTTCGACCT,sample,62283,61868,3622,58246,5637,52609,30551,2066,13818,1635,44369,4539,3542,2094,8738,3803
ACTATACTTTCGACCT,sample,136523,135714,5641,130073,19009,111064,84199,6422,12882,1324,97081,6237,4094,2531,23398,13894
CCAGAGCGTTCGACCT,sample,87360,86786,4574,82212,12032,70180,49202,3658,11559,1533,60761,4228,3656,2454,15452,8863
GGAGGACGTTCGACCT,sample,68492,67996,3595,64401,5834,58567,38536,2347,11953,1639,50489,4092,4088,3024,6892,4427
CATTGCAGTTCGACCT,sample,73149,72718,2325,70393,13311,57082,46810,2219,6129,489,52939,1435,2204,1642,17943,9646
AATCCGTCTTCGACCT,sample,169218,168299,10291,158008,21906,136102,86677,6054,24574,2673,111251,16124,6384,2517,24972,14971
CGTACGTCTTCGACCT,sample,65217,64718,4556,60162,10954,49208,29296,2057,9822,1216,39118,6817,4125,1699,12066,7499
AGTCCGCATTCGACCT,sample,174268,173417,6176,167241,23991,143250,118864,7610,11177,1632,130041,3967,2877,2209,41527,18579
TTGGTACCTTCGACCT,sample,122581,121894,5015,116879,14154,102725,81294,6626,10485,776,91779,3544,3594,3062,18641,11299
GCCTGAACTTCGACCT,sample,101859,101319,3353,97966,14647,83319,66323,4914,7925,963,74248,3194,2644,2132,24375,10223
ACGTATTATTCGACCT,sample,48925,48622,3021,45601,7424,38177,25714,1970,6172,748,31886,3573,3950,2444,5086,5310
CGTATGAATTCGACCT,sample,95437,94812,3425,91387,9503,81884,55431,4553,14441,2191,69872,5268,3254,2176,10038,6337
GAAGGCGCTTCGACCT,sample,158162,157029,11008,146021,9040,136981,74253,5814,30629,3483,104882,22802,8745,2981,11256,5944
CCAATTCCTTCGACCT,sample,151033,150230,4607,145623,18233,127390,107996,7239,8081,1410,116077,2664,2687,2602,22115,13082
TTGGTTAATTCGACCT,sample,152012,151180,5592,145588,15850,129738,97675,7536,15356,1530,113031,7641,4146,2169,32437,11650
GTACCGTATTCGACCT,sample,160712,159945,6897,153048,19079,133969,96920,5782,18704,1883,115624,10680,4806,2268,28396,13504
TCAATATATTCGACCT,sample,94917,94227,6556,87671,8245,79426,44986,3654,15859,1724,60845,13203,5793,2359,4510,5043
ACGTAAGTTCCAGACT,sample,59044,58684,4087,54597,6734,47863,29679,1487,10241,1173,39920,5283,3766,1788,9378,4456
CAACCGCGTCCAGACT,sample,38619,38257,3208,35049,4344,30705,13694,853,8736,904,22430,6518,4484,1526,3987,2975
TTAGAAGTTCCAGACT,sample,61780,61412,3373,58039,8187,49852,36395,2341,6372,906,42767,3838,3902,2663,9139,5817
CATAACCTTCCAGACT,sample,32091,31841,1838,30003,4865,25138,17715,1044,3600,401,21315,2378,2547,1439,5022,3320
GGAGGACGTCCAGACT,sample,73369,73011,2516,70495,10087,60408,48775,3432,5470,668,54245,2063,2257,2035,15480,7635
GACGATAATCCAGACT,sample,68998,68647,2856,65791,9033,56758,44300,3170,5524,558,49824,3206,2960,2300,12403,6850
CATTGCAGTCCAGACT,sample,69269,68781,3767,65014,7339,57675,39688,2893,8457,1039,48145,5598,3801,1825,9393,5692
CCATGAAGTCCAGACT,sample,71888,71544,2390,69154,10685,58469,48935,3154,3943,502,52878,1935,2008,1681,18233,8285
ACGACTTCTCCAGACT,sample,82965,82441,5055,77386,9974,67412,46062,3073,10647,1562,56709,6068,4296,2033,12782,7529
TTGGTACCTCCAGACT,sample,59200,58797,2378,56419,5926,50493,39836,3170,4959,553,44795,1975,3374,3041,6432,4806
GTTAGGACTCCAGACT,Pos_Ctrl,31303,31007,1739,29268,1177,28091,23670,2276,1434,231,25104,480,4129,4370,1640,294
CGTATGAATCCAGACT,sample,90539,89923,6980,82943,9065,73878,43074,2662,15562,1754,58636,10826,5512,1801,14700,6575
TTGGCCTCTCCAGACT,Pos_Ctrl,24341,24160,1332,22828,1035,21793,18358,1918,1008,154,19366,355,3663,3730,1595,333
ACCAATGCTCCAGACT,sample,48223,47905,1897,46008,4655,41353,29559,2169,6262,804,35821,2559,2757,2032,5719,3051
GTACCGTATCCAGACT,sample,84654,84182,3814,80368,9692,70676,51263,3280,9183,877,60446,6073,3735,1684,16934,6897
GGCATATATCCAGACT,sample,71966,71611,4206,67405,6828,60577,41500,2469,9523,1269,51023,5816,3779,1640,14292,4767
TCGCCTGATCCAGACT,sample,14651,14507,1885,12622,1472,11150,3747,284,3614,388,7361,3117,2509,988,299,802
CTTCATGATCCAGACT,sample,101247,100686,4969,95717,9814,85903,63254,4421,10799,1244,74053,6185,3653,2026,15808,7653
ATGACCGATCCAGACT,sample,60147,59748,3522,56226,5168,51058,29379,1956,12036,1627,41415,6060,3516,1639,6794,3665
TCCAACTTACCATTAT,sample,248496,247176,15430,231746,30804,200942,125003,7409,38675,3702,163678,26153,7957,2775,41187,22083
ACGTAAGTACCATTAT,sample,69829,69421,2675,66746,11922,54824,42019,2956,6628,724,48647,2497,3340,2747,10959,9018
CCTCTAGAACCATTAT,sample,195197,193963,9350,184613,28498,156115,109735,6701,22496,3115,132231,14068,6389,2972,31988,21106
TTCGTAATACCATTAT,sample,243956,242433,15705,226728,33245,193483,125923,8884,33222,3724,159145,21730,6985,2340,48207,23005
CAACCGCGACCATTAT,sample,82355,81739,4839,76900,13668,63232,37011,2571,13475,1520,50486,8655,5058,1867,10388,9370
AATGGTAAACCATTAT,sample,263609,262061,11197,250864,32561,218303,168932,10992,23504,2877,192436,11998,5419,3027,48192,23533
TTCCGTCTACCATTAT,sample,64474,63940,4758,59182,5073,54109,25034,1789,17655,2062,42689,7569,4582,2144,2635,3511
GGAGGACGACCATTAT,sample,73161,72591,6262,66329,6087,60242,32723,2094,14667,1458,47390,9300,5915,2841,7576,4228
GGACGTAGACCATTAT,sample,90290,89705,4575,85130,10690,74440,54174,4118,8788,966,62962,6394,5102,3246,11093,7697
CTTGATAGACCATTAT,sample,172175,171323,5238,166085,24896,141189,120178,8804,7967,1148,128145,3092,3008,3159,29423,17846
GGCCAGAGACCATTAT,sample,71142,70655,4773,65882,7009,58873,37486,2404,10838,927,48324,7218,4509,2344,7641,5039
CATTGCAGACCATTAT,sample,243381,241800,16604,225196,26386,198810,119832,8639,38961,4684,158793,26694,9993,2839,44072,18529
AATCCGTCACCATTAT,sample,156331,155382,5800,149582,19503,130079,97417,8726,14287,1844,111704,7805,4692,3114,13167,13723
GTCCTGCCACCATTAT,sample,215032,214133,5305,208828,31204,177624,151853,10973,11055,1439,162908,2304,1498,1764,57551,23020
CTAGGACCACCATTAT,sample,184965,183848,8968,174880,19448,155432,115575,8333,19281,2145,134856,10098,5194,2739,33535,13475
AAGAGCGCACCATTAT,sample,164585,163938,4284,159654,22599,137055,111595,8078,11272,1104,122867,5006,3811,2410,36827,16761
TCAATATAACCATTAT,sample,219623,218279,14936,203343,16754,186589,109677,7336,38116,4689,147793,26771,8365,2386,35749,10262
AGGTCGGAACCATTAT,sample,222391,221316,9112,212204,26055,186149,124314,8553,28982,3387,153296,20913,6200,2292,43203,18186
TTATTCGAACCATTAT,sample,201207,200182,5511,194671,19533,175138,140746,10521,14329,1509,155075,8033,4822,3172,28298,14098
GGAGAGTTCAATGGAT,sample,149869,149195,5763,143432,18848,124584,93694,7104,14881,1603,108575,7302,5428,3822,17546,13529
TATCAGTTCAATGGAT,sample,148575,147939,5943,141996,24363,117633,88636,6514,14324,1302,102960,6857,4385,2799,28057,17056
TCCTCCGTCAATGGAT,sample,4562,4543,144,4399,779,3620,2666,222,455,17,3121,260,831,642,554,531
GGACCTCTCAATGGAT,sample,157032,155659,11579,144080,17854,126226,60546,4314,33162,3576,93708,24628,7995,2285,13558,11511
GGCCAGAGCAATGGAT,sample,172351,171522,5462,166060,28181,137879,115227,8024,9066,1425,124293,4137,2450,2093,41141,20764
GCCTGAACCAATGGAT,Neg_Ctrl,573,328,171,157,43,114,72,10,24,1,96,7,45,28,19,13
CGTATGAACAATGGAT,sample,112874,112134,5178,106956,13918,93038,59148,4368,17230,1685,76378,10607,5020,1815,19469,9843
AATATATCCAATGGAT,Neg_Ctrl,590,354,164,190,17,173,98,9,39,8,137,19,67,38,28,19
AAGAGCGCCAATGGAT,sample,105534,104974,3377,101597,14304,87293,69395,5605,7606,968,77001,3719,3216,2013,17999,9942
GTCTTAGCCAATGGAT,sample,18209,18066,1342,16724,1647,15077,8745,655,3368,364,12113,1945,2225,1231,1983,980
CCAATTCCCAATGGAT,sample,33230,33071,1284,31787,5500,26287,18458,1976,3546,375,22004,1932,1897,1143,4869,3748
AGGTCGGACAATGGAT,Pos_Ctrl,41487,41223,2028,39195,1772,37423,31510,3297,1713,244,33223,659,4699,5340,2647,666
TTATTCGACAATGGAT,sample,9934,9902,232,9670,1629,8041,6504,633,580,74,7084,250,1195,1202,1287,1125
ATGACCGACAATGGAT,sample,165196,164591,4066,160525,21236,139289,118157,9027,8665,1122,126822,2318,1984,1635,42745,16213
TATCAGTTAGATTCAT,sample,56341,55980,2547,53433,6813,46620,27553,1863,11620,1427,39173,4157,3225,1803,8996,4853
TCCAACTTAGATTCAT,sample,73633,73185,3158,70027,9091,60936,39899,2423,12606,1470,52505,4538,3317,1910,9914,6684
GGTTGCGTAGATTCAT,sample,70770,70302,4162,66140,9493,56647,38232,2955,9523,1055,47755,4882,4158,2502,10520,6825
ACGTAAGTAGATTCAT,sample,116406,115741,6594,109147,15238,93909,53797,4667,23244,2961,77041,9240,4581,2051,15550,10602
CCTCTAGAAGATTCAT,sample,78830,78284,4929,73355,11014,62341,38620,2965,12265,1385,50885,7106,4863,2187,11432,7399
AGTACCATAGATTCAT,sample,132165,131481,4533,126948,19037,107911,79144,5962,15400,1853,94544,5552,3298,2485,22020,14675
TTCTAATGAGATTCAT,sample,72223,71634,5668,65966,6742,59224,31481,1860,14881,1728,46362,9274,5490,2425,4148,4453
TAGTACGGAGATTCAT,sample,120382,119783,5421,114362,18409,95953,76080,5800,8004,1154,84084,4915,4158,2875,19032,13730
CCAGAGCGAGATTCAT,sample,77073,76580,2040,74540,8410,66130,56212,3616,4550,423,60762,1329,3006,3206,8436,5845
GGACGTAGAGATTCAT,sample,107156,106748,3296,103452,13882,89570,71019,4187,9510,840,80529,4014,3087,1901,25739,10614
ACGACTTCAGATTCAT,sample,123770,123048,5916,117132,12297,104835,77675,4904,13612,1879,91287,6765,4351,2299,21807,9068
AATCCGTCAGATTCAT,sample,80086,79590,4323,75267,6829,68438,36382,2650,19581,2442,55963,7383,4225,2038,8145,4886
AACTCGTAAGATTCAT,sample,124001,123489,4218,119271,14730,104541,84128,5912,8978,1125,93106,4398,2936,2083,24740,10851
CGTATGAAAGATTCAT,sample,120991,120167,6586,113581,11567,102014,62789,4238,19715,1853,82504,13419,5448,1946,23101,7773
AATATATCAGATTCAT,sample,83122,82635,4986,77649,8849,68800,47077,3175,10467,1238,57544,6843,4115,1688,16510,6192
TGCTTCGCAGATTCAT,sample,94856,94396,3710,90686,9069,81617,62322,4825,8465,948,70787,5057,3730,2291,14712,6904
AAGAGCGCAGATTCAT,sample,70792,70210,7942,62268,6458,55810,23704,1558,15979,1626,39683,12943,6580,1636,6968,4057
CCAATTCCAGATTCAT,sample,62378,61963,3814,58149,7736,50413,31533,2391,9070,882,40603,6537,4029,1592,6959,5535
GTACCGTAAGATTCAT,sample,127319,126750,6405,120345,11208,109137,71600,4963,20618,2700,92218,9256,4609,2260,16574,6722
TCGCCTGAAGATTCAT,sample,63383,62945,2922,60023,6513,53510,32531,2402,11683,1448,44214,5446,3091,1512,6988,4617
CTTCATGAAGATTCAT,sample,133022,132307,9687,122620,10569,112051,61824,3538,27134,3092,88958,16463,7671,2461,15161,7003
AGGTCGGAAGATTCAT,sample,68158,67803,2795,65008,9181,55827,39629,2751,8254,788,47883,4405,3653,2082,11085,6459
GGAGAGTTCAATCTTG,sample,123429,122816,6396,116420,20813,95607,60635,2931,18769,2290,79404,10982,5333,1630,29452,13977
ATTCTCTTCAATCTTG,sample,137664,136935,9836,127099,18415,108684,63151,4251,23783,2795,86934,14704,6318,2473,20808,13465
AGTACCATCAATCTTG,sample,146066,145249,8034,137215,17977,119238,75683,5460,20747,2997,96430,14351,6554,2657,21090,12233
TTCTAATGCAATCTTG,sample,92263,91646,4660,86986,11279,75707,45304,3171,15987,1749,61291,9496,4469,1663,10493,8047
TAGTACGGCAATCTTG,sample,81972,81523,5678,75845,12091,63754,37163,2223,14535,1562,51698,8271,4569,1521,16666,8415
CAACCGCGCAATCTTG,sample,86150,85644,2283,83361,7103,76258,62826,4856,5408,577,68234,2591,3285,3018,9939,4895
CAAGGCCTCAATCTTG,sample,104217,103479,8288,95191,14969,80222,43028,2792,20603,2223,63631,11576,5840,1579,18212,9754
ACTATACTCAATCTTG,sample,203145,202045,6393,195652,27514,168138,134010,8527,18113,2216,152123,5272,3026,2506,37206,21168
GTTAGCCGCAATCTTG,sample,89555,88959,3205,85754,14547,71207,55739,4506,6490,960,62229,3512,3478,2490,13167,10381
GGAGGACGCAATCTTG,sample,132200,131451,4922,126529,16990,109539,90548,6541,8712,797,99260,2941,2910,2421,31854,12355
GGACGTAGCAATCTTG,sample,95026,94395,5859,88536,6943,81593,40083,2722,24595,3401,64678,10792,4792,1849,8008,4634
ACCTCGAGCAATCTTG,sample,112002,111422,3915,107507,16442,91065,71380,4691,10195,938,81575,3861,2559,1712,25209,11537
GACGATAACAATCTTG,sample,156646,155702,6150,149552,12900,136652,114449,7743,9152,1104,123601,4204,4255,3883,17914,9497
ACGACTTCCAATCTTG,sample,130176,129089,9362,119727,14947,104780,57481,4215,23064,2994,80545,17026,7268,2450,16318,10614
CATGATTCCAATCTTG,sample,82142,81626,3228,78398,9074,69324,54796,3994,6689,716,61485,3129,3866,3123,11626,6578
AATCCGTCCAATCTTG,sample,160540,159760,4996,154764,24806,129958,112556,7602,7513,904,120069,1383,1567,1770,46933,19246
AGTCCGCACAATCTTG,sample,205733,204462,10647,193815,22948,170867,116904,7337,25590,2537,142494,18499,5993,2512,38195,16437
CTAGGACCCAATCTTG,sample,107600,106908,5764,101144,13952,87192,63841,3794,12706,1318,76547,5533,3972,2149,21718,10018
CGGATTACCAATCTTG,sample,172243,171084,9952,161132,15378,145754,100880,6686,21244,2211,122124,14733,6811,2971,24462,10202
ACGTATTACAATCTTG,sample,11082,10885,1730,9155,649,8506,2541,207,3229,377,5770,2152,2023,637,386,307
CGTATGAACAATCTTG,sample,120112,119277,6670,112607,16688,95919,58824,4191,18880,2275,77704,11749,5437,1839,17331,11174
ACCAATGCCAATCTTG,sample,15714,15461,4061,11400,1074,10326,1468,107,4539,469,6007,3743,2765,345,214,417
TTGGTTAACAATCTTG,sample,132174,131322,6554,124768,15592,109176,77618,6067,14549,1559,92167,9383,4605,2272,18872,10207
TCAATATACAATCTTG,sample,84708,84166,3234,80932,9590,71342,51265,4057,10569,803,61834,4648,3758,2448,14214,6713
TCGCCTGACAATCTTG,sample,124349,123688,5722,117966,11330,106636,69040,5161,19783,1907,88823,10745,4910,2244,19094,7645
CTTCATGACAATCTTG,sample,129618,128836,7645,121191,13531,107660,69321,4810,18997,1956,88318,12576,5093,1812,25853,9237
TTATTCGACAATCTTG,Neg_Ctrl,550,375,137,238,17,221,151,3,43,5,194,19,90,48,46,13
GACCGGAACAATCTTG,sample,134043,133402,5129,128273,16681,111592,82897,4943,13567,1638,96464,8547,4061,1956,26617,12632
ATTCTCTTCGTTCCGA,sample,138394,137503,7089,130414,19745,110669,78367,6173,17281,2229,95648,6619,4398,3150,18751,14984
AAGTTCGTCGTTCCGA,sample,141242,140265,7526,132739,25111,107628,78725,5309,14248,1579,92973,7767,4343,2323,24921,17306
TCCTCCGTCGTTCCGA,sample,48150,47543,3832,43711,3852,39859,16241,1426,15230,1581,31471,5381,3747,1711,1041,2168
TTCTAATGCGTTCCGA,sample,41352,40901,3098,37803,6834,30969,20102,1510,5371,818,25473,3168,3031,1695,7158,4750
TAGTACGGCGTTCCGA,sample,131796,130904,7510,123394,10690,112704,66758,4146,27381,3678,94139,10741,4873,2279,14360,7032
AATGGTAACGTTCCGA,sample,185629,184511,12264,172247,19496,152751,90752,5206,30712,3461,121464,22620,7156,2303,23723,14343
TTAGAAGTCGTTCCGA,sample,202669,201469,11975,189494,21990,167504,114651,7408,25417,3351,140068,16677,5965,2080,42452,15360
TTCCGTCTCGTTCCGA,sample,95249,94513,6502,88011,13825,74186,49730,3794,12475,1441,62205,6746,4688,2488,12788,9933
ACTATACTCGTTCCGA,sample,119156,118343,6884,111459,12288,99171,53768,3239,27198,3310,80966,11656,5005,2348,6192,8310
CCGCAACGCGTTCCGA,sample,98127,97371,7942,89429,10966,78463,34374,2337,24036,2531,58410,15185,6301,1606,9809,7171
CTTGATAGCGTTCCGA,sample,157055,155965,12060,143905,15406,128499,69576,5228,28890,3291,98466,21514,8056,2836,9986,10189
TGGACGAGCGTTCCGA,sample,116922,116245,5749,110496,14964,95532,65017,4420,16044,1918,81061,8133,5148,2468,16790,10346
CGTACGTCCGTTCCGA,sample,166777,165776,7885,157891,22349,135542,103516,5908,16774,2103,120290,7241,3818,2460,34059,17091
CTAGGACCCGTTCCGA,sample,100678,99965,7115,92850,13061,79789,52463,4146,13953,1611,66416,7616,4867,2262,16463,9135
AACTCGTACGTTCCGA,sample,156210,155310,6744,148566,21399,127167,101225,7494,11144,1655,112369,5649,3569,2357,30170,15794
TTGGCCTCCGTTCCGA,sample,161848,161106,5332,155774,23622,132152,108238,6613,10968,1450,119206,4883,3738,2858,29546,17245
TGCTTCGCCGTTCCGA,sample,30540,30287,5199,25088,1859,23229,6055,420,9066,1116,15121,6572,4486,1141,1338,894
AAGAGCGCCGTTCCGA,sample,104147,103473,4391,99082,11814,87268,66884,4642,10472,1305,77356,3965,3139,1993,20581,8910
CCAATTCCCGTTCCGA,sample,119052,118288,5800,112488,12091,100397,68163,4733,15091,1714,83254,10696,5452,2223,14440,8232
AGGTCGGACGTTCCGA,sample,165792,165231,4164,161067,21163,139904,114201,8362,11266,1209,125467,4866,3200,2566,25380,15123
GGAGAGTTCAATTCGG,sample,91673,91036,5698,85338,15736,69602,45591,3845,11567,1304,57158,7295,4966,2489,5937,10850
ATTCTCTTCAATTCGG,Pos_Ctrl,50657,50264,3101,47163,2339,44824,37745,3483,2483,372,40228,741,5291,5558,4590,1165
TCCAACTTCAATTCGG,sample,78619,78030,3528,74502,17325,57177,39359,3174,9625,1156,48984,3863,3051,1636,11564,11624
GGTTGCGTCAATTCGG,sample,89696,89106,4803,84303,16660,67643,49093,3622,8385,1185,57478,5358,4578,3076,11084,11553
AGTACCATCAATTCGG,sample,141529,140634,7360,133274,20556,112718,87034,5659,12841,1490,99875,5694,3860,2383,30170,15126
ACGTTATGCAATTCGG,Pos_Ctrl,36621,36075,2709,33366,1785,31581,26557,2369,1828,282,28385,545,4717,4661,3105,1010
AATGGTAACAATTCGG,sample,123728,123093,5190,117903,12422,105481,71286,4800,19559,2643,90845,7193,3808,2130,15870,8185
GCCTTGCTCAATTCGG,Pos_Ctrl,36358,36110,1291,34819,1500,33319,27932,3284,1391,224,29323,488,4342,4967,2408,459
CCAGAGCGCAATTCGG,sample,160623,159914,6910,153004,21665,131339,100138,6365,14720,1407,114858,8709,3884,2102,36396,15918
CCGCAACGCAATTCGG,Pos_Ctrl,33394,33059,1709,31350,1394,29956,25265,2659,1371,208,26636,453,4313,4643,2635,554
GGCCAGAGCAATTCGG,sample,126126,125281,6809,118472,12715,105757,58908,4174,28677,3459,87585,10539,5086,2196,17166,8798
CCATGAAGCAATTCGG,Pos_Ctrl,55239,54457,3302,51155,2197,48958,41280,3975,2543,354,43823,806,5340,5991,4224,895
GTCCTGCCCAATTCGG,sample,169374,168596,7953,160643,20088,140555,105654,6504,16934,1869,122588,9594,4972,2606,32388,14420
TTGGTACCCAATTCGG,sample,83736,83203,5874,77329,11746,65583,41369,2447,12475,1237,53844,8055,4811,1833,14745,7869
CGGATTACCAATTCGG,Pos_Ctrl,46896,46314,2309,44005,1758,42247,35576,3557,1991,285,37567,838,4759,5531,2572,553
AACTCGTACAATTCGG,sample,136810,136115,4671,131444,18266,113178,90144,5445,10931,1424,101075,5234,3483,2394,30719,13275
TTGGCCTCCAATTCGG,Pos_Ctrl,37307,37084,1561,35523,1538,33985,28658,3091,1559,190,30217,487,4481,4920,2281,448
AATATATCCAATTCGG,sample,186265,185487,4915,180572,23608,156964,130178,11300,9734,1222,139912,4530,2924,2632,35914,18097
TGCTTCGCCAATTCGG,sample,125394,124818,5016,119802,14778,105024,79408,5553,11529,1230,90937,7304,4042,2153,22425,10565
GAAGGCGCCAATTCGG,sample,137784,137151,6545,130606,14653,115953,81967,6044,16608,1838,98575,9496,5216,2153,23011,9589
TCGCCTGACAATTCGG,sample,122027,121387,6948,114439,12031,102408,62528,4600,18615,2056,81143,14609,5925,1932,17884,7864
TTATTCGACAATTCGG,sample,99160,98630,4729,93901,13179,80722,54494,3884,12778,1576,67272,7990,4724,2244,16577,9339
ATGACCGACAATTCGG,sample,173800,173101,4416,168685,24911,143774,123522,8808,8640,525,132162,2279,1396,1681,46510,17885
GGTTGCGTAACTCCGG,sample,40520,40131,4744,35387,4440,30947,13834,884,8612,772,22446,6845,4776,1931,3493,2710
TGAGCGCGAACTCCGG,sample,56488,56173,1750,54423,8149,46274,35553,2532,5427,525,40980,2237,2198,1718,10103,5853
AATGGTAAAACTCCGG,sample,135525,134921,4807,130114,17380,112734,90447,7142,10793,1032,101240,3320,2919,2364,29290,13437
TTAGAAGTAACTCCGG,sample,118115,117368,6420,110948,16434,94514,67989,4940,12828,1391,80817,7366,4551,2381,22234,11417
TCGCATCTAACTCCGG,sample,50108,49697,3994,45703,4510,41193,26771,1735,7925,884,34696,3878,4339,2731,4621,3299
CAAGGCCTAACTCCGG,sample,49181,48946,2552,46394,9063,37331,24201,1580,7430,732,31631,3388,2932,1316,9984,6316
GACGGAGAAACTCCGG,sample,106735,105933,5770,100163,12598,87565,61049,3851,13022,1691,74071,7952,4631,2123,20570,9614
CCGCAACGAACTCCGG,sample,52874,52476,3098,49378,6144,43234,31362,2403,5947,669,37309,2853,3882,2965,6326,4734
TGGACGAGAACTCCGG,sample,47033,46673,3291,43382,3370,40012,18781,1253,13358,1553,32139,5067,3732,1699,3609,2156
CATTGCAGAACTCCGG,sample,99044,98288,7134,91154,11542,79612,42019,3230,20788,2360,62807,11215,5758,2345,9756,7706
CGAGGCAGAACTCCGG,sample,106673,106092,2936,103156,14966,88190,75462,5111,6260,615,81722,742,1250,1418,34457,11746
AATCCGTCAACTCCGG,sample,93526,92952,4031,88921,12509,76412,59636,3498,8937,700,68573,3641,2811,1677,20546,9276
TTGGTACCAACTCCGG,sample,97803,97273,3968,93305,14659,78646,60241,4507,8536,758,68777,4604,3234,2091,20805,10735
ACGTATTAAACTCCGG,sample,97668,97098,3525,93573,16940,76633,65889,4687,4705,280,70594,1072,1521,1672,25872,13203
ACCAATGCAACTCCGG,sample,101132,100398,7276,93122,8603,84519,51511,3618,16957,1814,68468,10619,5456,1964,16735,5688
TGCTTCGCAACTCCGG,sample,58154,57807,3836,53971,7217,46754,29124,2058,8528,925,37652,6119,3463,1293,9630,4932
AAGAGCGCAACTCCGG,sample,61899,61427,2832,58595,4305,54290,38261,2660,8641,895,46902,3833,3480,2461,4938,2833
GTCTTAGCAACTCCGG,sample,65958,65409,5784,59625,5921,53704,27702,2196,12567,1348,40269,9891,4993,1378,9330,3727
TCAATATAAACTCCGG,sample,42325,42041,2949,39092,3787,35305,21072,1387,7782,809,28854,4255,3017,1281,6278,2333
ATTCTCTTCCTGAAGG,sample,157931,157130,5349,151781,23610,128171,107174,7354,8319,1190,115493,4134,2899,2466,30292,16880
TCCAACTTCCTGAAGG,Neg_Ctrl,365,213,100,113,15,98,82,1,11,0,93,4,44,31,23,8
GGTTGCGTCCTGAAGG,sample,137394,136389,9808,126581,15308,111273,67728,3994,21759,2199,89487,15593,6601,2228,22760,11283
ACGTAAGTCCTGAAGG,sample,137236,136408,7084,129324,18001,111323,85043,5364,12879,1147,97922,6890,3372,1949,34054,14650
TTCTAATGCCTGAAGG,Neg_Ctrl,398,239,136,103,9,94,44,1,12,0,56,37,35,29,13,13
CAACCGCGCCTGAAGG,sample,76990,76398,5013,71385,8092,63293,43863,2600,10249,974,54112,5607,4147,2088,14979,6145
CAAGGCCTCCTGAAGG,Neg_Ctrl,649,456,340,116,14,102,60,4,25,5,85,8,47,26,19,10
GGACGTAGCCTGAAGG,Neg_Ctrl,323,218,97,121,19,102,69,5,16,0,85,12,52,38,15,10
TGGACGAGCCTGAAGG,sample,50214,49862,3996,45866,6767,39099,26427,1570,6932,682,33359,3488,3484,2263,7867,5266
CATGATTCCCTGAAGG,sample,167065,166018,8368,157650,18225,139425,104476,8404,14960,1527,119436,10058,5034,2447,31979,13733
CGTACGTCCCTGAAGG,sample,141112,140198,8787,131411,15686,115725,72048,4992,21495,2185,93543,15005,6071,1794,28778,10415
GTCCTGCCCCTGAAGG,sample,102677,101849,8155,93694,12445,81249,43235,3207,18508,2093,61743,14206,6121,1703,17369,8758
GTTAGGACCCTGAAGG,Neg_Ctrl,329,215,116,99,10,89,60,0,24,0,84,5,47,27,15,5
AATATATCCCTGAAGG,Neg_Ctrl,477,358,170,188,35,153,105,8,20,4,125,16,53,38,47,20
GTCTTAGCCCTGAAGG,sample,57430,56876,5255,51621,4733,46888,23497,1486,12427,1244,35924,8234,5458,2268,5335,3174
CCAATTCCCCTGAAGG,sample,57137,56719,3579,53140,4634,48506,25256,1795,13376,1597,38632,6482,3573,1433,5532,3220
GTACCGTACCTGAAGG,sample,76359,75746,6258,69488,6838,62650,29553,2349,18358,1429,47911,10961,4668,1394,8131,4103
GGAGAGTTAATATTCG,sample,93346,92870,3330,89540,10665,78875,55400,3212,14177,1662,69577,4424,3554,2743,14056,7855
ACGTAAGTAATATTCG,sample,34879,34518,4270,30248,4028,26220,11126,673,7932,869,19058,5620,3751,1387,2915,2524
TGAGCGCGAATATTCG,sample,52943,52683,1973,50710,7349,43361,32649,2519,5585,556,38234,2052,3069,2622,7061,5194
CAACCGCGAATATTCG,sample,70445,70026,3612,66414,9014,57400,43386,2092,6744,723,50130,4455,2980,1490,19203,6830
CATAACCTAATATTCG,sample,109818,108930,7253,101677,9989,91688,51268,3544,24051,2572,75319,10253,4763,1820,18006,6876
ACCTCGAGAATATTCG,sample,83081,82642,3328,79314,9744,69570,52451,3607,9521,917,61972,3074,3005,2178,15881,7353
TGGACGAGAATATTCG,sample,109889,109255,4736,104519,12806,91713,68098,4086,11482,1368,79580,6679,3710,1889,26021,9391
AATCCGTCAATATTCG,sample,80499,79999,2810,77189,9369,67820,54497,3925,6425,1047,60922,1926,2351,2222,13308,7080
CGTACGTCAATATTCG,sample,54985,54306,6157,48149,4519,43630,14398,922,14873,1377,29271,12060,5985,1581,1951,2587
CTAGGACCAATATTCG,sample,64679,64166,2704,61462,5768,55694,35627,1999,13094,1396,48721,3578,2701,1807,9772,4204
CGGATTACAATATTCG,sample,79351,78791,4216,74575,9425,65150,46069,2744,10340,1189,56409,4808,3039,1532,19690,6860
GTTAGGACAATATTCG,sample,80479,79908,4250,75658,9239,66419,46405,2902,9936,1238,56341,5938,4103,2035,14485,6621
AACTCGTAAATATTCG,sample,70996,70485,3053,67432,8628,58804,45282,2567,6894,820,52176,3241,2450,1385,16392,6656
CGTATGAAAATATTCG,sample,142265,141123,10373,130750,10769,119981,60984,4235,30173,3139,91157,21450,7413,1909,18407,7402
ACCAATGCAATATTCG,sample,87336,86748,3658,83090,6993,76097,56935,3416,10451,1528,67386,3767,3242,2410,13534,5349
AAGAGCGCAATATTCG,sample,59187,58739,3723,55016,4494,50522,25787,1871,15151,1517,40938,6196,3816,1652,6531,3021
CCAATTCCAATATTCG,sample,40305,40008,2124,37884,5017,32867,22557,1655,5416,699,27973,2540,2833,1589,6784,3671
GTACCGTAAATATTCG,Pos_Ctrl,54977,54320,2733,51587,2003,49584,41450,4080,2831,366,44281,857,5175,6045,3002,709
ATGACCGAAATATTCG,sample,118708,118034,4440,113594,15131,98463,68401,5660,13806,1631,82207,8965,4647,1905,20816,10515
TATCAGTTAGTCTCCG,sample,72800,72480,3125,69355,12407,56948,37788,2465,9847,1127,47635,5721,4151,1961,12878,8468
ATTCTCTTAGTCTCCG,sample,20651,20521,1625,18896,2514,16382,8812,681,3990,408,12802,2491,2541,1102,2871,1716
TTCTAATGAGTCTCCG,sample,96028,95577,3900,91677,12597,79080,60941,3488,8915,1202,69856,4534,4224,3026,17833,9521
CAACCGCGAGTCTCCG,sample,94076,93653,3292,90361,11832,78529,62431,4962,7328,816,69759,2992,3486,2710,15750,9258
TTAGAAGTAGTCTCCG,sample,114786,114153,7501,106652,11814,94838,52225,2817,20999,2515,73224,16282,6907,1859,22254,8260
GCCTTGCTAGTCTCCG,sample,92764,92300,2721,89579,13599,75980,58383,5186,7890,691,66273,3830,2658,1690,20477,9907
GGAGGACGAGTCTCCG,sample,14419,14306,1215,13091,1715,11376,5619,386,3314,416,8933,1641,2070,917,1467,1071
GGACGTAGAGTCTCCG,sample,121586,121152,2958,118194,15962,102232,88326,6032,5407,689,93733,1778,1962,2020,26523,12114
GGCCAGAGAGTCTCCG,sample,34786,34469,3039,31430,8110,23320,9069,728,7274,679,16343,5570,3437,851,3444,5121
CCATGAAGAGTCTCCG,sample,103987,103435,4151,99284,12137,87147,57246,4275,15441,1831,72687,8354,4655,1826,17975,8374
TTGGTACCAGTCTCCG,sample,121314,120747,3084,117663,13234,104429,90147,7067,5764,646,95911,805,1324,1600,29137,10286
CTAGGACCAGTCTCCG,sample,75878,75500,2038,73462,7827,65635,53708,3243,6009,792,59717,1883,2629,2362,11321,5414
AATATATCAGTCTCCG,sample,54468,54079,1781,52298,5058,47240,30012,2095,10633,1252,40645,3248,2836,2096,1891,3207
GTCTTAGCAGTCTCCG,sample,87295,86732,4445,82287,8330,73957,48063,2980,13168,1504,61231,8242,4802,2254,11732,5776
TTGGTTAAAGTCTCCG,sample,105058,104387,7491,96896,7612,89284,47521,3563,21498,2670,69019,14032,6642,2204,10215,4910
TTATTCGAAGTCTCCG,sample,130080,129405,5924,123481,11161,112320,76723,5866,18271,2500,94994,8960,5036,2545,15771,8210
ATGACCGAAGTCTCCG,sample,102436,101970,2619,99351,11189,88162,68799,5561,9244,1032,78043,3526,2826,1874,17732,7511
GGTTGCGTTGCCTACG,sample,79249,78795,2675,76120,10963,65157,54871,3921,4259,412,59130,1694,1753,1690,21719,8112
TCCTCCGTTGCCTACG,sample,59187,58800,3248,55552,5678,49874,34843,2385,7962,796,42805,3888,3352,2243,8287,4284
TCGCATCTTGCCTACG,sample,12462,12324,1637,10687,947,9740,4680,268,2638,325,7318,1829,1817,653,1753,589
CATAACCTTGCCTACG,sample,29804,29584,1278,28306,4548,23758,17463,1355,2904,460,20367,1576,2176,1552,3660,3057
GGACGTAGTGCCTACG,sample,43081,42882,2445,40437,6235,34202,21525,1493,6621,993,28146,3570,3402,1686,5390,4312
CCATGAAGTGCCTACG,sample,73640,73136,5319,67817,7726,60091,40302,2571,9958,999,50260,6261,4283,1523,16052,5546
CATGATTCTGCCTACG,sample,54274,53786,5016,48770,4731,44039,20089,1119,12507,1248,32596,9076,5073,1437,6756,3038
GTCCTGCCTGCCTACG,sample,25907,25700,928,24772,2431,22341,16603,1018,2858,318,19461,1544,2354,1956,1365,1637
TTGGTACCTGCCTACG,sample,74063,73586,5049,68537,6752,61785,40030,2377,11444,1219,51474,6715,4078,1505,15478,4621
CGTATGAATGCCTACG,sample,71361,70905,3158,67747,7087,60660,48137,3553,5383,657,53520,2930,2932,1806,12146,5295
TGCTTCGCTGCCTACG,sample,32308,32007,3485,28522,2923,25599,9235,478,8277,939,17512,6670,3748,1018,2088,1848
TTGGTTAATGCCTACG,sample,71167,70850,2967,67883,8445,59438,47826,3168,5205,513,53031,2726,1785,1320,16400,5896
GTACCGTATGCCTACG,sample,99426,98967,3997,94970,8004,86966,67126,4796,9279,1160,76405,4605,3364,2090,16252,6418
GGCATATATGCCTACG,Neg_Ctrl,282,182,117,65,2,63,56,4,1,0,57,2,27,24,12,6
AAGTTCGTCTTAGTTC,sample,120745,120060,5114,114946,15518,99428,71495,4652,15628,1995,87123,5658,3647,2500,23537,11016
ACGTAAGTCTTAGTTC,sample,102734,102075,5576,96499,16845,79654,52307,3888,13537,1407,65844,8515,4523,1907,16345,12187
ACGTTATGCTTAGTTC,sample,117086,116178,5992,110186,11759,98427,64526,3243,21227,2683,85753,6748,4019,2067,20877,7588
TGAGCGCGCTTAGTTC,sample,36938,36652,2793,33859,4303,29556,18535,1247,6068,669,24603,3037,2982,1669,5647,2952
CTTGATAGCTTAGTTC,sample,190033,189107,5205,183902,22733,161169,134740,8936,12606,1352,147346,3535,2245,1891,47528,16745
GACGATAACTTAGTTC,sample,162343,161353,8026,153327,19348,133979,92789,5726,20536,2774,113325,12154,5333,2026,34243,13826
ACGACTTCCTTAGTTC,sample,131574,130802,6246,124556,16125,108431,79778,5508,15038,1798,94816,6309,4323,2459,22901,12816
CGTACGTCCTTAGTTC,sample,147839,147109,4252,142857,23332,119525,103908,5591,7909,958,111817,1159,1562,1691,40858,17689
TTGGTACCCTTAGTTC,sample,113809,113115,4450,108665,7571,101094,60121,3958,26305,3021,86426,7689,3823,2055,8029,5256
AACTCGTACTTAGTTC,sample,174428,173439,8983,164456,17152,147304,106347,6696,19515,2920,125862,11826,5138,2024,38906,12844
AATATATCCTTAGTTC,sample,63028,62659,3013,59646,14835,44811,33379,2267,5382,555,38761,3228,2520,1594,11927,10212
GAAGGCGCCTTAGTTC,sample,119095,118305,6785,111520,11269,100251,63347,5489,19267,2464,82614,9684,5305,2260,15087,7578
CCAATTCCCTTAGTTC,sample,82304,81818,3007,78811,12434,66377,52509,3593,6322,1227,58831,2726,2158,1335,20445,9186
TATCAGTTCGAGCTTC,sample,142916,142233,5177,137056,23502,113554,86205,6545,13240,1411,99445,6153,4558,2817,26506,16453
GGTTGCGTCGAGCTTC,sample,102004,101247,7764,93483,12346,81137,40739,2722,20659,2269,61398,14748,6013,1530,12092,7683
TTCGTAATCGAGCTTC,sample,120874,120133,5745,114388,12559,101829,65980,4305,19922,2496,85902,9126,4025,1673,21487,9215
TGAGCGCGCGAGCTTC,sample,94428,93802,3435,90367,10602,79765,63288,4875,7269,746,70557,3587,3207,2193,16406,7816
TCGCATCTCGAGCTTC,sample,97810,97293,3422,93871,15166,78705,56590,3115,12621,1219,69211,5160,3887,1903,21152,10853
CAAGGCCTCGAGCTTC,sample,142420,141686,4797,136889,19506,117383,93803,5847,11364,1222,105167,5147,3840,2668,26892,14426
ACTATACTCGAGCTTC,sample,116573,115685,5664,110021,18341,91680,58090,5193,16140,2433,74230,9824,5173,1819,13949,12899
GACGGAGACGAGCTTC,sample,113938,113180,5579,107601,14552,93049,62975,4781,15779,1852,78754,7662,5195,2882,19287,10319
CCAGAGCGCGAGCTTC,sample,101206,100584,5852,94732,14048,80684,52181,3951,15035,1655,67216,7862,5939,3049,17581,10319
TGGACGAGCGAGCTTC,sample,74496,73893,4974,68919,7603,61316,29856,2601,17096,1648,46952,10115,5197,1638,6192,5285
GGCCAGAGCGAGCTTC,sample,75051,74426,3781,70645,10048,60597,39572,3230,10606,1266,50178,5923,4189,2033,7491,7817
CATTGCAGCGAGCTTC,sample,88759,87994,7844,80150,9661,70489,30978,2405,20517,2278,51495,14311,6701,2009,6973,6414
CATGATTCCGAGCTTC,sample,117987,117180,3825,113355,10982,102373,76933,5471,14093,2113,91026,3763,3419,2974,14836,8374
CGTACGTCCGAGCTTC,sample,108539,107845,5237,102608,13528,89080,66769,3388,11583,1423,78352,5917,3943,1834,25113,9772
TTGGTACCCGAGCTTC,sample,55841,55396,4719,50677,5228,45449,27504,1632,9011,1167,36515,6135,3964,1597,9742,3522
CTAGGACCCGAGCTTC,sample,91155,90412,4949,85463,11733,73730,49087,3575,11803,1399,60890,7866,5041,2327,14010,8810
CGGATTACCGAGCTTC,sample,48693,48205,2375,45830,4065,41765,23815,1679,10771,1478,34586,4022,3418,1891,2423,2911
GTTAGGACCGAGCTTC,sample,101663,101002,3875,97127,8667,88460,63575,4295,14698,1674,78273,4218,2844,2029,19021,5802
AACTCGTACGAGCTTC,sample,182655,181285,15678,165607,13594,152013,61944,3833,45794,4888,107738,35554,10023,2367,17411,8223
TTGGCCTCCGAGCTTC,sample,109208,108535,5941,102594,12667,89927,60855,3593,15153,1454,76008,8872,4638,1805,20873,9550
ACCAATGCCGAGCTTC,sample,143228,142432,6640,135792,14506,121286,89240,7599,14144,1774,103384,8529,4229,1836,27285,10054
GAAGGCGCCGAGCTTC,sample,85167,84510,5579,78931,6324,72607,47041,3564,12173,1802,59214,8027,5127,2258,11041,4232
CCAATTCCCGAGCTTC,sample,94843,94237,3222,91015,10559,80456,66752,4588,5524,611,72276,2981,2766,2125,15453,8085
GGCATATACGAGCTTC,sample,133579,132900,4246,128654,14296,114358,97813,6192,6663,790,104476,2900,2258,2069,24685,11081
CTTCATGACGAGCTTC,sample,161418,160598,9074,151524,12691,138833,75244,4458,32990,3624,108234,22517,8234,2002,28892,8524
GGAGAGTTGTAGAATG,sample,103433,102776,7931,94845,9915,84930,30493,2081,27860,2912,58353,21584,7927,1988,5094,6174
ATTCTCTTGTAGAATG,Pos_Ctrl,49076,48654,2438,46216,1753,44463,37700,3244,2454,313,40154,752,5118,5611,3596,658
GGTTGCGTGTAGAATG,sample,145481,144637,9922,134715,20148,114567,78873,5535,17454,2191,96327,10514,5450,1941,23889,14309
ACGTAAGTGTAGAATG,sample,108826,108197,5544,102653,12279,90374,56504,4394,17756,2530,74260,9190,4326,1673,19788,9001
TTCGTAATGTAGAATG,sample,71924,71223,4405,66818,12411,54407,36764,2369,9574,1224,46338,4476,3459,1809,14353,8291
ACGTTATGGTAGAATG,sample,40809,40464,3547,36917,4603,32314,20128,1113,6689,745,26817,3639,3227,1342,8701,3221
TAGTACGGGTAGAATG,sample,110896,110268,5038,105230,12318,92912,70686,4491,10723,1148,81409,5864,3465,1895,20657,8947
AATGGTAAGTAGAATG,sample,147930,147054,10223,136831,13670,123161,75216,4868,23182,2681,98398,17214,6986,2049,26819,9249
TTAGAAGTGTAGAATG,sample,58387,57816,4826,52990,8152,44838,17678,1348,14040,1630,31718,10142,5162,1706,3034,5497
GGACCTCTGTAGAATG,Pos_Ctrl,37610,37129,2308,34821,1444,33377,27941,2741,1870,223,29811,602,4591,4834,2669,554
CATAACCTGTAGAATG,sample,136916,136134,6782,129352,14823,114529,80889,5403,16417,1780,97306,10040,5102,2208,27303,10571
CCGCAACGGTAGAATG,sample,71918,71343,6072,65271,7104,58167,34334,1988,12500,1393,46834,7952,4950,1646,13219,5072
GGACGTAGGTAGAATG,sample,113009,112474,5247,107227,13182,94045,72446,4629,9788,1092,82234,6090,3503,1925,28765,9554
CGAGGCAGGTAGAATG,Pos_Ctrl,43065,42504,2059,40445,1614,38831,32535,3312,1980,274,34515,730,4755,5274,2634,508
CCATGAAGGTAGAATG,sample,73318,72811,4182,68629,5461,63168,30404,1939,20434,2576,50838,7815,3687,1759,4492,3815
AATCCGTCGTAGAATG,sample,14561,14436,820,13616,3205,10411,7276,433,1691,227,8967,784,1614,1030,2419,2163
CGTATGAAGTAGAATG,sample,78618,77910,4367,73543,9404,64139,38351,2255,13112,1308,51463,9113,4931,2227,5506,6689
TTGGCCTCGTAGAATG,sample,71828,71320,4049,67271,7422,59849,38044,2688,11643,1107,49687,6367,4860,2406,10037,5362
ACCAATGCGTAGAATG,Pos_Ctrl,20886,20776,497,20279,6503,13776,10677,1026,1543,179,12220,351,2357,2248,1638,4057
GACCGGAAGTAGAATG,sample,3810,3751,206,3545,535,3010,1353,163,930,101,2283,463,715,351,225,316
TATCAGTTCAATAGTC,sample,57870,57634,2795,54839,8713,46126,31638,2102,7799,866,39437,3721,3308,1792,11869,6130
AAGTTCGTCAATAGTC,sample,7150,7086,889,6197,731,5466,1994,152,1858,226,3852,1236,1378,470,421,436
CCTCTAGACAATAGTC,sample,46437,46185,1693,44492,7296,37196,27091,1822,5527,682,32618,2074,2597,1794,10115,5226
AGTACCATCAATAGTC,sample,98828,98426,2968,95458,16371,79087,64819,3718,6750,982,71569,2818,2309,1725,28185,12179
TTCGTAATCAATAGTC,sample,23859,23715,1294,22421,3465,18956,11216,726,4439,508,15655,2067,2682,1528,1961,2371
ACGTTATGCAATAGTC,sample,55134,54869,2381,52488,9064,43424,33151,2236,4443,527,37594,3067,3385,2393,10295,6704
TGAGCGCGCAATAGTC,sample,63659,63281,3278,60003,8097,51906,34251,1923,9056,1091,43307,5585,3682,1526,11020,6166
TTCCGTCTCAATAGTC,sample,88602,88069,4585,83484,9517,73967,48079,3199,13284,1253,61363,8152,4238,1468,18816,6701
GGACCTCTCAATAGTC,sample,54709,54431,1443,52988,7701,45287,37425,2668,3662,391,41087,1141,2143,2090,6316,5484
GGACGTAGCAATAGTC,sample,62864,62569,3010,59559,6199,53360,32798,2470,11512,1181,44310,5399,3991,2006,8739,4316
CTTGATAGCAATAGTC,sample,58218,57876,2362,55514,6826,48688,34863,2617,7623,737,42486,2848,3145,2216,8508,4815
GACGATAACAATAGTC,sample,49197,48917,2605,46312,6458,39854,27310,2038,6308,627,33618,3571,3117,1684,7956,4953
CGTACGTCCAATAGTC,sample,52044,51608,2596,49012,3813,45199,24619,1412,13659,1354,38278,4155,2837,1495,2770,2445
GCCTGAACCAATAGTC,sample,72685,72124,5832,66292,6905,59387,28605,1587,15596,1819,44201,11780,5793,1525,11569,4543
AACTCGTACAATAGTC,sample,73092,72638,5229,67409,7627,59782,33821,1715,14580,1678,48401,7988,4441,1400,12802,5434
AATATATCCAATAGTC,sample,43847,43324,5692,37632,2742,34890,13222,833,11437,1218,24659,8180,5201,1755,2036,1573
AAGAGCGCCAATAGTC,sample,35833,35620,1476,34144,3539,30605,23024,1425,4269,469,27293,1418,1991,1421,7732,2708
TCGCCTGACAATAGTC,sample,76446,76069,2440,73629,9881,63748,51365,3265,5860,832,57225,2426,1816,1282,16178,7050
TTATTCGACAATAGTC,sample,56793,56479,3348,53131,5593,47538,28512,1923,9918,1157,38430,6028,4063,1912,5416,3879
GGAGAGTTCGTTACTC,sample,111025,110516,4390,106126,21561,84565,58060,3604,13463,1536,71523,7902,4699,2010,25708,14790
ATTCTCTTCGTTACTC,sample,54948,54617,3500,51117,6595,44522,24428,2002,12440,1528,36868,4124,3551,1756,7646,4821
TCCAACTTCGTTACTC,Neg_Ctrl,1185,869,658,211,39,172,100,9,42,6,142,15,55,37,41,27
CCTCTAGACGTTACTC,sample,99413,98627,5127,93500,10076,83424,51053,2921,19643,2684,70696,7123,3487,1973,17985,7491
CAACCGCGCGTTACTC,sample,113675,112992,5166,107826,12923,94903,62859,4133,18166,2625,81025,7120,3918,2171,20386,10334
TTCCGTCTCGTTACTC,sample,119880,119160,5413,113747,15953,97794,72404,5116,13035,1566,85439,5673,4385,2982,20895,12243
TCGCATCTCGTTACTC,Neg_Ctrl,422,226,83,143,24,119,65,15,9,2,74,28,40,24,29,7
GTTAGCCGCGTTACTC,sample,154228,152983,12833,140150,17503,122647,54700,3772,35245,3641,89945,25289,8710,2042,16745,11639
GGAGGACGCGTTACTC,sample,116342,115436,6707,108729,17447,91282,58681,3440,18002,2081,76683,9078,4868,1917,17589,11674
CTTGATAGCGTTACTC,sample,39860,39545,2915,36630,3478,33152,18899,1223,7625,942,26524,4463,3377,1504,6481,2360
ACCTCGAGCGTTACTC,sample,134545,133672,6176,127496,15440,112056,82227,6212,14377,1790,96604,7450,4567,2991,17825,12012
TGGACGAGCGTTACTC,sample,171608,170657,8201,162456,25636,136820,97548,7374,17692,2162,115240,12044,4268,1862,32917,18060
GACGATAACGTTACTC,sample,113707,112980,5004,107976,18484,89492,58337,4499,15921,1627,74258,9108,4805,1879,12048,12967
CCATGAAGCGTTACTC,Neg_Ctrl,541,284,142,142,13,129,81,5,21,6,102,16,48,29,35,5
GTCCTGCCCGTTACTC,sample,92477,91838,5637,86201,12543,73658,50650,3374,12030,1375,62680,6229,4682,2549,15517,9641
CTAGGACCCGTTACTC,sample,105291,104532,6125,98407,13245,85162,58632,5497,12519,1620,71151,6894,4970,2979,10780,9452
AACTCGTACGTTACTC,sample,124698,123934,7155,116779,16010,100769,69557,5320,14297,1647,83854,9948,5014,1963,26597,11165
CGTATGAACGTTACTC,sample,147386,146178,9645,136533,11404,125129,59265,3897,37186,4738,96451,20043,5613,1898,12279,7382
TGCTTCGCCGTTACTC,Neg_Ctrl,514,314,110,204,20,184,113,13,36,10,149,12,75,45,36,11
GTACCGTACGTTACTC,sample,180126,179202,6855,172347,18457,153890,118335,9674,16674,2166,135009,7041,4075,2224,29682,13326
TTATTCGACGTTACTC,sample,236559,235230,14858,220372,20205,200167,103691,8208,48972,4572,152663,34724,10099,2365,36961,12790
GACCGGAACGTTACTC,sample,86611,86219,2595,83624,12605,71019,57638,4391,6326,603,63964,2061,2278,1853,18979,9033
ATTCTCTTTGGACTGC,sample,95216,94491,8855,85636,8672,76964,28848,2135,24324,2629,53172,19028,7900,2044,8229,5526
TCCAACTTTGGACTGC,sample,47115,46810,2739,44071,5615,38456,21781,1579,9730,1151,31511,4215,3798,2170,2583,3661
AAGTTCGTTGGACTGC,sample,75068,74584,4076,70508,8554,61954,34280,1906,15032,1542,49312,9194,4644,1654,12262,6288
GGTTGCGTTGGACTGC,sample,35418,35250,1356,33894,6768,27126,20918,1434,3449,325,24367,1000,1923,1498,7526,4866
ATGCCTGGTGGACTGC,sample,65016,64594,5184,59410,5315,54095,31561,1931,11057,1305,42618,8241,4301,1541,9256,3510
TGAGCGCGTGGACTGC,sample,66326,65955,3293,62662,7819,54843,38385,2008,9491,894,47876,4065,3088,1516,13854,5955
AATGGTAATGGACTGC,sample,63476,63050,3667,59383,10192,49191,34028,2323,7915,1022,41943,3903,3420,1741,11116,7649
TTAGAAGTTGGACTGC,sample,76717,76157,3599,72558,9690,62868,44210,2948,9587,1171,53797,4952,4547,2693,8352,6965
GGACCTCTTGGACTGC,sample,88059,87431,4198,83233,13579,69654,47848,3234,11417,1065,59265,6090,3341,1477,14964,9995
GCCTTGCTTGGACTGC,sample,45567,45288,1966,43322,6745,36577,28683,2273,3757,352,32440,1512,2654,2276,8748,5161
GGACGTAGTGGACTGC,sample,95079,94469,4589,89880,9360,80520,59537,4226,10065,1354,69602,5338,4256,2116,18797,7182
GGCCAGAGTGGACTGC,sample,34544,34312,1446,32866,5206,27660,20899,1623,3488,480,24387,1170,1981,1416,6922,3841
CCATGAAGTGGACTGC,sample,77706,77143,3702,73441,9476,63965,46071,3317,9346,1121,55417,4110,3303,1925,12488,6812
AATCCGTCTGGACTGC,sample,100155,99375,5905,93470,10861,82609,56198,3845,13944,1475,70142,7147,4321,2092,16974,8112
TTGGTACCTGGACTGC,sample,99675,99121,3822,95299,12562,82737,65279,4808,8459,1006,73738,3185,3440,2579,19444,9531
CGGATTACTGGACTGC,sample,103110,102496,4576,97920,13253,84667,60958,4453,11740,1191,72698,6325,3824,1679,21686,9846
GCCTGAACTGGACTGC,sample,81182,80637,5019,75618,7467,68151,42502,2976,12867,1411,55369,8395,4625,1812,13267,5724
ACGTATTATGGACTGC,sample,109035,108458,4195,104263,13619,90644,69649,4896,10124,1755,79773,4220,2771,1393,28189,9834
GTCTTAGCTGGACTGC,sample,88109,87504,6118,81386,7992,73394,37586,2939,16733,1779,54319,14357,6211,1961,10342,5071
GTACCGTATGGACTGC,sample,52635,52291,2848,49443,4701,44742,28558,2083,8711,1079,37269,4311,3811,2321,5166,3454
GGCATATATGGACTGC,sample,33584,33352,1595,31757,4537,27220,16725,1216,4868,823,21593,3588,2566,1190,2430,3133
TCAATATATGGACTGC,sample,151240,150251,7344,142907,11572,131335,99057,6478,13519,1637,112576,10644,4896,2540,20254,7407
TCGCCTGATGGACTGC,sample,39212,38947,2139,36808,4985,31823,20949,1196,5898,667,26847,3113,3060,1611,6731,3392
AGGTCGGATGGACTGC,sample,94790,93999,7009,86990,8631,78359,42784,2617,18132,1881,60916,12945,6205,1849,10343,5673
GGTTGCGTCCTTGAGC,sample,147761,147049,7816,139233,24822,114411,88908,5435,11670,1325,100578,7073,4258,2530,31462,18111
TTCGTAATCCTTGAGC,Pos_Ctrl,61868,61289,3315,57974,2348,55626,46897,4568,2857,349,49754,955,5307,6340,3453,823
ACGTTATGCCTTGAGC,sample,101213,100555,5027,95528,12706,82822,56044,3411,15535,2052,71579,5780,3535,1850,22983,9019
TGAGCGCGCCTTGAGC,sample,116257,115316,11279,104037,9902,94135,43298,2589,29652,3615,72950,14981,7642,2667,10901,6777
TTCCGTCTCCTTGAGC,sample,163235,162440,5964,156476,22446,134030,104566,6101,14785,1737,119351,6841,3956,2084,39967,16351
GTTAGCCGCCTTGAGC,Pos_Ctrl,31757,31501,1947,29554,1367,28187,23856,2317,1368,180,25224,466,4179,4431,2693,569
GACGATAACCTTGAGC,sample,108571,107947,6367,101580,11311,90269,62951,4257,13914,1454,76865,7693,5452,2840,17298,7862
CATGATTCCCTTGAGC,sample,147629,146469,9022,137447,11901,125546,78731,5213,26053,2907,104784,12642,5522,2753,20872,8323
TTGGTACCCCTTGAGC,Pos_Ctrl,41493,41007,2564,38443,1621,36822,30871,3069,1946,186,32817,750,4738,5243,2162,625
CGGATTACCCTTGAGC,sample,153865,152582,13242,139340,16338,123002,55148,3335,35216,3464,90364,25839,8547,1996,16410,11168
GCCTGAACCCTTGAGC,sample,154277,153223,7963,145260,15435,129825,94100,6901,16399,2192,110499,10233,4876,2554,21410,11749
AACTCGTACCTTGAGC,sample,154154,153191,8845,144346,14035,130311,88359,4988,20235,2483,108594,14246,6079,2435,24285,9942
TGCTTCGCCCTTGAGC,sample,86234,85683,4727,80956,9502,71454,50457,3813,9720,979,60177,6485,4068,2217,13484,6573
AGGTCGGACCTTGAGC,Pos_Ctrl,44833,44465,2461,42004,1601,40403,34270,3203,2043,287,36313,600,4932,5788,2454,634
TTATTCGACCTTGAGC,sample,142908,141929,9627,132302,11739,120563,76780,5205,22012,2426,98792,14140,6997,2606,16617,8439
ATGACCGACCTTGAGC,sample,132997,132356,5314,127042,17790,109252,75494,4955,20031,1916,95525,6856,3526,1717,25773,12301
GGAGAGTTCGATATCC,sample,9657,9603,305,9298,1060,8238,4756,507,2131,263,6887,581,1773,1255,383,677
ATTCTCTTCGATATCC,sample,150926,150444,4837,145607,25785,119822,90094,6273,13799,1702,103893,7954,5054,2331,31330,17434
ACGTAAGTCGATATCC,sample,91403,91050,4046,87004,19678,67326,49875,3082,8660,1019,58535,4690,3899,2296,18261,13202
TAGTACGGCGATATCC,sample,117218,116699,6503,110196,17032,93164,64629,3531,14641,1454,79270,8909,4682,1701,31682,12325
TTAGAAGTCGATATCC,sample,151371,150658,5701,144957,19525,125432,89021,6211,20685,3090,109706,6425,3915,2643,25621,15528
GGACCTCTCGATATCC,sample,160838,160134,6314,153820,23980,129840,96473,6681,17039,2404,113512,7243,3721,2209,33689,17917
GCCTTGCTCGATATCC,sample,31813,31619,1329,30290,4643,25647,20545,1412,2790,266,23335,634,1618,1419,6738,3623
CCAGAGCGCGATATCC,sample,145374,144752,4474,140278,19038,121240,95717,7931,11582,1323,107299,4687,3613,2410,29295,13881
CTTGATAGCGATATCC,sample,148652,147911,6907,141004,18550,122454,88550,5877,17003,1965,105553,9059,4720,2127,33770,13739
GACGATAACGATATCC,sample,168798,168030,6764,161266,20243,141023,110247,7033,14642,1913,124889,7188,4533,2758,32814,14031
CATTGCAGCGATATCC,sample,49459,49178,2061,47117,6117,41000,31110,2273,5194,642,36304,1781,3042,2544,7285,4350
AATCCGTCCGATATCC,sample,60675,60297,2306,57991,10256,47735,39316,3231,3531,492,42847,1165,2107,1986,12861,7604
CGTACGTCCGATATCC,sample,70699,70216,4006,66210,9522,56688,35396,2318,11724,1225,47120,6025,4161,1816,11030,6513
AGTCCGCACGATATCC,sample,169813,168700,9522,159178,13468,145710,96977,6999,26010,3220,122987,12504,6377,3356,16226,9835
CTAGGACCCGATATCC,sample,38627,38387,1697,36690,5388,31302,14734,1043,9111,964,23845,5450,4543,1979,1905,3731
GTTAGGACCGATATCC,sample,155664,154834,6861,147973,16984,130989,93801,6494,17677,2415,111478,10602,5249,2361,27953,11985
GCCTGAACCGATATCC,sample,99479,98780,5259,93521,8961,84560,51193,3544,18421,2507,69614,8895,4557,1920,10784,5809
TTGGCCTCCGATATCC,sample,65236,64806,4724,60082,7234,52848,32220,2158,10112,1042,42332,7316,4355,1472,10100,4962
TGCTTCGCCGATATCC,sample,68292,67963,2280,65683,8814,56869,47337,3593,3746,602,51083,1591,2574,2569,10461,6426
TCAATATACGATATCC,sample,145520,144219,17676,126543,7325,119218,45119,2756,40979,4695,86098,25669,9602,2912,7496,3993
TTATTCGACGATATCC,sample,139069,138308,6557,131751,13123,118628,82038,5991,17471,1952,99509,11176,5799,2808,16211,8814
TATCAGTTATCTGACC,sample,54275,53998,3176,50822,7034,43788,29070,2094,7417,928,36487,4279,3771,2076,8330,4746
GGTTGCGTATCTGACC,sample,49818,49502,2594,46908,7235,39673,25972,2011,7461,871,33433,3358,2474,1529,6949,5022
ACGTAAGTATCTGACC,sample,19892,19802,514,19288,4657,14631,10937,928,1890,147,12827,729,1475,1135,4434,3087
ACGTTATGATCTGACC,Neg_Ctrl,356,193,95,98,20,78,54,2,16,2,70,4,36,20,23,5
GGACCTCTATCTGACC,sample,88029,87464,5186,82278,9531,72747,48707,2523,11624,1220,60331,8673,4590,1596,19793,6998
GGAGGACGATCTGACC,Neg_Ctrl,276,160,79,81,17,64,39,3,15,0,54,7,36,16,8,6
GGACGTAGATCTGACC,sample,21791,21670,1153,20517,3298,17219,12732,886,2463,270,15195,868,1581,995,5672,2343
CTTGATAGATCTGACC,sample,54897,54568,2750,51818,8184,43634,31421,2115,5657,733,37078,3708,3031,1539,11525,5855
GACGATAAATCTGACC,sample,69426,69010,3204,65806,8185,57621,38236,2711,10989,1280,49225,4405,3458,1958,9551,6269
CGAGGCAGATCTGACC,sample,60032,59636,3361,56275,6607,49668,36060,2026,7489,922,43549,3171,2730,1721,10474,4574
AATCCGTCATCTGACC,sample,33231,32993,2392,30601,3096,27505,17451,1191,5527,683,22978,2653,2724,1608,5003,2054
CTAGGACCATCTGACC,Neg_Ctrl,332,197,93,104,18,86,50,6,19,0,69,11,38,24,16,13
AACTCGTAATCTGACC,sample,82864,82309,6570,75739,8367,67372,33600,2249,17238,1726,50838,12559,5508,1674,8281,5423
ACCAATGCATCTGACC,sample,83815,83307,4529,78778,8502,70276,49586,3110,10273,1322,59859,5985,3777,1886,15564,5973
GAAGGCGCATCTGACC,sample,65191,64744,4791,59953,5747,54206,30589,1835,13012,1271,43601,7499,4370,1304,11241,4011
AAGAGCGCATCTGACC,sample,45099,44810,1242,43568,4422,39146,32156,2536,2728,399,34884,1327,2664,2656,4071,3112
TTGGTTAAATCTGACC,sample,85242,84428,10435,73993,4543,69450,16961,1272,26262,2688,43223,22267,8011,1821,1885,2020
GGCATATAATCTGACC,sample,83456,83047,3986,79061,7785,71276,51091,3858,8923,923,60014,6481,4629,2441,11412,5424
TTATTCGAATCTGACC,Neg_Ctrl,313,211,45,166,27,139,93,4,28,4,121,10,63,38,25,10
GACCGGAAATCTGACC,sample,56497,56192,4558,51634,6069,45565,18204,1171,13800,1608,32004,10782,4908,1197,4730,4041
ACGTAAGTCTTCTTAC,sample,123249,122594,8242,114352,16785,97567,66134,4316,15558,1630,81692,9929,5257,2558,20425,11620
CCTCTAGACTTCTTAC,sample,120422,119467,8600,110867,13328,97539,55503,3165,20941,2622,76444,15308,6320,2134,18325,9266
ATGCCTGGCTTCTTAC,sample,67857,67413,5266,62147,11749,50398,27170,1839,12109,1291,39279,7989,4743,1698,9098,7529
TAGTACGGCTTCTTAC,sample,132692,131915,7497,124418,16749,107669,76537,4267,15562,1395,92099,9908,5024,2008,31624,12274
CAACCGCGCTTCTTAC,sample,68175,67738,3049,64689,9175,55514,41397,2696,6926,661,48323,3834,3596,2167,13777,6567
AATGGTAACTTCTTAC,sample,23214,23054,1385,21669,5969,15700,10183,942,2628,351,12811,1596,2293,1486,2327,3780
TTAGAAGTCTTCTTAC,sample,160846,159908,12407,147501,20457,127044,75165,4292,26499,2528,101664,18560,7366,1885,34238,14394
GCCTTGCTCTTCTTAC,sample,63515,63063,5042,58021,7672,50349,27268,1834,12318,1638,39586,7291,4296,1730,5667,5029
CAAGGCCTCTTCTTAC,sample,22076,21896,1181,20715,5472,15243,10528,595,2693,287,13221,1140,1806,1180,3195,3556
CTTGATAGCTTCTTAC,sample,147085,146167,6424,139743,13868,125875,84322,4946,25499,2648,109821,8460,3752,2217,23332,9843
GGCCAGAGCTTCTTAC,sample,159826,158830,15090,143740,11751,131989,69883,4583,34912,3978,104795,18633,8453,2523,19507,7615
CGTACGTCCTTCTTAC,sample,119713,119021,6261,112760,17132,95628,61846,4172,17462,1829,79308,10319,4915,1739,22476,12192
GCCTGAACCTTCTTAC,sample,190323,188789,16569,172220,10428,161792,76039,5406,52726,6200,128765,21421,8619,2994,15739,5937
CGTATGAACTTCTTAC,sample,121998,121032,10639,110393,11439,98954,51077,2545,24806,2965,75883,17561,7098,1849,20563,7441
GAAGGCGCCTTCTTAC,sample,61676,61232,2672,58560,2781,55779,38011,2845,9836,1147,47847,3940,3769,2851,405,1528
TTATTCGACTTCTTAC,sample,94481,93942,3758,90184,10854,79330,57305,4419,10385,1712,67690,5509,3981,2265,13217,7631
TATCAGTTACTTCTAC,sample,79170,78685,4578,74107,11997,62110,38025,2612,12570,1328,50595,7575,4259,1632,15251,8484
TAGTACGGACTTCTAC,sample,88802,88379,2545,85834,13160,72674,63387,4260,4015,307,67402,705,1296,1604,23572,10297
CATAACCTACTTCTAC,sample,40796,40547,2068,38479,4304,34175,24349,1659,5321,587,29670,2259,3016,2224,4641,3232
GACGATAAACTTCTAC,sample,89058,88568,5128,83440,8436,75004,45962,3120,14760,1839,60722,9323,5102,1796,16186,6375
GGCCAGAGACTTCTAC,sample,37436,37068,3293,33775,3490,30285,14255,1080,8565,1088,22820,5297,3407,1254,3710,2213
GTCCTGCCACTTCTAC,sample,94408,93756,5935,87821,7996,79825,54045,3611,13808,1433,67853,6928,4367,1859,15080,6002
CTAGGACCACTTCTAC,sample,44391,43975,2682,41293,5132,36161,20706,1546,8000,838,28706,5071,3956,2117,2321,3308
AATATATCACTTCTAC,sample,93196,92517,5979,86538,9109,77429,49717,2827,13742,1796,63459,9347,4737,1659,17406,6256
GAAGGCGCACTTCTAC,sample,114381,113725,7803,105922,9375,96547,62556,5232,15464,1727,78020,11568,5934,2041,16996,6285
TTGGTTAAACTTCTAC,sample,101353,100667,6786,93881,7932,85949,55006,3399,15812,1657,70818,10075,4931,1899,13504,5578
GTACCGTAACTTCTAC,sample,89050,88601,2149,86452,8428,78024,68023,5565,2713,664,70736,1059,2084,2478,14813,6429
TTATTCGAACTTCTAC,sample,68283,67848,5312,62536,5834,56702,27634,2194,14609,1813,42243,10452,5469,1801,6465,3708
ATGACCGAACTTCTAC,sample,82050,81550,5569,75981,7148,68833,34616,2840,16602,1842,51218,12933,5804,1495,10637,4515
ATTCTCTTAGAAGTAA,sample,135152,134683,2987,131696,21719,109977,88718,7171,10304,1063,99022,2721,2254,1909,29496,16166
TCCTCCGTAGAAGTAA,sample,112277,111717,4665,107052,10460,96592,72961,5464,10637,1124,83598,6406,4816,3256,12134,7331
CCTCTAGAAGAAGTAA,sample,103177,102697,3712,98985,11611,87374,65220,4878,10963,1119,76183,5194,3986,2677,15081,8370
AGTACCATAGAAGTAA,sample,74781,74429,2460,71969,14694,57275,44085,4000,6340,502,50425,2348,2387,1784,11913,10091
TTCTAATGAGAAGTAA,sample,54755,54302,5788,48514,4176,44338,14589,957,16445,1978,31034,10369,5091,1555,1296,2332
ATGCCTGGAGAAGTAA,sample,157891,157234,5594,151640,17600,134040,95993,7262,19120,2275,115113,9390,5627,2648,25580,12291
TGAGCGCGAGAAGTAA,sample,110422,109995,3575,106420,16383,90037,70356,5665,8990,1057,79346,3969,2723,1971,25514,11533
CAACCGCGAGAAGTAA,sample,104595,104069,4060,100009,14390,85619,63671,4383,10610,1313,74281,5642,3400,1538,27704,10899
TTAGAAGTAGAAGTAA,sample,63826,63546,2395,61151,11725,49426,38414,2703,5610,515,44024,2184,2748,1947,14676,8333
GCCTTGCTAGAAGTAA,sample,90990,90479,4148,86331,10847,75484,54002,3824,9917,1585,63919,6156,4819,2814,13817,7488
CAAGGCCTAGAAGTAA,sample,112172,111570,3928,107642,11691,95951,77123,6456,7913,1075,85036,3384,4060,3728,12867,9124
CCAGAGCGAGAAGTAA,sample,136961,136302,6840,129462,19405,110057,74276,5621,18192,1942,92468,10026,4756,1644,31296,13371
GGAGGACGAGAAGTAA,sample,75897,75401,2997,72404,8408,63996,44742,3163,11397,1456,56139,3238,2997,1942,15603,6252
CTTGATAGAGAAGTAA,sample,91893,91321,3342,87979,8742,79237,61859,4598,8800,1014,70659,2966,3643,3250,12627,6719
CATTGCAGAGAAGTAA,sample,118547,117091,18026,99065,8090,90975,33531,2090,28108,3111,61639,24135,9249,1845,10299,4521
CGAGGCAGAGAAGTAA,sample,100841,100265,4688,95577,11731,83846,60653,4640,11611,1348,72264,5594,3858,1842,20874,9080
GCCTGAACAGAAGTAA,sample,153878,152991,5534,147457,15174,132283,100222,6650,14981,2542,115203,7888,3969,2446,24952,11230
GGCATATAAGAAGTAA,sample,152763,151719,10926,140793,13102,127691,69642,4479,30746,3042,100388,19782,7307,1784,22815,9104
Short,Non_sample,0,NA,NA,NA,NA,NA,NA,NA,NA,NA,NA,NA,NA,NA,NA,NA
Unselected,Non_sample,0,NA,NA,NA,NA,NA,NA,NA,NA,NA,NA,NA,NA,NA,NA,NA
Undetermined,Non_sample,153266496,NA,NA,NA,NA,NA,NA,NA,NA,NA,NA,NA,NA,NA,NA,NA
