Barcode,Sample,Barcoded_Reads,Trimmed_Reads,Unmapped_Reads,Mapped_Reads,Multimapped_Reads,Uniquely_Mapped_Reads,Exon_Reads,Ambiguous_Exon_Reads,Intron_Reads,Ambiguous_Intron_Reads,Gene_Reads,Intergenic_Reads,No_of_Genes,No_of_Transcripts,Mitochondrial_Reads,Ribosomal_Reads
GGAGAAGCCGTTGGTT,sample,77865,77077,8748,68329,7596,60733,20321,1383,24523,2969,44844,11537,6492,1822,4814,5198
TCATCGAACGTTGGTT,sample,370,343,43,300,79,221,123,5,44,8,167,41,95,47,54,54
TACGCGAGCGTTGGTT,sample,129,117,27,90,10,80,35,2,33,3,68,7,41,14,14,11
GACTCAAGCGTTGGTT,sample,109,99,18,81,20,61,36,2,18,1,54,4,35,29,11,13
CCGTACGCCGTTGGTT,sample,120,110,20,90,13,77,42,7,17,2,59,9,34,15,17,8
GATGCGTTCGTTGGTT,sample,1079,1025,144,881,210,671,307,39,191,25,498,109,222,103,107,134
ATGGCGTTCGTTGGTT,sample,759,727,123,604,77,527,170,12,190,13,360,142,201,59,58,56
ACGCTTAACGTTGGTT,sample,21785,21533,1628,19905,5684,14221,8740,693,3086,345,11826,1357,2124,1240,2663,3660
AAGGTCTGCGTTGGTT,sample,71,65,5,60,4,56,24,3,22,0,46,7,28,6,7,5
CTAACCGGCGTTGGTT,sample,55,47,17,30,1,29,8,6,8,0,16,7,14,4,2,5
TAACGAAGCGTTGGTT,sample,96,84,9,75,8,67,39,4,12,0,51,12,36,16,13,7
GCGTTACCCGTTGGTT,sample,56,52,15,37,6,31,15,1,5,0,20,10,13,10,6,4
CAGCTTCGCGTTGGTT,sample,62,51,9,42,6,36,15,2,7,0,22,12,17,8,4,5
TCAATCAGCGTTGGTT,sample,91,84,27,57,10,47,18,1,17,2,35,9,25,11,11,7
CGTAGAACCGTTGGTT,sample,100,82,32,50,5,45,25,1,12,1,37,6,25,12,9,5
AGATACTACGTTGGTT,sample,83,71,24,47,7,40,20,0,14,1,34,5,30,12,3,4
GCGCAATACGTTGGTT,sample,50,44,13,31,9,22,17,0,2,1,19,2,12,6,3,4
CTGGTCTTCTATCGTT,sample,40460,40150,2798,37352,7013,30339,13147,777,9475,1129,22622,5811,4033,1339,4845,4805
GACGTATGCTATCGTT,sample,22696,22394,2805,19589,4089,15500,5351,402,5453,595,10804,3699,3256,980,1894,2641
TCATACCACTATCGTT,sample,5444,5312,928,4384,925,3459,1278,120,1204,124,2482,733,1109,369,390,602
TACGCGAGCTATCGTT,sample,3685,3638,515,3123,702,2421,968,55,826,88,1794,484,745,260,322,414
GACTCAAGCTATCGTT,sample,3070,2998,409,2589,412,2177,775,34,776,109,1551,483,639,175,354,281
TGGATCAACTATCGTT,sample,24697,24393,2944,21449,4611,16838,8010,451,4757,595,12767,3025,2636,909,3900,3098
GATGCGTTCTATCGTT,sample,15887,15602,2421,13181,1670,11511,3743,220,4397,577,8140,2574,2464,759,1075,1027
CCATTCTTCTATCGTT,sample,4956,4854,286,4568,1248,3320,1953,252,645,86,2598,384,673,420,766,773
AGCGTCTTCTATCGTT,sample,9453,9345,761,8584,1914,6670,3615,253,1648,236,5263,918,1140,508,1730,1271
GCTCTTCTCTATCGTT,sample,42051,41612,5362,36250,4947,31303,11234,600,11108,1063,22342,7298,4130,865,4184,3399
CCTAGCGGCTATCGTT,sample,9194,9063,1593,7470,1241,6229,2130,143,2158,214,4288,1584,1505,399,978,852
AGCAGAGCCTATCGTT,sample,87,82,15,67,15,52,30,0,16,0,46,6,28,12,5,7
TGCGCTCCCTATCGTT,sample,50,46,11,35,9,26,13,2,8,0,21,3,15,14,5,4
GTCGCGAACTATCGTT,sample,53,48,8,40,11,29,13,0,5,4,18,7,8,2,8,6
CGTCGAGGCTATCGTT,sample,69,58,5,53,8,45,26,0,11,0,37,8,27,14,3,3
CGCGGTCGCTATCGTT,sample,34,34,4,30,5,25,13,0,8,1,21,3,9,5,11,4
ATTCTACCCTATCGTT,sample,71,66,6,60,20,40,16,0,12,5,28,7,19,9,4,9
CTGGTCTTGTCTTCTT,Pos_Ctrl,54149,52758,4566,48192,2366,45826,38379,3193,3001,426,41380,827,5424,6040,3495,1021
CATAATGGGTCTTCTT,sample,16629,16303,2225,14078,2241,11837,5454,424,3615,340,9069,2004,2424,1136,1177,1421
TATACGGAGTCTTCTT,Pos_Ctrl,30869,30113,2759,27354,1176,26178,21655,1902,1815,229,23470,577,4600,4564,1743,547
GAGCCTCCGTCTTCTT,sample,25496,25063,2382,22681,4946,17735,10132,611,4159,527,14291,2306,2355,1166,3510,3625
GGTAGAGAGTCTTCTT,sample,18462,17932,4094,13838,1554,12284,2818,188,4961,564,7779,3753,3073,690,627,868
TCATCGAAGTCTTCTT,sample,18450,18150,3934,14216,1289,12927,2248,104,5477,555,7725,4543,3225,459,697,686
ATTCAAGGGTCTTCTT,sample,34319,33762,4514,29248,4586,24662,8007,528,8798,975,16805,6354,4280,992,3149,3028
ATACGTTCGTCTTCTT,sample,38194,37530,5881,31649,5275,26374,8866,464,9661,1153,18527,6230,4179,945,3518,3621
TCTCAGGAGTCTTCTT,sample,10376,10179,1868,8311,1220,7091,2648,130,2482,272,5130,1559,1730,491,1011,830
TGCGCGTTGTCTTCTT,sample,23717,23381,2506,20875,4750,16125,8987,501,3923,426,12910,2288,1920,743,4244,3289
CCATTCTTGTCTTCTT,sample,26398,25966,2572,23394,3719,19675,9189,499,6230,852,15419,2905,2779,1091,2814,2581
AGCGTCTTGTCTTCTT,sample,33824,33392,3372,30020,6627,23393,11075,733,6422,617,17497,4546,3362,1221,3537,4491
TAGCGAGTGTCTTCTT,sample,58432,57513,8874,48639,5643,42996,11899,585,16385,1723,28284,12404,6381,1158,4652,3448
GCTCTTCTGTCTTCTT,sample,23177,22776,4083,18693,2589,16104,5038,208,5952,587,10990,4319,3244,751,1801,1713
AAGGTCTGGTCTTCTT,sample,18634,18359,2201,16158,2486,13672,5792,407,4357,436,10149,2680,2424,652,2234,1771
CTAACCGGGTCTTCTT,sample,22490,22237,2464,19773,3233,16540,6542,410,5141,701,11683,3746,2774,671,2024,2166
TAACGAAGGTCTTCTT,sample,19454,19255,1428,17827,3408,14419,8055,460,3566,361,11621,1977,1694,736,2652,2484
AGCAGAGCGTCTTCTT,sample,42756,42266,6006,36260,4723,31537,9215,450,11468,1131,20683,9273,5581,1166,2769,2977
ATACCGCCGTCTTCTT,sample,13771,13629,835,12794,4851,7943,4084,309,2128,202,6212,1220,1533,677,1669,2703
CGTCGAGGGTCTTCTT,sample,127,121,8,113,20,93,41,3,20,5,61,24,43,28,6,12
CGCGGTCGGTCTTCTT,sample,87,86,4,82,8,74,31,0,36,0,67,7,33,9,13,6
ATGAATAGGTCTTCTT,sample,140,136,16,120,16,104,51,0,24,3,75,26,44,21,18,10
TCAATCAGGTCTTCTT,sample,116,113,31,82,8,74,35,1,19,2,54,17,36,20,9,7
GACTAACCGTCTTCTT,sample,132,131,11,120,7,113,52,1,36,2,88,22,44,13,20,12
CGCGAGACGTCTTCTT,sample,102,99,15,84,11,73,34,2,20,3,54,14,32,14,11,10
CCTAACTAGTCTTCTT,Pos_Ctrl,230,174,43,131,43,88,46,9,19,1,65,13,44,33,12,13
GCGCAATAGTCTTCTT,sample,77,73,6,67,7,60,33,1,16,0,49,10,26,12,13,4
GACGTATGTAGGCTCT,sample,22536,22079,2665,19414,3977,15437,7828,507,4660,578,12488,1864,2471,1116,2330,2852
CATAATGGTAGGCTCT,sample,46809,45947,5108,40839,7615,33224,15345,693,9644,931,24989,6611,3478,1057,6519,5305
CTAGCGACTAGGCTCT,sample,102107,100997,7637,93360,22825,70535,38741,2665,17612,1894,56353,9623,5229,1839,15042,15214
TCATCGAATAGGCTCT,sample,55025,54544,4617,49927,12487,37440,17405,1266,10857,1197,28262,6715,4710,1907,6314,7967
TCATACCATAGGCTCT,sample,86073,85266,5386,79880,23084,56796,37260,2213,11572,1320,48832,4431,3797,2158,11584,15317
GCAACTAGTAGGCTCT,sample,37973,37415,4059,33356,8334,25022,13049,817,6386,682,19435,4088,3532,1426,4825,5985
GACTCAAGTAGGCTCT,sample,32315,31854,3033,28821,5143,23678,11295,836,7326,933,18621,3288,3121,1319,3401,3627
ATACGTTCTAGGCTCT,sample,100303,99351,6022,93329,28747,64582,41181,2660,13541,1243,54722,5957,3240,1498,16670,18761
ATGGCGTTTAGGCTCT,sample,49919,49257,5048,44209,10019,34190,16317,923,9897,1183,26214,5870,4087,1373,6981,6776
CGGTTGGTTAGGCTCT,sample,54411,53620,6936,46684,7625,39059,15176,748,13238,1457,28414,8440,4952,1197,6805,4929
TAGCGAGTTAGGCTCT,sample,77313,76255,9327,66928,9446,57482,20160,1235,20517,2040,40677,13530,5895,1408,8782,6535
GCTCTTCTTAGGCTCT,sample,50691,49554,4545,45009,7228,37781,17503,902,12519,1224,30022,5633,3667,1385,5611,5508
CTAACCGGTAGGCTCT,sample,57681,56982,4437,52545,14611,37934,21454,1295,9117,1027,30571,5041,3243,1383,8282,9669
GGCGACGATAGGCTCT,sample,35705,35151,2670,32481,8133,24348,12346,1079,6618,730,18964,3575,2939,1181,4546,5176
GCTGCTTCTAGGCTCT,sample,73417,72087,7205,64882,11870,53012,22537,1158,16576,1588,39113,11153,4487,1166,10085,8741
ATACCGCCTAGGCTCT,sample,72162,71187,7817,63370,12340,51030,24845,1570,14174,1796,39019,8645,5807,2269,5410,8292
GCGTTACCTAGGCTCT,sample,51071,50467,4078,46389,7381,39008,19510,1189,11902,1575,31412,4832,3527,1360,7830,5320
GGCGTACCTAGGCTCT,sample,30602,30230,1703,28527,6176,22351,11496,840,7035,845,18531,2135,2395,1166,4271,4248
TCTCCTAGTAGGCTCT,sample,15320,15106,1147,13959,3325,10634,4764,426,3161,359,7925,1924,1950,638,1651,2071
ATTCTACCTAGGCTCT,sample,347,327,44,283,49,234,149,5,53,5,202,22,105,61,49,37
CGTAGAACTAGGCTCT,sample,232,224,35,189,22,167,69,1,58,4,127,35,70,26,25,17
AACCGGTTTTGACTAT,sample,37210,36639,6391,30248,3937,26311,7640,509,9884,1275,17524,7003,4520,1065,2636,2517
TCTAGGTTTTGACTAT,sample,22387,21951,3796,18155,2521,15634,6336,452,4643,530,10979,3673,3186,1301,1092,1608
GTCGTTCTTTGACTAT,Neg_Ctrl,2337,956,692,264,29,235,68,7,72,3,140,85,78,24,25,7
CATAATGGTTGACTAT,sample,17584,17167,3266,13901,2018,11883,3459,216,4578,483,8037,3147,2683,741,1077,1339
GGAGAAGCTTGACTAT,Neg_Ctrl,2040,828,619,209,46,163,69,3,50,4,119,37,69,24,19,6
GAGCCTCCTTGACTAT,sample,42559,41717,8368,33349,3768,29581,6469,273,12110,1294,18579,9435,5373,772,2538,2313
CATACTCCTTGACTAT,sample,11456,11108,1552,9556,2315,7241,3231,247,2146,209,5377,1408,1618,571,1433,1524
GGTAGAGATTGACTAT,sample,4228,4101,919,3182,385,2797,663,67,993,121,1656,953,862,210,152,209
CGTCGCCATTGACTAT,sample,37705,37145,3648,33497,7261,26236,14896,929,6506,639,21402,3266,2379,1012,6858,5150
TCATCGAATTGACTAT,sample,28173,27609,4735,22874,3756,19118,5897,288,6935,869,12832,5129,3667,833,2470,2449
TGATTCCGTTGACTAT,Pos_Ctrl,51294,49977,4726,45251,2221,43030,36222,3022,2690,292,38912,804,5453,6045,3134,1084
TACGCGAGTTGACTAT,sample,57215,56393,3267,53126,11559,41567,31390,1988,5168,929,36558,2092,2106,1335,9877,8176
CCGTACGCTTGACTAT,sample,28993,28463,3689,24774,4285,20489,9217,530,6115,653,15332,3974,3376,889,4391,3036
TCTCAGGATTGACTAT,sample,48243,47459,6917,40542,4583,35959,9862,542,14136,1292,23998,10127,5548,1059,2884,3013
GATGCGTTTTGACTAT,sample,22661,22270,1848,20422,5498,14924,9411,366,3094,462,12505,1591,1591,791,4605,3719
ATGGCGTTTTGACTAT,Pos_Ctrl,36465,35726,3238,32488,1677,30811,25837,2151,1894,272,27731,657,4595,4785,2228,831
ACGCTTAATTGACTAT,sample,21934,21574,2298,19276,3932,15344,8163,544,4104,382,12267,2151,2330,929,3451,2666
TAGCGAGTTTGACTAT,sample,22262,21903,2497,19406,3796,15610,8025,257,4367,395,12392,2566,2132,685,4033,2808
GAGATTCTTTGACTAT,sample,38079,37265,8841,28424,2930,25494,5159,293,10568,1094,15727,8380,5009,763,1900,1782
AAGGTCTGTTGACTAT,sample,12177,11969,2437,9532,1355,8177,2044,118,3169,307,5213,2539,2282,522,620,820
CCTAGCGGTTGACTAT,Pos_Ctrl,20324,19988,1828,18160,952,17208,14330,1384,1008,128,15338,358,3587,3350,1198,502
CTAACCGGTTGACTAT,sample,31900,31430,4888,26542,3436,23106,6565,415,8621,842,15186,6663,3985,772,2924,2088
GGCGACGATTGACTAT,sample,19920,19595,2756,16839,2725,14114,6488,373,4069,443,10557,2741,2644,1025,1918,1916
ATACCGCCTTGACTAT,sample,35817,35215,4330,30885,4800,26085,10264,532,8591,810,18855,5888,3661,829,4583,3568
CGTCGAGGTTGACTAT,Pos_Ctrl,22203,21905,1652,20253,958,19295,16414,1494,973,139,17387,275,3787,3934,1098,436
TTATGACGTTGACTAT,sample,19138,18890,3047,15843,1918,13925,4358,205,4932,510,9290,3920,2882,547,1955,1180
TCTCCTAGTTGACTAT,sample,26285,25940,1846,24094,5465,18629,11647,557,3988,462,15635,1975,1728,786,4572,3865
TAACGCCATTGACTAT,sample,21321,21021,3247,17774,3002,14772,4926,344,5157,503,10083,3842,2877,705,1805,1932
CGTAGAACTTGACTAT,sample,1756,1724,156,1568,312,1256,539,30,430,31,969,226,448,172,177,213
GCGCAATATTGACTAT,Neg_Ctrl,117,96,16,80,10,70,31,2,26,2,57,9,34,15,8,7
TTAACTGATTGACTAT,sample,129,125,20,105,20,85,42,0,26,1,68,16,42,18,16,13
TCTAGGTTTGCAGTTG,sample,22955,22465,1634,20831,6067,14764,10218,611,2595,232,12813,1108,1618,1065,3980,4058
CTGGTCTTTGCAGTTG,sample,28574,27968,3298,24670,3928,20742,8852,558,6618,673,15470,4041,3314,1104,3645,2549
AGCTGAATTGCAGTTG,sample,17055,16723,2419,14304,3330,10974,4811,281,3357,339,8168,2186,2242,840,1698,2145
TCGAACGATGCAGTTG,sample,31854,31447,2295,29152,7311,21841,11344,722,5782,661,17126,3332,2876,1067,4780,4863
GGTAGAGATGCAGTTG,sample,16466,16189,2022,14167,2614,11553,4172,273,3999,410,8171,2699,2419,654,1670,1772
CGTCGCCATGCAGTTG,sample,32495,31964,2590,29374,6532,22842,11453,859,6020,920,17473,3590,2513,900,5455,4563
ATTCAAGGTGCAGTTG,sample,98479,97227,11925,85302,10217,75085,18675,861,29004,3071,47679,23474,9335,1546,5916,6577
GCAACTAGTGCAGTTG,sample,6990,6830,665,6165,1229,4936,2403,210,1563,185,3966,575,1445,722,596,874
TACGCGAGTGCAGTTG,sample,20469,20079,2925,17154,2036,15118,4782,301,5598,611,10380,3826,3066,872,1297,1375
CCGTACGCTGCAGTTG,sample,40462,39670,7414,32256,2122,30134,3817,184,13471,1469,17288,11193,5752,769,810,931
TCTCAGGATGCAGTTG,sample,16936,16587,2212,14375,1784,12591,4334,311,4729,498,9063,2719,2620,772,1376,1167
TGCGCGTTTGCAGTTG,sample,22901,22471,1644,20827,4165,16662,10146,708,3638,430,13784,1740,2089,1149,3489,2814
CCATTCTTTGCAGTTG,sample,20905,20496,1954,18542,2984,15558,6916,338,5012,464,11928,2828,2226,754,2939,2111
CGGTTGGTTGCAGTTG,sample,25318,24883,3154,21729,2891,18838,7157,510,6003,677,13160,4491,3056,846,2536,1976
GGCGACGATGCAGTTG,sample,19736,19350,2325,17025,2365,14660,6050,331,4642,503,10692,3134,2697,769,2779,1685
TAACGAAGTGCAGTTG,sample,11600,11400,1385,10015,1681,8334,3685,192,2682,282,6367,1493,1900,758,1071,1126
GCCTATTCTGCAGTTG,sample,33475,32735,4584,28151,3786,24365,7897,470,8653,960,16550,6385,4139,851,2953,2665
ATACCGCCTGCAGTTG,sample,13512,13241,1443,11798,1596,10202,4929,319,2899,431,7828,1624,1819,750,1633,1193
TCTCCTAGTGCAGTTG,sample,31115,30631,3230,27401,3634,23767,8097,481,8391,937,16488,5861,3793,861,2482,2699
TCAATCAGTGCAGTTG,sample,19011,18710,2048,16662,1807,14855,5732,408,5055,671,10787,2989,2648,874,1580,1265
TAACGCCATGCAGTTG,sample,28856,28411,4309,24102,2214,21888,5617,233,9081,886,14698,6071,4160,826,1551,1300
CGCGAGACTGCAGTTG,sample,32195,31622,3686,27936,3896,24040,9330,436,7665,800,16995,5809,3679,896,3432,2728
AGATACTATGCAGTTG,sample,25259,24829,3507,21322,2980,18342,4781,265,7406,718,12187,5172,3446,660,1698,1859
CTGGTCTTTCATGCTG,sample,13830,13627,690,12937,3482,9455,5851,270,2131,214,7982,989,1166,598,2833,2337
GTCGTTCTTCATGCTG,sample,16506,16316,1647,14669,2042,12627,5283,362,4506,488,9789,1988,2311,915,1207,1487
GAGCCTCCTCATGCTG,sample,12407,12097,2108,9989,1326,8663,2473,105,3223,318,5696,2544,2129,415,1079,845
GCAACTAGTCATGCTG,Neg_Ctrl,838,289,247,42,5,37,22,1,10,1,32,3,19,12,9,0
TACGCGAGTCATGCTG,sample,17150,16739,3080,13659,1342,12317,3470,207,4708,501,8178,3431,2885,714,908,860
ATACGTTCTCATGCTG,sample,29958,29335,6271,23064,2288,20776,5043,344,8173,843,13216,6373,4541,836,1419,1410
CCGTACGCTCATGCTG,sample,18735,18367,2749,15618,2238,13380,4993,241,4513,545,9506,3088,2677,522,2565,1449
TGGATCAATCATGCTG,sample,22052,21614,5439,16175,1129,15046,2172,153,6701,806,8873,5214,3735,479,383,580
TGCGCGTTTCATGCTG,Neg_Ctrl,993,484,316,168,26,142,37,1,66,5,103,33,61,13,9,6
GCTCTTCTTCATGCTG,sample,10571,10355,2247,8108,1309,6799,1874,91,2373,293,4247,2168,1541,321,922,1576
GAGATTCTTCATGCTG,sample,7617,7450,1198,6252,760,5492,1909,128,2041,196,3950,1218,1524,497,501,518
CTAAGCATTCATGCTG,sample,20766,20380,3624,16756,1665,15091,3467,227,5843,628,9310,4926,3352,539,1241,1026
CTAACCGGTCATGCTG,Neg_Ctrl,613,215,154,61,7,54,27,1,15,1,42,10,33,12,4,0
TAACGAAGTCATGCTG,sample,6831,6722,1228,5494,821,4673,1681,76,1511,199,3192,1206,1215,285,791,535
GCCTATTCTCATGCTG,sample,11273,11057,1474,9583,1824,7759,3375,220,2318,275,5693,1571,1767,611,1220,1338
GCGTTACCTCATGCTG,sample,8434,8250,969,7281,1545,5736,3091,174,1444,242,4535,785,1253,557,1249,1090
CAGCTTCGTCATGCTG,Neg_Ctrl,567,253,167,86,14,72,29,3,26,3,55,11,37,16,8,2
CGCGGTCGTCATGCTG,sample,6625,6500,856,5644,843,4801,2055,80,1506,188,3561,972,1068,314,919,608
TCTCCTAGTCATGCTG,sample,24375,23896,5361,18535,1501,17034,3002,191,7074,680,10076,6087,4040,493,927,751
ATGAATAGTCATGCTG,sample,7609,7459,1017,6442,992,5450,2802,208,1471,201,4273,768,1138,567,647,743
TAACGCCATCATGCTG,sample,7575,7458,868,6590,1133,5457,2807,183,1475,149,4282,843,1143,472,1101,778
ATTCTACCTCATGCTG,sample,7911,7745,567,7178,1617,5561,4059,184,1012,142,5071,164,649,458,1944,1249
ATATGCAATCATGCTG,sample,60,56,8,48,9,39,15,6,6,2,21,10,16,6,4,6
CTGGTCTTTTAGGCGG,Pos_Ctrl,60633,59512,4334,55178,2478,52700,44513,3727,3067,391,47580,1002,5701,6727,4434,1285
GTCGTTCTTTAGGCGG,sample,31043,30538,3580,26958,5464,21494,9787,548,6505,587,16292,4067,3204,945,4372,3830
AGAGTTCTTTAGGCGG,sample,25095,24615,3027,21588,3130,18458,7168,562,6433,901,13601,3394,2950,960,2372,2270
CATAATGGTTAGGCGG,sample,45046,44431,3589,40842,7403,33439,16568,1554,10114,1321,26682,3882,3099,1271,5753,5417
TATACGGATTAGGCGG,Pos_Ctrl,53073,52023,4046,47977,2211,45766,38406,3301,2814,384,41220,861,5461,6238,3660,1011
GGTAGAGATTAGGCGG,sample,64570,63826,5625,58201,10141,48060,24799,1517,12664,1207,37463,7873,4781,1563,10601,7415
CGTCGCCATTAGGCGG,sample,74419,73379,8466,64913,11962,52951,20962,1013,17586,1715,38548,11675,5653,1353,7884,7831
TGGATCAATTAGGCGG,sample,39101,38485,4112,34373,6167,28206,12583,462,8613,1112,21196,5436,3077,862,5790,4230
GGCAGGTTTTAGGCGG,sample,16349,15924,3056,12868,1775,11093,3265,231,4076,460,7341,3061,2405,563,1312,1127
GATGCGTTTTAGGCGG,sample,42520,41607,7214,34393,3507,30886,5867,283,13417,1229,19284,10090,5494,822,1642,2066
AGCGTCTTTTAGGCGG,sample,30509,29945,3565,26380,5460,20920,9267,604,6192,696,15459,4161,3217,1040,3749,3897
CTAACCGGTTAGGCGG,sample,39559,38911,4212,34699,7004,27695,13131,748,7998,856,21129,4962,3220,1015,5402,5021
GGCGACGATTAGGCGG,sample,38633,37988,5554,32434,4032,28402,8374,540,10573,1217,18947,7698,4501,834,3468,2630
TAACGAAGTTAGGCGG,sample,18233,17901,2958,14943,1569,13374,3924,308,5015,605,8939,3522,2930,828,1020,941
TCAATCAGTTAGGCGG,sample,60352,59479,6141,53338,5767,47571,24099,1578,11657,1069,35756,9168,5095,1707,3907,3991
TAACGCCATTAGGCGG,sample,30390,29950,3856,26094,2234,23860,8230,567,8941,991,17171,5131,3614,1092,1619,1562
GACTAACCTTAGGCGG,sample,65313,64089,10449,53640,4972,48668,12603,606,18616,1963,31219,14880,6369,1163,3765,3285
AGATACTATTAGGCGG,sample,50821,49939,6183,43756,7202,36554,15572,706,11226,1349,26798,7701,3877,973,5972,5208
TTAACTGATTAGGCGG,sample,53397,52858,6169,46689,5520,41169,15555,836,13201,1271,28756,10306,5405,1385,4469,3692
AACCGGTTTCAGATAC,sample,2290,2184,183,2001,500,1501,810,38,416,54,1226,183,442,222,309,336
CTGGTCTTTCAGATAC,sample,27181,26759,4294,22465,3075,19390,5515,318,7322,901,12837,5334,3457,693,2373,1909
TATACGGATCAGATAC,sample,17799,17459,2366,15093,2850,12243,4564,174,4143,405,8707,2957,2297,538,2260,1891
CATACTCCTCAGATAC,sample,6891,6720,971,5749,859,4890,2191,118,1614,127,3805,840,1228,460,900,603
TCGAACGATCAGATAC,sample,16546,16247,3016,13231,2046,11185,3630,160,4040,448,7670,2907,2389,586,1504,1260
TCATCGAATCAGATAC,sample,23767,23277,5610,17667,2468,15199,2677,162,6473,652,9150,5235,3432,454,939,1378
TACGCGAGTCAGATAC,sample,20181,19832,3197,16635,2631,14004,5082,222,4496,500,9578,3704,2599,533,2515,1690
ATACGTTCTCAGATAC,sample,14176,13894,2199,11695,2254,9441,3254,194,3295,382,6549,2316,2129,564,1354,1443
CCGTACGCTCAGATAC,sample,11925,11673,1048,10625,2518,8107,4815,213,1780,174,6595,1125,1211,555,2541,1772
TGGATCAATCAGATAC,sample,12905,12696,1226,11470,2611,8859,5475,254,1921,169,7396,1040,1204,530,3122,1842
CCATTCTTTCAGATAC,sample,21053,20640,3770,16870,2156,14714,5176,337,5056,614,10232,3531,2867,831,1759,1324
ACGCTTAATCAGATAC,sample,17701,17445,2291,15154,2761,12393,5905,396,3583,350,9488,2159,2087,754,2316,1971
CATTCGGTTCAGATAC,sample,10373,10144,2810,7334,660,6674,983,73,2924,330,3907,2364,1968,248,250,317
GCTCTTCTTCAGATAC,sample,21406,21025,4556,16469,2031,14438,3581,253,5480,570,9061,4554,3177,588,1471,1274
CCTAGCGGTCAGATAC,sample,2101,2046,235,1811,391,1420,728,73,366,60,1094,193,470,229,232,260
GGCGACGATCAGATAC,sample,22183,21749,4929,16820,1727,15093,2871,172,6170,667,9041,5213,3586,542,1008,985
TAACGAAGTCAGATAC,sample,17048,16838,1550,15288,2102,13186,8754,1010,1871,243,10625,1308,2152,1504,1705,1486
GCTGCTTCTCAGATAC,sample,16325,16006,2826,13180,2016,11164,4050,207,3883,418,7933,2606,2383,577,1738,1341
AGCAGAGCTCAGATAC,sample,8055,7871,970,6901,1616,5285,2623,156,1444,174,4067,888,1166,492,990,1060
ATACCGCCTCAGATAC,sample,3509,3334,316,3018,1111,1907,1304,51,335,43,1639,174,438,277,575,646
GCGTTACCTCAGATAC,sample,10550,10328,1445,8883,1971,6912,3165,212,1992,201,5157,1342,1465,540,1240,1318
GGCGTACCTCAGATAC,sample,12541,12262,2541,9721,1288,8433,2265,126,3329,376,5594,2337,2163,419,894,845
TCAATCAGTCAGATAC,sample,9968,9764,1237,8527,1043,7484,2215,137,2687,283,4902,2162,1912,506,426,599
CGTAGAACTCAGATAC,sample,12285,12008,2397,9611,1004,8607,2176,156,3263,378,5439,2634,2029,347,895,635
AGATACTATCAGATAC,sample,13338,13057,1955,11102,1258,9844,3875,210,3522,381,7397,1856,1787,520,1264,900
ATATGCAATCAGATAC,sample,96,92,11,81,10,71,33,3,25,0,58,10,27,11,12,5
CTGGTCTTTCGCTAGG,sample,11233,11023,1176,9847,2285,7562,4464,213,1634,227,6098,1024,1267,664,1739,1619
GTCGTTCTTCGCTAGG,Neg_Ctrl,1007,429,309,120,10,110,50,3,27,3,77,27,44,18,10,4
CATAATGGTCGCTAGG,sample,19119,18678,4615,14063,1417,12646,2200,111,5462,539,7662,4334,3386,446,569,820
GGAGAAGCTCGCTAGG,Neg_Ctrl,709,311,231,80,5,75,21,0,31,2,52,21,32,13,9,2
GAGCCTCCTCGCTAGG,sample,7952,7765,1291,6474,974,5500,1784,120,1855,188,3639,1553,1465,405,619,669
TCGAACGATCGCTAGG,sample,5436,5301,788,4513,876,3637,1648,84,1090,115,2738,700,876,290,838,586
CGTCGCCATCGCTAGG,sample,8110,7879,1463,6416,994,5422,1872,89,1934,196,3806,1331,1344,289,977,636
GCAACTAGTCGCTAGG,sample,772,732,184,548,114,434,147,11,152,15,299,109,186,64,59,66
TACGCGAGTCGCTAGG,sample,3158,3049,790,2259,229,2030,435,11,808,91,1243,685,639,80,176,142
CCGCAGTCTCGCTAGG,sample,2762,2643,499,2144,379,1765,682,41,575,55,1257,412,501,147,352,260
ATGGCGTTTCGCTAGG,sample,1517,1455,351,1104,133,971,185,10,405,41,590,330,328,67,40,63
TGCGCGTTTCGCTAGG,sample,1471,1402,268,1134,167,967,321,25,343,29,664,249,286,79,166,115
CGGTTGGTTCGCTAGG,sample,3046,2987,640,2347,202,2145,435,30,923,100,1358,657,727,120,149,111
GCTCTTCTTCGCTAGG,sample,8533,8306,1037,7269,1277,5992,2306,166,2018,212,4324,1290,1176,371,915,910
CCTAGCGGTCGCTAGG,sample,5967,5810,1070,4740,433,4307,1152,53,1681,181,2833,1240,1339,320,292,275
CTAACCGGTCGCTAGG,sample,10983,10756,1968,8788,865,7923,2119,110,3030,320,5149,2344,1878,370,610,568
TAACGAAGTCGCTAGG,sample,6224,6084,911,5173,509,4664,1419,88,1766,145,3185,1246,1242,330,445,306
TTATGACGTCGCTAGG,sample,9998,9786,1801,7985,857,7128,2381,156,2464,283,4845,1844,1772,534,606,633
ATGAATAGTCGCTAGG,sample,6403,6258,1151,5107,601,4506,1666,117,1453,150,3119,1120,1191,395,492,377
AAGTAGAGTCGCTAGG,sample,6323,6157,899,5258,940,4318,2084,145,1244,125,3328,720,964,380,831,674
TCAATCAGTCGCTAGG,sample,7663,7529,1097,6432,776,5656,2635,197,1549,147,4184,1128,1457,627,531,538
ATTCTACCTCGCTAGG,Pos_Ctrl,12668,12359,1165,11194,526,10668,8961,763,682,84,9643,178,2876,2514,692,336
CCTAACTATCGCTAGG,sample,8068,7789,1893,5896,500,5396,801,31,2347,244,3148,1973,1542,163,285,265
GCGCAATATCGCTAGG,sample,4643,4473,822,3651,488,3163,1124,105,1085,122,2209,727,906,298,281,300
GTCGTTCTCCGTTGCG,sample,80600,79028,9618,69410,14248,55162,27494,1699,15338,1799,42832,8832,4952,1509,11342,10447
TATACGGACCGTTGCG,sample,66959,65630,13789,51841,5144,46697,8273,436,19404,2044,27677,16540,7866,1076,2493,2965
CATACTCCCCGTTGCG,sample,26507,25869,5204,20665,2351,18314,5547,363,7285,715,12832,4404,3503,897,1898,1593
TCGAACGACCGTTGCG,sample,18622,18176,3466,14710,1920,12790,4384,300,4948,656,9332,2502,2654,718,1462,1252
TCATCGAACCGTTGCG,sample,32363,31660,7214,24446,2684,21762,5748,362,8805,1010,14553,5837,4271,916,1590,1625
TACGCGAGCCGTTGCG,sample,11892,11659,1445,10214,2475,7739,4518,218,1894,199,6412,910,1300,589,1953,1669
CCGTACGCCCGTTGCG,sample,7431,7252,2630,4622,558,4064,1082,69,1533,174,2615,1206,1181,273,418,811
TCTCAGGACCGTTGCG,sample,29435,28667,3393,25274,6490,18784,10996,564,4196,480,15192,2548,2029,905,5519,4387
GGCAGGTTCCGTTGCG,sample,32646,31825,5576,26249,3649,22600,6046,332,8912,970,14958,6340,4074,822,2079,2257
GATGCGTTCCGTTGCG,sample,17819,17477,1827,15650,2825,12825,6670,356,3678,431,10348,1690,2017,970,2379,1926
ATGGCGTTCCGTTGCG,sample,57335,56623,5425,51198,11933,39265,20202,1437,10457,1218,30659,5951,3855,1214,8026,8186
AGCGTCTTCCGTTGCG,sample,49681,49114,5864,43250,6485,36765,12960,699,12700,1364,25660,9042,4527,1107,5363,4720
GCTCTTCTCCGTTGCG,sample,42879,42448,5116,37332,4002,33330,10629,591,11765,1284,22394,9061,4912,840,4021,2796
CTAAGCATCCGTTGCG,sample,51265,50682,4401,46281,9128,37153,20522,928,9771,867,30293,5065,2706,946,11592,6616
ATACCGCCCCGTTGCG,sample,30559,29854,4482,25372,4512,20860,8178,384,6978,714,15156,4606,3131,734,3837,3396
GCGTTACCCCGTTGCG,sample,37728,36905,6749,30156,2289,27867,7388,454,10776,1132,18164,8117,4342,931,2567,1627
GTCGCGAACCGTTGCG,sample,39959,39155,7134,32021,3928,28093,8101,510,10004,1070,18105,8408,4332,815,2896,2769
CAGCTTCGCCGTTGCG,sample,21615,21173,3001,18172,4326,13846,6781,439,3979,407,10760,2240,2069,725,2786,3076
CGCGGTCGCCGTTGCG,sample,15516,15205,2276,12929,1320,11609,4748,242,3868,406,8616,2345,2074,685,1520,920
ATGAATAGCCGTTGCG,sample,50161,49085,13469,35616,2738,32878,4852,203,14570,1450,19422,11803,6122,763,1417,1387
TAACGCCACCGTTGCG,sample,23358,22930,3648,19282,2343,16939,6561,450,5690,705,12251,3533,2770,823,2291,1656
ATTCTACCCCGTTGCG,sample,31631,30992,4392,26600,4375,22225,9445,525,7302,781,16747,4172,3214,1007,3013,3140
GCGCAATACCGTTGCG,sample,40044,39153,6733,32420,3906,28514,8088,482,10795,1090,18883,8059,4420,782,3359,2731
AACCGGTTAGGCCAAG,sample,72647,71345,8465,62880,12327,50553,20461,874,16594,1671,37055,10953,4259,1131,9513,8356
TCTAGGTTAGGCCAAG,sample,50315,49238,8294,40944,6841,34103,14113,1016,10605,1497,24718,6872,4796,1904,2694,4672
CATAATGGAGGCCAAG,sample,76593,75758,6839,68919,9855,59064,21486,1103,20518,2257,42004,13700,5342,1133,9121,6898
GAGCCTCCAGGCCAAG,sample,12274,11968,2106,9862,1199,8663,2534,122,3346,308,5880,2353,2129,414,1200,751
GGTAGAGAAGGCCAAG,sample,35045,34469,3626,30843,6540,24303,12709,716,6782,654,19491,3442,2592,914,5500,4620
TACGCGAGAGGCCAAG,sample,34579,34003,3791,30212,6740,23472,11295,626,6553,789,17848,4209,3407,1190,3861,4370
GACTCAAGAGGCCAAG,sample,32282,31742,4535,27207,3995,23212,7829,444,8450,896,16279,5593,3799,1020,2843,2794
GATGCGTTAGGCCAAG,sample,13870,13691,1242,12449,4586,7863,4225,291,2003,224,6228,1120,1354,625,2147,2682
TGCGCGTTAGGCCAAG,sample,33256,32747,4218,28529,5174,23355,8742,439,7658,724,16400,5792,3471,874,3689,4047
CGGTTGGTAGGCCAAG,sample,9309,9132,1209,7923,1161,6762,2646,79,2326,272,4972,1439,1488,386,1236,780
GAGATTCTAGGCCAAG,sample,37638,36979,5702,31277,3839,27438,6742,433,10628,978,17370,8657,4838,1053,2111,2469
GGCGTACCAGGCCAAG,sample,35199,34493,5677,28816,4178,24638,8483,401,8320,957,16803,6477,3855,803,3856,2830
ATGAATAGAGGCCAAG,sample,22482,22103,3821,18282,2577,15705,5268,357,5417,573,10685,4090,3410,923,1459,1795
TCAATCAGAGGCCAAG,sample,6433,6300,1503,4797,427,4370,1149,81,1630,200,2779,1310,1429,390,218,241
TAACGCCAAGGCCAAG,sample,17655,17326,2308,15018,1729,13289,5705,375,4043,347,9748,2819,2498,919,1544,1221
GACTAACCAGGCCAAG,Neg_Ctrl,1290,538,421,117,14,103,31,1,47,3,78,21,41,10,12,3
CGTAGAACAGGCCAAG,sample,24342,23829,3323,20506,2778,17728,8081,449,5101,548,13182,3549,2705,866,3279,1934
AGATACTAAGGCCAAG,sample,18762,18384,2833,15551,2307,13244,5446,307,4392,429,9838,2670,2171,651,2305,1601
ATATGCAAAGGCCAAG,sample,26862,26510,3267,23243,3109,20134,8213,545,6123,647,14336,4606,3147,1017,2254,2077
AGCTGAATAGAACCGC,sample,68492,67597,5924,61673,15895,45778,30525,1878,8889,1018,39414,3468,2093,1086,14496,11146
CATACTCCAGAACCGC,sample,16657,16330,3410,12920,1597,11323,3130,201,4335,469,7465,3188,2546,521,1190,956
CTAGCGACAGAACCGC,sample,82306,81314,8850,72464,10089,62375,26205,1701,20813,2964,47018,10692,5289,1577,8904,7110
TCATACCAAGAACCGC,sample,32466,31657,5410,26247,4431,21816,7059,440,8338,905,15397,5074,3785,932,2566,2836
ATTCAAGGAGAACCGC,sample,39288,38476,6171,32305,4987,27318,8648,477,9544,926,18192,7723,4463,950,3671,3406
GACTCAAGAGAACCGC,sample,55758,54667,7774,46893,6718,40175,13380,738,13994,1367,27374,10696,4992,955,6021,4523
CCGTACGCAGAACCGC,sample,29118,28632,3213,25419,4120,21299,9646,651,6992,818,16638,3192,3112,1175,2581,2877
TCTCAGGAAGAACCGC,sample,23635,23187,4420,18767,2951,15816,4454,329,6051,685,10505,4297,3568,1010,911,1733
TGGATCAAAGAACCGC,sample,48351,47696,3821,43875,11439,32436,20918,1006,6497,673,27415,3342,2296,1036,10120,8144
GATGCGTTAGAACCGC,sample,47558,46815,8197,38618,4875,33743,11178,614,12102,1262,23280,8587,5381,1224,3624,2982
ATGGCGTTAGAACCGC,sample,51367,50558,7260,43298,8686,34612,13839,763,10901,1055,24740,8054,4165,1147,5055,5922
AGCGTCTTAGAACCGC,sample,26271,25755,4289,21466,3210,18256,5812,327,6503,694,12315,4920,3161,736,2280,1991
ACGCTTAAAGAACCGC,sample,11046,10800,1940,8860,1305,7555,2226,141,2780,336,5006,2072,1806,442,809,827
GCTGCTTCAGAACCGC,sample,28957,28498,2889,25609,5776,19833,10832,706,5044,573,15876,2678,2428,1080,4250,4087
AGCAGAGCAGAACCGC,sample,32354,31693,3974,27719,5366,22353,10917,422,6389,822,17306,3803,2516,850,5189,3873
TGCGCTCCAGAACCGC,sample,90817,88733,25953,62780,4755,58025,6645,370,26227,2686,32872,22097,9278,981,1205,2396
CAGCTTCGAGAACCGC,sample,33593,32892,4965,27927,3316,24611,8812,499,8668,801,17480,5831,3780,852,2909,2345
TTATGACGAGAACCGC,sample,34993,34435,4802,29633,4628,25005,10565,651,7750,888,18315,5151,3541,928,3496,3450
TCTCCTAGAGAACCGC,sample,43456,42573,6102,36471,4461,32010,9532,470,11761,1249,21293,8998,4559,792,3097,3047
CGTAGAACAGAACCGC,sample,60126,58891,10057,48834,5661,43173,12446,1051,15431,1632,27877,12613,5582,1031,5164,4075
ATATGCAAAGAACCGC,sample,30239,29928,3639,26289,3130,23159,9111,705,7722,982,16833,4639,3268,919,3188,2005
GTCGTTCTCATCAAGC,sample,49111,48264,5154,43110,8058,35052,16893,757,10519,1012,27412,5871,3191,941,8905,5716
AGAGTTCTCATCAAGC,sample,25633,25248,2526,22722,3920,18802,9032,654,5937,704,14969,2475,2528,1237,2333,2903
CATAATGGCATCAAGC,sample,57226,56117,9975,46142,5977,40165,11893,614,15318,1664,27211,10676,5803,1181,4950,3896
TATACGGACATCAAGC,sample,9090,8858,2073,6785,987,5798,1168,80,2435,249,3603,1866,1614,269,449,612
GAGCCTCCCATCAAGC,sample,33854,33219,2520,30699,7209,23490,14136,640,5647,442,19783,2625,1849,780,7322,5144
CATACTCCCATCAAGC,sample,34681,34139,3532,30607,7179,23428,14888,1123,4454,515,19342,2448,2774,1708,3227,4858
CTAGCGACCATCAAGC,sample,15796,15453,2634,12819,2998,9821,4084,273,3117,290,7201,2057,2164,723,1674,1811
CCGCAGTCCATCAAGC,sample,15626,15208,2907,12301,1662,10639,3089,134,3900,426,6989,3090,2345,503,1233,930
CCGTACGCCATCAAGC,sample,32660,32060,4903,27157,4533,22624,8465,514,7794,909,16259,4942,3269,886,3387,3013
TCTCAGGACATCAAGC,sample,30077,29597,3958,25639,2640,22999,6927,436,8668,810,15595,6158,3823,774,2270,1810
TGCGCGTTCATCAAGC,sample,26472,26034,3592,22442,4160,18282,9337,471,5036,622,14373,2816,2119,723,4426,3031
GAGATTCTCATCAAGC,sample,31469,30717,6257,24460,3349,21111,5737,210,7997,773,13734,6394,3977,682,2584,2013
CCTAGCGGCATCAAGC,sample,22499,22119,3708,18411,2667,15744,5331,232,5481,629,10812,4071,3088,729,2087,1801
GGCGACGACATCAAGC,sample,24471,23960,4108,19852,2676,17176,6296,467,5520,593,11816,4300,2997,698,2497,1739
TAACGAAGCATCAAGC,sample,26920,26554,3839,22715,2938,19777,7189,448,6806,812,13995,4522,3197,713,2779,2001
AGCAGAGCCATCAAGC,sample,24196,23751,4935,18816,1715,17101,3780,260,6891,733,10671,5437,3569,593,1317,1014
CGTCGAGGCATCAAGC,Pos_Ctrl,24989,24397,2078,22319,1136,21183,17749,1638,1266,152,19015,378,4022,4106,1096,643
TCTCCTAGCATCAAGC,sample,38481,37785,5212,32573,3940,28633,8758,525,10652,1217,19410,7481,4233,788,3488,2826
AAGTAGAGCATCAAGC,sample,24466,23888,3959,19929,2585,17344,6859,411,5540,587,12399,3947,3033,819,1944,1933
TAACGCCACATCAAGC,sample,25008,24599,3440,21159,3186,17973,7062,375,5993,634,13055,3909,3026,703,3149,2217
CGCGAGACCATCAAGC,sample,40313,39453,6972,32481,4563,27918,9580,616,9397,1002,18977,7323,4434,952,3498,3235
AGATACTACATCAAGC,sample,20234,19769,2637,17132,3021,14111,6851,331,3942,364,10793,2623,1944,691,2434,2240
AACCGGTTAGAGAGCC,sample,37325,36546,6006,30540,4783,25757,8501,582,8963,1164,17464,6547,3870,1036,3196,3008
GTCGTTCTAGAGAGCC,sample,16737,16509,1862,14647,3848,10799,4521,364,3454,420,7975,2040,2344,809,1682,2399
AGAGTTCTAGAGAGCC,sample,26109,25584,3827,21757,3041,18716,7084,352,6569,752,13653,3959,3134,921,2725,2141
TATACGGAAGAGAGCC,sample,5458,5306,1006,4300,617,3683,1035,113,1395,150,2430,990,1155,303,351,373
CTAGCGACAGAGAGCC,sample,32247,31526,6579,24947,3497,21450,4403,310,8600,898,13003,7239,4449,696,1508,2063
TCATCGAAAGAGAGCC,sample,17969,17643,1666,15977,3760,12217,7190,413,2986,249,10176,1379,1379,691,3453,2730
ATTCAAGGAGAGAGCC,sample,43772,43036,6178,36858,5342,31516,10785,629,10629,1178,21414,8295,4974,1170,4132,3797
TACGCGAGAGAGAGCC,sample,14616,14358,1446,12912,2082,10830,5276,319,3375,386,8651,1474,2021,971,1358,1546
CCGTACGCAGAGAGCC,sample,19270,18889,1903,16986,3072,13914,6552,321,4204,442,10756,2395,1975,688,2851,2178
GGCAGGTTAGAGAGCC,sample,23398,22987,4083,18904,2921,15983,7331,515,4496,410,11827,3231,3280,1459,754,2057
CCATTCTTAGAGAGCC,sample,29727,29103,4143,24960,3230,21730,6964,287,7404,807,14368,6268,3220,727,2837,2333
ACGCTTAAAGAGAGCC,sample,25953,25583,3465,22118,2762,19356,8994,520,5844,480,14838,3518,3080,1087,2308,1823
TAGCGAGTAGAGAGCC,sample,22727,22342,2530,19812,3528,16284,8585,378,4250,551,12835,2520,1918,678,3988,2843
CTAAGCATAGAGAGCC,sample,25064,24676,2695,21981,3481,18500,8382,405,5597,777,13979,3339,2729,836,3094,2547
GGCGACGAAGAGAGCC,sample,14887,14572,2670,11902,1997,9905,3304,233,3395,412,6699,2561,2271,629,1226,1321
GTCGCGAAAGAGAGCC,sample,12189,11926,903,11023,2780,8243,6161,273,1310,167,7471,332,737,553,2725,2040
CGTCGAGGAGAGAGCC,sample,12295,12013,2290,9723,1059,8664,2091,105,3251,363,5342,2854,2137,385,819,629
TCAATCAGAGAGAGCC,sample,75110,73827,11898,61929,3204,58725,16743,812,26775,3462,43518,10933,6268,1401,1652,1609
TAACGCCAAGAGAGCC,sample,15327,15033,2349,12684,1525,11159,3940,200,4009,408,7949,2602,2202,483,1673,1139
CGCGAGACAGAGAGCC,sample,16135,15771,2834,12937,1190,11747,3741,236,4487,545,8228,2738,2541,643,965,822
CCTAACTAAGAGAGCC,sample,15141,14768,2656,12112,1817,10295,4228,233,3504,336,7732,1994,1717,551,1715,1418
TTAACTGAAGAGAGCC,sample,12708,12493,1025,11468,2386,9082,5840,342,1802,225,7642,873,1099,599,2268,1743
TCTAGGTTAGCATTGA,sample,80815,80030,8199,71831,13786,58045,21721,1019,19962,2154,41683,13189,5518,1453,9601,8956
CTGGTCTTAGCATTGA,sample,94553,93451,6315,87136,21163,65973,36364,2499,15907,1885,52271,9318,4087,1400,17451,14368
TCGAACGAAGCATTGA,sample,42913,42270,4042,38228,7297,30931,14919,900,9179,872,24098,5061,3042,1037,5865,5484
GGTAGAGAAGCATTGA,sample,54671,53738,5603,48135,9889,38246,19010,1411,9990,1168,29000,6667,3947,1435,7072,7056
CGTCGCCAAGCATTGA,sample,19973,19437,3400,16037,2662,13375,4559,269,4833,513,9392,3201,2637,633,1909,1828
ATTCAAGGAGCATTGA,sample,50582,49852,4095,45757,9663,36094,19647,1599,8957,992,28604,4899,3304,1388,6944,6518
TGATTCCGAGCATTGA,sample,15039,14753,2006,12747,2206,10541,4628,329,3373,329,8001,1882,2118,828,1445,1527
GCAACTAGAGCATTGA,sample,10077,9820,1190,8630,1767,6863,3305,206,2188,322,5493,842,1595,827,987,1393
TACGCGAGAGCATTGA,sample,87465,86419,6704,79715,13963,65752,34695,1537,20216,2226,54911,7078,3115,1238,13565,10237
TGCGCGTTAGCATTGA,sample,37334,36752,4661,32091,6011,26080,10921,725,8326,787,19247,5321,3647,1127,4041,4013
CCATTCTTAGCATTGA,sample,45837,45234,3973,41261,8842,32419,19352,1308,7323,672,26675,3764,2443,1030,9778,6438
CGGTTGGTAGCATTGA,sample,59618,58791,7067,51724,5627,46097,12392,536,17820,1696,30212,13653,5803,937,5439,3775
ACGCTTAAAGCATTGA,sample,46957,46327,3789,42538,7373,35165,17567,878,9092,1417,26659,6211,2958,937,8129,5362
CATTCGGTAGCATTGA,sample,20743,20410,1745,18665,3714,14951,7864,531,4285,385,12149,1886,2226,837,3052,2731
GCTCTTCTAGCATTGA,sample,54969,54192,4852,49340,10526,38814,23562,1236,8697,1019,32259,4300,2402,943,10672,7611
GAGATTCTAGCATTGA,sample,35020,34606,3384,31222,5066,26156,12203,738,7542,757,19745,4916,3483,1217,4239,3397
TAACGAAGAGCATTGA,sample,46889,46155,5196,40959,6896,34063,13666,542,10610,1099,24276,8146,4381,941,6340,4700
AGCAGAGCAGCATTGA,sample,29966,29405,3455,25950,4932,21018,9729,594,6222,842,15951,3631,2707,879,4148,3304
TGCGCTCCAGCATTGA,sample,25701,25317,2026,23291,6806,16485,9824,545,3840,522,13664,1754,2392,1226,3185,4436
CGTCGAGGAGCATTGA,sample,6975,6804,838,5966,1207,4759,1821,135,1689,187,3510,927,1482,567,344,792
CAGCTTCGAGCATTGA,Neg_Ctrl,1334,689,474,215,31,184,96,3,46,2,142,37,76,31,38,17
AAGTAGAGAGCATTGA,sample,23738,23329,2297,21032,4443,16589,10154,764,3554,425,13708,1692,1993,896,4061,3375
TTAACTGAAGCATTGA,sample,36545,36165,2933,33232,4876,28356,12605,639,8435,895,21040,5782,3616,862,4597,3377
AACCGGTTAATTACCA,sample,39229,38657,5023,33634,5168,28466,10317,609,9730,1032,20047,6778,4009,936,4514,3583
GTCGTTCTAATTACCA,sample,22929,22497,2053,20444,4251,16193,8176,363,4664,505,12840,2485,1722,613,4127,3097
GACGTATGAATTACCA,sample,27601,27110,3901,23209,3975,19234,7323,314,6307,563,13630,4727,2876,734,3246,2706
GGAGAAGCAATTACCA,sample,28150,27764,3606,24158,4019,20139,9111,505,5665,626,14776,4232,3414,1284,2148,2787
CTAGCGACAATTACCA,sample,19882,19552,2677,16875,2606,14269,5411,292,4924,623,10335,3019,2477,671,2206,1712
TCATACCAAATTACCA,sample,21456,21007,3289,17718,2458,15260,5419,222,5536,622,10955,3461,2610,607,2350,1686
ATTCAAGGAATTACCA,sample,26191,25693,4678,21015,2085,18930,4827,236,7692,881,12519,5294,3592,702,1688,1419
GCAACTAGAATTACCA,sample,3399,3281,407,2874,383,2491,1034,62,899,159,1933,337,851,358,286,277
CCGTACGCAATTACCA,sample,15224,14860,2883,11977,1555,10422,3098,158,3842,430,6940,2894,2321,647,715,1016
CCATTCTTAATTACCA,sample,22586,22171,2699,19472,3955,15517,7859,370,3929,452,11788,2907,1770,696,3188,3561
CTAAGCATAATTACCA,sample,20907,20436,4629,15807,1832,13975,3241,241,5357,549,8598,4587,2857,534,1062,1088
ATACCGCCAATTACCA,sample,19224,18802,3523,15279,1789,13490,4707,225,4970,609,9677,2979,2667,766,1604,1158
CGTCGAGGAATTACCA,sample,10771,10523,1162,9361,1925,7436,3777,168,2024,200,5801,1267,1431,593,1628,1419
TCTCCTAGAATTACCA,sample,7788,7674,759,6915,868,6047,3385,217,1553,156,4938,736,1253,681,890,652
ATGAATAGAATTACCA,sample,14537,14228,2801,11427,1557,9870,3104,152,3715,405,6819,2494,2245,524,1160,1035
TCAATCAGAATTACCA,sample,9888,9634,1452,8182,1191,6991,3436,147,1862,198,5298,1348,1119,371,1935,963
CGCGAGACAATTACCA,sample,9658,9450,1150,8300,1439,6861,3716,312,1615,162,5331,1056,1439,706,1238,1138
AGATACTAAATTACCA,sample,17862,17447,3488,13959,1841,12118,4244,232,4038,530,8282,3074,2309,590,1482,1165
TTAACTGAAATTACCA,sample,13685,13457,1874,11583,1778,9805,4436,295,2876,237,7312,1961,1946,726,1273,1207
CTGGTCTTTAGATGAC,Pos_Ctrl,10663,10548,474,10074,564,9510,8016,788,486,46,8502,174,2362,2172,933,317
GTCGTTCTTAGATGAC,sample,38648,38175,5466,32709,5545,27164,8914,613,9667,1059,18581,6911,4369,985,3667,3683
AGAGTTCTTAGATGAC,sample,45780,45180,3738,41442,8631,32811,15471,786,9539,1036,25010,5979,3315,991,7615,5886
AGCTGAATTAGATGAC,sample,32461,31833,3868,27965,4763,23202,9334,672,8291,850,17625,4055,2836,1002,3117,3013
CATAATGGTAGATGAC,sample,24796,24383,4095,20288,2402,17886,4332,231,7079,766,11411,5478,3865,766,1597,1407
TATACGGATAGATGAC,sample,31043,30648,2891,27757,6465,21292,12434,839,4453,489,16887,3077,2627,1241,4311,4390
GGAGAAGCTAGATGAC,sample,25261,24855,3029,21826,3737,18089,8730,489,5088,513,13818,3269,2911,1118,2562,2454
CATACTCCTAGATGAC,Pos_Ctrl,31761,30748,2900,27848,1294,26554,22331,1905,1635,205,23966,478,4615,4614,1881,690
CTAGCGACTAGATGAC,sample,20044,19717,1765,17952,2138,15814,7245,508,5542,578,12787,1941,2431,1097,1741,1488
GGTAGAGATAGATGAC,sample,48764,48007,5289,42718,9884,32834,17687,831,8629,833,26316,4854,3403,1156,7146,6813
CGTCGCCATAGATGAC,sample,19823,19452,2102,17350,2742,14608,7318,347,4564,486,11882,1893,2075,906,2446,2071
TCATACCATAGATGAC,sample,24548,24071,4215,19856,3140,16716,5502,278,5817,571,11319,4548,3086,802,2055,1977
ATTCAAGGTAGATGAC,sample,42623,42051,5245,36806,6195,30611,12379,557,9419,1206,21798,7050,3822,1037,5292,4043
TGATTCCGTAGATGAC,Pos_Ctrl,35807,35020,3657,31363,1714,29649,24807,2096,1937,241,26744,568,4834,4871,2253,883
TACGCGAGTAGATGAC,sample,24955,24404,4228,20176,3715,16461,5805,343,5681,663,11486,3969,3118,865,2212,2321
GACTCAAGTAGATGAC,sample,16462,16120,2861,13259,1670,11589,3917,228,3984,442,7901,3018,2404,534,1825,1099
CCGCAGTCTAGATGAC,sample,7784,7568,1341,6227,1422,4805,2071,136,1398,176,3469,1024,1258,485,783,945
TCTCAGGATAGATGAC,sample,20995,20633,2909,17724,3018,14706,6172,401,4405,495,10577,3233,2713,933,2111,2080
TGGATCAATAGATGAC,sample,37989,37270,7748,29522,4388,25134,6387,408,9582,989,15969,7768,4961,983,1990,2518
ACGCTTAATAGATGAC,sample,27137,26747,4012,22735,2866,19869,7689,573,6931,683,14620,3993,3387,1284,1789,1961
CATTCGGTTAGATGAC,sample,31818,31253,3580,27673,5521,22152,9760,502,6526,607,16286,4757,2916,906,4059,3805
TAGCGAGTTAGATGAC,sample,23260,22960,2597,20363,4441,15922,9565,693,3210,395,12775,2059,2372,1325,2115,2916
CCTAGCGGTAGATGAC,sample,17851,17506,2568,14938,2366,12572,4965,218,3980,437,8945,2972,2218,603,2386,1694
CTAACCGGTAGATGAC,sample,21320,20923,3397,17526,3203,14323,6277,298,4117,463,10394,3168,2271,640,3018,2073
GCCTATTCTAGATGAC,sample,10854,10606,1404,9202,2492,6710,3168,191,1895,239,5063,1217,1509,556,1532,1531
TGCGCTCCTAGATGAC,sample,27885,27511,4515,22996,2303,20693,7349,513,7940,987,15289,3904,3389,1089,1640,1717
TCTCCTAGTAGATGAC,sample,22256,21806,2354,19452,3844,15608,7451,426,4369,451,11820,2911,1924,745,2901,2787
TCTAGGTTGTTCAGAA,sample,10592,10280,1886,8394,1133,7261,1904,163,2836,296,4740,2062,1763,364,769,729
GTCGTTCTGTTCAGAA,sample,21304,20768,3720,17048,2353,14695,2930,262,5886,659,8816,4958,3099,512,873,1315
CATAATGGGTTCAGAA,sample,11484,11270,1763,9507,1696,7811,2280,133,3171,388,5451,1839,2087,576,491,1086
TATACGGAGTTCAGAA,sample,19993,19651,2376,17275,3391,13884,6828,459,3794,374,10622,2429,2379,884,2385,2419
GGAGAAGCGTTCAGAA,sample,12771,12535,2298,10237,1409,8828,2762,137,3212,358,5974,2359,2163,567,826,905
TCATACCAGTTCAGAA,sample,25657,25223,2786,22437,4874,17563,9255,445,4377,416,13632,3070,2054,790,3425,3433
GCAACTAGGTTCAGAA,sample,3046,2906,532,2374,361,2013,601,26,812,82,1413,492,739,235,173,277
GACTCAAGGTTCAGAA,sample,15413,15142,2030,13112,1454,11658,4656,258,4043,425,8699,2276,2259,767,1310,1062
CCGCAGTCGTTCAGAA,sample,12706,12432,1389,11043,2680,8363,4849,357,1998,235,6847,924,1602,927,1485,1898
TGGATCAAGTTCAGAA,sample,20808,20352,3277,17075,1624,15451,4128,224,5928,683,10056,4488,3009,585,1388,1069
ATGGCGTTGTTCAGAA,sample,13339,13108,1823,11285,1276,10009,3583,254,3565,378,7148,2229,1906,655,844,971
CCATTCTTGTTCAGAA,sample,10571,10374,977,9397,2169,7228,4628,197,1536,121,6164,746,1071,591,1603,1512
CGGTTGGTGTTCAGAA,sample,4059,3978,403,3575,659,2916,1651,134,662,75,2313,394,798,387,624,422
CATTCGGTGTTCAGAA,sample,21177,20736,3515,17221,1675,15546,4543,200,5561,599,10104,4643,3075,654,1853,977
TAGCGAGTGTTCAGAA,sample,8032,7839,875,6964,1025,5939,3067,194,1462,135,4529,1081,1128,447,1234,754
AAGGTCTGGTTCAGAA,sample,88627,87289,10282,77007,7059,69948,22387,2127,22692,2434,45079,20308,6109,1068,3992,3924
TAACGAAGGTTCAGAA,sample,64074,63377,5843,57534,7724,49810,19070,1551,15570,1887,34640,11732,6088,1414,2561,5100
GGCGTACCGTTCAGAA,sample,92430,91211,12638,78573,9684,68889,25571,1282,22473,2700,48044,16863,7139,1287,11011,6413
GTCGCGAAGTTCAGAA,sample,42309,41827,5541,36286,3788,32498,11870,583,11064,1226,22934,7755,4697,1018,4372,2261
CGTCGAGGGTTCAGAA,sample,35512,35143,2189,32954,5240,27714,16504,1249,6450,649,22954,2862,2743,1330,5557,3721
ATTCTACCGTTCAGAA,sample,53607,52860,5929,46931,7109,39822,18832,1059,11247,1152,30079,7532,4230,927,9048,4878
GACTAACCGTTCAGAA,sample,34305,33811,1999,31812,8450,23362,14469,729,5101,487,19570,2576,1986,756,6794,5616
CGTAGAACGTTCAGAA,sample,53544,52861,4360,48501,7785,40716,20192,1051,11439,1312,31631,6722,4185,1063,7661,5028
AGATACTAGTTCAGAA,sample,57920,57347,4851,52496,7977,44519,22397,1327,12955,1804,35352,6036,3782,1225,9455,5774
CCTAACTAGTTCAGAA,Pos_Ctrl,32103,31750,1369,30381,1292,29089,24554,2618,1265,170,25819,482,4288,5020,1917,459
ATATGCAAGTTCAGAA,sample,210,203,23,180,22,158,71,5,43,5,114,34,57,21,25,18
GTCGTTCTTTCTGGTT,Neg_Ctrl,2398,642,478,164,33,131,57,0,50,4,107,20,66,21,21,3
CATAATGGTTCTGGTT,sample,28906,28361,5336,23025,2377,20648,5765,280,7926,727,13691,5950,4168,907,1872,1348
CTAGCGACTTCTGGTT,Neg_Ctrl,1157,603,301,302,36,266,109,6,83,5,192,63,104,35,28,13
TCGAACGATTCTGGTT,sample,24431,24061,3319,20742,3625,17117,7264,261,5517,632,12781,3443,2624,678,3587,2321
GCAACTAGTTCTGGTT,Neg_Ctrl,413,238,148,90,12,78,25,1,25,6,50,21,36,21,9,3
GACTCAAGTTCTGGTT,sample,2061,2002,349,1653,317,1336,483,19,431,73,914,330,436,115,232,187
CCGCAGTCTTCTGGTT,sample,8546,8319,1298,7021,1251,5770,1848,102,2078,233,3926,1509,1522,381,756,818
TGCGCGTTTTCTGGTT,sample,53278,52356,8574,43782,4583,39199,11046,685,15495,1853,26541,10120,5460,1194,3380,2834
CATTCGGTTTCTGGTT,sample,33993,33494,3600,29894,3654,26240,10769,833,8296,720,19065,5622,3445,746,4794,2424
CCTAGCGGTTCTGGTT,sample,26210,25780,3612,22168,1964,20204,7045,501,7331,770,14376,4557,3310,1014,1613,1198
CTAACCGGTTCTGGTT,sample,20258,19879,2882,16997,3508,13489,3461,272,5067,548,8528,4141,2777,555,1079,2186
GGCGACGATTCTGGTT,sample,30657,30098,2399,27699,6324,21375,14193,822,4257,417,18450,1686,1965,1127,6172,4446
TAACGAAGTTCTGGTT,sample,36553,36085,5069,31016,4649,26367,11063,521,8072,859,19135,5852,3797,1095,4547,3084
AGCAGAGCTTCTGGTT,sample,17817,17453,1855,15598,2884,12714,6669,352,3186,427,9855,2080,1972,736,3163,2102
CGTCGAGGTTCTGGTT,sample,7616,7421,990,6431,1248,5183,3065,169,1161,161,4226,627,870,434,1294,918
AAGTAGAGTTCTGGTT,sample,63573,62424,8715,53709,5143,48566,18159,868,16432,1762,34591,11345,5762,1183,6197,3098
CGCGAGACTTCTGGTT,sample,46548,45701,4542,41159,5219,35940,15530,970,12182,1292,27712,5966,3089,829,6178,4154
AGATACTATTCTGGTT,sample,64660,63961,4295,59666,11538,48128,33078,2154,8567,1056,41645,3273,2565,1341,11108,8441
TTAACTGATTCTGGTT,sample,41669,40985,3479,37506,4050,33456,15815,1107,10520,1345,26335,4669,3300,1135,5049,3031
ATATGCAATTCTGGTT,sample,37331,36916,3535,33381,5207,28174,14905,945,7234,632,22139,4458,3383,1217,5498,3496
GAGCCTCCGTTCGGTT,sample,25646,25143,2590,22553,4639,17914,9939,655,4506,570,14445,2244,2205,1006,4103,3258
CATACTCCGTTCGGTT,sample,20031,19584,2294,17290,4048,13242,7444,378,3296,339,10740,1785,1811,700,3801,2729
CTAGCGACGTTCGGTT,sample,15815,15476,2507,12969,1668,11301,3820,310,4185,553,8005,2433,2464,727,1286,1099
TCGAACGAGTTCGGTT,sample,106851,105582,9247,96335,14219,82116,39104,2105,22516,2260,61620,16131,5805,1508,12597,10461
TACGCGAGGTTCGGTT,sample,45853,45142,4914,40228,8644,31584,16475,1060,8261,964,24736,4824,3633,1414,5525,5688
GGCAGGTTGTTCGGTT,sample,48748,47893,6433,41460,8042,33418,14000,812,10029,1079,24029,7498,4467,1427,4306,5400
ATGGCGTTGTTCGGTT,sample,96440,95228,8441,86787,11408,75379,34339,1965,23907,2633,58246,12535,5350,1610,12932,8103
ACGCTTAAGTTCGGTT,sample,7406,7269,878,6391,878,5513,2769,204,1526,151,4295,863,1468,765,700,613
GCTCTTCTGTTCGGTT,sample,129798,128071,12059,116012,15785,100227,43320,2384,30933,3125,74253,20465,7192,1636,14959,11085
GAGATTCTGTTCGGTT,sample,65912,65009,5501,59508,9368,50140,26819,1549,13461,1385,40280,6926,4072,1409,9766,6432
CCTAGCGGGTTCGGTT,sample,81345,80248,6480,73768,7672,66096,27226,1593,20592,2162,47818,14523,6070,1140,7358,4996
CTAACCGGGTTCGGTT,sample,80176,79134,2779,76355,11280,65075,46275,4505,9310,1088,55585,3897,2301,988,6538,7763
ATACCGCCGTTCGGTT,sample,71050,70232,5821,64411,10879,53532,28563,1605,14754,1326,43317,7284,4117,1370,10853,7799
GCGTTACCGTTCGGTT,sample,37833,37169,5048,32121,5194,26927,11632,701,8144,904,19776,5546,4152,1197,4403,3573
TCTCCTAGGTTCGGTT,sample,86174,84972,8083,76889,10930,65959,33495,2340,18234,1724,51729,10166,5209,1373,11713,7644
ATGAATAGGTTCGGTT,sample,45669,45066,3571,41495,8014,33481,20994,1088,6730,725,27724,3944,2136,903,9988,5812
AAGTAGAGGTTCGGTT,sample,26063,25623,3273,22350,2512,19838,7499,578,6785,888,14284,4088,3321,1038,2503,1654
TCAATCAGGTTCGGTT,sample,28220,27757,4100,23657,2888,20769,8116,488,6496,729,14612,4940,3453,884,3363,1867
TAACGCCAGTTCGGTT,sample,142771,141597,11094,130503,17298,113205,55221,3813,30483,2776,85704,20912,8082,2022,9170,12271
ATTCTACCGTTCGGTT,sample,131129,129828,9718,120110,14086,106024,49767,3747,31696,3627,81463,17187,6286,1498,14882,10528
GACTAACCGTTCGGTT,sample,59042,58291,5415,52876,6736,46140,21898,1553,14241,1531,36139,6917,4285,1602,4366,4697
CGTAGAACGTTCGGTT,sample,55297,54598,4554,50044,11644,38400,22732,1272,8137,1069,30869,5190,3520,1217,9361,7868
AGATACTAGTTCGGTT,sample,62486,61669,7808,53861,7309,46552,15855,1123,16194,2135,32049,11245,5425,1242,4796,4757
GCGCAATAGTTCGGTT,Neg_Ctrl,961,317,210,107,17,90,31,2,42,0,73,15,44,21,14,2
AACCGGTTTGGCGGTT,sample,134610,132421,13229,119192,15587,103605,38396,2202,39037,4118,77433,19852,6918,1965,14128,10495
CTGGTCTTTGGCGGTT,sample,100551,98937,10414,88523,12560,75963,29478,2342,24127,2621,53605,17395,7077,2121,9087,8492
AGAGTTCTTGGCGGTT,sample,126964,124997,12932,112065,15542,96523,42660,2683,31915,3315,74575,15950,5278,1509,15735,10405
AGCTGAATTGGCGGTT,sample,118194,116324,11761,104563,11159,93404,41423,2350,31061,3457,72484,15113,6001,1835,10872,7687
CATAATGGTGGCGGTT,sample,13122,12752,1887,10865,1692,9173,4102,278,2743,307,6845,1743,1861,609,1851,1132
TATACGGATGGCGGTT,sample,143050,140268,7732,132536,23778,108758,73988,5151,18884,1821,92872,8914,3642,1669,26100,17194
CATACTCCTGGCGGTT,sample,91561,90544,9396,81148,15515,65633,23660,1202,21808,2661,45468,16302,8079,1488,11041,10225
CTAGCGACTGGCGGTT,sample,109261,107518,9545,97973,14596,83377,35643,2320,29098,2752,64741,13564,5427,1688,10132,10722
GGTAGAGATGGCGGTT,sample,63912,62798,5275,57523,12958,44565,26647,1512,9823,916,36470,5667,3920,1570,8769,8819
TACGCGAGTGGCGGTT,sample,61340,60369,8195,52174,8354,43820,16374,874,14605,1592,30979,10375,5444,1405,5703,5385
GACTCAAGTGGCGGTT,sample,57175,56398,5172,51226,6497,44729,19078,1342,15652,1807,34730,6850,4313,1531,5491,4405
CCGTACGCTGGCGGTT,sample,93220,91490,10318,81172,11516,69656,23503,1338,25806,2568,49309,16441,6598,1372,8268,7536
TGGATCAATGGCGGTT,sample,137433,135652,14693,120959,20392,100567,46150,2680,29450,3706,75600,18581,6951,1632,21835,13747
GGCAGGTTTGGCGGTT,sample,147517,146097,6497,139600,28472,111128,83471,5251,15918,1838,99389,4650,3722,2622,16526,19714
GATGCGTTTGGCGGTT,sample,32937,32094,4790,27304,4351,22953,6010,392,9050,925,15060,6576,3916,736,1934,2797
CCATTCTTTGGCGGTT,sample,88417,87019,7300,79719,12145,67574,28451,2091,22621,2663,51072,11748,5163,1710,6546,8081
TAGCGAGTTGGCGGTT,sample,206257,203902,16836,187066,21242,165824,63693,4419,60677,6842,124370,30193,9057,2186,21358,14774
GAGATTCTTGGCGGTT,sample,40116,39103,4445,34658,5460,29198,14676,762,8021,791,22697,4948,3014,1002,6369,4166
CCTAGCGGTGGCGGTT,sample,66022,65328,5058,60270,9700,50570,26335,1677,13840,1527,40175,7191,4238,1651,9452,7079
GGCGACGATGGCGGTT,sample,95992,94245,11792,82453,10164,72289,28716,1752,23279,2754,51995,15788,7037,1491,13852,7265
GCGTTACCTGGCGGTT,sample,139874,138199,9615,128584,23433,105151,55573,3285,26932,3105,82505,16256,6868,2257,15298,17612
CGTCGAGGTGGCGGTT,sample,15925,15576,1532,14044,1703,12341,6865,476,2966,374,9831,1660,2244,1212,1171,1408
TCAATCAGTGGCGGTT,sample,80960,79938,6578,73360,9931,63429,28396,1209,19963,2199,48359,11662,5366,1170,11650,7059
TAACGCCATGGCGGTT,sample,33908,33473,4613,28860,2751,26109,7639,510,10166,1055,17805,6739,4086,961,1931,1621
CGCGAGACTGGCGGTT,sample,53205,52201,5359,46842,7782,39060,16208,1243,12903,1383,29111,7323,4119,1068,5158,5152
CGTAGAACTGGCGGTT,sample,136737,135229,13658,121571,19262,102309,39511,3200,32895,3510,72406,23193,9277,2399,8935,12144
AGATACTATGGCGGTT,sample,98620,97314,8254,89060,17707,71353,45927,3548,14242,2124,60169,5512,2679,1069,17754,12800
TTAACTGATGGCGGTT,sample,88635,87601,8117,79484,9757,69727,28013,2520,21251,2575,49264,15368,6235,1276,9339,6129
CATAATGGTCCTTATT,sample,15759,15428,1557,13871,3165,10706,6282,270,2424,258,8706,1472,1327,593,3454,2254
TATACGGATCCTTATT,sample,36283,35641,5047,30594,5482,25112,10662,691,7612,793,18274,5354,3840,1239,3429,3490
GAGCCTCCTCCTTATT,sample,13238,12905,1478,11427,2156,9271,4323,187,2825,348,7148,1588,1670,474,2450,1451
TCGAACGATCCTTATT,sample,19711,19299,2587,16712,3403,13309,5588,280,4004,490,9592,2947,2398,734,2812,2198
GGTAGAGATCCTTATT,sample,37149,36502,4939,31563,3293,28270,11085,565,10195,1255,21280,5170,3729,1157,3190,2380
GACTCAAGTCCTTATT,sample,23415,22874,4362,18512,1889,16623,4941,203,6011,625,10952,4843,2988,627,1771,1146
CCGCAGTCTCCTTATT,sample,46737,45774,11164,34610,3529,31081,5005,300,13336,1357,18341,11083,6199,871,1310,1927
CCGTACGCTCCTTATT,sample,33435,32987,3926,29061,4588,24473,11436,765,6653,640,18089,4979,3684,1414,3442,3125
GATGCGTTTCCTTATT,sample,20770,20403,3992,16411,1682,14729,3679,174,5676,637,9355,4563,3101,530,1530,1059
ACGCTTAATCCTTATT,sample,24742,24297,2443,21854,3172,18682,9978,469,4525,531,14503,3179,2280,893,4145,2367
CATTCGGTTCCTTATT,sample,15789,15466,2104,13362,1627,11735,5967,333,3088,400,9055,1947,2278,1033,1377,1172
AAGGTCTGTCCTTATT,sample,15050,14810,1479,13331,2946,10385,6564,419,2018,263,8582,1121,1614,869,2670,2027
GGCGACGATCCTTATT,sample,10208,10008,1943,8065,990,7075,2094,175,2498,312,4592,1996,1727,431,742,586
TGCGCTCCTCCTTATT,sample,7778,7672,786,6886,992,5894,2294,99,2051,241,4345,1209,1514,455,741,662
ATACCGCCTCCTTATT,sample,20386,20126,1830,18296,2850,15446,6558,393,4914,476,11472,3105,2471,687,2760,1950
GCGTTACCTCCTTATT,sample,12895,12711,1712,10999,1233,9766,4131,355,2951,308,7082,2021,2124,719,1329,817
GGCGTACCTCCTTATT,sample,18935,18637,1170,17467,2915,14552,9529,742,2764,304,12293,1213,1573,815,3401,2024
CGTCGAGGTCCTTATT,Pos_Ctrl,14160,13995,830,13165,535,12630,10632,1129,559,80,11191,230,2936,2936,603,238
TTATGACGTCCTTATT,sample,57186,56664,4605,52059,6718,45341,20228,1324,13473,1314,33701,9002,4321,1054,8117,5005
ATGAATAGTCCTTATT,sample,112028,110972,16334,94638,5959,88679,19106,1371,37740,4067,56846,26395,10140,1751,3796,2624
AAGTAGAGTCCTTATT,sample,37178,36801,2190,34611,8392,26219,15584,1267,5195,558,20779,3615,2768,1289,3086,5285
TCAATCAGTCCTTATT,sample,53258,52591,4898,47693,7626,40067,20623,1785,10451,937,31074,6271,3714,1069,5181,5320
GACTAACCTCCTTATT,sample,47042,46468,6036,40432,4577,35855,14069,714,11721,1340,25790,8011,4472,979,4792,2821
CGCGAGACTCCTTATT,sample,14857,14605,1513,13092,1431,11661,5615,429,3419,348,9034,1850,2209,994,986,937
CGTAGAACTCCTTATT,sample,31049,30470,7163,23307,1399,21908,3259,158,9400,1000,12659,8091,4544,638,713,573
GTCGTTCTAATAAGGT,sample,25623,24989,5679,19310,2036,17274,3354,255,7076,751,10430,5838,3537,603,1143,1138
CATAATGGAATAAGGT,sample,102396,100987,13442,87545,7269,80276,20316,886,31015,3112,51331,24947,8588,1291,8628,4455
GAGCCTCCAATAAGGT,sample,19158,18876,2613,16263,3710,12553,5762,447,3363,366,9125,2615,2804,1216,1716,2408
CTAGCGACAATAAGGT,sample,43961,42953,7586,35367,3638,31729,8951,637,12455,1339,21406,8347,5162,1523,1915,2446
ATACGTTCAATAAGGT,sample,27679,27336,2072,25264,7050,18214,12171,870,3197,329,15368,1647,2436,1509,4193,4458
CCGCAGTCAATAAGGT,sample,1704,1650,133,1517,357,1160,697,52,272,12,969,127,398,234,274,235
CCGTACGCAATAAGGT,sample,23280,22963,2402,20561,3380,17181,7866,360,5082,540,12948,3333,3039,1065,3054,2271
TGGATCAAAATAAGGT,sample,104973,103600,14548,89052,9854,79198,23284,1433,28626,3128,51910,22727,7871,1374,10571,6003
ATGGCGTTAATAAGGT,Pos_Ctrl,70057,68771,5310,63461,2883,60578,50657,4579,3533,508,54190,1301,5900,7091,3932,1144
CCATTCTTAATAAGGT,sample,87855,86435,13946,72489,7434,65055,14274,819,26064,2775,40338,21123,8858,1479,4879,4592
TAGCGAGTAATAAGGT,sample,170109,168411,10784,157627,25959,131668,67364,4267,34525,4218,101889,21294,6575,2010,18605,17972
GCTCTTCTAATAAGGT,sample,34618,34082,4185,29897,5614,24283,12070,778,6333,690,18403,4412,3481,1348,3743,3445
CTAAGCATAATAAGGT,sample,75772,74744,7118,67626,7631,59995,23083,1679,21512,2692,44595,11029,4993,1455,6116,4901
CCTAGCGGAATAAGGT,Pos_Ctrl,36426,35827,2681,33146,1434,31712,26852,2423,1708,196,28560,533,4649,4977,2491,624
GCTGCTTCAATAAGGT,sample,83859,82807,6495,76312,11824,64488,31621,1575,20301,2106,51922,8885,4197,1376,11400,8396
GCCTATTCAATAAGGT,sample,121051,119237,11935,107302,13923,93379,39770,2383,29024,2865,68794,19337,5925,1476,17619,9963
TGCGCTCCAATAAGGT,sample,32524,31959,3832,28127,4252,23875,11692,574,6567,791,18259,4251,2898,817,5133,2967
CAGCTTCGAATAAGGT,sample,97046,95707,8830,86877,11791,75086,40031,2879,19333,1659,59364,11184,5331,1516,11426,8634
TCTCCTAGAATAAGGT,sample,102132,100892,9434,91458,13517,77941,39056,2816,22095,1938,61151,12036,5506,1564,12905,9298
ATGAATAGAATAAGGT,sample,97380,95883,14342,81541,6993,74548,16055,1029,30614,3084,46669,23766,8012,1357,4146,3608
AAGTAGAGAATAAGGT,sample,101471,100112,10618,89494,10088,79406,38347,2509,21997,2615,60344,13938,6147,1763,8557,6519
TAACGCCAAATAAGGT,sample,87370,85992,9907,76085,11263,64822,29984,1625,19356,2213,49340,11644,5559,1261,11761,8050
TTAACTGAAATAAGGT,sample,87391,86542,5115,81427,14523,66904,38321,2098,16670,2562,54991,7253,3514,1157,16234,9888
TCTAGGTTCAGGACCA,sample,102803,101084,10501,90583,17853,72730,33401,2139,22481,2494,55882,12215,5428,1613,13649,12655
GGAGAAGCCAGGACCA,sample,37865,37164,6770,30394,4215,26179,8979,522,9680,956,18659,6042,4101,928,3877,2675
CGTCGCCACAGGACCA,sample,97299,95984,8314,87670,12398,75272,48421,2938,13887,1522,62308,8504,5175,2328,11435,9491
TCATCGAACAGGACCA,sample,128524,126869,14650,112219,15640,96579,40600,1950,30671,3495,71271,19863,7485,1683,17186,10507
TCATACCACAGGACCA,sample,76440,75234,6178,69056,12560,56496,31582,1671,14102,1363,45684,7778,3226,1174,13861,8847
GCAACTAGCAGGACCA,sample,7995,7714,1296,6418,856,5562,1909,111,2062,252,3971,1228,1634,522,687,611
CCGCAGTCCAGGACCA,sample,30877,30258,3429,26829,3935,22894,9898,701,7629,841,17527,3825,3319,1139,3721,2822
TGCGCGTTCAGGACCA,sample,40417,39685,3882,35803,6198,29605,18395,1172,5746,782,24141,3510,2618,1393,5082,4573
CCATTCTTCAGGACCA,sample,62726,61611,5670,55941,9792,46149,26062,2340,10502,998,36564,6247,4239,1853,6647,6977
AGCGTCTTCAGGACCA,sample,172966,171153,19789,151364,13838,137526,50050,3149,47186,5546,97236,31595,9016,2175,12083,9227
GCTCTTCTCAGGACCA,sample,82605,81476,6396,75080,9168,65912,34719,2073,18315,2112,53034,8693,4122,1642,12041,6564
AAGGTCTGCAGGACCA,sample,139777,138145,14142,124003,20087,103916,49644,3115,28079,2747,77723,20331,7990,2183,13730,14693
AGCAGAGCCAGGACCA,sample,89018,87591,12288,75303,10763,64540,27742,1370,19799,2104,47541,13525,6135,1262,13726,7454
TGCGCTCCCAGGACCA,sample,127764,125672,25350,100322,11236,89086,18163,848,36601,3792,54764,29682,10668,1485,6431,6512
GGCGTACCCAGGACCA,sample,58472,57588,3799,53789,11744,42045,25603,1224,9353,764,34956,5101,2846,1024,13254,8593
GTCGCGAACAGGACCA,sample,37078,36452,5214,31238,5363,25875,9974,452,8800,944,18774,5705,3849,868,4668,3304
CAGCTTCGCAGGACCA,Neg_Ctrl,2389,1096,862,234,26,208,88,12,62,8,150,38,80,29,50,7
TTATGACGCAGGACCA,sample,66085,64932,5461,59471,14817,44654,24614,1526,10478,1060,35092,6976,4145,1339,8740,9864
TCTCCTAGCAGGACCA,sample,82085,80915,9447,71468,10151,61317,27584,1520,17627,2478,45211,12108,5103,1166,10195,6965
TCAATCAGCAGGACCA,sample,58775,57853,6247,51606,5415,46191,18642,1292,15854,1984,34496,8419,4966,1220,5268,3612
TAACGCCACAGGACCA,sample,53984,53494,3273,50221,7948,42273,23666,1457,10677,1222,34343,5251,3629,1032,9420,5457
GACTAACCCAGGACCA,sample,64798,63744,8860,54884,9860,45024,22448,1627,12674,1317,35122,6958,2952,919,9103,7005
AGATACTACAGGACCA,sample,52292,51577,4384,47193,8882,38311,25767,1380,7672,989,33439,2503,1791,866,10545,6765
GTCGTTCTCCTCGTTG,sample,22145,21611,3095,18516,4008,14508,7428,440,3921,322,11349,2397,2305,908,3059,2707
AGCTGAATCCTCGTTG,sample,32741,32065,3415,28650,4514,24136,11693,789,7435,890,19128,3329,2615,1199,3415,3347
GAGCCTCCCCTCGTTG,sample,63613,62615,6546,56069,7454,48615,18659,1261,16569,1677,35228,10449,5413,1310,6945,4808
CATACTCCCCTCGTTG,sample,28456,27871,3067,24804,4037,20767,10202,594,5854,763,16056,3354,2781,1145,3807,2591
GGTAGAGACCTCGTTG,sample,82504,80991,11409,69582,8739,60843,27996,1747,17476,1812,45472,11812,5863,1728,6886,6272
TCATACCACCTCGTTG,sample,124697,122868,17832,105036,11232,93804,27820,1957,34879,3647,62699,25501,8787,1551,11993,6932
CCGTACGCCCTCGTTG,sample,14455,14141,2171,11970,1761,10209,4715,378,2757,300,7472,2059,2000,794,1490,1148
TGGATCAACCTCGTTG,sample,122778,121421,15497,105924,13468,92456,39966,2547,27803,2943,67769,19197,7331,1803,12970,8764
GATGCGTTCCTCGTTG,sample,50339,49255,7299,41956,7248,34708,10253,877,13277,1373,23530,8928,4564,907,2332,4453
ATGGCGTTCCTCGTTG,sample,158078,156398,10454,145944,21738,124206,61891,5897,37300,4039,99191,15079,5451,1665,20994,15451
TGCGCGTTCCTCGTTG,Neg_Ctrl,4454,1368,1001,367,33,334,130,8,113,9,243,74,136,44,47,4
TAGCGAGTCCTCGTTG,sample,66744,65824,8030,57794,8093,49701,22026,1428,14840,1269,36866,10138,5271,1216,7832,5680
GCTCTTCTCCTCGTTG,sample,101433,99982,10825,89157,10766,78391,28085,1477,26077,3233,54162,19519,7319,1371,9614,6733
CTAACCGGCCTCGTTG,Neg_Ctrl,2290,761,542,219,34,185,78,3,57,5,135,42,74,21,34,5
GGCGACGACCTCGTTG,sample,51260,50343,2866,47477,9926,37551,26432,1502,6418,1031,32850,2168,1852,964,11993,7401
TAACGAAGCCTCGTTG,sample,67454,66531,7096,59435,8955,50480,27294,1081,12980,1409,40274,7716,3374,1041,14158,6385
AGCAGAGCCCTCGTTG,sample,93712,92703,10601,82102,8733,73369,27300,1413,23874,2654,51174,18128,6498,1270,6199,5077
TCTCCTAGCCTCGTTG,sample,21917,21624,2923,18701,3530,15171,6421,454,4710,507,11131,3079,2605,1036,1507,2366
ATGAATAGCCTCGTTG,sample,81399,80285,7918,72367,10013,62354,29630,1709,16898,2290,46528,11827,4317,1058,12034,7364
AAGTAGAGCCTCGTTG,sample,40788,40160,4977,35183,4441,30742,11919,817,10461,956,22380,6589,4053,933,4363,2923
TCAATCAGCCTCGTTG,sample,72734,71874,7218,64656,8422,56234,25223,1450,16869,1629,42092,11063,4928,1219,8984,6444
TAACGCCACCTCGTTG,sample,84961,84079,10730,73349,8141,65208,22646,1246,22338,2190,44984,16788,6751,1112,10309,5340
ATTCTACCCCTCGTTG,Pos_Ctrl,57389,56465,4147,52318,2326,49992,42531,3708,2622,289,45153,842,5233,6540,2767,929
CGTAGAACCCTCGTTG,sample,79499,78130,14637,63493,6294,57199,14372,1017,22419,2135,36791,17256,7029,1307,4154,3283
AGATACTACCTCGTTG,sample,90773,89819,6985,82834,11240,71594,40695,3266,16110,1439,56805,10084,4588,1630,11843,7868
CTGGTCTTTTGCGGAC,sample,57478,56841,4360,52481,11407,41074,25454,1442,8720,1117,34174,4341,2565,1130,12621,7980
AGAGTTCTTTGCGGAC,sample,28641,28381,3362,25019,3004,22015,8908,641,7747,961,16655,3758,3316,1220,2408,1961
CTAGCGACTTGCGGAC,sample,68083,67155,8262,58893,9542,49351,20913,974,15562,1550,36475,10352,5308,1085,10240,6040
TCATCGAATTGCGGAC,sample,80558,79662,7052,72610,12227,60383,29063,1605,17121,1740,46184,10854,4995,1611,10647,8465
ATTCAAGGTTGCGGAC,sample,20072,19753,2815,16938,2904,14034,6680,325,3844,433,10524,2752,2300,647,3339,1884
GCAACTAGTTGCGGAC,sample,2922,2859,434,2425,565,1860,671,40,667,69,1338,413,747,268,234,364
GACTCAAGTTGCGGAC,sample,48109,47655,3445,44210,4425,39785,28079,2081,6152,661,34231,2812,3901,2840,5774,3365
CCGCAGTCTTGCGGAC,sample,19775,19399,2053,17346,3793,13553,7960,385,3377,338,11337,1493,1648,701,4030,2726
CCGTACGCTTGCGGAC,sample,47814,47082,6097,40985,5141,35844,14870,778,11264,1613,26134,7319,4423,1173,6090,3247
TGGATCAATTGCGGAC,sample,30247,29822,3730,26092,4464,21628,10129,614,6414,748,16543,3723,3035,1015,4081,3094
GGCAGGTTTTGCGGAC,sample,112225,110615,13779,96836,13433,83403,25957,1379,29209,2902,55166,23956,8232,1640,10113,8740
GATGCGTTTTGCGGAC,sample,52213,51751,4778,46973,9287,37686,22164,1618,8213,1063,30377,4628,3555,1507,7909,6500
ATGGCGTTTTGCGGAC,sample,64861,64115,6200,57915,10262,47653,22042,1057,15193,1548,37235,7813,4557,1161,9262,6847
TGCGCGTTTTGCGGAC,sample,95032,93740,18207,75533,8580,66953,14695,896,27510,2846,42205,21006,8751,1436,5056,5429
CTAAGCATTTGCGGAC,sample,63196,62689,3740,58949,13416,45533,32443,1880,7059,918,39502,3233,2724,1661,11024,9816
GGCGACGATTGCGGAC,sample,31642,31132,4038,27094,5157,21937,10422,744,6187,710,16609,3874,3448,1265,3285,3446
GCCTATTCTTGCGGAC,sample,43506,42811,4043,38768,8104,30664,17951,859,7114,723,25065,4017,2540,985,8385,5982
ATACCGCCTTGCGGAC,sample,71051,70242,6030,64212,12490,51722,29602,1601,12106,1294,41708,7119,3723,1284,11737,8927
GGCGTACCTTGCGGAC,sample,83617,82813,10728,72085,13763,58322,27064,1798,16029,1990,43093,11441,4643,1206,11558,9483
GTCGCGAATTGCGGAC,sample,28444,27859,5531,22328,2813,19515,5941,413,7092,727,13033,5342,3691,945,1785,1711
CAGCTTCGTTGCGGAC,sample,52718,51902,4870,47032,7499,39533,21112,1398,9613,1044,30725,6366,3500,1148,6760,5530
TTATGACGTTGCGGAC,sample,54301,53709,3534,50175,5463,44712,24059,1620,12189,1465,36248,5379,3253,1307,6078,3867
ATGAATAGTTGCGGAC,sample,94869,93656,12862,80794,9275,71519,26753,1566,23988,2567,50741,16645,7009,1658,8012,6751
ATTCTACCTTGCGGAC,sample,80060,79125,6627,72498,12116,60382,34360,1980,15221,1547,49581,7274,3755,1001,11425,8598
GACTAACCTTGCGGAC,sample,40190,39847,2604,37243,7504,29739,15333,1471,7764,1081,23097,4090,2975,906,5328,5323
AGATACTATTGCGGAC,sample,55246,54661,8422,46239,4564,41675,12913,946,15289,1623,28202,10904,5237,1094,2673,2788
GCGCAATATTGCGGAC,sample,82848,81991,8328,73663,11284,62379,24662,1686,19579,2081,44241,14371,6573,1499,7528,7292
ATATGCAATTGCGGAC,sample,208,203,31,172,24,148,76,4,46,2,122,20,67,27,36,16
TCTAGGTTTCCATTGG,sample,108566,106357,9804,96553,10524,86029,34955,2523,28925,3591,63880,16035,4689,1188,10824,7630
AGCTGAATTCCATTGG,sample,45557,44643,7294,37349,4648,32701,12959,604,10259,1239,23218,7640,4543,1296,3516,2930
TACGCGAGTCCATTGG,sample,6462,6313,1207,5106,447,4659,1217,47,1836,175,3053,1384,1358,255,444,271
TGCGCGTTTCCATTGG,sample,27126,26725,4972,21753,1559,20194,4892,314,7604,837,12496,6547,3869,757,1101,795
TAGCGAGTTCCATTGG,sample,18666,18451,1789,16662,3054,13608,7396,577,3311,344,10707,1980,1970,841,1631,2111
GCTCTTCTTCCATTGG,sample,44989,44444,5308,39136,3708,35428,11453,745,12599,1258,24052,9373,4701,864,3601,2097
GAGATTCTTCCATTGG,sample,18764,18471,1181,17290,2392,14898,9570,550,3140,373,12710,1265,1291,575,3048,1820
AAGGTCTGTCCATTGG,sample,41613,41114,6450,34664,3246,31418,8951,616,11633,1463,20584,8755,5211,1132,1859,1951
CCTAGCGGTCCATTGG,sample,9993,9810,864,8946,1823,7123,3596,260,1941,223,5537,1103,1433,691,841,1131
CTAACCGGTCCATTGG,sample,23701,23364,3107,20257,1954,18303,6499,366,6119,690,12618,4629,3068,654,1653,1103
AGCAGAGCTCCATTGG,sample,24859,24430,2410,22020,2895,19125,11471,498,4477,425,15948,2254,2030,746,4673,2176
ATACCGCCTCCATTGG,sample,44884,44223,5113,39110,3747,35363,16910,1067,10010,1077,26920,6299,4291,1309,4466,2546
CGCGGTCGTCCATTGG,sample,36239,35715,4167,31548,4107,27441,11910,529,8382,725,20292,5895,3507,821,5390,2741
ATGAATAGTCCATTGG,sample,35535,35159,3286,31873,5439,26434,15518,872,5751,614,21269,3679,3250,1346,3299,3822
TAACGCCATCCATTGG,sample,29168,28777,3535,25242,2854,22388,9133,674,7392,767,16525,4422,3105,876,3137,1990
GACTAACCTCCATTGG,Neg_Ctrl,1434,439,339,100,14,86,34,2,26,3,60,21,37,12,11,1
GGAGAAGCCATAGGCG,sample,146617,143852,33263,110589,9205,101384,18160,758,42065,4498,60225,35903,11666,1689,6107,4724
CATACTCCCATAGGCG,sample,39331,38556,4256,34300,6001,28299,14929,842,7316,733,22245,4479,3250,1256,5875,4366
TCGAACGACATAGGCG,sample,87451,86266,11885,74381,8990,65391,22426,1124,23936,2419,46362,15486,6932,1355,9415,6159
GCAACTAGCATAGGCG,sample,3058,2969,522,2447,279,2168,472,51,947,112,1419,586,866,187,149,143
TACGCGAGCATAGGCG,sample,9769,9563,660,8903,2014,6889,4902,317,1128,99,6030,443,939,590,2368,1471
GACTCAAGCATAGGCG,sample,18021,17715,2740,14975,2181,12794,5056,275,4028,430,9084,3005,2547,800,1834,1422
CCGCAGTCCATAGGCG,sample,32262,31605,3404,28201,3807,24394,11947,711,7545,882,19492,3309,2969,1199,4132,2910
CCGTACGCCATAGGCG,sample,38291,37589,4829,32760,5693,27067,12703,612,7814,798,20517,5140,3128,933,6122,3949
TCTCAGGACATAGGCG,sample,32940,32345,2746,29599,6507,23092,15061,730,4561,437,19622,2303,2220,1065,7006,4657
TGGATCAACATAGGCG,sample,60632,59523,9592,49931,7812,42119,13554,795,14973,1630,28527,11167,5932,1379,4364,5290
CTAAGCATCATAGGCG,sample,88093,86938,9888,77050,8554,68496,28241,1525,22891,2715,51132,13124,5546,1444,11479,5890
AAGGTCTGCATAGGCG,sample,66563,65841,4524,61317,9498,51819,35738,2720,8331,1089,44069,3941,3703,2261,8167,6829
CTAACCGGCATAGGCG,sample,64569,63697,5034,58663,9999,48664,25672,1763,13482,876,39154,6871,3694,1082,12039,7372
GGCGACGACATAGGCG,sample,101298,99885,9506,90379,10921,79458,36642,1806,26438,2603,63080,11969,4338,1275,14980,8001
GCTGCTTCCATAGGCG,sample,84217,82862,10603,72259,9221,63038,23109,1642,21756,2159,44865,14372,6009,1357,9900,5875
GCCTATTCCATAGGCG,sample,80772,79770,5693,74077,12527,61550,37001,2154,13441,1663,50442,7291,4214,1733,8804,8352
GGCGTACCCATAGGCG,sample,62971,62117,7247,54870,5581,49289,19786,1253,16805,1722,36591,9723,5232,1232,6012,3844
CGTCGAGGCATAGGCG,sample,29443,29092,2802,26290,4972,21318,11428,706,5538,620,16966,3026,3197,1369,3200,3474
TCTCCTAGCATAGGCG,sample,3408,3325,316,3009,647,2362,1174,100,712,62,1886,314,736,353,380,404
ATGAATAGCATAGGCG,sample,80549,79710,9625,70085,10565,59520,22317,1767,19404,2301,41721,13731,6235,1501,6727,6844
CGCGAGACCATAGGCG,sample,77891,76721,5643,71078,10669,60409,35844,1644,14791,1643,50635,6487,3625,1111,17260,7986
CGTAGAACCATAGGCG,sample,25718,25216,2737,22479,3272,19207,8136,747,6403,678,14539,3243,2665,878,2658,2037
TTAACTGACATAGGCG,sample,84243,83475,7876,75599,9823,65776,30818,1779,18902,2042,49720,12235,5124,1374,11062,7281
ATATGCAACATAGGCG,sample,750,728,55,673,117,556,339,20,129,15,468,53,204,122,130,84
CTGGTCTTTTGGAGAG,Pos_Ctrl,116673,114081,8706,105375,4562,100813,84554,7328,6262,747,90816,1922,6643,8861,7386,1744
TATACGGATTGGAGAG,sample,44867,44162,4428,39734,5591,34143,14353,1051,11727,1137,26080,5875,3839,1368,3567,3912
CATACTCCTTGGAGAG,sample,54353,53633,6248,47385,3756,43629,15651,1185,16857,2002,32508,7934,4648,1586,3122,2321
TCGAACGATTGGAGAG,sample,118709,117217,15296,101921,11601,90320,33660,2286,28397,2995,62057,22982,8133,1960,10176,7586
TCATCGAATTGGAGAG,sample,94312,92795,15466,77329,8016,69313,19581,911,26665,2961,46246,19195,7843,1419,7465,4935
TGATTCCGTTGGAGAG,Pos_Ctrl,70571,69115,6001,63114,2929,60185,50512,4381,3684,448,54196,1160,5908,6857,4559,1396
GCAACTAGTTGGAGAG,sample,15599,15352,1411,13941,2110,11831,6800,417,2966,358,9766,1290,2366,1412,1776,1493
CCGCAGTCTTGGAGAG,sample,41483,40693,7391,33302,4658,28644,7627,422,10652,1245,18279,8698,4875,1055,2609,2678
TGCGCGTTTTGGAGAG,sample,111199,109961,8043,101918,16959,84959,54191,3878,15474,2290,69665,9126,5366,2376,12396,12395
TAGCGAGTTTGGAGAG,sample,81411,80408,5975,74433,10014,64419,41121,2689,12345,1490,53466,6774,4615,2379,9245,6499
CTAAGCATTTGGAGAG,sample,35296,34700,4108,30592,3771,26821,11932,671,8509,1034,20441,4675,3159,975,4760,2698
CTAACCGGTTGGAGAG,sample,36017,35387,6263,29124,2021,27103,7096,589,10691,1203,17787,7524,4256,978,1486,989
TAACGAAGTTGGAGAG,sample,55049,54233,5584,48649,4995,43654,19689,1291,12739,1375,32428,8560,4046,954,7090,3361
AGCAGAGCTTGGAGAG,sample,50874,50091,6153,43938,5495,38443,19153,939,10568,1264,29721,6519,3776,1005,9475,3690
ATACCGCCTTGGAGAG,sample,27691,27244,2119,25125,6847,18278,10436,740,4351,418,14787,2333,2638,1366,3574,4176
GGCGTACCTTGGAGAG,sample,106454,104595,17101,87494,10370,77124,26086,1223,26095,2860,52181,20860,7596,1382,11442,6879
CGTCGAGGTTGGAGAG,sample,66964,66005,6348,59657,8662,50995,24422,1807,13823,1515,38245,9428,4922,1368,8672,6170
TCTCCTAGTTGGAGAG,sample,107319,105738,13972,91766,9763,82003,30318,1707,27538,2714,57856,19726,7329,1360,11560,6396
ATGAATAGTTGGAGAG,sample,36956,36109,8913,27196,2074,25122,4900,318,10835,1199,15735,7870,4677,855,1201,1052
AAGTAGAGTTGGAGAG,sample,58249,57324,5768,51556,6066,45490,22638,1257,12716,1488,35354,7391,4013,1012,9677,4353
TCAATCAGTTGGAGAG,sample,89633,88433,11148,77285,8722,68563,26571,1434,22827,2659,49398,15072,6263,1331,8999,5827
TAACGCCATTGGAGAG,sample,179247,176763,30154,146609,12440,134169,31171,1941,53024,5516,84195,42517,12803,2058,10794,6386
ATTCTACCTTGGAGAG,sample,47956,46979,6782,40197,4949,35248,12021,742,12975,1281,24996,8229,4750,1199,1397,2985
CGTAGAACTTGGAGAG,sample,75627,74410,10108,64302,8333,55969,24954,1684,17185,1839,42139,10307,5820,1393,9772,5568
AGATACTATTGGAGAG,sample,69735,68399,13229,55170,5063,50107,10505,964,20994,2184,31499,15460,6694,1421,1845,2725
ATATGCAATTGGAGAG,sample,466,447,48,399,62,337,195,14,75,9,270,44,158,86,49,46
AACCGGTTTTCAAGCC,sample,58697,57904,6419,51485,14862,36623,18385,1207,9806,1070,28191,6155,3843,1372,7212,9474
AGAGTTCTTTCAAGCC,sample,187641,184433,37329,147104,10603,136501,28360,1631,58107,5771,86467,42632,12846,2272,7703,5733
CTAGCGACTTCAAGCC,sample,167997,165280,31875,133405,11585,121820,25398,1075,49225,5044,74623,41078,12481,1901,8603,6419
TCGAACGATTCAAGCC,sample,28323,27811,6344,21467,2367,19100,4381,268,7600,831,11981,6020,3842,691,1447,1283
GGTAGAGATTCAAGCC,sample,105121,103148,18727,84421,8385,76036,20808,1072,28563,2785,49371,22808,7900,1424,8353,4896
ATTCAAGGTTCAAGCC,sample,53791,52878,9129,43749,3637,40112,13492,902,15173,1594,28665,8951,5397,1509,3028,2354
GCAACTAGTTCAAGCC,sample,22068,21692,1819,19873,3381,16492,10153,779,3641,397,13794,1522,2607,1647,2145,2577
TGCGCGTTTTCAAGCC,sample,70335,69273,9623,59650,6685,52965,18643,1227,20151,2236,38794,10708,4795,1146,6616,4523
ACGCTTAATTCAAGCC,sample,64574,63825,6285,57540,7934,49606,28408,1840,10741,1227,39149,7390,4722,2041,5288,5377
CTAACCGGTTCAAGCC,sample,44148,43642,2525,41117,7462,33655,23725,1674,5423,452,29148,2381,2323,1305,8208,5633
TAACGAAGTTCAAGCC,sample,53670,52934,6541,46393,6196,40197,15055,951,13624,1557,28679,9010,4525,1140,6456,4357
GCTGCTTCTTCAAGCC,sample,73574,72530,10143,62387,6777,55610,19566,865,19651,2106,39217,13422,6180,1259,8863,4398
GCCTATTCTTCAAGCC,sample,48832,48215,4086,44129,10241,33888,17500,1468,8421,902,25921,5597,3871,1246,6225,6550
CGTCGAGGTTCAAGCC,Pos_Ctrl,41502,40785,3128,37657,1679,35978,30174,2958,1988,267,32162,591,4772,5420,1959,665
CAGCTTCGTTCAAGCC,sample,45972,45070,7036,38034,3774,34260,12533,684,11401,1239,23934,8403,4558,903,4679,2415
CGCGGTCGTTCAAGCC,sample,46946,46290,5289,41001,5329,35672,16726,1306,9855,1182,26581,6603,4211,1143,4851,3731
TCAATCAGTTCAAGCC,sample,41723,41165,4499,36666,3363,33303,13862,954,10646,1297,24508,6544,3820,1069,3522,2114
TAACGCCATTCAAGCC,sample,80205,79321,9763,69558,5876,63682,17985,1495,22894,2383,40879,18925,7240,1283,5709,3356
CGTAGAACTTCAAGCC,sample,38110,37508,4019,33489,3420,30069,12983,620,10157,1166,23140,5143,3344,1086,3407,2303
AGATACTATTCAAGCC,sample,83256,81933,11621,70312,8199,62113,23167,1538,20206,1937,43373,15265,6270,1260,8244,5757
GCGCAATATTCAAGCC,sample,99775,98219,16289,81930,5421,76509,16779,1176,31483,3291,48262,23780,9973,1591,3329,3068
ATATGCAATTCAAGCC,sample,37449,37069,3075,33994,4652,29342,14493,903,8260,798,22753,4888,3342,969,4717,3251
AACCGGTTAACTTAAC,sample,128585,127452,9346,118106,19753,98353,47170,3312,26364,2606,73534,18901,6941,1886,18544,13218
GTCGTTCTAACTTAAC,Neg_Ctrl,2638,914,592,322,43,279,111,17,95,1,206,55,106,46,38,6
AGCTGAATAACTTAAC,sample,81825,80519,10127,70392,10402,59990,21006,1386,19646,2239,40652,15713,6050,1223,7576,6964
GACGTATGAACTTAAC,sample,61071,60313,5964,54349,9731,44618,20640,1014,13118,1376,33758,8470,5090,1469,7666,6469
GGAGAAGCAACTTAAC,sample,55713,55034,3479,51555,12590,38965,28038,1445,5823,662,33861,2997,2018,1151,11847,8638
CATACTCCAACTTAAC,sample,67613,66879,5432,61447,9021,52426,27167,2247,14371,1642,41538,6999,4308,1697,8358,6212
CTAGCGACAACTTAAC,sample,69569,68724,4063,64661,14618,50043,31779,1868,10054,1032,41833,5310,3164,1476,13038,10278
GGTAGAGAAACTTAAC,sample,69118,68116,7549,60567,8097,52470,23332,1213,16543,1829,39875,9553,5139,1278,10466,5787
GCAACTAGAACTTAAC,Neg_Ctrl,1909,653,469,184,29,155,74,7,34,13,108,27,58,29,34,4
TACGCGAGAACTTAAC,sample,136364,134895,9221,125674,13966,111708,51470,4863,31666,3482,83136,20227,7755,2142,12301,9260
GACTCAAGAACTTAAC,sample,94238,92745,6528,86217,14043,72174,38151,3030,16963,2068,55114,11962,3749,1143,12922,10328
AAGGTCTGAACTTAAC,sample,93611,92431,10948,81483,9055,72428,26445,1584,24611,2785,51056,17003,6843,1314,12274,6221
GGCGACGAAACTTAAC,sample,47325,46542,5395,41147,6254,34893,16481,961,10105,1116,26586,6230,4207,1197,5141,4183
TAACGAAGAACTTAAC,sample,33425,32943,3798,29145,3960,25185,9475,702,7812,882,17287,6314,3739,1182,2254,2551
GCTGCTTCAACTTAAC,sample,44847,44308,2971,41337,5668,35669,23335,1344,6620,647,29955,3723,3101,1533,5924,4301
AGCAGAGCAACTTAAC,sample,38756,38246,5567,32679,3401,29278,11080,649,10100,1043,21180,6406,4064,1111,3577,2028
ATACCGCCAACTTAAC,sample,66444,65474,12261,53213,4647,48566,13141,779,18820,1885,31961,13941,6908,1366,4474,2389
TCTCCTAGAACTTAAC,sample,90772,89539,12938,76601,6678,69923,20823,1337,25185,2584,46008,19994,7360,1234,7933,4551
ATGAATAGAACTTAAC,sample,49041,48390,5804,42586,4616,37970,15299,1069,12223,1357,27522,8022,4479,985,5797,3265
TAACGCCAAACTTAAC,sample,41406,40832,5016,35816,4303,31513,11954,695,10735,1178,22689,6951,4089,963,4540,2681
ATTCTACCAACTTAAC,sample,41873,41334,3134,38200,8651,29549,19542,1488,5129,603,24671,2787,2469,1105,7697,6246
CGCGAGACAACTTAAC,sample,25469,24975,3146,21829,2323,19506,8070,589,6487,744,14557,3616,2691,877,2448,1564
TCTAGGTTATACTTGA,sample,37915,37217,3184,34033,8309,25724,16335,694,5466,674,21801,2555,2346,1069,7965,5656
CTGGTCTTATACTTGA,sample,123275,121127,19322,101805,12501,89304,25771,1592,34067,3872,59838,24002,8988,1706,10176,7617
AGCTGAATATACTTGA,sample,30941,30320,5255,25065,2653,22412,6808,477,8519,866,15327,5742,3360,950,2161,1544
CATACTCCATACTTGA,sample,63031,61909,6805,55104,9725,45379,22937,1034,12267,1194,35204,7947,3416,1012,11190,6756
GGTAGAGAATACTTGA,sample,64234,63177,9644,53533,7228,46305,18212,1041,15243,1490,33455,10319,5257,1261,7821,4852
ATTCAAGGATACTTGA,sample,104269,102669,7852,94817,15746,79071,47100,3439,17448,2019,64548,9065,4679,1418,12046,11196
GCAACTAGATACTTGA,sample,20731,20363,2261,18102,2288,15814,6574,677,5101,618,11675,2844,3235,1313,1436,1503
GACTCAAGATACTTGA,sample,43582,43017,4679,38338,7647,30691,11969,753,9785,1234,21754,6950,4512,1164,4701,5131
TCTCAGGAATACTTGA,sample,66930,65828,9296,56532,6482,50050,17450,1169,17500,1821,34950,12110,5826,1183,8062,4169
GATGCGTTATACTTGA,sample,65968,65210,4974,60236,11736,48500,29731,1621,10138,1038,39869,5972,3503,1505,12333,7939
ATGGCGTTATACTTGA,sample,78331,77223,9314,67909,7574,60335,25014,1349,20594,2444,45608,10934,5468,1572,8210,5381
GCTCTTCTATACTTGA,sample,39569,38892,5515,33377,7731,25646,10179,569,8471,854,18650,5573,3850,964,4373,5113
CTAACCGGATACTTGA,sample,46683,45992,6358,39634,4817,34817,11480,799,11896,1341,23376,9301,4840,1072,4846,2987
GCCTATTCATACTTGA,sample,96797,95322,10486,84836,9924,74912,29515,1510,24944,2638,54459,16305,6096,1334,12296,7071
AGCAGAGCATACTTGA,sample,49965,49305,6086,43219,6057,37162,18948,1215,9665,880,28613,6454,3937,1148,7071,4333
TGCGCTCCATACTTGA,sample,65387,64523,5056,59467,10278,49189,29786,1477,10640,1050,40426,6236,3078,1088,12398,7201
GGCGTACCATACTTGA,sample,89697,88352,14986,73366,6277,67089,19957,1203,24481,2773,44438,18675,8319,1811,3919,3884
CAGCTTCGATACTTGA,Neg_Ctrl,2052,690,458,232,28,204,70,14,80,5,150,35,94,29,29,3
CGCGGTCGATACTTGA,sample,35007,34468,3865,30603,4314,26289,11550,901,7969,900,19519,4969,3390,951,4080,2844
TTATGACGATACTTGA,sample,83925,83009,9080,73929,9307,64622,29112,2059,18841,2010,47953,12600,5451,1270,10626,6623
TCTCCTAGATACTTGA,sample,79923,78807,10702,68105,7003,61102,19998,1440,21966,2219,41964,15479,7240,1578,5121,4277
AAGTAGAGATACTTGA,sample,59557,58837,3402,55435,9299,46136,32854,2016,7451,1093,40305,2722,1965,984,12288,7381
TAACGCCAATACTTGA,sample,40402,39868,4424,35444,6189,29255,12608,1057,8525,805,21133,6260,3465,953,3900,3820
ATTCTACCATACTTGA,sample,39360,38764,5552,33212,4268,28944,11184,554,9478,931,20662,6797,4035,826,4911,2648
GACTAACCATACTTGA,sample,87692,86650,4867,81783,14065,67718,40889,2977,15572,1833,56461,6447,3613,1321,14177,10029
CGCGAGACATACTTGA,sample,74815,73849,5126,68723,9791,58932,32365,1920,15694,1532,48059,7421,3622,1080,14178,7460
CGTAGAACATACTTGA,sample,117613,116049,14281,101768,13857,87911,28951,1974,30440,3196,59391,23350,8907,1516,10826,8632
ATATGCAAATACTTGA,sample,212,202,32,170,20,150,57,3,54,2,111,34,58,21,26,13
AACCGGTTATCCGCGA,sample,234708,232058,28068,203990,25731,178259,51941,2736,69248,6752,121189,47582,12044,2590,18321,17344
AGAGTTCTATCCGCGA,sample,95474,93899,14771,79128,12439,66689,25729,1314,21057,2168,46786,16421,6509,1550,10566,7782
AGCTGAATATCCGCGA,sample,156271,154491,13119,141372,26934,114438,67255,3391,25438,3140,92693,15214,4772,1612,28138,19362
CGTCGCCAATCCGCGA,sample,85573,84409,9771,74638,13151,61487,24489,1508,20483,2157,44972,12850,6531,1828,7437,8663
TGATTCCGATCCGCGA,sample,90409,89477,6587,82890,9268,73622,39418,3082,21007,2291,60425,7824,4158,1918,8561,6611
GCAACTAGATCCGCGA,sample,28029,27406,3347,24059,4116,19943,7936,427,6498,817,14434,4265,3510,894,3091,2652
ATACGTTCATCCGCGA,sample,260447,257267,42640,214627,18608,196019,42353,2182,78633,8061,120986,64790,13424,2574,14811,11212
CCGCAGTCATCCGCGA,sample,90678,89318,10236,79082,10215,68867,31335,1701,20580,2463,51915,12788,5704,1374,11335,6549
CCGTACGCATCCGCGA,sample,91776,90459,10995,79464,11843,67621,27101,1332,22266,2496,49367,14426,6668,1367,11682,7810
GATGCGTTATCCGCGA,sample,240990,238249,33058,205191,14034,191157,36825,2221,78752,8186,115577,65173,13018,2303,9829,8028
CATTCGGTATCCGCGA,sample,73559,72602,7271,65331,9777,55554,29755,2142,13395,1664,43150,8598,4334,1476,10855,7422
GAGATTCTATCCGCGA,sample,128642,126851,21218,105633,10294,95339,30186,1745,34432,3803,64618,25173,8540,1529,12450,6206
TAACGAAGATCCGCGA,sample,77393,76533,6798,69735,11301,58434,31224,1824,15461,1766,46685,8159,3900,1216,13026,8507
GCTGCTTCATCCGCGA,sample,103880,102606,10034,92572,14662,77910,35701,2233,22236,2056,57937,15684,6135,1499,14486,10673
AGCAGAGCATCCGCGA,sample,67111,66106,9968,56138,6940,49198,16061,1309,17841,1663,33902,12324,6091,1570,3638,4098
TTATGACGATCCGCGA,sample,89773,88737,8218,80519,10262,70257,33800,2096,18775,2124,52575,13462,5517,1228,13448,7559
AAGTAGAGATCCGCGA,sample,104029,102691,15407,87284,8173,79111,24615,1298,29394,3220,54009,20584,7510,1343,8252,4588
CGCGAGACATCCGCGA,sample,44920,44280,3617,40663,8414,32249,20652,1252,6336,679,26988,3330,2745,1015,7443,5714
CGTAGAACATCCGCGA,sample,166484,164165,18018,146147,15673,130474,39520,2293,47737,4801,87257,36123,8664,1736,12109,11168
TCTAGGTTAGGACTCA,sample,81697,80174,14179,65995,8180,57815,15566,941,21830,2215,37396,17263,7104,1343,5750,4740
AGCTGAATAGGACTCA,sample,79261,77922,8825,69097,7502,61595,28570,1512,18621,2308,47191,10584,4667,1551,7509,4847
GGAGAAGCAGGACTCA,sample,217960,214915,29831,185084,10039,175045,49362,3285,80711,10106,130073,31581,10524,2499,7931,5216
CTAGCGACAGGACTCA,sample,118291,116663,9595,107068,16334,90734,45242,2209,24104,2426,69346,16753,5249,1395,17943,11160
GGTAGAGAAGGACTCA,sample,70517,69253,7773,61480,10538,50942,23415,1381,14385,1579,37800,10182,5268,1551,8743,6907
TCATACCAAGGACTCA,sample,86890,85827,6975,78852,12223,66629,43499,2752,12282,1106,55781,6990,4526,2239,10116,8801
ATTCAAGGAGGACTCA,sample,76452,75278,9604,65674,6483,59191,22016,1612,21844,2664,43860,11055,6009,1709,5067,4362
TACGCGAGAGGACTCA,sample,58655,57766,8442,49324,5178,44146,14996,929,16000,1885,30996,10336,5382,1164,5645,3483
TGGATCAAAGGACTCA,sample,82620,81493,6531,74962,10544,64418,32609,1807,17208,1610,49817,11184,4480,1180,14236,7807
TGCGCGTTAGGACTCA,sample,125348,123344,25286,98058,7553,90505,15985,1067,38035,3974,54020,31444,9461,1519,5109,3755
ACGCTTAAAGGACTCA,sample,72641,71623,11055,60568,7121,53447,20777,1152,17650,1597,38427,12271,5648,1074,9209,4655
CATTCGGTAGGACTCA,sample,64531,63654,3805,59849,9614,50235,30210,1217,11649,1077,41859,6082,3277,1122,13365,6887
CTAAGCATAGGACTCA,sample,53291,52458,7825,44633,4368,40265,13334,805,14735,1539,28069,9852,5149,1359,3927,2725
CCTAGCGGAGGACTCA,sample,35722,35206,3140,32066,6204,25862,13705,1077,6587,849,20292,3644,3107,1211,4804,4355
CTAACCGGAGGACTCA,sample,171883,169699,25090,144609,10861,133748,39153,3718,55388,6547,94541,28942,10835,2373,6728,5938
AGCAGAGCAGGACTCA,sample,79416,78274,7302,70972,8562,62410,29784,1400,17400,2042,47184,11784,5698,1145,8879,6365
GCGTTACCAGGACTCA,sample,85384,83967,11184,72783,8857,63926,21851,1210,22656,2525,44507,15684,6563,1384,8124,5670
AAGTAGAGAGGACTCA,sample,91559,90347,10635,79712,8175,71537,26825,2013,23228,2519,50053,16952,6697,1420,7583,5808
GACTAACCAGGACTCA,sample,79705,78681,6642,72039,9371,62668,32804,1951,16402,1756,49206,9755,4358,1118,12273,6968
CGCGAGACAGGACTCA,sample,44279,43659,4084,39575,4468,35107,17008,1177,9794,1211,26802,5917,3386,1162,4787,2903
CGTAGAACAGGACTCA,sample,69869,68909,8044,60865,7749,53116,18945,1368,18117,1964,37062,12722,5752,1254,5741,5306
AGATACTAAGGACTCA,sample,77243,76263,7078,69185,10332,58853,32339,2360,13540,1347,45879,9267,4443,1362,9276,7097
CCTAACTAAGGACTCA,Pos_Ctrl,75142,73421,4766,68655,2605,66050,55657,5185,3397,496,59054,1315,5520,7259,3264,977
GCGCAATAAGGACTCA,sample,58337,57593,4421,53172,7164,46008,25041,1768,11200,1161,36241,6838,4209,1364,6625,5313
AGAGTTCTTATTGAAC,sample,306903,303419,60028,243391,11898,231493,53037,4095,106363,12911,159400,55087,14523,3313,5674,4838
AGCTGAATTATTGAAC,sample,101203,100096,9776,90320,12856,77464,36957,2975,21302,2406,58259,13824,6828,2326,10647,8776
GAGCCTCCTATTGAAC,sample,88803,87938,5423,82515,15957,66558,40048,2860,14400,1564,54448,7686,4466,1747,16604,11454
CATACTCCTATTGAAC,sample,79399,78558,6315,72243,15373,56870,33073,2377,13175,1667,46248,6578,4055,1584,12876,10327
TCGAACGATATTGAAC,sample,39680,39166,5041,34125,4852,29273,11552,812,10450,1198,22002,5261,3931,1190,4234,3550
TCATCGAATATTGAAC,sample,49741,49200,1833,47367,14181,33186,23126,1239,6483,632,29609,1706,2049,1502,6389,8936
TACGCGAGTATTGAAC,sample,67986,67171,5663,61508,11805,49703,23990,1526,14216,1463,38206,8508,4457,1267,9106,7708
ATACGTTCTATTGAAC,sample,52162,51415,7065,44350,6345,38005,14430,969,13060,1385,27490,8161,4792,1037,6055,3952
CCGCAGTCTATTGAAC,sample,33232,32762,3212,29550,4732,24818,12692,861,6817,880,19509,3568,3499,1590,3131,3119
CCGTACGCTATTGAAC,sample,76939,75850,9474,66376,8800,57576,21737,1478,19027,2021,40764,13313,5903,1363,8614,6085
GGCAGGTTTATTGAAC,sample,80777,79958,5689,74269,8266,66003,36810,2549,17684,1880,54494,7080,4350,2111,6700,5927
GATGCGTTTATTGAAC,sample,60852,60020,5516,54504,11432,43072,21077,1699,12075,1374,33152,6847,4055,1301,7211,7352
TGCGCGTTTATTGAAC,sample,61108,60447,4542,55905,11978,43927,28374,2209,8557,898,36931,3889,3601,1954,7537,8561
CCATTCTTTATTGAAC,sample,45483,44823,3995,40828,5825,35003,17781,1023,10254,1182,28035,4763,3141,1360,5584,4070
AGCGTCTTTATTGAAC,sample,62121,61261,5062,56199,9437,46762,27325,1896,11756,1151,39081,4634,3560,1551,6806,6518
CGGTTGGTTATTGAAC,sample,119002,117337,18629,98708,8104,90604,20071,1021,36671,4037,56742,28804,10034,1670,6393,4557
GCTCTTCTTATTGAAC,sample,42528,41908,4663,37245,4297,32948,13598,944,11110,1547,24708,5749,3753,1321,4155,2965
GAGATTCTTATTGAAC,sample,45203,44580,4813,39767,4963,34804,15493,1088,11445,1369,26938,5409,3759,1351,4603,3483
CTAAGCATTATTGAAC,sample,83985,82851,8432,74419,10341,64078,25482,1431,21040,2447,46522,13678,5726,1312,10588,7176
AAGGTCTGTATTGAAC,sample,104727,103505,12715,90790,11766,79024,32262,2399,24941,2704,57203,16718,6954,1775,9687,7791
CTAACCGGTATTGAAC,sample,39029,38548,3784,34764,6057,28707,15633,884,7325,920,22958,3945,2426,910,7014,4308
GGCGACGATATTGAAC,sample,30796,30224,6514,23710,2349,21361,4732,331,8849,845,13581,6604,4186,908,936,1264
ATACCGCCTATTGAAC,sample,84663,83388,10826,72562,9363,63199,24034,1426,21349,2167,45383,14223,6412,1291,10649,6060
CGCGGTCGTATTGAAC,sample,47673,47031,5072,41959,5811,36148,16739,1234,10664,1368,27403,6143,3925,1114,5121,4005
TTATGACGTATTGAAC,sample,82917,81696,8516,73180,7255,65925,26955,1581,21755,2452,48710,13182,5462,1174,9558,5900
ATTCTACCTATTGAAC,sample,29970,29456,2342,27114,3750,23364,13504,967,5791,931,19295,2171,2119,1076,3827,3156
GACTAACCTATTGAAC,sample,39975,39289,4650,34639,4880,29759,13067,568,9426,988,22493,5710,3703,878,5189,3818
CTGGTCTTGTTCAACT,sample,61217,60228,7847,52381,5783,46598,17415,1293,15164,1494,32579,11232,5473,1404,5227,4240
GTCGTTCTGTTCAACT,sample,31929,31285,2900,28385,5175,23210,13789,906,5148,595,18937,2772,2258,950,4193,3518
AGCTGAATGTTCAACT,sample,45810,45028,5027,40001,6095,33906,16062,1385,9179,1007,25241,6273,3510,933,5402,4356
GACGTATGGTTCAACT,sample,42402,41627,4767,36860,5259,31601,12326,1104,10466,1086,22792,6619,3887,903,3362,3662
GGAGAAGCGTTCAACT,sample,28038,27577,3966,23611,3965,19646,7064,595,6344,781,13408,4862,3565,1005,2105,2573
GAGCCTCCGTTCAACT,sample,23631,23327,2372,20955,3546,17409,8689,515,4994,522,13683,2689,2641,981,3326,2369
TCGAACGAGTTCAACT,sample,22937,22617,2497,20120,4585,15535,7345,481,4440,454,11785,2815,2472,809,3372,2906
GGTAGAGAGTTCAACT,sample,34517,34034,3456,30578,5400,25178,10361,716,8193,929,18554,4979,3601,1063,3958,3789
TCATCGAAGTTCAACT,sample,23436,23090,2900,20190,3014,17176,6873,404,5746,741,12619,3412,3008,989,2416,1860
ATTCAAGGGTTCAACT,sample,16231,15911,1887,14024,2595,11429,5597,396,3158,350,8755,1928,2046,797,2271,1849
ATACGTTCGTTCAACT,sample,20550,20200,1831,18369,2940,15429,7273,442,5050,579,12323,2085,2140,821,2694,2189
CCGTACGCGTTCAACT,sample,18230,17808,1537,16271,3193,13078,9159,445,2566,253,11725,655,900,542,3784,2346
GATGCGTTGTTCAACT,sample,13385,13079,1391,11688,2894,8794,4736,229,2358,253,7094,1218,1321,530,2361,2065
CGGTTGGTGTTCAACT,sample,15473,15238,1580,13658,2816,10842,4386,220,3589,363,7975,2284,2149,699,1867,1902
GAGATTCTGTTCAACT,sample,22276,21900,3884,18016,2764,15252,4749,282,5481,634,10230,4106,3035,808,1595,1702
CTAAGCATGTTCAACT,sample,13556,13310,1444,11866,2497,9369,4250,196,2721,275,6971,1927,1683,604,1695,1695
AAGGTCTGGTTCAACT,sample,21060,20727,2360,18367,3152,15215,7111,454,4429,520,11540,2701,2631,936,2437,2225
CCTAGCGGGTTCAACT,sample,10978,10780,1190,9590,1691,7899,4015,154,1981,220,5996,1529,1389,435,2086,1161
GGCGACGAGTTCAACT,sample,17304,17025,1931,15094,2654,12440,5883,466,3311,401,9194,2379,2560,1092,1394,1812
TAACGAAGGTTCAACT,sample,14863,14664,1843,12821,1438,11383,4343,241,4065,493,8408,2241,2331,739,1419,867
AGCAGAGCGTTCAACT,sample,30065,29465,5345,24120,3069,21051,4981,328,8245,864,13226,6633,4505,748,1739,1932
CGTCGAGGGTTCAACT,sample,14979,14708,1402,13306,1714,11592,5952,362,3037,276,8989,1965,1988,854,1990,1315
CGCGGTCGGTTCAACT,sample,7360,7230,1172,6058,1014,5044,1213,78,2031,180,3244,1542,1480,301,408,630
TCTCCTAGGTTCAACT,sample,23963,23537,3691,19846,2336,17510,6589,322,5925,612,12514,4062,3069,695,3030,1537
CGTAGAACGTTCAACT,sample,8019,7809,891,6918,1425,5493,3292,182,1272,143,4564,604,993,477,1433,1079
GCGCAATAGTTCAACT,Neg_Ctrl,414,151,110,41,7,34,13,0,17,1,30,3,20,7,7,0
TTAACTGAGTTCAACT,sample,12588,12401,1381,11020,1547,9473,4710,293,2661,284,7371,1525,1450,568,1949,1088
AACCGGTTCTGAGGTT,sample,100144,98563,10667,87896,14329,73567,36128,1625,21574,2261,57702,11979,5734,1867,12848,9784
AGCTGAATCTGAGGTT,sample,323101,318401,38690,279711,36578,243133,102755,7810,76055,6440,178810,50073,9345,2507,27924,28130
GAGCCTCCCTGAGGTT,sample,74517,73666,5724,67942,15806,52136,33898,1922,10647,1037,44545,4632,2476,1219,15096,11532
CATACTCCCTGAGGTT,sample,118385,116916,11936,104980,16826,88154,36650,1981,26344,2960,62994,20219,7612,1535,16597,11556
CTAGCGACCTGAGGTT,sample,98878,97715,7443,90272,18053,72219,39128,2413,17854,1837,56982,10987,4784,1438,19450,12132
GGTAGAGACTGAGGTT,sample,88006,86999,6338,80661,16187,64474,40457,2752,13649,1762,54106,5854,4198,2320,10171,11134
TCATCGAACTGAGGTT,sample,109107,107821,11348,96473,16069,80404,32646,1809,25865,3266,58511,16818,7017,1767,14060,11160
TCATACCACTGAGGTT,sample,38357,37671,8876,28795,2204,26591,3619,292,11948,1190,15567,9542,5543,759,1093,1082
ATTCAAGGCTGAGGTT,sample,116739,115302,11103,104199,19059,85140,35865,2155,27102,3357,62967,16661,6311,1887,13654,14320
TACGCGAGCTGAGGTT,sample,93616,92449,9572,82877,15926,66951,34116,2409,17016,2393,51132,11017,4452,1606,13717,11060
CCGCAGTCCTGAGGTT,sample,95100,93855,9177,84678,14295,70383,32859,2478,20049,2715,52908,12282,5339,1518,14859,10655
CCGTACGCCTGAGGTT,sample,79772,78621,9459,69162,9373,59789,22941,1138,19521,1971,42462,14218,6757,1442,10086,6200
CATTCGGTCTGAGGTT,sample,54119,53144,6096,47048,7955,39093,18751,1198,11704,1379,30455,6061,3907,1532,6468,5605
TAGCGAGTCTGAGGTT,sample,47062,46255,5190,41065,5891,35174,13828,882,12752,1374,26580,6338,3989,1363,3740,3971
GAGATTCTCTGAGGTT,sample,30514,29972,3396,26576,5644,20932,9751,577,6324,712,16075,3568,3092,1225,3275,4000
CTAAGCATCTGAGGTT,sample,62503,61496,7289,54207,5874,48333,17652,1072,18734,2146,36386,8729,4971,1691,4217,3948
CCTAGCGGCTGAGGTT,sample,36168,35528,2893,32635,7833,24802,16122,832,4630,404,20752,2814,1991,983,7062,5756
GCCTATTCCTGAGGTT,sample,63286,62253,5907,56346,9004,47342,21583,1127,15298,1776,36881,7558,4578,1239,9477,5671
AGCAGAGCCTGAGGTT,sample,54174,53316,6094,47222,10396,36826,24936,1245,6936,877,31872,2832,1730,836,12060,6864
TGCGCTCCCTGAGGTT,sample,39715,39063,6103,32960,4097,28863,10194,678,10927,1164,21121,5900,4107,1211,3341,2848
CGTCGAGGCTGAGGTT,sample,53190,52379,4787,47592,9321,38271,18676,1055,11018,912,29694,6610,3913,1341,7187,6636
CAGCTTCGCTGAGGTT,sample,68046,66930,6397,60533,11337,49196,27710,1627,11771,1262,39481,6826,3169,1247,12116,7920
TCTCCTAGCTGAGGTT,sample,154198,151752,26522,125230,12183,113047,28008,1227,43558,4705,71566,35549,11236,1845,11658,7359
CGCGAGACCTGAGGTT,sample,63504,62190,6482,55708,10129,45579,24593,1513,11393,1363,35986,6717,3470,1115,9150,7114
AGATACTACTGAGGTT,sample,48567,47686,5120,42566,10571,31995,16527,1135,7853,1101,24380,5379,2495,786,7185,6946
TCTAGGTTAGACCGTT,sample,62301,61090,9744,51346,7953,43393,15519,898,14319,1541,29838,11116,4921,1104,7306,4907
GAGCCTCCAGACCGTT,sample,66862,66101,5456,60645,12965,47680,27868,2199,10346,1055,38214,6212,4483,2029,8760,9106
CTAGCGACAGACCGTT,sample,82010,80751,6583,74168,14425,59743,31644,2595,14513,1813,46157,9178,4169,1457,13166,10562
TCGAACGAAGACCGTT,sample,61531,60658,5305,55353,11422,43931,27739,1837,9507,977,37246,3871,2202,989,15204,8118
GGTAGAGAAGACCGTT,sample,69682,68479,6165,62314,12117,50197,25940,1811,13824,1619,39764,7003,4469,1653,7799,8187
ATTCAAGGAGACCGTT,sample,160872,158920,10112,148808,20919,127889,91655,5075,19737,1875,111392,9547,4647,1940,20353,16126
GCAACTAGAGACCGTT,sample,11295,10925,1332,9593,1937,7656,3449,256,2489,263,5938,1199,1841,754,1344,1321
TACGCGAGAGACCGTT,sample,66253,65457,4946,60511,10397,50114,30707,2013,10828,1174,41535,5392,4056,2228,6179,7742
ATACGTTCAGACCGTT,sample,71819,70770,7105,63665,11861,51804,25004,1642,14229,1968,39233,8961,4869,1596,8597,8236
TCTCAGGAAGACCGTT,sample,79239,78375,8289,70086,12464,57622,30372,2125,13850,1528,44222,9747,5035,1911,9421,9127
GGCAGGTTAGACCGTT,sample,27746,27216,4587,22629,4044,18585,6719,460,6553,669,13272,4184,3219,948,2362,2784
ATGGCGTTAGACCGTT,sample,95261,94179,9330,84849,15802,69047,33013,1889,18819,2097,51832,13229,5875,1770,12044,10847
TGCGCGTTAGACCGTT,sample,75104,74078,5535,68543,13347,55196,34272,2052,11938,1201,46210,5733,3316,1164,16036,9626
AGCGTCTTAGACCGTT,sample,104393,103000,8955,94045,18613,75432,42416,2163,17509,2313,59925,11031,4319,1468,18461,13276
GAGATTCTAGACCGTT,sample,88703,87632,8405,79227,10373,68854,29811,2194,24362,2529,54173,9958,5135,1681,8180,7842
GCCTATTCAGACCGTT,sample,77152,76130,7093,69037,12149,56888,32302,1795,13715,1163,46017,7913,3799,1239,15660,9113
TGCGCTCCAGACCGTT,sample,81755,80831,5470,75361,16294,59067,39176,2132,11196,1375,50372,5188,2692,1170,16559,11441
ATACCGCCAGACCGTT,sample,16760,16278,2496,13782,2600,11182,2764,304,4475,495,7239,3144,2643,711,585,1590
GCGTTACCAGACCGTT,sample,73053,72049,5861,66188,13468,52720,28132,1876,13170,1404,41302,8138,4075,1431,10653,9600
CGCGGTCGAGACCGTT,sample,40078,39499,4658,34841,5329,29512,12262,469,9333,1128,21595,6320,4088,942,5921,3656
TTATGACGAGACCGTT,sample,73210,72345,6863,65482,7239,58243,23738,1631,19173,2420,42911,11281,5342,1510,6318,5568
TAACGCCAAGACCGTT,sample,24738,24490,1656,22834,5269,17565,10863,556,3548,456,14411,2142,1950,691,5340,3897
AGATACTAAGACCGTT,sample,89374,88484,8998,79486,12151,67335,25474,1570,21134,2440,46608,16717,6811,1609,7733,8288
CCTAACTAAGACCGTT,sample,78547,77684,8427,69257,8748,60509,25311,1900,18030,1890,43341,13378,5414,1399,9770,5881
GCGCAATAAGACCGTT,sample,11645,11504,897,10607,1396,9211,4896,419,2371,260,7267,1265,1858,1019,1151,981
TCTAGGTTCTTGAGTT,sample,172910,171494,12108,159386,31303,128083,60766,3263,37190,3930,97956,22934,6961,2146,25117,20723
AGCTGAATCTTGAGTT,sample,81517,80405,8013,72392,20172,52220,27531,1798,13320,1477,40851,8094,4666,1898,10711,13749
GGAGAAGCCTTGAGTT,sample,103694,102336,9034,93302,14280,79022,36668,1879,23482,2744,60150,14249,6262,1602,15658,9498
GAGCCTCCCTTGAGTT,sample,99461,98300,8778,89522,14164,75358,36365,2240,21925,2284,58290,12544,5694,1775,15204,10067
CTAGCGACCTTGAGTT,sample,120878,119527,9091,110436,24997,85439,51605,2585,19765,1765,71370,9719,4454,1703,24564,17865
TCATCGAACTTGAGTT,sample,166101,164052,14877,149175,26563,122612,55053,2572,35948,4391,91001,24648,7590,1951,24076,19274
TCATACCACTTGAGTT,sample,115970,114388,14643,99745,11160,88585,26994,1243,32913,3716,59907,23719,8334,1859,10780,8158
ATTCAAGGCTTGAGTT,sample,230813,228019,32024,195995,14116,181879,45419,2810,81854,9861,127273,41935,12274,2870,9588,8275
TGATTCCGCTTGAGTT,sample,161699,159617,23073,136544,18203,118341,40544,2038,40714,4182,81258,30863,9602,1990,15749,12177
TACGCGAGCTTGAGTT,sample,64307,63390,8733,54657,9865,44792,18135,1274,13839,1504,31974,10040,5783,1623,6469,6638
GACTCAAGCTTGAGTT,sample,84656,83427,7991,75436,11674,63762,29293,2134,19209,2540,48502,10586,5508,1745,8951,8269
CCGCAGTCCTTGAGTT,sample,114922,113229,11853,101376,22699,78677,41468,2771,20167,1913,61635,12358,4630,1356,19663,15491
CCGTACGCCTTGAGTT,sample,40848,40293,4024,36269,8631,27638,13908,943,7285,762,21193,4740,4197,1842,4103,5591
TGGATCAACTTGAGTT,sample,63137,62170,8089,54081,7169,46912,17583,1136,16654,2103,34237,9436,5204,1490,6110,5061
GGCAGGTTCTTGAGTT,sample,116691,114877,12393,102484,16714,85770,37213,2258,27349,2796,64562,16154,7183,2016,12939,11767
GATGCGTTCTTGAGTT,sample,236054,231815,23949,207866,24356,183510,68383,4562,61089,6555,129472,42921,10350,2279,20888,18406
TGCGCGTTCTTGAGTT,sample,96110,94853,11593,83260,12895,70365,28654,1784,22253,2162,50907,15512,6630,1489,11894,9133
CGGTTGGTCTTGAGTT,sample,77217,76053,7498,68555,10778,57777,24722,1297,18119,1860,42841,11779,5211,1232,10904,7730
ACGCTTAACTTGAGTT,sample,148339,146374,13490,132884,17746,115138,65957,3706,26848,2849,92805,15778,7039,2032,20269,12976
GCTCTTCTCTTGAGTT,sample,180520,178156,13429,164727,18984,145743,83848,5308,37320,4375,121168,14892,6024,2248,17698,14996
GGCGACGACTTGAGTT,sample,120045,118259,16596,101663,10491,91172,24016,1516,36167,4317,60183,25156,9263,1743,7306,7293
GCCTATTCCTTGAGTT,sample,51301,50311,6862,43449,6835,36614,12765,557,12454,1469,25219,9369,5118,904,5969,4741
GGCGTACCCTTGAGTT,sample,93234,91786,13793,77993,13147,64846,27560,1836,20377,2447,47937,12626,5112,1473,11132,9272
TTATGACGCTTGAGTT,sample,62587,61680,7460,54220,9013,45207,19810,1033,13827,1341,33637,9196,4566,1091,7765,6423
ATGAATAGCTTGAGTT,sample,71593,70241,8807,61434,6421,55013,19600,1195,19126,2019,38726,13073,6078,1299,7761,4681
GACTAACCCTTGAGTT,sample,37296,36632,4593,32039,5321,26718,14392,804,6235,639,20627,4648,3613,1329,5092,3946
CGTAGAACCTTGAGTT,sample,67312,66173,7261,58912,8615,50297,23750,1652,14453,1287,38203,9155,4153,1100,10271,6674
TTAACTGACTTGAGTT,sample,71014,69995,8801,61194,5870,55324,18400,834,20469,1858,38869,13763,6382,1234,7640,3667
AGAGTTCTTCGGAGTT,sample,24094,23540,3044,20496,3352,17144,6926,385,5490,561,12416,3782,2946,914,2630,2463
TATACGGATCGGAGTT,sample,29477,28964,3982,24982,3598,21384,8127,422,7105,752,15232,4978,3406,899,3740,2429
GAGCCTCCTCGGAGTT,sample,21833,21387,2279,19108,2789,16319,7629,545,4395,463,12024,3287,2476,862,2991,2034
TCGAACGATCGGAGTT,sample,15113,14811,1373,13438,3225,10213,6252,331,2236,174,8488,1220,1428,674,2891,2337
GCAACTAGTCGGAGTT,sample,7223,6939,817,6122,1250,4872,2380,154,1356,145,3736,837,1099,431,1169,862
CCGCAGTCTCGGAGTT,sample,31710,31042,3986,27056,3545,23511,8842,450,7852,865,16694,5502,3606,794,3821,2522
CCGTACGCTCGGAGTT,sample,26925,26434,3601,22833,2872,19961,6510,325,6933,827,13443,5366,3690,835,2718,1802
TCTCAGGATCGGAGTT,sample,59775,58803,4489,54314,7780,46534,29290,1867,9130,886,38420,5361,3372,1363,9767,5458
AGCGTCTTTCGGAGTT,sample,21123,20698,2687,18011,2320,15691,6261,348,5003,463,11264,3616,2614,733,2164,1540
CGGTTGGTTCGGAGTT,sample,18400,18088,1598,16490,3109,13381,8197,457,2736,272,10933,1719,1820,894,3575,2219
GCTCTTCTTCGGAGTT,sample,46053,44954,4737,40217,6009,34208,15611,1038,10204,1170,25815,6185,3832,968,6636,4388
GGCGACGATCGGAGTT,sample,8824,8636,1736,6900,636,6264,1332,68,2495,309,3827,2060,1670,276,559,379
GCCTATTCTCGGAGTT,sample,15352,15066,2078,12988,1720,11268,3084,184,4222,426,7306,3352,2767,604,803,1156
TGCGCTCCTCGGAGTT,sample,19140,18770,1870,16900,2667,14233,7026,521,3735,423,10761,2528,2353,932,2423,1887
CGTCGAGGTCGGAGTT,Pos_Ctrl,22393,21851,1527,20324,779,19545,16417,1421,1226,98,17643,383,3824,3757,1371,355
CGCGGTCGTCGGAGTT,sample,7470,7272,906,6366,1020,5346,2685,115,1404,138,4089,1004,1130,402,1194,776
ATGAATAGTCGGAGTT,sample,11431,11125,1411,9714,1918,7796,4969,397,1659,136,6628,635,998,609,1812,1404
AAGTAGAGTCGGAGTT,sample,14078,13784,1506,12278,1998,10280,5788,362,2455,216,8243,1459,1536,695,1979,1547
ATTCTACCTCGGAGTT,sample,12504,12231,1359,10872,1638,9234,4502,267,2548,250,7050,1667,1887,664,1893,1159
CGCGAGACTCGGAGTT,sample,8284,8120,881,7239,1368,5871,3204,214,1478,186,4682,789,1096,472,1408,987
ATATGCAATCGGAGTT,sample,7373,7254,597,6657,893,5764,2713,222,1739,208,4452,882,1269,563,928,583
CTGGTCTTTGAACCTT,Pos_Ctrl,69078,67565,4648,62917,2697,60220,50582,4455,3561,424,54143,1198,5942,7131,4485,1114
TATACGGATGAACCTT,sample,60795,59977,5310,54667,9159,45508,19946,1328,14296,1443,34242,8495,4349,1174,8808,6657
GGTAGAGATGAACCTT,Pos_Ctrl,92542,90744,5835,84909,3525,81384,68625,6135,4480,670,73105,1474,6380,8210,6022,1489
CGTCGCCATGAACCTT,sample,4953,4823,618,4205,889,3316,1690,76,890,112,2580,548,714,290,874,627
TCATCGAATGAACCTT,sample,51075,50527,3784,46743,6156,40587,20634,1396,12286,1636,32920,4635,3767,1887,4601,4655
TCATACCATGAACCTT,sample,171708,169723,21047,148676,11482,137194,35881,2137,59254,6881,95135,33041,10953,2396,8522,7271
ATTCAAGGTGAACCTT,sample,69714,68651,9540,59111,6710,52401,14425,675,19804,2087,34229,15410,7206,1371,5891,4281
TGATTCCGTGAACCTT,sample,73979,73065,7261,65804,15010,50794,29262,1838,11571,1184,40833,6939,4408,1704,11121,10311
TGGATCAATGAACCTT,sample,74124,73262,6296,66966,13063,53903,32393,1653,11859,1309,44252,6689,3875,1388,14454,9616
GATGCGTTTGAACCTT,sample,57405,56625,7226,49399,4390,45009,17872,1389,14559,1701,32431,9488,5420,2134,1390,2750
ATGGCGTTTGAACCTT,Pos_Ctrl,96688,95300,6026,89274,4024,85250,71550,6696,4878,577,76428,1549,6337,8307,6080,1696
CTAAGCATTGAACCTT,sample,33590,32981,5343,27638,2802,24836,6312,457,9240,1027,15552,7800,4256,926,1858,1589
CCTAGCGGTGAACCTT,Pos_Ctrl,23413,22949,1700,21249,952,20297,17080,1624,1123,117,18203,353,3882,3928,1324,373
CTAACCGGTGAACCTT,sample,31485,30974,3856,27118,4374,22744,9977,420,6970,656,16947,4721,3061,722,5124,2849
GCCTATTCTGAACCTT,sample,43670,43039,4763,38276,4751,33525,15735,737,10653,1064,26388,5336,3780,1277,5299,3520
AGCAGAGCTGAACCTT,sample,16304,16006,1493,14513,1793,12720,6615,448,4078,317,10693,1262,1939,1040,1367,1320
GGCGTACCTGAACCTT,sample,35424,34773,3434,31339,5890,25449,13600,978,6355,723,19955,3793,2958,1083,5062,4542
CAGCTTCGTGAACCTT,sample,50818,49992,8748,41244,4076,37168,11064,770,13393,1340,24457,10601,5784,1329,2602,2460
CGCGGTCGTGAACCTT,sample,21960,21613,2430,19183,2706,16477,6749,409,5236,531,11985,3552,2771,754,2850,1850
TTATGACGTGAACCTT,sample,59962,59077,7144,51933,5111,46822,16066,1089,16341,1947,32407,11379,5910,1421,4315,3502
ATTCTACCTGAACCTT,Pos_Ctrl,34843,34239,2187,32052,1241,30811,26003,2478,1636,182,27639,512,4523,5016,2060,483
GACTAACCTGAACCTT,sample,38465,37804,5021,32783,4438,28345,11431,502,9084,988,20515,6340,3371,880,4316,3222
CGTAGAACTGAACCTT,sample,28210,27577,3717,23860,2236,21624,9415,669,6738,735,16153,4067,3600,1469,1820,1431
TTAACTGATGAACCTT,sample,20725,20385,2442,17943,2164,15779,6874,411,4742,499,11616,3253,2383,606,3305,1462
ATATGCAATGAACCTT,sample,50631,49993,6462,43531,4562,38969,14025,793,13694,1554,27719,8903,5321,1182,5349,2938
AACCGGTTACCGAATT,sample,107483,105978,8907,97071,20242,76829,41573,1923,18707,1527,60280,13099,3946,1411,19281,14159
GTCGTTCTACCGAATT,sample,89777,88505,7017,81488,20353,61135,39880,2591,11929,1434,51809,5301,2759,1360,18490,14201
AGAGTTCTACCGAATT,sample,35495,34865,4685,30180,6131,24049,9814,636,7623,941,17437,5035,3926,1297,3492,4170
AGCTGAATACCGAATT,sample,32299,31503,5101,26402,5059,21343,8112,603,6937,612,15049,5079,3524,1132,2208,3583
GACGTATGACCGAATT,sample,93117,91541,11765,79776,15853,63923,32489,1973,17261,1709,49750,10491,5453,1760,11311,11276
CATACTCCACCGAATT,sample,83440,81949,9637,72312,11179,61133,25435,1234,19535,2438,44970,12491,5909,1412,11061,7647
GGTAGAGAACCGAATT,sample,95761,94208,10180,84028,11460,72568,28508,2165,23966,2866,52474,15063,6583,2158,4538,7670
GCAACTAGACCGAATT,sample,72649,70655,9154,61501,10327,51174,28064,2144,11314,1193,39378,8459,5258,1966,5699,7589
CCGTACGCACCGAATT,sample,114049,112373,9307,103066,11147,91919,39688,3021,30920,3838,70608,14452,5833,1748,8828,7675
TCTCAGGAACCGAATT,sample,127250,125534,13832,111702,14768,96934,43107,2760,27942,3507,71049,19618,7258,1823,9996,9509
GGCAGGTTACCGAATT,sample,256171,252803,22210,230593,26355,204238,90946,5140,61881,7484,152827,38787,9474,2300,28581,19606
AGCGTCTTACCGAATT,sample,90413,88997,13199,75798,8796,67002,23066,1735,22505,2416,45571,17280,6286,1384,7549,5882
GAGATTCTACCGAATT,sample,130137,125523,21495,104028,10622,93406,23830,1521,35892,3670,59722,28493,9343,1637,8405,6762
AAGGTCTGACCGAATT,sample,97588,96344,10725,85619,9410,76209,23596,1708,27679,2833,51275,20393,7753,1555,9272,5883
CCTAGCGGACCGAATT,sample,21048,19621,1589,18032,4689,13343,9160,726,2512,243,11672,702,1410,1035,2236,2878
GCGTTACCACCGAATT,sample,119158,117485,13486,103999,14839,89160,38570,2011,27809,2972,66379,17798,6517,1691,15288,10387
GTCGCGAAACCGAATT,sample,49562,48805,9442,39363,3356,36007,6953,384,15044,1535,21997,12091,6162,1255,1330,1868
CAGCTTCGACCGAATT,Neg_Ctrl,2172,889,626,263,35,228,101,6,62,7,163,52,92,41,29,7
AAGTAGAGACCGAATT,sample,29540,28967,4044,24923,3202,21721,5380,393,8287,971,13667,6690,4292,809,2129,2065
TAACGCCAACCGAATT,sample,35323,34881,5466,29415,2372,27043,7176,489,11202,1214,18378,6962,4408,1132,1197,1179
CGTAGAACACCGAATT,sample,70836,69707,4904,64803,12867,51936,32120,1583,12288,1216,44408,4729,3042,1162,12709,9229
AGATACTAACCGAATT,sample,102798,101711,7364,94347,17142,77205,49217,3186,15724,2083,64941,6995,4225,1349,18381,13132
AACCGGTTGGTCTGGT,sample,157730,156152,15589,140563,20695,119868,44091,2957,38525,5137,82616,29158,9966,1855,21094,14012
CTGGTCTTGGTCTGGT,sample,57845,57060,5130,51930,8523,43407,20318,1154,12229,1346,32547,8360,4322,1227,8688,5972
GTCGTTCTGGTCTGGT,Neg_Ctrl,2330,1026,700,326,45,281,103,9,85,11,188,73,114,47,23,18
CATACTCCGGTCTGGT,sample,60446,59755,4768,54987,12511,42476,23870,1579,9796,1455,33666,5776,3311,1288,9292,8597
CTAGCGACGGTCTGGT,sample,96341,94653,14436,80217,10199,70018,19837,1011,26342,2693,46179,20135,8596,1595,7162,6637
CGTCGCCAGGTCTGGT,Neg_Ctrl,2796,1020,766,254,29,225,78,6,82,7,160,52,79,29,33,6
TCATCGAAGGTCTGGT,sample,78574,77514,7017,70497,12536,57961,29062,1868,16480,1717,45542,8834,4750,1307,10490,9349
TGATTCCGGGTCTGGT,sample,109717,107365,9344,98021,18021,80000,39534,2956,21474,2545,61008,13491,6205,1778,10830,12327
TGGATCAAGGTCTGGT,sample,96967,96061,7019,89042,14425,74617,42765,3061,17300,1808,60065,9683,4977,2020,10815,10700
GATGCGTTGGTCTGGT,sample,131847,130375,8284,122091,15209,106882,60318,4626,24414,2759,84732,14765,6085,1735,19267,12034
TGCGCGTTGGTCTGGT,Neg_Ctrl,2378,905,583,322,63,259,118,7,81,7,199,46,107,51,37,10
ACGCTTAAGGTCTGGT,sample,79506,78490,4967,73523,13627,59896,44713,2114,10214,983,54927,1872,1440,885,22064,11038
CTAACCGGGGTCTGGT,Neg_Ctrl,1637,785,522,263,54,209,91,6,71,2,162,39,72,27,45,9
GCTGCTTCGGTCTGGT,sample,56534,55712,6123,49589,7240,42349,14551,681,14482,1669,29033,10966,5811,1096,5505,4980
AGCAGAGCGGTCTGGT,sample,36944,36339,3259,33080,5828,27252,16214,768,5933,432,22147,3905,1979,815,7797,4286
GGCGTACCGGTCTGGT,sample,41841,41141,4491,36650,3592,33058,15607,991,9416,1120,25023,5924,4314,1692,2295,2532
CGTCGAGGGGTCTGGT,sample,36799,36259,3115,33144,6311,26833,14944,982,6463,619,21407,3825,2369,925,5760,4717
CAGCTTCGGGTCTGGT,sample,49726,49226,3749,45477,7428,38049,25752,1933,6560,913,32312,2891,3605,2292,5940,5783
ATGAATAGGGTCTGGT,sample,52039,51340,3919,47421,7343,40078,25863,1196,7900,774,33763,4345,2153,926,11074,6135
AAGTAGAGGGTCTGGT,sample,49762,48950,4570,44380,6525,37855,21376,1524,8587,825,29963,5543,3750,1287,8485,4924
TCAATCAGGGTCTGGT,sample,31442,31048,2746,28302,4129,24173,11751,718,6569,762,18320,4373,3193,911,4725,3224
GACTAACCGGTCTGGT,Neg_Ctrl,2344,1273,1069,204,42,162,79,4,46,3,125,30,73,36,30,5
AGATACTAGGTCTGGT,sample,24904,24500,2493,22007,5194,16813,10665,885,3600,371,14265,1292,1992,1168,3062,3431
ATATGCAAGGTCTGGT,sample,41662,41278,2417,38861,7410,31451,18649,959,7056,749,25705,4038,2171,802,9327,5481
AGCTGAATCGACGTTA,sample,119677,117670,13342,104328,15380,88948,40786,2196,29374,3143,70160,13449,5731,1751,12919,11225
GACGTATGCGACGTTA,sample,60611,59248,9020,50228,7569,42659,15391,1031,14206,1661,29597,10370,5662,1632,5187,5055
CTAGCGACCGACGTTA,sample,157841,155327,14378,140949,27892,113057,59538,4861,28295,3159,87833,17204,6839,2260,15615,20384
CGTCGCCACGACGTTA,sample,213760,211352,14547,196805,20239,176566,95683,5270,47377,7730,143060,20506,5937,2232,17586,14796
TGATTCCGCGACGTTA,sample,253371,250717,24177,226540,28099,198441,101416,7373,51907,5501,153323,32244,9267,2654,26229,19447
GACTCAAGCGACGTTA,sample,147683,145820,12007,133813,22032,111781,61851,4462,26236,4254,88087,14978,5814,1711,22117,16778
ATACGTTCCGACGTTA,sample,208206,205312,19390,185922,23371,162551,68204,3906,49559,4732,117763,36150,8437,1738,28533,15035
TGGATCAACGACGTTA,sample,171588,168921,18446,150475,16761,133714,48687,5057,45089,5391,93776,29490,8665,1778,12600,11151
GGCAGGTTCGACGTTA,sample,227926,225037,21563,203474,36929,166545,83924,5657,44266,4291,128190,28407,8533,2094,28089,25364
GATGCGTTCGACGTTA,sample,36195,35402,4076,31326,5384,25942,11208,855,8754,857,19962,4268,3427,1407,2642,3481
ATGGCGTTCGACGTTA,sample,36170,35490,6621,28869,6542,22327,11625,708,5425,538,17050,4031,3143,1439,3753,4210
CGGTTGGTCGACGTTA,sample,223506,221076,17981,203095,26398,176697,90602,6863,46269,4634,136871,28329,8624,2380,23602,19224
ACGCTTAACGACGTTA,sample,204947,202553,15663,186890,32117,154773,87004,6502,36378,4582,123382,20307,4765,1560,34914,22039
CTAACCGGCGACGTTA,sample,44221,43714,2607,41107,7943,33164,20890,1554,7369,968,28259,2383,2580,1766,5625,5624
GGCGACGACGACGTTA,sample,71677,70924,6985,63939,9377,54562,23327,1455,17397,2053,40724,10330,5640,1652,8694,6563
TAACGAAGCGACGTTA,sample,87415,86528,8762,77766,13255,64511,33148,1535,17296,1793,50444,10739,4807,1330,14509,9457
AGCAGAGCCGACGTTA,sample,57282,56603,5057,51546,8999,42547,23391,1398,10385,1294,33776,6079,3891,1205,11566,6054
TGCGCTCCCGACGTTA,sample,83747,83044,6078,76966,15377,61589,32684,2529,14821,1650,47505,9905,4787,1391,13002,10654
CGCGGTCGCGACGTTA,sample,54571,54081,3537,50544,11553,38991,23162,1219,8682,1353,31844,4575,2779,1005,10294,8184
ATGAATAGCGACGTTA,sample,72963,72422,6848,65574,13086,52488,25320,2204,14650,2079,39970,8235,3851,1158,9963,8340
GACTAACCCGACGTTA,sample,4193,4047,332,3715,814,2901,1659,151,764,83,2423,244,794,452,559,509
CGCGAGACCGACGTTA,sample,736,694,69,625,90,535,290,21,151,21,441,52,228,105,112,55
TTAACTGACGACGTTA,sample,16261,16092,1357,14735,2521,12214,5512,461,3761,387,9273,2093,2275,837,1853,1651
CTGGTCTTTACTAAGT,sample,100710,98542,8690,89852,17002,72850,44201,3489,15347,2154,59548,7659,4334,1579,16196,12311
CTAGCGACTACTAAGT,sample,17463,16973,1283,15690,4589,11101,7999,554,1503,152,9502,893,1894,1444,2399,2951
CGTCGCCATACTAAGT,sample,18015,17657,1359,16298,2728,13570,8601,575,2927,312,11528,1155,1947,1202,2353,2078
TGATTCCGTACTAAGT,sample,45121,44199,5847,38352,5137,33215,10996,594,11435,1203,22431,8987,4896,1045,3859,3650
GCAACTAGTACTAAGT,sample,9033,8707,1038,7669,1161,6508,2526,163,2199,226,4725,1394,1635,620,850,743
TACGCGAGTACTAAGT,sample,24497,23828,5708,18120,1239,16881,2400,132,7518,825,9918,6006,4038,503,615,624
ATACGTTCTACTAAGT,sample,27798,26991,2595,24396,5585,18811,12111,548,3843,405,15954,1904,1726,837,5678,3920
CCGCAGTCTACTAAGT,sample,62503,61566,7349,54217,5985,48232,18701,1064,14840,1359,33541,12268,5200,1084,6734,4268
GATGCGTTTACTAAGT,sample,10638,10400,1715,8685,1621,7064,2976,178,2124,235,5100,1551,1410,420,1515,1141
CCATTCTTTACTAAGT,sample,19103,18705,2234,16471,2012,14459,6003,409,5008,568,11011,2471,2349,782,2272,1369
ACGCTTAATACTAAGT,sample,15063,14797,1740,13057,1436,11621,5147,300,3775,476,8922,1923,2430,960,1128,935
CATTCGGTTACTAAGT,sample,18954,18571,2312,16259,2984,13275,6074,322,3853,431,9927,2595,2251,753,2627,2098
GCTCTTCTTACTAAGT,sample,12858,12510,2140,10370,1498,8872,3105,104,2964,302,6069,2397,1820,452,1554,1027
GAGATTCTTACTAAGT,sample,9882,9633,1091,8542,2098,6444,3892,203,1482,133,5374,734,904,442,2085,1515
CTAACCGGTACTAAGT,sample,9527,9375,1374,8001,1127,6874,2736,169,2259,219,4995,1491,1586,497,1126,727
GGCGACGATACTAAGT,sample,13733,13488,1668,11820,1982,9838,4309,386,2677,302,6986,2164,1735,583,1736,1420
GCCTATTCTACTAAGT,sample,18674,18268,2940,15328,1300,14028,3693,203,5834,568,9527,3730,3105,674,909,852
AGCAGAGCTACTAAGT,sample,33975,33417,7176,26241,3021,23220,4640,228,9425,1084,14065,7843,4917,543,1904,1750
CAGCTTCGTACTAAGT,sample,10988,10764,1116,9648,1578,8070,4654,306,1917,248,6571,945,1202,523,2291,1212
TCAATCAGTACTAAGT,sample,12481,12266,1083,11183,1734,9449,6215,424,1692,166,7907,952,1332,787,1922,1352
ATTCTACCTACTAAGT,sample,24896,24466,4198,20268,2152,18116,6217,246,6172,670,12389,4811,3495,714,2102,1519
ATATGCAATACTAAGT,sample,20019,19737,2990,16747,2436,14311,5583,249,4567,501,10150,3411,2522,572,2352,1498
AACCGGTTTTGCCGCT,sample,172063,170857,10752,160105,33909,126196,67324,4641,30744,3973,98068,19514,7309,2387,26234,23674
AGCTGAATTTGCCGCT,sample,287796,284936,19744,265192,39871,225321,119278,9510,61289,7796,180567,27448,7970,2709,25997,29764
GACGTATGTTGCCGCT,sample,241913,239133,20865,218268,37124,181144,89455,5879,49552,6937,139007,29321,9209,2539,27589,26954
TATACGGATTGCCGCT,sample,100039,98749,7760,90989,11502,79487,37930,2301,24483,3055,62413,11718,5179,1802,12673,7837
CTAGCGACTTGCCGCT,sample,112918,111319,12916,98403,13521,84882,31232,2024,28821,3234,60053,19571,8121,2212,10492,9472
CGTCGCCATTGCCGCT,sample,60520,59476,4096,55380,5510,49870,21604,1677,18601,2560,40205,5428,3619,1573,5798,4154
TCATCGAATTGCCGCT,sample,135518,133899,13324,120575,16676,103899,39772,2492,34157,3702,73929,23776,7568,1840,15939,12041
TCATACCATTGCCGCT,sample,75793,74980,3503,71477,10841,60636,36922,2562,15036,2095,51958,4021,3268,2004,10396,8113
ATTCAAGGTTGCCGCT,sample,66434,65548,5487,60061,8738,51323,23266,1862,18077,1927,41343,6191,4515,2072,4694,6102
ATACGTTCTTGCCGCT,sample,107162,104136,15257,88879,19634,69245,42195,3107,14163,1492,56358,8288,5071,2164,13128,12477
TCTCAGGATTGCCGCT,sample,202859,200289,20575,179714,19317,160397,59273,3081,54168,5386,113441,38489,10332,2067,19862,13377
GGCAGGTTTTGCCGCT,sample,47862,46817,5132,41685,8178,33507,16617,1143,9241,1217,25858,5289,4054,1553,5605,5773
TGCGCGTTTTGCCGCT,sample,57254,56241,8377,47864,4553,43311,9227,681,18604,2008,27831,12791,6213,1192,2424,2611
AGCGTCTTTTGCCGCT,sample,48883,47937,4367,43570,9384,34186,19524,1068,8537,798,28061,4259,2750,1072,9477,6420
ACGCTTAATTGCCGCT,sample,28016,27230,4322,22908,2381,20527,8313,430,7417,871,15730,3496,3549,1341,2132,1566
TAGCGAGTTTGCCGCT,sample,43213,42493,3253,39240,11206,28034,19677,1473,4362,558,24039,1964,2621,1844,6178,7440
TAACGAAGTTGCCGCT,sample,47575,47007,3694,43313,6855,36458,20631,978,8882,926,29513,5041,3114,1069,10399,5009
CAGCTTCGTTGCCGCT,sample,53987,53148,6214,46934,7367,39567,18959,1242,11123,1144,30082,7099,4487,1499,7012,5226
CGCGGTCGTTGCCGCT,sample,42655,42048,4077,37971,4392,33579,17794,1170,8270,840,26064,5505,4076,1701,3858,3216
TAACGCCATTGCCGCT,sample,34844,34319,3504,30815,2820,27995,9560,768,10722,1195,20282,5750,3429,1072,2279,1842
ATTCTACCTTGCCGCT,sample,73697,72769,6183,66586,10896,55690,30984,1618,14879,1658,45863,6551,3524,1190,12938,8693
CCTAACTATTGCCGCT,sample,67525,66714,4894,61820,12826,48994,34447,1945,7321,1032,41768,4249,2315,1261,14788,9960
ATATGCAATTGCCGCT,sample,75299,74557,7170,67387,9074,58313,26135,1563,17695,1820,43830,11100,5678,1393,10078,6326
AACCGGTTTTCGACCT,sample,204856,202653,24447,178206,28150,150056,61787,3866,44666,4755,106453,34982,10342,2685,17171,19222
TCTAGGTTTTCGACCT,sample,363503,358589,45937,312652,15754,296898,91411,5670,136086,20287,227497,43444,12110,3230,10787,9322
AGCTGAATTTCGACCT,sample,146528,144563,11337,133226,22681,110545,64993,3237,28293,2804,93286,11218,4715,1639,27259,16493
CATAATGGTTCGACCT,sample,45183,44516,6720,37796,6409,31387,9635,623,11348,1280,20983,8501,5488,1443,2868,3951
TATACGGATTCGACCT,sample,69328,68604,6446,62158,7724,54434,23013,1386,19588,1999,42601,8448,4697,1539,7414,5584
GGAGAAGCTTCGACCT,sample,72153,71383,6855,64528,9886,54642,21987,1579,18440,1773,40427,10863,5972,1552,8295,6977
CATACTCCTTCGACCT,sample,57884,56609,8434,48175,7316,40859,14867,1011,13564,1600,28431,9817,5573,1512,5609,4845
CGTCGCCATTCGACCT,sample,50644,49842,4566,45276,11186,34090,20012,1213,7900,729,27912,4236,3059,1197,8576,7745
TCATCGAATTCGACCT,sample,83382,82069,10155,71914,12145,59769,26112,1131,17704,2426,43816,12396,5579,1232,11098,7949
ATTCAAGGTTCGACCT,sample,206992,205107,9694,195413,23970,171443,130269,9172,19509,2625,149778,9868,4325,2587,21581,18532
CCGTACGCTTCGACCT,sample,48034,47112,8110,39002,4819,34183,10490,528,12373,1273,22863,9519,5340,1178,3488,3148
CGGTTGGTTTCGACCT,sample,41739,41358,2854,38504,7822,30682,18810,1692,6157,705,24967,3318,3206,1900,4824,5292
GAGATTCTTTCGACCT,sample,111421,110031,11657,98374,11247,87127,44615,2515,21548,2546,66163,15903,7094,2640,6560,7789
TAACGAAGTTCGACCT,sample,9635,9429,2024,7405,709,6696,1884,103,2729,243,4613,1737,1773,373,799,446
GCGTTACCTTCGACCT,sample,47821,47146,4674,42472,7381,35091,18950,896,9539,1292,28489,4414,3299,1244,7188,5498
CGCGGTCGTTCGACCT,sample,20700,20543,1751,18792,2291,16501,8676,608,4102,468,12778,2647,2894,1453,1541,1518
TCTCCTAGTTCGACCT,sample,36842,36306,4296,32010,4286,27724,13223,720,7609,925,20832,5247,3388,765,7183,2947
ATGAATAGTTCGACCT,sample,30051,29540,3496,26044,3152,22892,10351,651,7116,749,17467,4025,3262,1058,3989,2211
TCAATCAGTTCGACCT,sample,33840,33459,3648,29811,3348,26463,9486,619,8874,818,18360,6666,4140,1079,2913,2013
CGCGAGACTTCGACCT,sample,59126,58331,5805,52526,6513,46013,18611,1018,15273,1574,33884,9537,4785,1032,8122,4780
CGTAGAACTTCGACCT,sample,47466,46738,5534,41204,5342,35862,13722,721,12092,1315,25814,8012,4508,1094,4582,3711
CCTAACTATTCGACCT,sample,34626,34191,3811,30380,4371,26009,10304,787,8896,1003,19200,5019,3793,1243,3299,3084
ATATGCAATTCGACCT,sample,35773,35385,3321,32064,4370,27694,12254,889,8196,881,20450,5474,4189,1516,3758,2907
AACCGGTTTCCAGACT,sample,75330,74559,10862,63697,7249,56448,13696,655,22426,2281,36122,17390,7775,1271,5084,4544
GACGTATGTCCAGACT,sample,36462,35816,4801,31015,4142,26873,10621,654,8838,947,19459,5813,3903,981,4729,2630
CATAATGGTCCAGACT,sample,64458,63657,7176,56481,5146,51335,17781,1144,21309,2018,39090,9083,4352,1116,5639,3557
GGAGAAGCTCCAGACT,sample,27163,26760,4217,22543,3401,19142,6356,379,6664,672,13020,5071,3726,706,3148,2233
ATTCAAGGTCCAGACT,sample,24859,24368,3051,21317,3416,17901,7709,460,5481,511,13190,3740,2961,965,2268,2302
TGATTCCGTCCAGACT,sample,60579,59554,11120,48434,5249,43185,8871,463,17787,1726,26658,14338,7316,985,2956,3420
CCGCAGTCTCCAGACT,sample,27832,27265,4035,23230,2695,20535,7890,383,6775,710,14665,4777,3226,804,3276,1737
GGCAGGTTTCCAGACT,sample,9891,9572,1965,7607,676,6931,2061,89,2882,261,4943,1638,1771,451,595,456
CCATTCTTTCCAGACT,sample,24165,23622,3588,20034,1994,18040,5526,323,6763,706,12289,4722,3141,623,2237,1302
AGCGTCTTTCCAGACT,sample,9337,9030,950,8080,1576,6504,4634,252,990,124,5624,504,1156,808,1666,1113
ACGCTTAATCCAGACT,sample,32611,32016,4073,27943,2913,25030,9599,632,7793,893,17392,6113,3666,844,3061,2042
GAGATTCTTCCAGACT,sample,48608,47879,7958,39921,3069,36852,8765,493,14655,1574,23420,11365,5648,1168,2166,1728
CCTAGCGGTCCAGACT,sample,10082,9869,1190,8679,1453,7226,3707,216,1805,187,5512,1311,1485,634,1109,1039
GGCGACGATCCAGACT,sample,10826,10549,1296,9253,1516,7737,3813,180,2089,217,5902,1438,1276,444,1900,1155
TAACGAAGTCCAGACT,sample,8126,7979,1003,6976,537,6439,2689,151,2241,262,4930,1096,1573,473,1082,386
GCCTATTCTCCAGACT,sample,4377,4270,869,3401,394,3007,837,39,1097,145,1934,889,883,190,346,279
TGCGCTCCTCCAGACT,Pos_Ctrl,11306,11112,745,10367,442,9925,8405,731,509,68,8914,212,2616,2336,684,158
GCGTTACCTCCAGACT,sample,14521,14278,1919,12359,1876,10483,4642,206,3129,351,7771,2155,2059,621,2013,1392
GGCGTACCTCCAGACT,sample,8707,8529,680,7849,1367,6482,4069,264,1373,151,5442,625,1257,779,926,1002
CGTCGAGGTCCAGACT,Pos_Ctrl,15865,15512,1136,14376,615,13761,11668,984,741,106,12409,262,3228,2920,973,242
TTATGACGTCCAGACT,sample,12439,12217,1755,10462,1029,9433,3634,217,3356,307,6990,1919,1901,572,1285,786
TTAACTGATCCAGACT,sample,9524,9361,943,8418,845,7573,3904,264,2029,298,5933,1078,1303,582,1465,611
ATATGCAATCCAGACT,sample,12990,12774,1758,11016,1361,9655,3145,203,3416,421,6561,2470,2100,471,1419,903
TCTAGGTTACCATTAT,sample,58234,57383,4924,52459,11833,40626,19034,1362,12338,1282,31372,6610,4661,1737,6269,7389
TATACGGAACCATTAT,sample,43244,42589,3300,39289,5526,33763,16945,921,10751,1254,27696,3892,3126,1427,4629,3930
CATACTCCACCATTAT,sample,109723,107992,10260,97732,17122,80610,41961,2407,21762,2652,63723,11828,5398,1444,18844,11793
CTAGCGACACCATTAT,sample,75384,74132,9483,64649,10401,54248,23318,1249,16825,2076,40143,10780,5681,1367,10281,6873
TCGAACGAACCATTAT,sample,120823,119229,13830,105399,15631,89768,34324,1469,30401,2885,64725,20689,8613,1927,13166,11059
GGTAGAGAACCATTAT,sample,216834,213532,28804,184728,18995,165733,41544,2378,68370,8727,109914,44714,12185,2586,8964,11634
TCATCGAAACCATTAT,sample,261875,259038,29579,229459,33771,195688,72284,5126,67187,7657,139471,43434,10027,2335,23187,24382
ATTCAAGGACCATTAT,sample,182140,179422,14188,165234,25269,139965,71022,3415,37401,4099,108423,24028,7435,1620,29152,17481
GCAACTAGACCATTAT,sample,55733,54493,4728,49765,12400,37365,27141,1506,6386,692,33527,1640,1659,1094,11906,9199
GGCAGGTTACCATTAT,sample,242162,238999,24229,214770,26332,188438,73853,4532,63745,6629,137598,39679,8105,2020,28563,17732
GATGCGTTACCATTAT,sample,235953,233041,22041,211000,33509,177491,86290,5828,48294,6088,134584,30991,7764,1786,31793,23464
ATGGCGTTACCATTAT,sample,257741,254709,15155,239554,44349,195205,128755,9791,37786,2924,166541,15949,4642,1766,41793,33126
TAGCGAGTACCATTAT,sample,143524,141743,13516,128227,31733,96494,59445,2735,21368,2009,80813,10937,3441,1173,25164,21701
GCTCTTCTACCATTAT,sample,153242,151584,13727,137857,11395,126462,49111,4036,47060,5674,96171,20581,7070,2036,12071,7486
GAGATTCTACCATTAT,sample,184952,182718,14699,168019,26310,141709,67385,4231,40350,4609,107735,25134,6728,1653,29649,20009
GCTGCTTCACCATTAT,sample,55962,55300,3439,51861,6593,45268,29217,2043,9622,1182,38839,3204,3063,2032,6716,5160
ATACCGCCACCATTAT,sample,77398,76153,9225,66928,9035,57893,22808,1366,18466,1880,41274,13373,5844,1557,8067,5934
GTCGCGAAACCATTAT,sample,85615,84451,9831,74620,12229,62391,26450,1802,19113,2344,45563,12682,5863,1531,8928,8447
GACTAACCACCATTAT,sample,71944,70978,6392,64586,11059,53527,31758,1897,12091,1398,43849,6383,3121,1129,12526,9319
CGCGAGACACCATTAT,sample,39039,38540,3336,35204,5197,30007,14565,910,8750,1038,23315,4744,2861,866,6594,3840
GCGCAATAACCATTAT,sample,69394,68516,6281,62235,7577,54658,24635,1797,16150,2140,40785,9936,4392,1307,8177,5569
AACCGGTTCAATGGAT,sample,102784,101600,8460,93140,17105,76035,39887,2423,20381,2145,60268,11199,4888,1493,15432,12401
TCTAGGTTCAATGGAT,sample,86799,86031,5565,80466,16635,63831,38281,2132,14350,2062,52631,7006,3834,1480,16449,11770
AGAGTTCTCAATGGAT,sample,34232,33432,5279,28153,3422,24731,8416,535,8824,936,17240,6020,3576,817,4198,2201
GACGTATGCAATGGAT,sample,101203,99602,12456,87146,11966,75180,34172,2593,23573,2955,57745,11887,6068,1643,13285,8660
TATACGGACAATGGAT,sample,57688,56711,8872,47839,8113,39726,14308,869,12892,1272,27200,10385,5067,1311,5462,5704
ATTCAAGGCAATGGAT,sample,98653,97121,8115,89006,15523,73483,36626,2117,20245,2266,56871,12229,4629,1718,12528,11463
CCGCAGTCCAATGGAT,sample,179487,176846,21931,154915,18042,136873,42177,2170,49424,5186,91601,37916,10721,1947,18965,12647
CCGTACGCCAATGGAT,sample,78468,77281,8513,68768,10771,57997,25687,1358,18628,1834,44315,10490,4783,1249,11800,7696
TCTCAGGACAATGGAT,sample,68636,67681,8272,59409,7525,51884,22518,1464,15800,1610,38318,10492,6209,2201,5086,5271
ATGGCGTTCAATGGAT,sample,150147,148389,17346,131043,17598,113445,40725,2962,38955,4312,79680,26491,7939,1947,15210,12444
TGCGCGTTCAATGGAT,sample,54697,53800,5400,48400,6792,41608,19182,1299,12340,1345,31522,7442,4400,1627,5187,4514
CCATTCTTCAATGGAT,sample,54350,53570,5239,48331,6829,41502,19802,1452,12637,1598,32439,6013,4508,1937,4631,5046
ACGCTTAACAATGGAT,sample,113683,112242,9213,103029,19641,83388,50553,3077,19023,1919,69576,8816,3216,1164,18934,14526
CATTCGGTCAATGGAT,sample,60552,59692,6327,53365,5441,47924,20990,1481,16164,1643,37154,7646,4782,1724,4232,4078
GCTCTTCTCAATGGAT,sample,128598,126981,12955,114026,15525,98501,45473,3126,28577,3105,74050,18220,6780,1861,13053,10835
AAGGTCTGCAATGGAT,sample,35710,35208,3716,31492,3493,27999,12322,1031,9757,1009,22079,3880,3233,1310,2979,2519
GGCGACGACAATGGAT,sample,54867,54093,4120,49973,10260,39713,22069,1453,9093,1114,31162,5984,2707,1047,10117,7704
ATACCGCCCAATGGAT,Neg_Ctrl,1882,864,587,277,33,244,102,7,83,9,185,43,96,41,45,8
CAGCTTCGCAATGGAT,Neg_Ctrl,1808,802,589,213,31,182,71,6,53,3,124,49,80,35,27,6
ATTCTACCCAATGGAT,sample,56220,55497,4063,51434,11802,39632,26492,1721,6989,789,33481,3641,2432,1223,10964,8956
AGATACTACAATGGAT,sample,34883,34141,2725,31416,4400,27016,12536,1012,9009,952,21545,3507,2678,1046,3104,2739
TTAACTGACAATGGAT,sample,28830,28421,4078,24343,3030,21313,8565,301,6622,642,15187,5183,3121,662,4342,1924
TCTAGGTTAGATTCAT,sample,60214,59610,4746,54864,8403,46461,28401,1830,9527,1000,37928,5703,4141,2123,5158,5737
CTGGTCTTAGATTCAT,sample,44706,44212,4152,40060,5998,34062,18055,1023,9886,1197,27941,3901,3315,1738,4289,4520
GTCGTTCTAGATTCAT,sample,70829,69960,6812,63148,11353,51795,27574,1911,14192,1176,41766,6942,4239,1545,8364,8214
AGAGTTCTAGATTCAT,sample,70302,69365,6980,62385,10667,51718,26923,1655,13060,1250,39983,8830,3589,1152,12824,7737
TATACGGAAGATTCAT,sample,80800,79926,5550,74376,14119,60257,34448,2286,14614,2035,49062,6874,3456,1301,14592,10544
GGAGAAGCAGATTCAT,sample,47064,46411,6032,40379,3959,36420,13026,761,14049,1578,27075,7006,4887,1582,3189,2873
GAGCCTCCAGATTCAT,sample,97944,96875,8086,88789,12567,76222,32525,2076,22843,2489,55368,16289,5850,1406,14982,9108
GGTAGAGAAGATTCAT,sample,103266,101921,8288,93633,11694,81939,45704,3042,21334,2775,67038,9084,4443,1844,9071,9341
TCATACCAAGATTCAT,sample,125113,123340,10755,112585,14307,98278,48426,3373,27665,2630,76091,16184,6123,1686,15459,10849
GACTCAAGAGATTCAT,sample,93812,92722,7114,85608,10504,75104,41696,3177,18260,2050,59956,9921,4699,1673,10918,7555
CCGCAGTCAGATTCAT,sample,140533,138793,11271,127522,20001,107521,59342,2750,27366,3221,86708,14842,5689,1533,22318,14450
GATGCGTTAGATTCAT,sample,50990,50281,5579,44702,7239,37463,19054,1279,10487,1098,29541,5545,3400,1168,6539,5537
CGGTTGGTAGATTCAT,sample,96681,95541,6897,88644,13411,75233,50255,2799,13578,1306,63833,7295,3040,1296,15734,9772
ACGCTTAAAGATTCAT,sample,105153,103831,9782,94049,12126,81923,39797,1500,21478,2224,61275,16924,5810,1407,14223,8315
TAGCGAGTAGATTCAT,sample,131771,130157,18616,111541,9984,101557,23288,1710,39638,4332,62926,32589,9780,1937,6090,5839
TAACGAAGAGATTCAT,sample,47779,47131,4782,42349,6021,36328,15101,765,11457,1361,26558,7644,4265,1149,5424,4279
GCGTTACCAGATTCAT,sample,19250,18862,1804,17058,3575,13483,7233,456,3672,362,10905,1760,1896,766,3120,2466
CGTCGAGGAGATTCAT,sample,40262,39702,2772,36930,7044,29886,18378,899,6146,798,24524,3665,2394,955,7417,5095
CAGCTTCGAGATTCAT,sample,36109,35491,2974,32517,5094,27423,14077,693,7334,649,21411,4670,2627,887,6119,3781
CGCGGTCGAGATTCAT,sample,19122,18758,2042,16716,2317,14399,6926,279,3980,453,10906,2761,2380,624,3454,1641
TCTCCTAGAGATTCAT,sample,39439,38752,6218,32534,3073,29461,7706,525,11128,1042,18834,9060,4695,762,3728,1897
ATGAATAGAGATTCAT,sample,36639,36084,2510,33574,6974,26600,18858,1330,4048,848,22906,1516,1574,1013,5343,5117
TCAATCAGAGATTCAT,sample,17783,17503,1755,15748,1279,14469,5829,399,5333,642,11162,2266,2284,768,1791,884
GACTAACCAGATTCAT,sample,41260,40591,5442,35149,3915,31234,12616,666,10061,1053,22677,6838,4105,1003,4692,3054
GCGCAATAAGATTCAT,sample,23649,23335,2219,21116,2153,18963,8593,507,6316,800,14909,2747,2608,968,2450,1369
AACCGGTTCAATCTTG,sample,78185,77428,6760,70668,13007,57661,23100,1793,17807,2115,40907,12846,5755,1237,10263,8931
TCTAGGTTCAATCTTG,sample,31835,31487,2533,28954,7229,21725,10912,733,5873,676,16785,3531,2635,932,5265,4731
CTGGTCTTCAATCTTG,sample,92504,91331,10139,81192,11536,69656,25256,1377,22943,2723,48199,17357,6594,1313,11787,7446
AGAGTTCTCAATCTTG,sample,35434,34894,4601,30293,5872,24421,11349,694,7000,746,18349,4632,3311,1034,4428,4000
AGCTGAATCAATCTTG,sample,93011,91857,7310,84547,16809,67738,42257,2736,13866,1911,56123,6968,3478,1603,15248,12368
GAGCCTCCCAATCTTG,sample,63293,62269,6944,55325,7302,48023,18756,1261,16094,1541,34850,10371,5196,1328,6218,4840
CTAGCGACCAATCTTG,sample,97496,95934,11465,84469,16764,67705,30353,1578,19496,2066,49849,14212,5628,1430,13632,10677
CCGTACGCCAATCTTG,sample,133439,131615,11212,120403,19878,100525,56287,3839,23943,2582,80230,13874,4434,1385,20197,14274
CGGTTGGTCAATCTTG,sample,80641,79574,7769,71805,11732,60073,30283,2664,14890,1656,45173,10580,5095,1505,9068,8590
GCTCTTCTCAATCTTG,sample,56318,55529,6922,48607,4972,43635,14583,929,15750,1785,30333,10588,5860,1583,3301,3023
CTAAGCATCAATCTTG,sample,54140,53328,5036,48292,8265,40027,20657,1212,11002,1298,31659,5858,3773,1186,8722,5960
AAGGTCTGCAATCTTG,sample,97078,95705,11022,84683,9603,75080,25211,1482,26074,2659,51285,19654,6904,1270,10645,7087
CTAACCGGCAATCTTG,sample,75536,74460,11146,63314,5375,57939,16794,736,22174,2355,38968,15880,7220,1329,6277,3366
GGCGACGACAATCTTG,sample,56160,55258,5800,49458,6623,42835,18398,1353,13278,1278,31676,8528,4479,1306,6688,4540
GCTGCTTCCAATCTTG,sample,40302,39767,3343,36424,7437,28987,19538,1077,5754,594,25292,2024,1889,939,8933,5548
AGCAGAGCCAATCTTG,sample,45690,45019,4779,40240,6507,33733,15297,863,10333,1055,25630,6185,3883,1222,5680,4624
GGCGTACCCAATCTTG,sample,58228,57046,8036,49010,5849,43161,15365,1136,14632,1653,29997,10375,5387,1150,5322,3729
CGTCGAGGCAATCTTG,sample,60597,59785,7904,51881,6717,45164,16063,831,14931,1475,30994,11864,5512,1020,7212,4538
TCTCCTAGCAATCTTG,sample,57495,56664,6740,49924,6171,43753,18213,1247,13182,1432,31395,9679,5175,1271,6477,4327
CGCGAGACCAATCTTG,sample,74117,72921,8294,64627,3943,60684,21040,1780,23915,2862,44955,11087,5501,1594,2941,2573
CCTAACTACAATCTTG,sample,29156,28658,3095,25563,3535,22028,9241,647,6997,806,16238,4337,3618,1198,2293,2345
GCGCAATACAATCTTG,Neg_Ctrl,1220,550,399,151,14,137,65,2,47,4,112,19,48,18,21,4
AACCGGTTCGTTCCGA,sample,111577,110086,17017,93069,12068,81001,23321,1312,30957,2984,54278,22427,7920,1625,8295,8553
CTGGTCTTCGTTCCGA,sample,97041,95593,8822,86771,13476,73295,33353,2153,24496,2322,57849,10971,5315,1566,11551,9367
GTCGTTCTCGTTCCGA,sample,86398,85079,9298,75781,17383,58398,32850,1652,13871,1632,46721,8393,3803,1196,16426,12397
AGAGTTCTCGTTCCGA,sample,139321,137302,17378,119924,19140,100784,41178,2736,31443,2991,72621,22436,7332,1921,14994,12557
TATACGGACGTTCCGA,sample,122200,120466,12392,108074,17144,90930,40990,2583,29711,3635,70701,14011,5852,1770,14073,12902
CATACTCCCGTTCCGA,sample,238587,235856,22620,213236,27939,185297,107838,7069,37341,4230,145179,28819,8336,2900,15710,19808
GGTAGAGACGTTCCGA,sample,265689,262150,39761,222389,21401,200988,54412,3914,74594,8510,129006,59558,12212,2280,19426,13425
TCATCGAACGTTCCGA,sample,247407,244504,27121,217383,16374,201009,67039,5934,71181,7731,138220,49124,11423,2804,14719,9849
ATACGTTCCGTTCCGA,sample,253349,250553,21922,228631,33698,194933,85571,5180,58082,5824,143653,40276,9990,2524,28103,22475
CCGTACGCCGTTCCGA,sample,163624,161866,15063,146803,22930,123873,65101,4648,31893,3146,96994,19085,7068,2381,16763,16239
TGGATCAACGTTCCGA,sample,130390,129059,8186,120873,19839,101034,69325,5195,17262,1523,86587,7729,4531,2196,16832,14185
GATGCGTTCGTTCCGA,sample,254318,251717,20808,230909,16911,213998,94261,8872,62149,8707,156410,40009,9180,2579,9914,10978
AGCGTCTTCGTTCCGA,sample,177774,175389,16051,159338,23755,135583,73543,4992,33197,3339,106740,20512,6732,1850,17799,16785
CCTAGCGGCGTTCCGA,sample,101477,100601,5785,94816,17833,76983,49892,3569,15137,1675,65029,6710,4000,1686,16404,12155
GCCTATTCCGTTCCGA,sample,78715,77837,5732,72105,7339,64766,33589,2160,19206,2438,52795,7373,4457,2043,7191,4974
ATACCGCCCGTTCCGA,sample,119198,117836,15009,102827,12112,90715,32667,2403,30336,3241,63003,22068,8627,2100,12021,7719
CAGCTTCGCGTTCCGA,sample,88027,87184,4344,82840,13933,68907,49470,4001,10534,1464,60004,3438,3048,2460,10514,10418
TTATGACGCGTTCCGA,sample,135762,134577,13405,121172,16652,104520,46572,2731,33518,3158,80090,18541,7436,2312,13876,10922
TAACGCCACGTTCCGA,sample,158636,157208,10587,146621,21267,125354,74229,4310,29419,3734,103648,13662,5828,1890,28751,15706
AGATACTACGTTCCGA,sample,130742,129717,9909,119808,20678,99130,56632,3899,24467,2867,81099,11265,5392,1881,16308,14770
CCTAACTACGTTCCGA,sample,141904,140584,8462,132122,18992,113130,66334,3927,26152,2705,92486,14012,4850,1574,24940,13609
ATATGCAACGTTCCGA,sample,347,339,45,294,38,256,116,7,67,12,183,54,102,48,35,28
TCTAGGTTCAATTCGG,sample,342695,337569,45089,292480,20334,272146,62864,4323,107545,10391,170409,87023,14831,3401,14012,11076
CTGGTCTTCAATTCGG,Pos_Ctrl,347970,342909,16589,326320,11531,314789,263040,25467,17997,2379,281037,5906,7267,12436,13265,3147
GTCGTTCTCAATTCGG,sample,170384,166406,9275,157131,23796,133335,88180,4504,22964,4647,111144,13040,4044,1384,22073,16760
AGAGTTCTCAATTCGG,sample,212713,209068,20792,188276,14780,173496,75040,5898,55574,6674,130614,30310,8031,2211,13511,8778
TATACGGACAATTCGG,sample,117361,116261,9554,106707,19587,87120,45808,2915,23758,2351,69566,12288,6196,1725,21587,13137
GGAGAAGCCAATTCGG,sample,89033,88129,5908,82221,20071,62150,34148,1861,16509,1589,50657,8043,4567,1849,11412,13231
CATACTCCCAATTCGG,Pos_Ctrl,100310,98333,6239,92094,3665,88429,74255,6578,4968,646,79223,1982,6688,8737,7049,1406
CGTCGCCACAATTCGG,sample,146575,145003,12229,132774,21434,111340,58871,3152,28297,2895,87168,18125,7690,2525,13576,14574
ATTCAAGGCAATTCGG,sample,166252,164654,12089,152565,28162,124403,65927,3429,32265,3170,98192,19612,6083,1910,29528,19879
TGATTCCGCAATTCGG,sample,124518,123273,8573,114700,24039,90661,51519,3031,20258,2422,71777,13431,4806,1680,24281,16427
GACTCAAGCAATTCGG,Pos_Ctrl,82644,81382,4856,76526,3226,73300,62287,5558,3765,518,66052,1172,6149,7960,6107,1282
TCTCAGGACAATTCGG,sample,130903,129266,10380,118886,12778,106108,47075,2293,33169,4168,80244,19403,6784,1686,14264,8467
ATGGCGTTCAATTCGG,Pos_Ctrl,121551,119926,7064,112862,4821,108041,90998,8613,6048,687,97046,1695,6711,9237,8434,1804
AGCGTCTTCAATTCGG,sample,61423,60582,5794,54788,10618,44170,17614,1185,14800,1624,32414,8947,5104,1378,5811,6634
CATTCGGTCAATTCGG,sample,90203,88985,9212,79773,10297,69476,30469,2142,23553,2786,54022,10526,5830,2041,8472,7281
GAGATTCTCAATTCGG,Pos_Ctrl,65690,64707,4217,60490,2496,57994,48656,4534,3262,452,51918,1090,5828,7008,4724,910
AAGGTCTGCAATTCGG,sample,83875,82901,7619,75282,8641,66641,31803,2074,21530,2222,53333,9012,4693,1704,9039,5837
GCTGCTTCCAATTCGG,sample,79469,78512,7651,70861,10953,59908,28852,1690,16645,1779,45497,10942,5648,1411,14303,7782
AGCAGAGCCAATTCGG,Pos_Ctrl,102915,101514,5421,96093,3920,92173,78252,7110,4804,546,83056,1461,6370,8783,7292,1465
CGTCGAGGCAATTCGG,Pos_Ctrl,74444,73239,4278,68961,2800,66161,55819,5200,3516,457,59335,1169,5841,7421,4957,873
CAGCTTCGCAATTCGG,sample,132298,130580,17117,113463,12116,101347,37650,2511,34663,3423,72313,23100,9170,2290,8823,7732
AAGTAGAGCAATTCGG,sample,71395,70574,6028,64546,9184,55362,29681,2273,13426,1192,43107,8790,5052,1826,8256,6648
TAACGCCACAATTCGG,sample,140477,139024,11260,127764,16101,111663,65627,3799,23699,3145,89326,15393,5308,1753,23686,11043
CGCGAGACCAATTCGG,sample,136431,134233,20430,113803,9957,103846,30168,1569,39942,3852,70110,28315,9899,2078,7474,5618
CCTAACTACAATTCGG,sample,41232,40641,3122,37519,6764,30755,18034,1005,6776,802,24810,4138,2743,1011,7486,4597
TCTAGGTTAACTCCGG,sample,26080,25786,1381,24405,3896,20509,10541,473,6373,830,16914,2292,2376,1020,4016,2516
CTGGTCTTAACTCCGG,sample,130134,128590,8826,119764,16541,103223,60337,4672,23725,2682,84062,11807,5136,1667,26338,11994
GTCGTTCTAACTCCGG,sample,169502,167621,20910,146711,23087,123624,49175,2994,39182,3979,88357,28294,8471,1986,19631,14686
GACGTATGAACTCCGG,sample,189825,186954,14070,172884,22822,150062,65727,3998,44599,4631,110326,31107,8531,2027,18308,15276
TATACGGAAACTCCGG,sample,70311,69454,5686,63768,13700,50068,28508,2089,11810,1191,40318,6470,4121,1583,10558,9092
ATTCAAGGAACTCCGG,sample,89375,88050,7806,80244,17727,62517,36864,2179,13824,1359,50688,8291,3464,1270,15701,12665
TGATTCCGAACTCCGG,sample,115838,114507,9837,104670,9921,94749,46021,2779,30610,4043,76631,11296,5589,2342,10158,7181
TACGCGAGAACTCCGG,sample,87401,86292,6437,79855,14766,65089,42881,3235,11346,1249,54227,6378,3150,1527,16328,10993
TCTCAGGAAACTCCGG,sample,166862,164956,15449,149507,11318,138189,51674,4198,47411,5872,99085,29034,8372,1990,12017,7752
GATGCGTTAACTCCGG,sample,27392,26801,3517,23284,4423,18861,8546,427,5584,497,14130,3807,2732,880,3810,3036
ATGGCGTTAACTCCGG,sample,46249,45482,4178,41304,7198,34106,18376,1137,9074,756,27450,4763,3390,1379,7347,4907
CCATTCTTAACTCCGG,sample,64929,63764,6985,56779,8770,48009,20016,1018,15108,1479,35124,10388,5264,1339,9123,6039
CGGTTGGTAACTCCGG,sample,25611,25131,1505,23626,3411,20215,11948,931,5121,678,17069,1537,1966,1219,4267,2512
TAGCGAGTAACTCCGG,sample,43984,43470,4792,38678,7778,30900,13221,872,9567,907,22788,6333,4392,1377,4428,5169
GCTCTTCTAACTCCGG,sample,65035,64114,4993,59121,12252,46869,25376,1601,11290,1221,36666,7381,3841,1184,12353,8652
TAACGAAGAACTCCGG,sample,49111,48442,2743,45699,10166,35533,25408,1069,6489,929,31897,1638,1704,872,13296,7358
GCTGCTTCAACTCCGG,sample,50284,49626,3499,46127,7304,38823,22663,1340,9093,800,31756,4927,3635,1251,10636,5186
GGCGTACCAACTCCGG,sample,48352,47530,5923,41607,5732,35875,14173,895,11109,1127,25282,8571,4723,1210,4583,3845
CAGCTTCGAACTCCGG,sample,64964,64222,4346,59876,11563,48313,31621,1506,9627,928,41248,4631,2821,1001,17140,8237
CGCGGTCGAACTCCGG,sample,15210,14977,1287,13690,2160,11530,6277,427,2990,320,9267,1516,2009,911,2438,1524
AAGTAGAGAACTCCGG,sample,62101,61383,6127,55256,5672,49584,20111,1446,16794,1742,36905,9491,4756,1377,5310,3728
TCAATCAGAACTCCGG,sample,54515,53787,7090,46697,4900,41797,15243,961,14117,1488,29360,9988,5579,1079,5485,3059
CCTAACTAAACTCCGG,sample,59206,58593,2855,55738,8639,47099,25921,2156,12873,1163,38794,4986,2630,959,10599,6136
TCTAGGTTCCTGAAGG,sample,100785,99250,11529,87721,12377,75344,32460,2125,23529,2671,55989,14559,5977,1433,15295,8423
GTCGTTCTCCTGAAGG,Neg_Ctrl,3704,1401,996,405,58,347,158,16,100,7,258,66,154,63,47,8
AGAGTTCTCCTGAAGG,sample,152445,150155,17348,132807,17856,114951,43064,2038,35944,3760,79008,30145,6994,1537,21539,11690
GACGTATGCCTGAAGG,sample,49789,48753,9180,39573,3802,35771,7652,393,15035,1454,22687,11237,5834,975,2599,2131
GAGCCTCCCCTGAAGG,sample,83716,82679,7383,75296,15233,60063,33531,2314,14143,1619,47674,8456,5702,2204,9933,10565
CTAGCGACCCTGAAGG,Neg_Ctrl,3861,1689,1131,558,90,468,186,9,167,14,353,92,188,60,78,13
TCGAACGACCTGAAGG,sample,34618,34114,2953,31161,7442,23719,13796,1015,5211,793,19007,2904,2856,1331,4916,5040
GCAACTAGCCTGAAGG,sample,27623,27005,2837,24168,3299,20869,9193,628,7320,799,16513,2929,3228,1269,2476,2349
ATACGTTCCCTGAAGG,Neg_Ctrl,3638,1619,1121,498,75,423,187,4,140,8,327,84,163,44,97,13
GGCAGGTTCCTGAAGG,sample,81688,80528,6704,73824,17367,56457,35525,2861,11125,1401,46650,5545,2962,1321,16481,12330
GATGCGTTCCTGAAGG,sample,113601,112094,11725,100369,18572,81797,38159,1719,24078,2122,62237,15719,6003,1433,18336,13365
TGCGCGTTCCTGAAGG,Neg_Ctrl,3100,1425,1027,398,47,351,147,5,102,13,249,84,131,43,65,13
TAGCGAGTCCTGAAGG,sample,44248,43638,5788,37850,6177,31673,12803,773,10549,1109,23352,6439,4291,1182,5042,4225
GCTCTTCTCCTGAAGG,sample,153278,151234,19767,131467,14743,116724,44564,2524,38470,3799,83034,27367,9442,2269,12789,10295
GAGATTCTCCTGAAGG,sample,44351,43550,5597,37953,5215,32738,14396,1032,9706,1016,24102,6588,3946,1185,4509,3424
CTAAGCATCCTGAAGG,Neg_Ctrl,3007,1348,1057,291,45,246,92,0,85,16,177,53,105,22,34,8
TAACGAAGCCTGAAGG,sample,110069,108562,16502,92060,10632,81428,27526,1886,27358,2844,54884,21814,9217,1916,10061,6400
GCTGCTTCCCTGAAGG,sample,43110,42516,4326,38190,3987,34203,12797,880,13382,1427,26179,5717,3826,1262,3503,2678
GCCTATTCCCTGAAGG,sample,58725,57851,5727,52124,6180,45944,20743,1141,15024,1507,35767,7529,4457,1411,6766,4741
AGCAGAGCCCTGAAGG,sample,80049,78805,9095,69710,11164,58546,25273,1526,16686,1657,41959,13404,4989,1279,10162,7874
TGCGCTCCCCTGAAGG,Neg_Ctrl,2032,952,688,264,35,229,78,9,95,8,173,39,87,31,24,12
ATACCGCCCCTGAAGG,sample,83746,82571,12022,70549,8819,61730,20692,1368,21320,2372,42012,15978,7346,1834,6224,5555
GCGTTACCCCTGAAGG,sample,45769,45017,3804,41213,4755,36458,18685,1238,10824,1076,29509,4635,3285,1286,5797,2982
GGCGTACCCCTGAAGG,sample,50607,49782,5874,43908,7334,36574,20149,970,8503,1195,28652,5757,3017,904,10462,5211
CGTCGAGGCCTGAAGG,sample,44390,43681,3190,40491,7136,33355,21334,1268,7066,597,28400,3090,2735,1213,8348,5326
CAGCTTCGCCTGAAGG,Neg_Ctrl,1907,907,620,287,35,252,146,3,60,4,206,39,103,54,52,10
TCTCCTAGCCTGAAGG,sample,73155,71969,9722,62247,8481,53766,21024,1142,17465,1827,38489,12308,5818,1284,7855,5887
ATGAATAGCCTGAAGG,sample,98986,97518,12270,85248,11487,73761,32016,1518,21997,2438,54013,15792,6653,1442,11365,8150
TCAATCAGCCTGAAGG,sample,53850,53186,4775,48411,5471,42940,25663,1607,9117,788,34780,5765,3799,1494,7381,4371
TAACGCCACCTGAAGG,sample,70544,69749,5875,63874,8171,55703,34428,2181,10907,1515,45335,6672,3451,1182,12837,6054
CTGGTCTTAATATTCG,sample,159865,157998,13319,144679,21657,123022,50727,2807,37391,4345,88118,27752,8304,2068,21152,15303
GTCGTTCTAATATTCG,sample,57517,56598,7776,48822,4166,44656,11934,1030,19078,1929,31012,10685,5120,1285,2428,2246
AGAGTTCTAATATTCG,sample,172019,169773,21638,148135,12852,135283,37519,2764,53818,5339,91337,35843,10007,2215,10141,7954
TATACGGAAATATTCG,sample,66850,65945,6322,59623,11376,48247,22640,1796,14504,1347,37144,7960,4708,1897,7377,7627
GAGCCTCCAATATTCG,sample,84463,83338,6912,76426,15003,61423,35941,2104,13504,2000,49445,7874,4503,1702,12902,10552
TCGAACGAAATATTCG,sample,115691,114563,7488,107075,19080,87995,59037,3278,15643,1687,74680,8350,3918,1682,22686,14123
TCATACCAAATATTCG,sample,134208,132362,13468,118894,15696,103198,46281,3053,31597,3063,77878,19204,7359,1614,23816,11248
CCGTACGCAATATTCG,sample,112959,111491,9455,102036,15488,86548,44255,3463,22703,3027,66958,13100,5734,1832,16993,10567
TGCGCGTTAATATTCG,sample,110613,109126,14160,94966,8203,86763,29646,1985,31494,3525,61140,20113,8846,2759,6292,5379
CATTCGGTAATATTCG,sample,177914,175949,14255,161694,16702,144992,64511,4390,44644,4792,109155,26655,7371,1999,18734,11294
CCTAGCGGAATATTCG,sample,47969,47280,3065,44215,6429,37786,21426,1473,9932,1098,31358,3857,2995,1279,7045,4522
GCGTTACCAATATTCG,sample,69921,68889,4839,64050,11986,52064,32538,1519,10797,1188,43335,6022,3035,1165,15544,8850
AAGTAGAGAATATTCG,sample,87662,86398,10646,75752,7879,67873,26950,1411,21860,2239,48810,15413,6947,1428,11502,4995
ATTCTACCAATATTCG,Pos_Ctrl,69685,68472,3967,64505,2312,62193,52415,5075,3135,519,55550,1049,5727,7196,4221,758
GCGCAATAAATATTCG,sample,56838,56145,3143,53002,9753,43249,27812,1854,8097,855,35909,4631,3342,1411,10653,6967
TCTAGGTTAGTCTCCG,sample,115653,114212,10810,103402,10909,92493,44345,2979,25306,3072,69651,16791,6612,1818,13861,7094
AGAGTTCTAGTCTCCG,sample,108929,107110,15741,91369,10116,81253,25387,1527,29160,2923,54547,22256,7980,1473,10818,6492
GAGCCTCCAGTCTCCG,sample,17293,17007,1124,15883,4845,11038,5974,404,3037,288,9011,1335,1898,925,2556,2904
CATACTCCAGTCTCCG,sample,173451,171024,17965,153059,19289,133770,50044,2830,42342,5447,92386,33107,9804,2000,19733,12975
TCGAACGAAGTCTCCG,sample,80111,79112,7267,71845,10909,60936,25679,1221,18912,1840,44591,13284,5883,1361,10464,7732
TCATACCAAGTCTCCG,sample,160101,157896,14539,143357,16029,127328,56812,4297,38006,4737,94818,23476,8066,1664,21430,11217
GATGCGTTAGTCTCCG,sample,278533,275726,27766,247960,18605,229355,76983,5235,80730,8710,157713,57697,12287,3101,14367,11261
TGCGCGTTAGTCTCCG,sample,155540,153452,15315,138137,14468,123669,49695,2695,39718,3923,89413,27638,8237,1504,15822,9497
TAGCGAGTAGTCTCCG,sample,83438,82406,5735,76671,12686,63985,32174,2529,17148,2094,49322,10040,5036,1714,9653,8676
GCTCTTCTAGTCTCCG,sample,146470,144663,7703,136960,19707,117253,69609,5130,25309,3057,94918,14148,4466,1351,30053,14093
AAGGTCTGAGTCTCCG,sample,82959,82247,7556,74691,9484,65207,29114,2212,20324,2695,49438,10862,5560,1708,9583,6214
CCTAGCGGAGTCTCCG,sample,44978,44537,3404,41133,4394,36739,17335,1300,11970,1161,29305,4973,3695,1465,4511,3181
TAACGAAGAGTCTCCG,sample,37447,37053,2787,34266,7515,26751,17241,1098,4871,701,22112,2840,2635,1249,7213,5197
ATACCGCCAGTCTCCG,sample,44024,43384,2855,40529,8900,31629,21440,1220,5549,865,26989,2555,2446,1290,8675,6531
CAGCTTCGAGTCTCCG,sample,49710,49247,2333,46914,9782,37132,24398,2151,6781,784,31179,3018,2720,1297,7636,6706
CGCGGTCGAGTCTCCG,sample,11224,11130,479,10651,2308,8343,6731,419,770,104,7501,319,1104,1019,1444,1560
TCTCCTAGAGTCTCCG,sample,28190,27955,1558,26397,5847,20550,14282,1116,3175,350,17457,1627,1684,875,5874,3968
ATGAATAGAGTCTCCG,sample,1691,1663,134,1529,207,1322,767,77,263,33,1030,182,445,301,202,111
TAACGCCAAGTCTCCG,sample,58663,58253,4486,53767,6955,46812,22852,1562,12709,1470,35561,8219,4611,1352,9691,4587
ATTCTACCAGTCTCCG,sample,72272,71676,5673,66003,9339,56664,28446,1940,14089,1372,42535,10817,5005,1446,9865,5921
CGCGAGACAGTCTCCG,sample,104706,103579,11695,91884,9278,82606,21075,1354,31135,3182,52210,25860,9781,1829,6572,5955
AGATACTAAGTCTCCG,sample,96916,95931,6385,89546,11738,77808,42719,2707,18674,2446,61393,11262,4672,1265,14822,8893
AACCGGTTTGCCTACG,sample,43817,43476,3442,40034,6346,33688,14840,918,9800,1162,24640,6968,4301,1002,7132,4349
GACGTATGTGCCTACG,sample,47087,45924,8256,37668,4370,33298,8220,362,13294,1437,21514,9985,5436,827,3088,2710
GGTAGAGATGCCTACG,sample,132367,130727,13134,117593,15234,102359,38179,1915,33992,3616,72171,24657,8500,1693,16291,10583
ATTCAAGGTGCCTACG,sample,44512,43986,3719,40267,5247,35020,19340,1423,8923,903,28263,4431,3535,1845,5156,3593
GCAACTAGTGCCTACG,sample,22369,21963,2326,19637,3498,16139,8745,550,3801,486,12546,2557,2397,1072,3197,2624
ATACGTTCTGCCTACG,sample,219138,216389,33460,182929,12675,170254,51077,3151,71520,8939,122597,35567,11501,2376,9215,7320
GATGCGTTTGCCTACG,sample,44429,44026,5346,38680,4550,34130,15584,1075,9759,997,25343,6715,4335,1482,4151,2921
TGCGCGTTTGCCTACG,sample,52230,51752,3162,48590,10139,38451,25437,1787,7259,789,32696,3179,3169,1688,8385,6844
GCTCTTCTTGCCTACG,sample,118955,117295,11909,105386,11173,94213,39523,1942,29549,3505,69072,19694,6679,1368,14429,7282
CTAAGCATTGCCTACG,sample,25239,24872,2685,22187,2684,19503,8856,413,6008,650,14864,3576,2495,817,3826,1784
TAACGAAGTGCCTACG,sample,39247,38795,5109,33686,3397,30289,10442,848,10391,1145,20833,7463,4533,1058,3584,1941
GCTGCTTCTGCCTACG,sample,28933,28615,3149,25466,2416,23050,9621,658,7723,888,17344,4160,3181,1124,2443,1721
GCCTATTCTGCCTACG,sample,18446,18145,1760,16385,2855,13530,6558,539,3660,387,10218,2386,2491,997,2030,1983
CAGCTTCGTGCCTACG,sample,44291,43583,5499,38084,3736,34348,13968,929,10823,1265,24791,7363,4102,1025,5276,2730
GACTAACCTGCCTACG,Neg_Ctrl,1114,445,309,136,12,124,58,3,49,3,107,11,57,14,19,5
TTAACTGATGCCTACG,sample,37619,37133,4788,32345,3566,28779,11090,614,9384,875,20474,6816,4196,971,3825,2333
TCTAGGTTCTTAGTTC,sample,101737,100315,9820,90495,13562,76933,36985,3043,21490,2143,58475,13272,6028,2019,6377,8616
CATAATGGCTTAGTTC,sample,94833,93581,6078,87503,18497,69006,48100,2662,11583,1478,59683,5183,2340,1120,24222,13532
TATACGGACTTAGTTC,sample,99999,98789,9913,88876,15054,73822,34718,2268,22068,2304,56786,12464,6327,2056,12778,10408
CATACTCCCTTAGTTC,sample,92685,91180,5943,85237,17295,67942,42105,2402,14865,1487,56970,7083,3574,1307,19547,12521
CTAGCGACCTTAGTTC,sample,191914,188882,29488,159394,19648,139746,45891,2587,47453,4938,93344,38877,12351,2601,14931,11165
TCGAACGACTTAGTTC,sample,136595,135005,8690,126315,18868,107447,75718,6321,14964,1526,90682,8918,4237,1837,18687,13581
TCATACCACTTAGTTC,sample,297128,293665,26775,266890,25103,241787,76991,4285,86404,10068,163395,64039,14060,3453,23937,15667
TGATTCCGCTTAGTTC,sample,254421,251107,22384,228723,25630,203093,75102,5125,65093,7596,140195,50177,12360,2596,27165,16511
TCTCAGGACTTAGTTC,sample,98375,96969,4834,92135,12237,79898,48426,3825,16836,2029,65262,8782,4407,1985,10978,8684
TGGATCAACTTAGTTC,sample,252415,249664,24057,225607,25650,199957,75023,5528,64524,7721,139547,47161,11844,2839,21971,17896
GGCAGGTTCTTAGTTC,sample,199468,197143,15196,181947,26559,155388,79688,5318,42106,4375,121794,23901,6576,1787,31060,18211
GATGCGTTCTTAGTTC,sample,186310,184237,14156,170081,25483,144598,80620,5334,35882,4015,116502,18747,6596,1651,38237,17785
ATGGCGTTCTTAGTTC,sample,149020,147210,10884,136326,23579,112747,70946,5660,21438,2588,92384,12115,5722,1851,25031,16528
TGCGCGTTCTTAGTTC,sample,271651,268291,27794,240497,21146,219351,71338,5441,79192,8273,150530,55107,12348,3034,19579,13051
AGCGTCTTCTTAGTTC,sample,249891,246651,27408,219243,19780,199463,58978,3767,72303,7165,131281,57250,11913,2210,21546,12366
CATTCGGTCTTAGTTC,sample,75203,74161,7432,66729,5957,60772,23788,1599,21166,2479,44954,11740,5130,1379,7495,4017
GAGATTCTCTTAGTTC,sample,63121,62284,4945,57339,10720,46619,24371,1789,12456,1415,36827,6588,4549,1628,10113,7538
CTAAGCATCTTAGTTC,sample,196720,194288,28915,165373,16614,148759,38962,2045,56990,6090,95952,44672,12683,2150,14265,10442
GGCGACGACTTAGTTC,sample,74311,73171,5756,67415,13239,54176,32820,1868,11906,1342,44726,6240,3091,1056,16029,9816
AGCAGAGCCTTAGTTC,sample,29267,28833,3248,25585,4508,21077,9222,625,6481,619,15703,4130,3270,1025,3605,2801
TGCGCTCCCTTAGTTC,sample,90933,89778,15388,74390,6803,67587,16222,883,26139,2805,42361,21538,9181,1517,5002,4034
GGCGTACCCTTAGTTC,sample,96010,94780,7309,87471,17796,69675,43879,2241,13969,1644,57848,7942,3527,1106,19797,12855
CAGCTTCGCTTAGTTC,sample,46131,45547,3792,41755,8542,33213,16407,1098,9245,1134,25652,5329,3608,1145,6861,5403
CGCGGTCGCTTAGTTC,sample,41622,41068,4120,36948,5098,31850,14531,956,10049,1148,24580,5166,3766,986,6216,3535
TCAATCAGCTTAGTTC,sample,57273,56466,6579,49887,5733,44154,20262,1225,13218,1431,33480,8018,4455,1184,8195,3991
ATTCTACCCTTAGTTC,sample,68509,67620,5914,61706,10360,51346,27448,1602,13494,1400,40942,7402,4350,1235,11516,7819
GACTAACCCTTAGTTC,sample,53758,52938,4809,48129,7527,40602,26150,1853,7494,1017,33644,4088,2198,963,10211,5712
AGCTGAATCGAGCTTC,sample,177979,175636,14048,161588,31667,129921,77028,3143,28948,3099,105976,17703,5493,1443,38777,22489
CTAGCGACCGAGCTTC,sample,209663,207074,17339,189735,24076,165659,70913,3377,54178,6506,125091,30685,8964,2018,29774,17758
TACGCGAGCGAGCTTC,sample,217119,213866,23276,190590,15476,175114,64297,4377,61196,6365,125493,38879,10634,2316,19398,10454
GACTCAAGCGAGCTTC,sample,182925,180371,19240,161131,17723,143408,49093,2996,48967,5695,98060,36657,10416,2112,18719,12046
ATACGTTCCGAGCTTC,sample,200340,197256,16982,180274,24612,155662,80408,5202,39595,4133,120003,26324,6773,1723,25091,17122
TCTCAGGACGAGCTTC,sample,199801,197766,13058,184708,22397,162311,83753,7463,41830,4366,125583,24899,8012,2380,20448,15776
TGGATCAACGAGCTTC,sample,162361,160251,8497,151754,20661,131093,73327,4883,35022,3701,108349,14160,4158,1364,27189,15534
GGCAGGTTCGAGCTTC,sample,232998,230408,14165,216243,22954,193289,102724,6377,54080,6614,156804,23494,7198,2307,29753,16062
CCATTCTTCGAGCTTC,sample,116233,114493,9768,104725,11428,93297,43955,2663,28625,3305,72580,14749,5395,1551,14774,7109
ACGCTTAACGAGCTTC,sample,161746,159683,8513,151170,22610,128560,83815,8144,22011,3672,105826,10918,3699,1457,23446,17509
AAGGTCTGCGAGCTTC,sample,116594,115580,5943,109637,24303,85334,56038,4906,16627,1670,72665,6093,3059,1268,24306,16861
CCTAGCGGCGAGCTTC,sample,51412,50786,4388,46398,6258,40140,17126,1181,12616,1605,29742,7612,4989,1442,6492,4347
GCTGCTTCCGAGCTTC,sample,87349,86267,7239,79028,10610,68418,34312,2305,18520,2223,52832,11058,5906,1729,10997,7478
TGCGCTCCCGAGCTTC,sample,112229,111172,8157,103015,18674,84341,45669,3072,20294,1685,65963,13621,5173,1820,18169,12760
GTCGCGAACGAGCTTC,sample,96278,94965,7975,86990,16316,70674,44258,2662,14526,2182,58784,7046,3366,1077,21199,11760
CGTCGAGGCGAGCTTC,sample,85856,84869,5106,79763,11539,68224,45622,3427,11809,1397,57431,5969,4175,2171,9328,7784
TTATGACGCGAGCTTC,sample,53724,53126,2676,50450,6612,43838,26923,1559,10315,1305,37238,3736,2458,1202,10988,5019
ATGAATAGCGAGCTTC,sample,52403,51620,5124,46496,6754,39742,22144,1198,9446,1071,31590,5883,3333,980,9935,4931
TCAATCAGCGAGCTTC,sample,59329,58578,3956,54622,7146,47476,25367,1427,12427,1178,37794,7077,4047,939,10893,5616
ATTCTACCCGAGCTTC,sample,26811,26431,2697,23734,5520,18214,7586,559,5595,620,13181,3854,3368,1180,1231,3457
GTCGTTCTGTAGAATG,sample,140859,138560,22160,116400,17364,99036,24747,1423,37704,4035,62451,31127,10842,1874,7515,10893
CGTCGCCAGTAGAATG,sample,150709,148429,10329,138100,19472,118628,71913,3792,24282,3091,96195,15550,5486,1387,27861,13986
TCATCGAAGTAGAATG,sample,193459,191437,15184,176253,26055,150198,67219,5587,42205,4049,109424,31138,9518,2504,16786,18519
ATTCAAGGGTAGAATG,sample,216258,214020,16140,197880,12832,185048,86292,4899,61650,7122,147942,25085,6899,2099,16252,10048
GCAACTAGGTAGAATG,Pos_Ctrl,25195,24902,967,23935,1224,22711,18729,2055,1327,198,20056,402,4338,5265,1328,426
CCGCAGTCGTAGAATG,sample,109290,106936,11711,95225,20033,75192,27222,2195,24892,2438,52114,18445,7158,1440,5656,12429
AGCGTCTTGTAGAATG,sample,175292,172530,13863,158667,16249,142418,68465,5213,38880,4796,107345,25064,6913,1778,18405,10966
AGCAGAGCGTAGAATG,sample,22978,22645,2912,19733,2896,16837,8427,562,4522,463,12949,2863,2854,1133,3013,1783
GCGTTACCGTAGAATG,sample,54169,53631,2275,51356,6277,45079,33426,2372,6253,1048,39679,1980,2907,2221,4932,4904
GTCGCGAAGTAGAATG,sample,66982,66036,6503,59533,6664,52869,23346,1359,16218,1919,39564,10027,4518,1222,9264,4890
CGCGGTCGGTAGAATG,Pos_Ctrl,39681,38960,2013,36947,1269,35678,30163,2766,1903,240,32066,606,4823,5544,2057,431
ATTCTACCGTAGAATG,sample,81891,81136,4912,76224,9885,66339,46218,4234,10559,1229,56777,4099,3466,2065,10078,7993
GACTAACCGTAGAATG,sample,80319,79314,7769,71545,10873,60672,34908,2158,13981,1587,48889,8038,3761,1254,11627,7802
CCTAACTAGTAGAATG,sample,24556,24188,2531,21657,3171,18486,8654,688,5226,643,13880,3275,2772,877,3137,2033
TTAACTGAGTAGAATG,sample,68788,68015,5176,62839,8524,54315,28789,1586,13598,1204,42387,9138,4145,1082,13479,6066
ATATGCAAGTAGAATG,sample,48310,47845,2743,45102,7258,37844,25973,1447,7541,853,33514,2030,1799,963,10257,5195
GACGTATGCAATAGTC,sample,68525,67677,6595,61082,6978,54104,22471,1463,18289,2503,40760,9378,4986,1405,8516,4593
GAGCCTCCCAATAGTC,sample,118879,117400,8368,109032,13875,95157,49250,2115,25024,2981,74274,15787,6106,1334,21132,9896
CTAGCGACCAATAGTC,sample,144950,143355,13888,129467,13334,116133,44775,3206,39365,4283,84140,24504,9436,2391,11072,8396
TCGAACGACAATAGTC,sample,108304,107169,11065,96104,9746,86358,35110,2050,26499,2452,61609,20247,7346,1345,11718,6442
CGTCGCCACAATAGTC,sample,102039,101009,6318,94691,18966,75725,43490,3152,17123,1718,60613,10242,5383,1689,12931,12941
TCATCGAACAATAGTC,sample,72024,71302,4177,67125,15022,52103,33356,2348,9785,1292,43141,5322,3693,1340,14025,10201
TCATACCACAATAGTC,sample,92248,91163,10298,80865,10472,70393,28531,1580,21728,2420,50259,16134,6738,1651,11346,6743
ATTCAAGGCAATAGTC,sample,116047,114850,9889,104961,13349,91612,37553,3053,28740,3331,66293,18935,7050,1767,15060,9692
GCAACTAGCAATAGTC,sample,27123,26785,2267,24518,2171,22347,8273,605,8765,961,17038,3743,3566,1291,2094,1434
GGCAGGTTCAATAGTC,sample,73669,72713,6319,66394,14375,52019,26118,1470,15310,1565,41428,7556,3846,1247,11141,9992
GATGCGTTCAATAGTC,sample,86338,85237,9348,75889,12648,63241,25723,1252,20052,2291,45775,13923,6462,1438,11173,8929
ATGGCGTTCAATAGTC,sample,79760,78830,9356,69474,8991,60483,25219,1525,18879,1982,44098,12878,6023,1397,11655,6350
TGCGCGTTCAATAGTC,sample,90980,89918,8805,81113,10982,70131,34414,2031,19895,2097,54309,11694,5172,1397,14169,7216
AGCGTCTTCAATAGTC,sample,52463,51900,4416,47484,6527,40957,22145,1619,12060,985,34205,4148,3099,1435,7491,4222
CATTCGGTCAATAGTC,sample,85357,84276,6670,77606,16370,61236,39502,2624,11845,1379,51347,5886,2979,1276,18401,11745
GCTGCTTCCAATAGTC,sample,85314,84080,9023,75057,9639,65418,31203,2096,18528,2115,49731,11476,5629,1506,12591,6862
TGCGCTCCCAATAGTC,sample,87996,86916,7652,79264,10681,68583,36250,2308,16762,1715,53012,11548,5181,1545,12886,7743
GCGTTACCCAATAGTC,sample,45572,44802,7447,37355,5003,32352,10488,851,11144,1159,21632,8710,4862,1059,3637,3102
CGTCGAGGCAATAGTC,sample,78127,77009,7973,69036,7933,61103,23134,1612,19693,2026,42827,14638,6175,1473,8338,5829
CGCGGTCGCAATAGTC,sample,61041,60146,5870,54276,6367,47909,20127,1441,14901,1773,35028,9667,4928,1098,8848,4575
TCTCCTAGCAATAGTC,sample,83106,82016,6688,75328,10752,64576,38925,2597,14389,1158,53314,7507,3648,1226,16485,8143
TAACGCCACAATAGTC,sample,56318,55454,6166,49288,4344,44944,16767,1301,16008,2187,32775,8681,4217,1129,3612,2543
GACTAACCCAATAGTC,sample,82043,80712,9603,71109,7626,63483,24627,1314,19296,2369,43923,15877,6163,1408,7949,4697
CGCGAGACCAATAGTC,sample,53981,52943,4452,48491,7289,41202,23862,1154,9491,1183,33353,5512,3398,1021,9741,5413
ATATGCAACAATAGTC,sample,68856,68218,4087,64131,9840,54291,34300,1949,10751,1626,45051,5665,3389,1220,13575,7003
GTCGTTCTCGTTACTC,Neg_Ctrl,5742,1873,1171,702,82,620,307,7,156,29,463,121,254,92,117,16
TCGAACGACGTTACTC,sample,158393,156763,9907,146856,29927,116929,76176,5945,20970,2427,97146,11411,5623,2292,23055,20789
CGTCGCCACGTTACTC,sample,221319,218915,11670,207245,46172,161073,105593,5583,32298,3542,137891,14057,3700,1584,41980,33454
TCATCGAACGTTACTC,sample,316529,313520,27459,286061,33638,252423,144734,7693,55241,6199,199975,38556,9884,3066,28591,23020
TCATACCACGTTACTC,sample,237863,234975,24560,210415,28022,182393,68529,3354,60411,7216,128940,42883,10705,2301,28300,18275
GCAACTAGCGTTACTC,sample,57446,56703,4028,52675,7365,45310,22784,1584,14793,1445,37577,4704,3765,1768,5425,5251
TACGCGAGCGTTACTC,Neg_Ctrl,3305,1271,592,679,79,600,283,21,158,19,441,119,218,78,121,22
CCGTACGCCGTTACTC,sample,95135,93872,10773,83099,8872,74227,27331,1963,26919,2951,54250,15063,6275,1861,9215,5559
GGCAGGTTCGTTACTC,sample,199640,197527,21754,175773,30209,145564,60683,3052,48016,5460,108699,28353,9414,2264,24401,19229
CCATTCTTCGTTACTC,sample,91352,90141,7673,82468,11183,71285,35340,2382,21750,2123,57090,9690,5400,2048,10975,8076
AGCGTCTTCGTTACTC,sample,108150,107039,8860,98179,14519,83660,42824,1970,24436,2680,67260,11750,5213,1735,16599,9662
CGGTTGGTCGTTACTC,sample,83834,82873,6064,76809,13883,62926,33009,1964,16871,2125,49880,8957,5082,1602,13498,9136
GCTCTTCTCGTTACTC,sample,169114,167142,11170,155972,34098,121874,81077,5690,21497,2773,102574,10837,4131,1963,35007,23948
GAGATTCTCGTTACTC,Neg_Ctrl,4012,1609,992,617,71,546,248,17,159,11,407,111,226,97,76,31
CTAAGCATCGTTACTC,sample,221796,219285,18863,200422,34769,165653,95414,4731,39959,5364,135373,20185,5745,2044,36904,25477
CCTAGCGGCGTTACTC,sample,93489,92241,10299,81942,13185,68757,34169,2682,17594,2077,51763,12235,6184,1689,12571,9330
TAACGAAGCGTTACTC,sample,29511,29040,2843,26197,4641,21556,11017,797,5868,657,16885,3217,2746,1101,3710,3082
GCTGCTTCCGTTACTC,sample,91156,89933,8750,81183,7657,73526,35947,1948,21760,2505,57707,11366,5343,1744,10264,5007
GCGTTACCCGTTACTC,sample,47014,46175,3948,42227,7655,34572,20224,1547,7902,758,28126,4141,3263,1236,6985,5279
GGCGTACCCGTTACTC,sample,150312,148534,14877,133657,17029,116628,51546,4499,39046,5002,90592,16535,6561,1781,15252,10414
GTCGCGAACGTTACTC,sample,264625,260384,48078,212306,17339,194967,39101,2113,79440,8425,118541,65888,15318,2811,13014,8539
CGCGGTCGCGTTACTC,sample,99456,97753,6445,91308,16907,74401,42472,2283,18468,1686,60940,9492,4158,1420,16010,12201
TTATGACGCGTTACTC,Neg_Ctrl,2838,1053,632,421,57,364,159,17,120,11,279,57,159,57,68,13
TCAATCAGCGTTACTC,sample,339078,335186,39574,295612,15671,279941,105832,6240,108507,14191,214339,45171,12538,2848,11218,7166
CGTAGAACCGTTACTC,sample,98261,96808,7470,89338,12818,76520,50672,3520,12859,1522,63531,7947,4843,2272,11424,9037
GCGCAATACGTTACTC,sample,103027,101652,5736,95916,17960,77956,55969,4177,11050,1828,67019,4932,3097,1593,17402,13416
TTAACTGACGTTACTC,sample,18061,17885,1837,16048,2925,13123,4031,179,5005,497,9036,3411,3010,628,1514,1657
TCTAGGTTTGGACTGC,sample,54482,53614,6568,47046,6326,40720,16178,1138,13419,1360,29597,8625,4320,1141,7419,3876
CATAATGGTGGACTGC,sample,112324,111105,8552,102553,14918,87635,54861,3479,16949,1973,71810,10373,5838,2761,9017,9788
TATACGGATGGACTGC,sample,49539,48773,2939,45834,13841,31993,18216,1261,8157,1296,26373,3063,3267,1626,5376,8497
GAGCCTCCTGGACTGC,sample,107726,106468,6909,99559,11686,87873,44604,2246,26795,3285,71399,10943,5173,1988,12793,8286
CATACTCCTGGACTGC,sample,78015,76754,8616,68138,6142,61996,20950,1308,23680,2664,44630,13394,6657,1715,6277,3862
TCGAACGATGGACTGC,sample,79641,78672,7898,70774,9132,61642,26259,1973,20074,2527,46333,10809,5667,1837,7062,6312
ATTCAAGGTGGACTGC,sample,171620,169462,10567,158895,17928,140967,80670,6355,32841,2980,113511,18121,6323,1708,22939,13208
GCAACTAGTGGACTGC,sample,49299,48618,2971,45647,6165,39482,25060,2057,7898,856,32958,3611,3454,1908,6280,4090
TACGCGAGTGGACTGC,sample,164474,162945,15427,147518,20640,126878,56176,3027,38981,3507,95157,25187,8787,2052,20542,13652
ATACGTTCTGGACTGC,sample,160360,157837,20398,137439,12065,125374,36066,2039,49167,4699,85233,33403,9825,2221,11011,7810
CCGTACGCTGGACTGC,sample,44936,44271,3646,40625,7281,33344,19039,1191,7741,1034,26780,4339,3215,1123,8523,5291
TGCGCGTTTGGACTGC,sample,74717,73735,4139,69596,17387,52209,33633,2157,10356,1472,43989,4591,3373,1522,12636,11700
CCATTCTTTGGACTGC,sample,133712,132181,11076,121105,13383,107722,48326,2938,35403,4922,83729,16133,6394,1825,15773,9651
ACGCTTAATGGACTGC,sample,137542,136165,8278,127887,16837,111050,63595,4674,25351,2776,88946,14654,7017,2540,17700,11893
CATTCGGTTGGACTGC,sample,133220,131534,7794,123740,20680,103060,59992,2448,23474,2768,83466,14378,5423,1452,26317,15046
TAGCGAGTTGGACTGC,sample,143926,142260,17039,125221,13043,112178,35359,2171,39723,4186,75082,30739,9620,2161,12266,8682
GCTCTTCTTGGACTGC,sample,161668,159911,11965,147946,22532,125414,72660,5638,28880,3869,101540,14367,6254,2235,20680,15827
AAGGTCTGTGGACTGC,sample,160426,158883,11245,147638,20339,127299,73835,5840,27333,2877,101168,17414,7466,2948,16312,14181
CTAACCGGTGGACTGC,sample,72107,71073,4250,66823,12533,54290,42632,2907,6204,1402,48836,1145,1438,968,19372,9354
GCCTATTCTGGACTGC,sample,103958,102348,11216,91132,10321,80811,29674,2414,25902,2835,55576,19986,7560,1325,11454,6804
TGCGCTCCTGGACTGC,sample,52796,51909,3628,48281,7636,40645,24627,1624,9284,1099,33911,4011,3117,1218,10458,5385
ATACCGCCTGGACTGC,sample,51621,50716,7818,42898,6058,36840,9894,786,14057,1567,23951,10536,5910,1171,3283,3809
GGCGTACCTGGACTGC,sample,48366,47760,4496,43264,5641,37623,18769,1248,11571,1210,30340,4825,3476,1385,5047,3935
CGCGGTCGTGGACTGC,sample,34695,34146,2141,32005,3935,28070,15805,1027,7475,937,23280,2826,2325,1148,5067,2832
TCAATCAGTGGACTGC,sample,49775,48931,5515,43416,4602,38814,17257,952,11777,1240,29034,7588,4003,823,8469,3089
AGATACTATGGACTGC,sample,79270,77961,8794,69167,9277,59890,28990,2294,15800,2015,44790,10791,5393,1656,7319,6528
AACCGGTTCCTTGAGC,sample,202790,199980,25467,174513,21386,153127,53865,4440,53211,6611,107076,35000,9585,2378,16106,14531
CTGGTCTTCCTTGAGC,sample,194622,191813,20131,171682,22182,149500,64283,3163,45480,4921,109763,31653,9044,2162,29082,15338
GTCGTTCTCCTTGAGC,sample,213735,211032,25888,185144,27987,157157,71846,4693,45328,5170,117174,30120,9625,2672,24904,19094
AGCTGAATCCTTGAGC,sample,242418,238480,32983,205497,27359,178138,75787,4667,52613,5491,128400,39580,10481,2582,23929,17831
GACGTATGCCTTGAGC,sample,186321,183882,18534,165348,20477,144871,67071,3026,46317,5260,113388,23197,6677,1806,28554,14820
GAGCCTCCCCTTGAGC,Pos_Ctrl,135572,133070,9143,123927,5082,118845,100961,8677,6281,895,107242,2031,6922,9787,9396,1544
CATACTCCCCTTGAGC,sample,267167,262652,44101,218551,19621,198930,28622,1602,85447,8907,114069,74352,15623,2831,7393,11120
GCAACTAGCCTTGAGC,sample,51244,50416,4157,46259,9666,36593,19251,1063,9612,1300,28863,5367,4211,1527,6316,6813
CCGTACGCCCTTGAGC,sample,136811,134937,13507,121430,15817,105613,55342,3327,26107,3515,81449,17322,7341,2577,11146,10318
GGCAGGTTCCTTGAGC,Pos_Ctrl,150432,148429,9840,138589,5892,132697,112295,10432,6685,905,118980,2380,7040,10099,9840,1831
TAGCGAGTCCTTGAGC,sample,240765,237774,21104,216670,29880,186790,95998,5164,50514,5521,146512,29593,8587,1847,40726,20434
CCTAGCGGCCTTGAGC,sample,126248,124865,9670,115195,18634,96561,56216,3360,22253,2926,78469,11806,4612,1409,21875,13026
GGCGACGACCTTGAGC,sample,119693,118202,10717,107485,15332,92153,47560,2628,26949,2784,74509,12232,4813,1560,17250,11565
GCTGCTTCCCTTGAGC,Pos_Ctrl,60618,59421,4008,55413,1988,53425,45254,4005,2913,322,48167,931,5541,6654,3766,699
TGCGCTCCCCTTGAGC,sample,161534,159638,16898,142740,19511,123229,55680,4137,35448,4389,91128,23575,7975,1942,15604,13419
CGTCGAGGCCTTGAGC,sample,70243,69011,9094,59917,7515,52402,21888,1613,16542,1689,38430,10670,5364,1217,8615,5041
CGCGGTCGCCTTGAGC,sample,77688,76768,5927,70841,13911,56930,34767,2283,12375,1437,47142,6068,3733,1516,12941,10105
TTATGACGCCTTGAGC,sample,189403,187230,22494,164736,15445,149291,43641,2359,56105,5322,99746,41864,11071,2320,13149,9912
TCTCCTAGCCTTGAGC,sample,115839,114420,7694,106726,18224,88502,52989,3423,19477,2370,72466,10243,4266,1229,24537,13363
ATTCTACCCCTTGAGC,sample,83942,82769,5818,76951,11996,64955,36419,2301,16203,1680,52622,8352,5239,2006,9660,7872
CGTAGAACCCTTGAGC,sample,76829,75227,8235,66992,9927,57065,27095,2140,16401,1780,43496,9649,5071,1296,6293,6642
CCTAACTACCTTGAGC,Pos_Ctrl,120865,118569,6976,111593,4267,107326,90941,8734,5332,711,96273,1608,6364,9093,6204,1234
TTAACTGACCTTGAGC,sample,90448,89409,8880,80529,6948,73581,39311,2599,17978,1906,57289,11787,5754,2344,7234,4554
ATATGCAACCTTGAGC,sample,83597,82922,5984,76938,15277,61661,34714,2711,14910,1568,49624,7758,5234,1997,9758,10143
AGAGTTCTCGATATCC,sample,252125,249412,29344,220068,35196,184872,73367,3985,55991,6145,129358,45384,12666,2640,25986,23497
GCAACTAGCGATATCC,sample,69351,68277,4367,63910,11017,52893,26221,1505,14270,1776,40491,9121,5218,1271,10627,7262
TACGCGAGCGATATCC,sample,193229,191693,12438,179255,27432,151823,90051,5241,36650,3609,126701,16272,6317,1834,36873,19023
ATACGTTCCGATATCC,sample,262648,260344,21109,239235,42590,196645,102319,4620,51031,5881,153350,32794,10147,2328,39235,30774
ATGGCGTTCGATATCC,sample,247530,244927,14720,230207,33806,196401,105699,5288,47179,5935,152878,32300,7591,2161,38573,22625
AGCGTCTTCGATATCC,sample,179770,178120,10087,168033,27322,140711,87215,5476,30833,3161,118048,14026,4658,1920,34079,20642
TAGCGAGTCGATATCC,sample,197287,195348,13415,181933,23490,158443,81145,4419,42419,4933,123564,25527,7518,1644,34700,15432
GCTCTTCTCGATATCC,sample,198615,196505,10647,185858,31416,154442,109509,8686,23499,4677,133008,8071,3432,1458,40073,23536
AAGGTCTGCGATATCC,sample,114596,113389,12246,101143,14745,86398,39982,2878,25496,2657,65478,15385,7126,1829,12660,10151
GGCGACGACGATATCC,sample,124189,122846,8384,114462,18952,95510,57039,3491,20317,2067,77356,12596,5339,1650,23092,13610
AGCAGAGCCGATATCC,sample,143486,141838,13670,128168,23622,104546,55877,3768,23870,3840,79747,17191,5567,1735,21512,15525
ATACCGCCCGATATCC,sample,109358,107911,11346,96565,12902,83663,40404,2041,23096,2066,63500,16056,6409,1175,22374,9211
CGTCGAGGCGATATCC,sample,78013,77099,5623,71476,7283,64193,34628,2149,18420,1696,53048,7300,4141,1649,10275,5385
CAGCTTCGCGATATCC,sample,141788,140053,13341,126712,17653,109059,53166,3920,29331,2609,82497,20033,6670,1574,20260,12509
TAACGCCACGATATCC,sample,81209,80324,6904,73420,6619,66801,33386,2060,18575,2655,51961,10125,4752,1640,10072,4575
GACTAACCCGATATCC,sample,97756,96249,8989,87260,11345,75915,34941,2684,22325,2478,57266,13487,5904,1446,12815,8130
CGCGAGACCGATATCC,sample,102241,100987,9546,91441,7352,84089,34915,2977,27351,3524,62266,15322,6038,1789,9814,4910
CCTAACTACGATATCC,sample,121267,119894,7711,112183,18541,93642,55923,2920,21255,2475,77178,11069,4168,1210,25829,14271
TTAACTGACGATATCC,sample,53613,53000,4570,48430,5556,42874,20918,1238,12654,1280,33572,6784,4067,1207,7375,3978
GACGTATGATCTGACC,sample,104457,103009,14307,88702,8447,80255,20489,1344,31106,3599,51595,23717,9451,1784,6192,5007
TATACGGAATCTGACC,sample,114622,113614,5654,107960,19630,88330,65151,2462,13991,1319,79142,5407,2714,1391,29452,14000
CATACTCCATCTGACC,Neg_Ctrl,3156,1216,697,519,92,427,202,9,115,14,317,87,175,67,70,15
CTAGCGACATCTGACC,sample,174421,172106,21264,150842,18200,132642,45422,2932,44310,4394,89732,35584,10427,2002,17842,11539
GGTAGAGAATCTGACC,sample,165992,164158,15085,149073,19976,129097,50794,3018,41931,4252,92725,29102,8996,1964,21317,14058
CGTCGCCAATCTGACC,sample,66962,66029,9053,56976,8357,48619,16456,1387,17591,2040,34047,11145,5803,1791,2880,5255
TCATCGAAATCTGACC,sample,123163,121954,8512,113442,18201,95241,57305,3367,21515,2606,78820,10448,5569,2019,18767,12867
ATTCAAGGATCTGACC,sample,27901,27696,2504,25192,3861,21331,9359,747,6379,705,15738,4141,3259,980,3488,2470
GCAACTAGATCTGACC,sample,45824,45024,4156,40868,5068,35800,14877,816,11627,1388,26504,7092,4406,1134,6783,3938
TACGCGAGATCTGACC,sample,64618,63772,8347,55425,7476,47949,17687,1179,16811,1620,34498,10652,5379,1142,7703,4746
CCGCAGTCATCTGACC,sample,110420,109029,11671,97358,16633,80725,39418,2482,22723,2511,62141,13591,6442,1766,13111,11261
GGCAGGTTATCTGACC,sample,121654,120206,10681,109525,14544,94981,48894,3761,26343,2979,75237,13004,5837,2053,11972,10552
GATGCGTTATCTGACC,Neg_Ctrl,3235,1263,690,573,77,496,175,20,166,17,341,118,170,61,52,15
AGCGTCTTATCTGACC,sample,109816,108446,11919,96527,12193,84334,31531,2129,29131,2779,60662,18764,7405,1716,11601,8062
CATTCGGTATCTGACC,sample,294941,291721,41091,250630,20754,229876,50547,4096,91493,9708,142040,74032,16017,3274,17940,12413
GCTCTTCTATCTGACC,sample,180149,178223,15534,162689,16427,146262,66577,3965,44394,5132,110971,26194,8512,1990,17873,10545
CTAACCGGATCTGACC,sample,89169,88281,9741,78540,10292,68248,28013,1568,20929,2162,48942,15576,6243,1324,12071,6661
GGCGACGAATCTGACC,sample,67389,66673,5682,60991,9228,51763,29610,1624,12351,1408,41961,6770,3958,1332,12175,6309
GCCTATTCATCTGACC,Neg_Ctrl,2462,808,494,314,35,279,131,6,84,8,215,50,118,37,50,5
GGCGTACCATCTGACC,sample,53112,52173,5780,46393,7739,38654,19931,1052,10329,1240,30260,6102,3886,970,8998,5415
CGTCGAGGATCTGACC,sample,48024,47469,1998,45471,11320,34151,26008,1602,4502,732,30510,1307,1349,753,10981,7742
GCGCAATAATCTGACC,Neg_Ctrl,748,275,125,150,16,134,63,4,38,5,101,24,63,27,14,1
ATATGCAAATCTGACC,sample,90781,90140,3103,87037,17031,70006,57401,3242,6148,571,63549,2644,2151,1566,16279,11578
AACCGGTTCTTCTTAC,sample,129468,128218,13238,114980,14128,100852,32892,2050,36281,3917,69173,25712,8191,1877,8926,8310
TCTAGGTTCTTCTTAC,sample,150124,148493,14734,133759,15178,118581,55587,3874,33695,3575,89282,21850,8213,2486,12652,10126
GTCGTTCTCTTCTTAC,sample,146658,144847,9076,135771,24528,111243,68349,4249,24438,3065,92787,11142,4227,1461,29875,17587
AGAGTTCTCTTCTTAC,sample,183016,180960,19984,160976,21167,139809,50995,3058,45988,4674,96983,35094,9243,1912,25001,14512
CATAATGGCTTCTTAC,sample,137940,136336,11035,125301,20780,104521,60355,3762,24055,2728,84410,13621,5298,1621,24811,14873
GGAGAAGCCTTCTTAC,sample,102837,101264,11852,89412,11235,78177,28522,1737,27236,2764,55758,17918,6940,1373,11301,7262
CTAGCGACCTTCTTAC,sample,121332,119686,15175,104511,9795,94716,35565,2070,34674,3425,70239,18982,6744,2073,8975,5607
TGATTCCGCTTCTTAC,sample,222625,220142,11204,208938,26516,182422,134107,9774,25416,3503,159523,9622,4641,2252,24462,20540
GCAACTAGCTTCTTAC,sample,41715,40790,3227,37563,4958,32605,16317,1179,9830,1070,26147,4209,3387,1184,5028,3143
TACGCGAGCTTCTTAC,sample,143267,141513,16806,124707,13190,111517,41179,2376,38153,4292,79332,25517,8566,1570,15929,8676
GACTCAAGCTTCTTAC,sample,200879,198491,16682,181809,19740,162069,88693,4406,38933,4210,127626,25827,7438,2018,22614,13289
ATACGTTCCTTCTTAC,sample,128086,126462,16187,110275,14875,95400,43039,2659,26916,3196,69955,19590,7052,1615,15908,9892
GGCAGGTTCTTCTTAC,sample,276055,272972,23570,249402,25051,224351,99328,5605,72138,7404,171466,39876,9877,2209,36410,17544
CGGTTGGTCTTCTTAC,sample,198074,195227,23406,171821,16792,155029,50197,2859,55930,5832,106127,40211,9765,2089,20256,9100
CATTCGGTCTTCTTAC,sample,151029,148887,16040,132847,15991,116856,45980,3074,36781,3787,82761,27234,7967,1570,18723,10598
CTAACCGGCTTCTTAC,sample,126225,124708,12541,112167,11922,100245,45504,2306,32238,3277,77742,16920,7059,1768,16962,7969
TAACGAAGCTTCTTAC,sample,122015,120653,8976,111677,17708,93969,54442,2424,21932,2305,76374,12866,4152,1489,21463,12535
AGCAGAGCCTTCTTAC,sample,44365,43591,5370,38221,4528,33693,15243,866,10680,1187,25923,5717,4024,1095,5752,3295
GCGTTACCCTTCTTAC,sample,79044,77805,7289,70516,10799,59717,32815,1943,14275,1694,47090,8990,4535,1315,13775,7721
CAGCTTCGCTTCTTAC,sample,96335,95144,7729,87415,14686,72729,38410,2830,18766,2301,57176,10422,4989,1459,16554,10160
CGCGGTCGCTTCTTAC,sample,55449,54620,6653,47967,5782,42185,17592,1107,12989,1452,30581,9045,4759,1086,7057,3851
CCTAACTACTTCTTAC,sample,72926,72028,5039,66989,9314,57675,33777,2666,13835,1598,47612,5799,3830,1445,13013,6903
AACCGGTTACTTCTAC,sample,86526,85562,6059,79503,14973,64530,34861,1604,16675,1508,51536,9882,4251,1170,15296,10073
TCTAGGTTACTTCTAC,sample,76667,75937,3822,72115,12903,59212,40545,2528,10753,1695,51298,3691,2424,1317,15067,9355
AGAGTTCTACTTCTAC,sample,87634,86565,8296,78269,11642,66627,34151,2687,16819,2102,50970,10868,5741,2091,8955,8221
GACGTATGACTTCTAC,sample,107366,105967,10920,95047,15595,79452,40042,2238,19491,2230,59533,15451,5204,1406,18796,10034
GGAGAAGCACTTCTAC,sample,110566,109393,15307,94086,7947,86139,25637,1853,34685,3620,60322,20344,8036,1870,8681,4952
GGTAGAGAACTTCTAC,sample,160084,158019,9978,148041,17308,130733,79386,6411,28748,2856,108134,13332,5504,2034,15935,12419
TCATCGAAACTTCTAC,sample,179051,176744,21915,154829,16852,137977,55670,3839,42994,5329,98664,30145,8660,1774,17655,11162
TACGCGAGACTTCTAC,sample,92519,91262,9472,81790,14447,67343,29461,2673,21218,2342,50679,11649,5175,1149,8657,9380
CCGCAGTCACTTCTAC,sample,89638,88409,8655,79754,10163,69591,31839,2560,20261,1985,52100,12946,5249,1521,7306,6388
CCGTACGCACTTCTAC,sample,57570,56691,6935,49756,5116,44640,18797,1212,13166,1468,31963,9997,4678,1027,5948,3339
TGGATCAAACTTCTAC,sample,126240,124478,8641,115837,15894,99943,55360,3935,24297,3174,79657,13177,4150,1206,22613,11433
GATGCGTTACTTCTAC,sample,168664,166552,19671,146881,14872,132009,48430,2497,42809,4809,91239,33464,8762,1620,15624,9055
ATGGCGTTACTTCTAC,sample,203189,201011,18995,182016,17967,164049,71584,6174,49014,5085,120598,32192,8599,1963,24807,11909
GAGATTCTACTTCTAC,sample,83573,82752,8369,74383,6498,67885,26024,1616,24277,2954,50301,13014,5989,1780,6987,3957
CTAACCGGACTTCTAC,sample,87475,86632,9199,77433,11120,66313,29500,1451,19393,1915,48893,14054,6002,1353,12957,6962
GGCGACGAACTTCTAC,sample,61356,60653,5145,55508,9075,46433,24190,1862,12420,1179,36610,6782,4489,1482,8612,6087
ATACCGCCACTTCTAC,sample,66433,65649,5813,59836,9714,50122,27506,1512,12427,1339,39933,7338,4493,1378,9910,6771
GCGTTACCACTTCTAC,sample,57327,56477,4105,52372,7576,44796,26918,1555,11145,1240,38063,3938,3171,1367,8423,5420
TAACGCCAACTTCTAC,sample,393,385,42,343,62,281,136,0,73,5,209,67,103,49,52,37
GACTAACCACTTCTAC,sample,220,214,22,192,29,163,64,3,58,3,122,35,76,33,21,21
AGATACTAACTTCTAC,sample,2507,2433,193,2240,346,1894,1293,156,280,48,1573,117,563,447,258,238
CCTAACTAACTTCTAC,sample,33710,33369,2504,30865,4384,26481,14368,1079,6761,743,21129,3530,2657,1116,4548,2912
GCGCAATAACTTCTAC,sample,49856,49373,3362,46011,4249,41762,20344,1598,12074,1148,32418,6598,3933,1380,5433,2856
AACCGGTTAGAAGTAA,sample,287377,284865,32566,252299,32425,219874,79314,5055,72936,8077,152250,54492,13336,2869,31685,19546
GTCGTTCTAGAAGTAA,sample,159888,158294,11390,146904,34308,112596,67225,4698,23810,2844,91035,14019,6377,2392,24507,22260
CATACTCCAGAAGTAA,sample,216903,214545,13976,200569,23547,177022,76514,5273,53529,5376,130043,36330,9985,2599,20377,16162
CTAGCGACAGAAGTAA,sample,224077,221387,15425,205962,21937,184025,89610,7512,53009,8206,142619,25688,6819,2400,20653,13452
TCATACCAAGAAGTAA,sample,310386,307100,29677,277423,21013,256410,97823,7034,87122,10845,184945,53586,9893,2842,19026,12743
TGATTCCGAGAAGTAA,sample,264558,261957,20041,241916,34365,207551,97921,8660,57809,5992,155730,37169,8898,2226,38529,24511
GCAACTAGAGAAGTAA,sample,79849,78237,5848,72389,9541,62848,35194,2232,15726,1680,50920,8016,4862,1345,13663,6906
TCTCAGGAAGAAGTAA,sample,219484,216673,16659,200014,23175,176839,91967,6832,43261,4843,135228,29936,8659,2167,20548,15190
TGCGCGTTAGAAGTAA,sample,305372,302099,27232,274867,29837,245030,88611,4352,81265,8784,169876,62018,12309,2686,28170,18107
GCTCTTCTAGAAGTAA,sample,726,713,57,656,86,570,315,11,130,23,445,91,204,99,137,76
TAACGAAGAGAAGTAA,sample,81031,80235,4373,75862,11352,64510,43304,1976,12875,1252,56179,5103,3529,1358,18639,8431
GCCTATTCAGAAGTAA,sample,122493,121332,7910,113422,21690,91732,50857,3543,23228,2255,74085,11849,4974,1537,16200,15511
GGCGTACCAGAAGTAA,sample,145266,143785,13165,130620,16173,114447,45528,3234,35215,3517,80743,26953,8266,1894,17964,11284
CGTCGAGGAGAAGTAA,sample,95163,94201,8877,85324,11871,73453,26689,1723,24543,2399,51232,18099,7111,1524,8925,7404
AAGTAGAGAGAAGTAA,sample,307,300,41,259,35,224,109,7,52,9,161,47,96,46,35,22
TCAATCAGAGAAGTAA,sample,363,353,36,317,46,271,125,8,83,5,208,50,118,46,40,32
TAACGCCAAGAAGTAA,sample,474,445,56,389,42,347,175,7,81,10,256,74,121,60,72,30
GACTAACCAGAAGTAA,sample,376,358,36,322,29,293,146,11,86,8,232,42,115,59,62,20
CGCGAGACAGAAGTAA,sample,336,326,28,298,34,264,107,4,91,7,198,55,123,46,34,31
CGTAGAACAGAAGTAA,sample,469,459,56,403,46,357,170,8,89,17,259,73,143,74,58,29
AGATACTAAGAAGTAA,sample,583,565,85,480,57,423,203,16,131,8,334,65,174,81,71,39
CCTAACTAAGAAGTAA,sample,403,393,41,352,59,293,147,24,61,8,208,53,121,71,37,46
TTAACTGAAGAAGTAA,sample,143193,141921,10651,131270,13289,117981,59840,4087,31123,3322,90963,19609,7834,2214,14252,8659
ATATGCAAAGAAGTAA,sample,69502,69021,5773,63248,9585,53663,26972,2540,14212,1357,41184,8582,4896,1770,4950,5688
Short,Non_sample,0,NA,NA,NA,NA,NA,NA,NA,NA,NA,NA,NA,NA,NA,NA,NA
Unselected,Non_sample,1145935,NA,NA,NA,NA,NA,NA,NA,NA,NA,NA,NA,NA,NA,NA,NA
Undetermined,Non_sample,156825278,NA,NA,NA,NA,NA,NA,NA,NA,NA,NA,NA,NA,NA,NA,NA
